Season,GameID,Date,Game,Player,PlayerID,Gm#,Team,Is_Home,Opp,PTS,REB,AST,STL,BLK,TOV,MP,OffREB,DefREB,FG,FGA,3P,3PA,FT,FTA,PF,BLK_STL,REB_AST,PTS_AST,PTS_REB,PTS_REB_AST,FANTASY
2024-25,202411090CLE,11/9/2024,CLE vs BRK,Jalen Wilson,wilsoja03,53,BRK,0,CLE,2,3,1,0,0,2,10.01666667,2,1,1,3,0,2,0,0,1,0,4,3,5,6,5.1
2024-25,202411090CLE,11/9/2024,CLE vs BRK,Keon Johnson,johnske07,14,BRK,0,CLE,6,4,2,0,0,3,12.23333333,1,3,2,7,2,6,0,0,0,0,6,8,10,12,10.8
2024-25,202411090ATL,11/9/2024,ATL vs CHI,Larry Nance Jr.,nancela02,67,ATL,1,CHI,6,2,2,0,0,0,13.88333333,0,2,2,3,1,1,1,2,4,0,4,8,8,10,11.4
2024-25,202411090LAC,11/9/2024,LAC vs TOR,Jamison Battle,battlja01,9,TOR,0,LAC,3,2,1,0,0,0,13.95,0,2,1,5,1,5,0,0,2,0,3,4,5,6,6.9
2024-25,202411090ATL,11/9/2024,ATL vs CHI,Julian Phillips,phillju01,50,CHI,0,ATL,10,4,0,2,1,0,14.15,4,0,4,8,2,3,0,0,2,3,4,10,14,14,23.8
2024-25,202411090CLE,11/9/2024,CLE vs BRK,Noah Clowney,clownno01,31,BRK,0,CLE,2,3,1,2,1,1,14.35,0,3,1,3,0,2,0,0,2,3,4,3,5,6,15.1
2024-25,202411090ATL,11/9/2024,ATL vs CHI,Dalen Terry,terryda01,69,CHI,0,ATL,9,4,1,0,1,0,14.36666667,2,2,2,4,1,3,4,4,1,1,5,10,13,14,18.3
2024-25,202411090SAS,11/9/2024,SAS vs UTA,Patty Mills,millspa02,41,UTA,0,SAS,5,1,0,0,0,2,14.46666667,0,1,2,3,1,2,0,0,1,0,1,5,6,6,4.2
2024-25,202411090CLE,11/9/2024,CLE vs BRK,Georges Niang,niangge01,93,CLE,1,BRK,8,2,1,0,1,1,14.71666667,0,2,4,6,0,1,0,0,3,1,3,9,10,11,13.9
2024-25,202411090CLE,11/9/2024,CLE vs BRK,Isaac Okoro,okorois01,80,CLE,1,BRK,3,1,1,0,0,0,14.91666667,0,1,1,5,0,3,1,2,1,0,2,4,4,5,5.7
2024-25,202411090SAS,11/9/2024,SAS vs UTA,Zach Collins,colliza01,79,SAS,1,UTA,5,3,4,1,0,0,15.31666667,1,2,2,5,1,1,0,0,4,1,7,9,8,12,17.6
2024-25,202411090ATL,11/9/2024,ATL vs CHI,Jalen Smith,smithja04,70,CHI,0,ATL,10,5,2,0,1,1,16.55,1,4,4,10,2,5,0,0,2,1,7,12,15,17,21
2024-25,202411090LAC,11/9/2024,LAC vs TOR,Nicolas Batum,batumni01,70,LAC,1,TOR,7,3,2,0,2,0,16.81666667,1,2,3,5,1,3,0,0,0,2,5,9,10,12,19.6
2024-25,202411090SAS,11/9/2024,SAS vs UTA,Cody Williams,willico04,9,UTA,0,SAS,0,1,1,1,1,2,16.98333333,0,1,0,3,0,2,0,0,0,2,2,1,1,2,6.7
2024-25,202411090CLE,11/9/2024,CLE vs BRK,Dean Wade,wadede01,63,CLE,1,BRK,3,4,1,1,0,0,17.73333333,0,4,1,4,1,3,0,0,1,1,5,4,7,8,12.3
2024-25,202411090CLE,11/9/2024,CLE vs BRK,Shake Milton,miltosh01,56,BRK,0,CLE,3,0,1,1,0,0,17.8,0,0,1,3,1,3,0,0,2,1,1,4,3,4,7.5
2024-25,202411090CLE,11/9/2024,CLE vs BRK,Ty Jerome,jeromty01,13,CLE,1,BRK,4,1,5,2,0,1,18.08333333,0,1,2,4,0,1,0,0,1,2,6,9,5,10,17.7
2024-25,202411090ATL,11/9/2024,ATL vs CHI,Garrison Mathews,mathega01,76,ATL,1,CHI,8,1,0,1,0,0,18.56666667,0,1,2,5,1,3,3,4,1,1,1,8,9,9,12.2
2024-25,202411090SAS,11/9/2024,SAS vs UTA,Walker Kessler,kesslwa01,73,UTA,0,SAS,7,5,0,0,1,2,18.86666667,2,3,3,4,0,0,1,2,1,1,5,7,12,12,14
2024-25,202411090LAC,11/9/2024,LAC vs TOR,Derrick Jones Jr.,jonesde02,86,LAC,1,TOR,4,1,0,0,1,0,18.93333333,1,0,1,5,0,3,2,2,5,1,1,4,5,5,8.2
2024-25,202411090ATL,11/9/2024,ATL vs CHI,Keaton Wallace,wallake01,9,ATL,1,CHI,4,1,2,0,1,1,18.93333333,0,1,2,5,0,2,0,0,2,1,3,6,5,7,10.2
2024-25,202411090SAS,11/9/2024,SAS vs UTA,Blake Wesley,weslebl01,70,SAS,1,UTA,5,0,2,1,0,2,18.96666667,0,0,2,4,0,0,1,1,1,1,2,7,5,7,9
2024-25,202411090LAC,11/9/2024,LAC vs TOR,Kris Dunn,dunnkr01,76,LAC,1,TOR,7,3,0,1,0,1,19.88333333,0,3,3,3,1,1,0,0,1,1,3,7,10,10,12.6
2024-25,202411090CLE,11/9/2024,CLE vs BRK,Sam Merrill,merrisa01,72,CLE,1,BRK,6,2,2,1,0,0,20,0,2,2,4,2,4,0,0,2,1,4,8,8,10,14.4
2024-25,202411090CLE,11/9/2024,CLE vs BRK,Ziaire Williams,willizi02,61,BRK,0,CLE,0,3,0,1,0,2,20.23333333,0,3,0,3,0,2,0,0,2,1,3,0,3,3,4.6
2024-25,202411090CLE,11/9/2024,CLE vs BRK,Jarrett Allen,allenja01,88,CLE,1,BRK,4,3,0,1,1,3,21.11666667,1,2,1,6,0,0,2,2,2,2,3,4,7,7,10.6
2024-25,202411090LAC,11/9/2024,LAC vs TOR,Kevin Porter Jr.,porteke02,10,LAC,1,TOR,15,6,5,1,0,2,21.56666667,0,6,5,9,2,2,3,6,2,1,11,20,21,26,30.7
2024-25,202411090SAS,11/9/2024,SAS vs UTA,Devin Vassell,vassede01,69,SAS,1,UTA,21,1,2,0,0,3,21.73333333,0,1,8,13,3,6,2,2,5,0,3,23,22,24,22.2
2024-25,202411090LAC,11/9/2024,LAC vs TOR,Davion Mitchell,mitchda01,82,TOR,0,LAC,7,4,4,0,0,0,21.93333333,2,2,2,9,1,5,2,4,2,0,8,11,11,15,17.8
2024-25,202411090SAS,11/9/2024,SAS vs UTA,Johnny Juzang,juzanjo01,26,UTA,0,SAS,10,4,0,0,1,0,22.15,0,4,3,4,1,2,3,3,2,1,4,10,14,14,17.8
2024-25,202411090ATL,11/9/2024,ATL vs CHI,Onyeka Okongwu,okongon01,64,ATL,1,CHI,8,7,1,0,0,0,22.41666667,1,6,2,5,1,1,3,4,1,0,8,9,15,16,17.9
2024-25,202411090LAC,11/9/2024,LAC vs TOR,Amir Coffey,coffeam01,80,LAC,1,TOR,6,1,0,0,0,0,23.08333333,0,1,2,6,1,2,1,2,1,0,1,6,7,7,7.2
2024-25,202411090LAC,11/9/2024,LAC vs TOR,Chris Boucher,bouchch01,60,TOR,0,LAC,14,6,0,1,0,0,24,3,3,6,12,0,4,2,3,2,1,6,14,20,20,24.2
2024-25,202411090SAS,11/9/2024,SAS vs UTA,Jordan Clarkson,clarkjo01,62,UTA,0,SAS,16,3,4,3,0,1,24.05,1,2,5,15,2,6,4,5,3,3,7,20,19,23,33.6
2024-25,202411090SAS,11/9/2024,SAS vs UTA,Kyle Filipowski,filipky01,8,UTA,0,SAS,8,5,6,1,0,1,24.61666667,0,5,3,5,1,2,1,4,1,1,11,14,13,19,25
2024-25,202411090SAS,11/9/2024,SAS vs UTA,Julian Champagnie,champju02,84,SAS,1,UTA,5,6,2,0,1,2,24.66666667,0,6,2,7,1,6,0,0,3,1,8,7,11,13,16.2
2024-25,202411090SAS,11/9/2024,SAS vs UTA,Isaiah Collier,colliis01,2,UTA,0,SAS,7,6,4,1,1,0,24.78333333,0,6,3,9,0,6,1,4,1,2,10,11,13,17,26.2
2024-25,202411090ATL,11/9/2024,ATL vs CHI,Josh Giddey,giddejo01,90,CHI,0,ATL,13,6,7,2,0,3,25.38333333,2,4,5,9,1,1,2,2,2,2,13,20,19,26,33.7
2024-25,202411090ATL,11/9/2024,ATL vs CHI,Clint Capela,capelca01,84,ATL,1,CHI,20,9,1,0,1,1,25.58333333,5,4,8,14,0,0,4,4,2,1,10,21,29,30,34.3
2024-25,202411090LAC,11/9/2024,LAC vs TOR,Immanuel Quickley,quickim01,70,TOR,0,LAC,21,3,4,1,0,1,26.11666667,1,2,8,18,3,8,2,2,2,1,7,25,24,28,32.6
2024-25,202411090SAS,11/9/2024,SAS vs UTA,Harrison Barnes,barneha02,92,SAS,1,UTA,10,2,2,0,0,3,27.2,1,1,4,7,2,4,0,0,1,0,4,12,12,14,12.4
2024-25,202411090SAS,11/9/2024,SAS vs UTA,Chris Paul,paulch01,68,SAS,1,UTA,3,2,9,1,0,2,27.5,0,2,0,6,0,6,3,3,1,1,11,12,5,14,19.9
2024-25,202411090LAC,11/9/2024,LAC vs TOR,Terance Mann,mannte01,85,LAC,1,TOR,4,5,0,0,1,0,28.5,2,3,2,5,0,1,0,0,4,1,5,4,9,9,13
2024-25,202411090CLE,11/9/2024,CLE vs BRK,Dorian Finney-Smith,finnedo01,78,BRK,0,CLE,10,4,0,0,0,0,28.7,3,1,4,8,2,6,0,0,3,0,4,10,14,14,14.8
2024-25,202411090SAS,11/9/2024,SAS vs UTA,Collin Sexton,sextoco01,87,UTA,0,SAS,23,4,2,2,0,3,28.95,1,3,8,13,1,3,6,7,4,2,6,25,27,29,33.8
2024-25,202411090SAS,11/9/2024,SAS vs UTA,John Collins,collijo01,77,UTA,0,SAS,15,10,2,3,0,5,29,3,7,6,11,1,3,2,2,5,3,12,17,25,27,34
2024-25,202411090ATL,11/9/2024,ATL vs CHI,Patrick Williams,willipa01,53,CHI,0,ATL,10,7,3,2,2,2,29.13333333,2,5,3,9,0,4,4,4,2,4,10,13,17,20,32.9
2024-25,202411090LAC,11/9/2024,LAC vs TOR,Jakob Poeltl,poeltja01,60,TOR,0,LAC,5,12,3,0,3,4,30.13333333,2,10,1,6,0,0,3,6,2,3,15,8,17,20,28.9
2024-25,202411090ATL,11/9/2024,ATL vs CHI,Zaccharie Risacher,risacza01,11,ATL,1,CHI,17,2,0,0,2,0,30.15,1,1,6,14,1,6,4,6,3,2,2,17,19,19,25.4
2024-25,202411090SAS,11/9/2024,SAS vs UTA,Keldon Johnson,johnske04,79,SAS,1,UTA,14,4,5,2,2,1,30.28333333,1,3,4,10,1,6,5,6,3,4,9,19,18,23,37.3
2024-25,202411090LAC,11/9/2024,LAC vs TOR,RJ Barrett,barrerj01,65,TOR,0,LAC,13,6,3,2,1,4,30.46666667,0,6,6,15,1,3,0,2,2,3,9,16,19,22,29.7
2024-25,202411090ATL,11/9/2024,ATL vs CHI,Ayo Dosunmu,dosunay01,86,CHI,0,ATL,19,2,4,0,1,2,30.6,0,2,7,10,2,3,3,3,1,1,6,23,21,25,28.4
2024-25,202411090CLE,11/9/2024,CLE vs BRK,Cameron Johnson,johnsca02,68,BRK,0,CLE,23,5,1,0,0,0,31.3,1,4,8,13,4,7,3,3,0,0,6,24,28,29,30.5
2024-25,202411090CLE,11/9/2024,CLE vs BRK,Caris LeVert,leverca01,77,CLE,1,BRK,12,2,6,1,2,1,31.38333333,0,2,6,11,0,4,0,0,2,3,8,18,14,20,31.4
2024-25,202411090ATL,11/9/2024,ATL vs CHI,Nikola Vucevic,vucevni01,86,CHI,0,ATL,18,12,1,2,0,2,31.45,2,10,8,13,2,4,0,0,2,2,13,19,30,31,37.9
2024-25,202411090ATL,11/9/2024,ATL vs CHI,Zach LaVine,lavinza01,32,CHI,0,ATL,18,2,7,1,0,3,31.58333333,0,2,7,12,1,5,3,4,1,1,9,25,20,27,30.9
2024-25,202411090CLE,11/9/2024,CLE vs BRK,Nic Claxton,claxtni01,80,BRK,0,CLE,10,10,4,0,1,2,32,2,8,4,5,0,0,2,3,0,1,14,14,20,24,29
2024-25,202411090CLE,11/9/2024,CLE vs BRK,Darius Garland,garlada01,68,CLE,1,BRK,20,1,6,1,0,3,32.26666667,0,1,8,11,2,5,2,2,3,1,7,26,21,27,30.2
2024-25,202411090SAS,11/9/2024,SAS vs UTA,Victor Wembanyama,wembavi01,81,SAS,1,UTA,24,16,0,0,7,6,32.68333333,3,13,8,15,6,9,2,2,3,7,16,24,40,40,58.2
2024-25,202411090ATL,11/9/2024,ATL vs CHI,Coby White,whiteco01,89,CHI,0,ATL,18,4,5,3,0,2,32.91666667,0,4,6,14,2,9,4,4,3,3,9,23,22,27,37.3
2024-25,202411090LAC,11/9/2024,LAC vs TOR,Gradey Dick,dickgr01,70,TOR,0,LAC,15,0,2,1,0,0,34.01666667,0,0,5,12,2,5,3,4,1,1,2,17,15,17,21
2024-25,202411090ATL,11/9/2024,ATL vs CHI,Jalen Johnson,johnsja05,67,ATL,1,CHI,20,6,5,1,1,3,34.11666667,1,5,6,11,3,6,5,6,3,2,11,25,26,31,37.7
2024-25,202411090LAC,11/9/2024,LAC vs TOR,James Harden,hardeja01,82,LAC,1,TOR,24,12,7,1,0,4,34.15,1,11,5,17,2,8,12,13,2,1,19,31,36,43,47.9
2024-25,202411090CLE,11/9/2024,CLE vs BRK,Donovan Mitchell,mitchdo01,66,CLE,1,BRK,22,1,1,1,0,1,34.53333333,0,1,5,12,4,6,8,8,2,1,2,23,23,24,26.7
2024-25,202411090SAS,11/9/2024,SAS vs UTA,Stephon Castle,castlst01,10,SAS,1,UTA,23,2,3,2,0,1,34.6,0,2,8,16,3,7,4,5,4,2,5,26,25,28,34.9
2024-25,202411090LAC,11/9/2024,LAC vs TOR,Norman Powell,powelno01,86,LAC,1,TOR,24,3,3,1,1,3,35.05,0,3,7,14,3,6,7,9,2,2,6,27,27,30,35.1
2024-25,202411090CLE,11/9/2024,CLE vs BRK,Evan Mobley,mobleev01,61,CLE,1,BRK,23,16,1,4,1,4,35.25,3,13,10,11,1,1,2,5,1,5,17,24,39,40,54.7
2024-25,202411090CLE,11/9/2024,CLE vs BRK,Cam Thomas,thomaca02,76,BRK,0,CLE,22,2,6,0,0,6,35.95,0,2,6,17,2,7,8,8,2,0,8,28,24,30,27.4
2024-25,202411090ATL,11/9/2024,ATL vs CHI,Dyson Daniels,daniedy01,70,ATL,1,CHI,16,8,3,6,0,1,36.11666667,1,7,7,15,0,3,2,4,1,6,11,19,24,27,47.1
2024-25,202411090SAS,11/9/2024,SAS vs UTA,Lauri Markkanen,markkla01,61,UTA,0,SAS,20,6,4,2,0,1,36.13333333,2,4,5,15,3,7,7,8,2,2,10,24,26,30,38.2
2024-25,202411090LAC,11/9/2024,LAC vs TOR,Ochai Agbaji,agbajoc01,88,TOR,0,LAC,21,7,3,2,0,0,36.18333333,2,5,9,14,3,6,0,0,3,2,10,24,28,31,39.9
2024-25,202411090CLE,11/9/2024,CLE vs BRK,Dennis Schroder,schrode01,90,BRK,0,CLE,22,2,5,0,0,1,37.41666667,1,1,7,14,4,8,4,4,2,0,7,27,24,29,30.9
2024-25,202411090ATL,11/9/2024,ATL vs CHI,Trae Young,youngtr01,65,ATL,1,CHI,14,3,16,0,0,6,37.86666667,1,2,6,16,2,6,0,0,2,0,19,30,17,33,35.6
2024-25,202411090LAC,11/9/2024,LAC vs TOR,Ivica Zubac,zubaciv01,78,LAC,1,TOR,14,12,1,2,3,1,38.33333333,2,10,7,12,0,0,0,0,3,5,13,15,26,27,43.9
2024-25,202411080BOS,11/8/2024,BOS vs BRK,Jordan Walsh,walshjo01,18,BOS,1,BRK,0,0,1,0,1,0,10.53333333,0,0,0,1,0,1,0,0,2,1,1,1,0,1,4.5
2024-25,202411080LAL,11/8/2024,LAL vs PHI,Reggie Jackson,jacksre01,86,PHI,0,LAL,3,2,2,0,0,0,10.95,0,2,1,6,1,4,0,0,4,0,4,5,5,7,8.4
2024-25,202411080SAC,11/8/2024,SAC vs LAC,Nicolas Batum,batumni01,69,LAC,0,SAC,0,4,0,0,0,1,11.38333333,1,3,0,0,0,0,0,0,4,0,4,0,4,4,3.8
2024-25,202411080OKC,11/8/2024,OKC vs HOU,Dillon Jones,jonesdi01,8,OKC,1,HOU,2,2,0,1,1,1,11.85,0,2,1,6,0,5,0,0,1,2,2,2,4,4,9.4
2024-25,202411080ORL,11/8/2024,ORL vs NOP,Cole Anthony,anthoco01,89,ORL,1,NOP,8,6,2,1,0,1,12,0,6,3,5,1,3,1,2,0,1,8,10,14,16,20.2
2024-25,202411080MIN,11/8/2024,MIN vs POR,Dalano Banton,bantoda01,62,POR,0,MIN,12,2,2,2,1,0,12,0,2,4,7,0,1,4,5,0,3,4,14,14,16,26.4
2024-25,202411080ORL,11/8/2024,ORL vs NOP,Daniel Theis,theisda01,70,NOP,0,ORL,2,1,2,0,0,0,12.11666667,1,0,1,3,0,0,0,0,1,0,3,4,3,5,6.2
2024-25,202411080NYK,11/8/2024,NYK vs MIL,Ryan Rollins,rolliry01,20,MIL,0,NYK,7,1,3,1,0,3,12.2,0,1,3,5,1,2,0,0,2,1,4,10,8,11,12.7
2024-25,202411080DET,11/8/2024,DET vs ATL,Larry Nance Jr.,nancela02,66,ATL,0,DET,13,1,2,1,0,0,12.51666667,0,1,5,5,3,3,0,0,2,1,3,15,14,16,20.2
2024-25,202411080ORL,11/8/2024,ORL vs NOP,Trey Jemison,jemistr01,29,NOP,0,ORL,0,3,0,0,0,2,12.78333333,1,2,0,1,0,0,0,0,5,0,3,0,3,3,1.6
2024-25,202411080MIN,11/8/2024,MIN vs POR,Josh Minott,minotjo01,36,MIN,1,POR,2,0,0,0,1,0,12.9,0,0,1,2,0,1,0,0,1,1,0,2,2,2,5
2024-25,202411080CHO,11/8/2024,CHO vs IND,Taj Gibson,gibsota01,24,CHO,1,IND,2,3,1,0,0,1,12.91666667,0,3,1,1,0,0,0,0,2,0,4,3,5,6,6.1
2024-25,202411080ORL,11/8/2024,ORL vs NOP,Jaylen Nowell,nowelja01,16,NOP,0,ORL,10,0,1,0,0,1,13.2,0,0,4,9,1,4,1,1,0,0,1,11,10,11,10.5
2024-25,202411080DET,11/8/2024,DET vs ATL,Ron Holland,hollaro01,10,DET,1,ATL,5,1,0,0,0,0,13.61666667,1,0,2,5,0,1,1,1,1,0,1,5,6,6,6.2
2024-25,202411080OKC,11/8/2024,OKC vs HOU,Alex Caruso,carusal01,80,OKC,1,HOU,10,4,1,1,0,0,13.76666667,1,3,3,5,2,3,2,2,2,1,5,11,14,15,19.3
2024-25,202411080DEN,11/8/2024,DEN vs MIA,Pelle Larsson,larsspe01,5,MIA,0,DEN,5,2,2,0,0,1,14.01666667,0,2,1,1,1,1,2,4,1,0,4,7,7,9,9.4
2024-25,202411080MEM,11/8/2024,MEM vs WAS,Jared Butler,butleja02,46,WAS,0,MEM,5,3,6,2,0,0,14.05,1,2,2,9,0,2,1,2,2,2,9,11,8,14,23.6
2024-25,202411080CLE,11/8/2024,CLE vs GSW,Kyle Anderson,anderky01,88,GSW,0,CLE,4,3,2,0,1,0,14.1,0,3,2,5,0,2,0,0,2,1,5,6,7,9,13.6
2024-25,202411080MEM,11/8/2024,MEM vs WAS,Johnny Davis,davisjo06,56,WAS,0,MEM,3,2,0,0,0,0,14.16666667,1,1,1,5,1,1,0,0,2,0,2,3,5,5,5.4
2024-25,202411080MEM,11/8/2024,MEM vs WAS,Jay Huff,huffja01,30,MEM,1,WAS,12,4,0,1,4,0,14.21666667,1,3,3,6,1,4,5,5,0,5,4,12,16,16,31.8
2024-25,202411080DAL,11/8/2024,DAL vs PHO,Mason Plumlee,plumlma01,55,PHO,0,DAL,4,2,0,0,0,0,14.31666667,0,2,2,2,0,0,0,2,2,0,2,4,6,6,6.4
2024-25,202411080CLE,11/8/2024,CLE vs GSW,Georges Niang,niangge01,92,CLE,1,GSW,7,2,1,0,0,1,14.36666667,0,2,3,4,1,2,0,0,2,0,3,8,9,10,9.9
2024-25,202411080CLE,11/8/2024,CLE vs GSW,Sam Merrill,merrisa01,71,CLE,1,GSW,5,2,1,0,0,0,14.6,0,2,1,4,1,4,2,2,0,0,3,6,7,8,8.9
2024-25,202411080DET,11/8/2024,DET vs ATL,Paul Reed,reedpa01,86,DET,1,ATL,5,1,0,1,0,2,15.08333333,0,1,2,6,1,1,0,0,2,1,1,5,6,6,7.2
2024-25,202411080LAL,11/8/2024,LAL vs PHI,Ricky Council IV,councri01,38,PHI,0,LAL,2,3,2,0,0,0,15.16666667,1,2,0,4,0,1,2,2,0,0,5,4,5,7,8.6
2024-25,202411080OKC,11/8/2024,OKC vs HOU,Steven Adams,adamsst01,4,HOU,0,OKC,5,2,1,1,0,3,15.51666667,1,1,2,2,0,0,1,3,1,1,3,6,7,8,8.9
2024-25,202411080LAL,11/8/2024,LAL vs PHI,Jaxson Hayes,hayesja02,80,LAL,1,PHI,8,2,0,0,4,0,15.56666667,1,1,3,4,0,0,2,2,3,4,2,8,10,10,22.4
2024-25,202411080BOS,11/8/2024,BOS vs BRK,Keon Johnson,johnske07,13,BRK,0,BOS,3,2,1,0,0,1,15.65,1,1,1,6,0,3,1,1,2,0,3,4,5,6,5.9
2024-25,202411080CLE,11/8/2024,CLE vs GSW,Kevon Looney,looneke01,83,GSW,0,CLE,9,7,1,2,0,0,15.66666667,1,6,4,6,0,0,1,1,2,2,8,10,16,17,24.9
2024-25,202411080LAL,11/8/2024,LAL vs PHI,Gabe Vincent,vincega01,20,LAL,1,PHI,2,0,0,0,0,0,15.66666667,0,0,1,2,0,1,0,0,3,0,0,2,2,2,2
2024-25,202411080DET,11/8/2024,DET vs ATL,David Roddy,roddyda01,73,ATL,0,DET,3,5,3,1,0,3,15.95,0,5,1,1,1,1,0,0,3,1,8,6,8,11,13.5
2024-25,202411080NYK,11/8/2024,NYK vs MIL,Jericho Sims,simsje01,53,NYK,1,MIL,2,5,1,1,0,1,15.95,4,1,1,2,0,0,0,0,2,1,6,3,7,8,11.5
2024-25,202411080NYK,11/8/2024,NYK vs MIL,Pat Connaughton,connapa01,85,MIL,0,NYK,2,0,2,0,0,0,16.15,0,0,1,4,0,2,0,0,0,0,2,4,2,4,5
2024-25,202411080LAL,11/8/2024,LAL vs PHI,Dalton Knecht,knechda01,9,LAL,1,PHI,2,4,0,0,0,0,16.16666667,0,4,1,8,0,5,0,0,0,0,4,2,6,6,6.8
2024-25,202411080CLE,11/8/2024,CLE vs GSW,Trayce Jackson-Davis,jackstr02,77,GSW,0,CLE,3,5,4,0,1,1,16.18333333,2,3,1,3,0,0,1,1,3,1,9,7,8,12,17
2024-25,202411080NYK,11/8/2024,NYK vs MIL,Tyler Kolek,kolekty01,6,NYK,1,MIL,8,4,2,1,0,1,16.23333333,2,2,3,5,2,4,0,0,2,1,6,10,12,14,17.8
2024-25,202411080OKC,11/8/2024,OKC vs HOU,Jabari Smith Jr.,smithja05,85,HOU,0,OKC,4,1,0,0,1,0,16.7,1,0,2,7,0,1,0,1,0,1,1,4,5,5,8.2
2024-25,202411080DET,11/8/2024,DET vs ATL,Onyeka Okongwu,okongon01,63,ATL,0,DET,8,5,3,0,1,1,16.81666667,2,3,4,7,0,1,0,0,4,1,8,11,13,16,20.5
2024-25,202411080NYK,11/8/2024,NYK vs MIL,Bobby Portis,portibo01,91,MIL,0,NYK,4,5,1,0,0,1,16.9,2,3,1,8,0,3,2,2,2,0,6,5,9,10,10.5
2024-25,202411080CLE,11/8/2024,CLE vs GSW,Moses Moody,moodymo01,75,GSW,0,CLE,11,2,1,0,0,1,16.93333333,0,2,5,10,1,3,0,0,1,0,3,12,13,14,13.9
2024-25,202411080MIN,11/8/2024,MIN vs POR,Robert Williams,williro04,7,POR,0,MIN,13,3,2,2,1,0,17.01666667,2,1,4,5,1,1,4,4,0,3,5,15,16,18,28.6
2024-25,202411080LAL,11/8/2024,LAL vs PHI,KJ Martin,martike04,68,PHI,0,LAL,11,2,0,0,1,0,17.11666667,0,2,4,5,1,1,2,2,1,1,2,11,13,13,16.4
2024-25,202411080NYK,11/8/2024,NYK vs MIL,Andre Jackson Jr.,jacksan01,65,MIL,0,NYK,3,0,1,0,1,1,17.53333333,0,0,1,3,1,3,0,0,1,1,1,4,3,4,6.5
2024-25,202411080CLE,11/8/2024,CLE vs GSW,De'Anthony Melton,meltode01,42,GSW,0,CLE,10,2,3,0,0,1,17.8,2,0,4,11,2,6,0,0,4,0,5,13,12,15,15.9
2024-25,202411080CHO,11/8/2024,CHO vs IND,Jarace Walker,walkeja02,43,IND,0,CHO,5,2,3,0,1,1,17.83333333,0,2,2,5,0,1,1,1,2,1,5,8,7,10,13.9
2024-25,202411080MIN,11/8/2024,MIN vs POR,Deandre Ayton,aytonde01,65,POR,0,MIN,4,6,0,1,0,1,17.9,2,4,2,6,0,1,0,0,1,1,6,4,10,10,13.2
2024-25,202411080SAC,11/8/2024,SAC vs LAC,Kris Dunn,dunnkr01,75,LAC,0,SAC,0,3,1,0,0,0,18.13333333,1,2,0,1,0,1,0,0,3,0,4,1,3,4,5.1
2024-25,202411080MEM,11/8/2024,MEM vs WAS,Brandon Clarke,clarkbr01,16,MEM,1,WAS,6,4,0,2,0,0,18.23333333,0,4,3,5,0,1,0,0,1,2,4,6,10,10,16.8
2024-25,202411080ORL,11/8/2024,ORL vs NOP,Moritz Wagner,wagnemo01,90,ORL,1,NOP,17,4,2,0,0,3,18.25,0,4,8,11,1,1,0,0,0,0,6,19,21,23,21.8
2024-25,202411080MIN,11/8/2024,MIN vs POR,Mike Conley,conlemi01,85,MIN,1,POR,2,1,2,1,0,0,18.3,0,1,1,7,0,4,0,0,2,1,3,4,3,5,9.2
2024-25,202411080CLE,11/8/2024,CLE vs GSW,Dean Wade,wadede01,62,CLE,1,GSW,3,6,2,0,2,0,18.33333333,1,5,1,1,1,1,0,0,1,2,8,5,9,11,19.2
2024-25,202411080ORL,11/8/2024,ORL vs NOP,Antonio Reeves,reevean01,5,NOP,0,ORL,3,3,1,1,0,0,18.35,0,3,1,5,1,3,0,0,1,1,4,4,6,7,11.1
2024-25,202411080SAC,11/8/2024,SAC vs LAC,Kevin Porter Jr.,porteke02,9,LAC,0,SAC,11,0,0,1,0,4,18.55,0,0,5,9,0,1,1,1,1,1,0,11,11,11,10
2024-25,202411080OKC,11/8/2024,OKC vs HOU,Reed Sheppard,sheppre01,9,HOU,0,OKC,4,2,4,0,0,1,18.55,0,2,2,2,0,0,0,0,1,0,6,8,6,10,11.4
2024-25,202411080DAL,11/8/2024,DAL vs PHO,Grayson Allen,allengr01,82,PHO,0,DAL,0,3,0,2,0,1,18.56666667,2,1,0,4,0,3,0,0,0,2,3,0,3,3,8.6
2024-25,202411080MIN,11/8/2024,MIN vs POR,Donovan Clingan,clingdo01,10,POR,0,MIN,6,3,0,0,2,0,18.56666667,1,2,3,7,0,0,0,0,1,2,3,6,9,9,15.6
2024-25,202411080MEM,11/8/2024,MEM vs WAS,Luke Kennard,kennalu01,41,MEM,1,WAS,11,3,3,0,0,3,18.6,1,2,4,7,3,5,0,0,1,0,6,14,14,17,16.1
2024-25,202411080CHO,11/8/2024,CHO vs IND,Josh Green,greenjo02,64,CHO,1,IND,2,1,0,0,1,1,18.65,1,0,1,2,0,1,0,0,3,1,1,2,3,3,5.2
2024-25,202411080DET,11/8/2024,DET vs ATL,Clint Capela,capelca01,83,ATL,0,DET,7,12,2,0,0,2,18.66666667,7,5,3,10,0,0,1,4,1,0,14,9,19,21,22.4
2024-25,202411080OKC,11/8/2024,OKC vs HOU,Luguentz Dort,dortlu01,88,OKC,1,HOU,3,0,1,0,0,1,18.98333333,0,0,1,7,1,5,0,0,3,0,1,4,3,4,3.5
2024-25,202411080SAC,11/8/2024,SAC vs LAC,Keon Ellis,elliske01,65,SAC,1,LAC,3,1,1,0,0,1,19.35,0,1,1,3,1,3,0,0,3,0,2,4,4,5,4.7
2024-25,202411080CLE,11/8/2024,CLE vs GSW,Buddy Hield,hieldbu01,94,GSW,0,CLE,3,2,1,0,0,1,19.35,0,2,1,4,1,4,0,0,2,0,3,4,5,6,5.9
2024-25,202411080ORL,11/8/2024,ORL vs NOP,Gary Harris,harriga01,63,ORL,1,NOP,7,1,2,0,1,0,19.48333333,1,0,2,3,1,2,2,3,1,1,3,9,8,10,14.2
2024-25,202411080DET,11/8/2024,DET vs ATL,Simone Fontecchio,fontesi01,76,DET,1,ATL,11,5,1,1,0,1,19.56666667,1,4,3,6,1,4,4,5,1,1,6,12,16,17,20.5
2024-25,202411080OKC,11/8/2024,OKC vs HOU,Ajay Mitchell,mitchaj01,9,OKC,1,HOU,12,2,7,3,0,0,19.71666667,0,2,5,6,1,2,1,1,2,3,9,19,14,21,33.9
2024-25,202411080ORL,11/8/2024,ORL vs NOP,Yves Missi,missiyv01,10,NOP,0,ORL,0,1,0,1,1,0,19.75,0,1,0,0,0,0,0,0,2,2,1,0,1,1,7.2
2024-25,202411080CHO,11/8/2024,CHO vs IND,Quenton Jackson,jacksqu01,5,IND,0,CHO,7,2,2,0,0,2,19.78333333,0,2,3,7,1,3,0,0,2,0,4,9,9,11,10.4
2024-25,202411080DEN,11/8/2024,DEN vs MIA,Nikola Jovic,jovicni01,54,MIA,0,DEN,11,4,2,3,0,1,19.96666667,2,2,4,7,1,2,2,2,0,3,6,13,15,17,26.8
2024-25,202411080SAC,11/8/2024,SAC vs LAC,Kevin Huerter,huertke01,71,SAC,1,LAC,4,2,1,0,0,0,19.98333333,0,2,2,5,0,3,0,0,2,0,3,5,6,7,7.9
2024-25,202411080DEN,11/8/2024,DEN vs MIA,Duncan Robinson,robindu01,75,MIA,0,DEN,20,3,3,1,0,1,20.26666667,0,3,7,12,6,10,0,0,4,1,6,23,23,26,30.1
2024-25,202411080MEM,11/8/2024,MEM vs WAS,John Konchar,konchjo01,59,MEM,1,WAS,0,2,2,1,2,0,20.3,2,0,0,2,0,2,0,0,0,3,4,2,2,4,14.4
2024-25,202411080CLE,11/8/2024,CLE vs GSW,Draymond Green,greendr01,64,GSW,0,CLE,6,2,6,3,0,2,20.53333333,0,2,2,7,2,5,0,0,4,3,8,12,8,14,24.4
2024-25,202411080CHO,11/8/2024,CHO vs IND,Obi Toppin,toppiob01,92,IND,0,CHO,2,2,1,1,0,1,20.61666667,1,1,1,4,0,2,0,0,0,1,3,3,4,5,7.9
2024-25,202411080MIN,11/8/2024,MIN vs POR,Shaedon Sharpe,sharpsh01,34,POR,0,MIN,6,2,2,0,0,2,20.73333333,0,2,2,8,0,4,2,3,1,0,4,8,8,10,9.4
2024-25,202411080CLE,11/8/2024,CLE vs GSW,Andrew Wiggins,wiggian01,78,GSW,0,CLE,11,1,2,1,0,1,20.81666667,1,0,4,9,1,3,2,2,0,1,3,13,12,14,17.2
2024-25,202411080DEN,11/8/2024,DEN vs MIA,Josh Richardson,richajo01,46,MIA,0,DEN,10,2,3,4,0,2,21.06666667,1,1,4,8,2,4,0,0,3,4,5,13,12,15,26.9
2024-25,202411080CLE,11/8/2024,CLE vs GSW,Caris LeVert,leverca01,76,CLE,1,GSW,8,7,4,3,1,1,21.21666667,2,5,2,5,2,3,2,2,0,4,11,12,15,19,33.4
2024-25,202411080CLE,11/8/2024,CLE vs GSW,Ty Jerome,jeromty01,12,CLE,1,GSW,20,1,3,0,0,3,21.25,1,0,7,8,3,3,3,3,2,0,4,23,21,24,22.7
2024-25,202411080CHO,11/8/2024,CHO vs IND,Tidjane Salaun,salauti01,7,CHO,1,IND,2,7,1,0,0,2,21.48333333,3,4,1,6,0,3,0,0,2,0,8,3,9,10,9.9
2024-25,202411080MEM,11/8/2024,MEM vs WAS,Zach Edey,edeyza01,10,MEM,1,WAS,14,8,2,1,2,3,21.71666667,2,6,5,8,1,2,3,3,3,3,10,16,22,24,32.6
2024-25,202411080MIN,11/8/2024,MIN vs POR,Naz Reid,reidna01,90,MIN,1,POR,15,4,1,1,0,1,22.08333333,0,4,6,11,3,5,0,0,4,1,5,16,19,20,23.3
2024-25,202411080SAC,11/8/2024,SAC vs LAC,Terance Mann,mannte01,84,LAC,0,SAC,2,5,3,0,0,0,22.2,1,4,0,4,0,2,2,2,2,0,8,5,7,10,12.5
2024-25,202411080LAL,11/8/2024,LAL vs PHI,Andre Drummond,drumman01,87,PHI,0,LAL,14,12,0,3,0,0,22.33333333,5,7,6,12,0,0,2,7,4,3,12,14,26,26,37.4
2024-25,202411080MIN,11/8/2024,MIN vs POR,Rudy Gobert,goberru01,85,MIN,1,POR,8,15,2,0,3,2,22.53333333,4,11,4,5,0,0,0,0,5,3,17,10,23,25,36
2024-25,202411080MEM,11/8/2024,MEM vs WAS,Jordan Poole,poolejo01,85,WAS,0,MEM,10,2,1,0,0,4,22.55,1,1,3,10,2,4,2,2,3,0,3,11,12,13,9.9
2024-25,202411080OKC,11/8/2024,OKC vs HOU,Cason Wallace,wallaca01,91,OKC,1,HOU,4,5,1,1,1,0,22.86666667,3,2,2,4,0,1,0,0,2,2,6,5,9,10,17.5
2024-25,202411080DAL,11/8/2024,DAL vs PHO,Daniel Gafford,gaffoda01,83,DAL,1,PHO,15,7,0,0,0,1,23.13333333,3,4,6,7,0,0,3,3,6,0,7,15,22,22,22.4
2024-25,202411080BOS,11/8/2024,BOS vs BRK,Ziaire Williams,willizi02,60,BRK,0,BOS,9,12,1,0,0,0,23.26666667,4,8,4,11,0,3,1,2,3,0,13,10,21,22,24.9
2024-25,202411080LAL,11/8/2024,LAL vs PHI,Guerschon Yabusele,yabusgu01,8,PHI,0,LAL,14,5,0,1,1,0,23.36666667,1,4,5,6,3,4,1,2,1,2,5,14,19,19,26
2024-25,202411080MEM,11/8/2024,MEM vs WAS,Jonas Valanciunas,valanjo01,89,WAS,0,MEM,16,5,0,2,3,0,23.43333333,3,2,7,11,0,1,2,2,2,5,5,16,21,21,37
2024-25,202411080MIN,11/8/2024,MIN vs POR,Deni Avdija,avdijde01,85,POR,0,MIN,9,5,1,1,0,1,23.45,1,4,4,9,0,2,1,3,2,1,6,10,14,15,18.5
2024-25,202411080CLE,11/8/2024,CLE vs GSW,Stephen Curry,curryst01,80,GSW,0,CLE,12,1,2,2,0,6,23.76666667,0,1,5,10,1,4,1,1,0,2,3,14,13,15,16.2
2024-25,202411080OKC,11/8/2024,OKC vs HOU,Isaiah Joe,joeis01,87,OKC,1,HOU,14,6,1,0,0,0,23.76666667,0,6,5,10,3,8,1,1,5,0,7,15,20,21,22.7
2024-25,202411080DEN,11/8/2024,DEN vs MIA,Russell Westbrook,westbru01,77,DEN,1,MIA,6,4,10,0,1,2,24.03333333,0,4,2,5,2,3,0,0,2,1,14,16,10,20,26.8
2024-25,202411080DEN,11/8/2024,DEN vs MIA,Julian Strawther,strawju01,59,DEN,1,MIA,6,1,0,0,1,2,24.05,0,1,3,8,0,3,0,0,1,1,1,6,7,7,8.2
2024-25,202411080ORL,11/8/2024,ORL vs NOP,Javonte Green,greenja02,19,NOP,0,ORL,3,1,1,0,0,0,24.08333333,0,1,1,6,1,2,0,0,1,0,2,4,4,5,5.7
2024-25,202411080OKC,11/8/2024,OKC vs HOU,Amen Thompson,thompam01,71,HOU,0,OKC,14,7,1,0,1,1,24.11666667,2,5,5,12,0,2,4,4,2,1,8,15,21,22,25.9
2024-25,202411080ORL,11/8/2024,ORL vs NOP,Anthony Black,blackan01,79,ORL,1,NOP,11,3,4,0,1,2,24.26666667,1,2,4,6,0,0,3,4,4,1,7,15,14,18,21.6
2024-25,202411080NYK,11/8/2024,NYK vs MIL,Brook Lopez,lopezbr01,88,MIL,0,NYK,7,3,1,0,0,2,24.46666667,2,1,3,5,0,1,1,2,1,0,4,8,10,11,10.1
2024-25,202411080MEM,11/8/2024,MEM vs WAS,Alex Sarr,sarral01,7,WAS,0,MEM,8,5,5,1,1,4,24.51666667,2,3,3,11,0,5,2,2,4,2,10,13,13,18,23.5
2024-25,202411080BOS,11/8/2024,BOS vs BRK,Jalen Wilson,wilsoja03,52,BRK,0,BOS,8,2,1,0,0,1,24.65,1,1,3,10,0,4,2,2,1,0,3,9,10,11,10.9
2024-25,202411080DAL,11/8/2024,DAL vs PHO,Dwight Powell,poweldw01,71,DAL,1,PHO,4,6,1,0,1,0,24.85,1,5,1,1,0,0,2,2,5,1,7,5,10,11,15.7
2024-25,202411080MEM,11/8/2024,MEM vs WAS,Jaylen Wells,wellsja01,10,MEM,1,WAS,11,0,1,1,1,2,24.85,0,0,4,10,1,4,2,3,3,2,1,12,11,12,16.5
2024-25,202411080LAL,11/8/2024,LAL vs PHI,Paul George,georgpa01,77,PHI,0,LAL,9,4,8,1,0,0,24.95,1,3,4,13,0,6,1,2,2,1,12,17,13,21,28.8
2024-25,202411080NYK,11/8/2024,NYK vs MIL,A.J. Green,greenaj01,64,MIL,0,NYK,9,0,0,0,0,0,24.96666667,0,0,3,6,3,6,0,0,4,0,0,9,9,9,9
2024-25,202411080DET,11/8/2024,DET vs ATL,Zaccharie Risacher,risacza01,10,ATL,0,DET,7,5,3,0,1,3,25.06666667,4,1,2,7,0,3,3,4,3,1,8,10,12,15,17.5
2024-25,202411080OKC,11/8/2024,OKC vs HOU,Tari Eason,easonta01,31,HOU,0,OKC,12,6,0,3,1,3,25.25,1,5,5,11,2,5,0,0,1,4,6,12,18,18,28.2
2024-25,202411080LAL,11/8/2024,LAL vs PHI,D'Angelo Russell,russeda01,86,LAL,1,PHI,18,2,3,0,0,2,25.4,0,2,7,12,2,4,2,3,0,0,5,21,20,23,22.9
2024-25,202411080MIN,11/8/2024,MIN vs POR,Toumani Camara,camarto01,80,POR,0,MIN,3,5,0,2,1,6,25.41666667,2,3,1,3,0,2,1,2,4,3,5,3,8,8,12
2024-25,202411080LAL,11/8/2024,LAL vs PHI,Caleb Martin,martica02,72,PHI,0,LAL,13,3,5,0,0,2,26.16666667,1,2,5,6,3,4,0,0,0,0,8,18,16,21,22.1
2024-25,202411080ORL,11/8/2024,ORL vs NOP,Brandon Ingram,ingrabr01,74,NOP,0,ORL,11,5,5,0,0,6,26.3,1,4,4,12,1,4,2,2,3,0,10,16,16,21,18.5
2024-25,202411080CLE,11/8/2024,CLE vs GSW,Donovan Mitchell,mitchdo01,65,CLE,1,GSW,12,5,4,0,0,4,26.43333333,0,5,4,13,2,7,2,2,4,0,9,16,17,21,20
2024-25,202411080CLE,11/8/2024,CLE vs GSW,Evan Mobley,mobleev01,60,CLE,1,GSW,23,4,4,1,2,2,26.43333333,0,4,7,12,0,3,9,10,0,3,8,27,27,31,40.8
2024-25,202411080CLE,11/8/2024,CLE vs GSW,Isaac Okoro,okorois01,79,CLE,1,GSW,16,1,4,0,1,0,26.5,1,0,6,10,4,6,0,0,2,1,5,20,17,21,26.2
2024-25,202411080CLE,11/8/2024,CLE vs GSW,Brandin Podziemski,podzibr01,82,GSW,0,CLE,14,7,4,4,0,1,26.5,2,5,6,12,1,6,1,2,1,4,11,18,21,25,39.4
2024-25,202411080BOS,11/8/2024,BOS vs BRK,Neemias Queta,quetane01,37,BOS,1,BRK,3,10,2,0,3,2,26.55,1,9,1,2,0,0,1,2,2,3,12,5,13,15,25
2024-25,202411080MIN,11/8/2024,MIN vs POR,Jaden McDaniels,mcdanja02,81,MIN,1,POR,5,3,2,2,0,0,26.61666667,0,3,2,8,1,2,0,0,2,2,5,7,8,10,17.6
2024-25,202411080OKC,11/8/2024,OKC vs HOU,Dillon Brooks,brookdi01,81,HOU,0,OKC,17,4,1,0,0,1,26.65,2,2,6,12,3,4,2,2,3,0,5,18,21,22,22.3
2024-25,202411080ORL,11/8/2024,ORL vs NOP,Tristan Da Silva,dasiltr01,6,ORL,1,NOP,7,3,1,0,0,0,26.66666667,0,3,3,11,1,7,0,0,1,0,4,8,10,11,12.1
2024-25,202411080ORL,11/8/2024,ORL vs NOP,Goga Bitadze,bitadgo01,68,ORL,1,NOP,11,9,3,1,2,0,26.71666667,5,4,5,6,0,0,1,1,3,3,12,14,20,23,35.3
2024-25,202411080MIN,11/8/2024,MIN vs POR,Anfernee Simons,simonan01,56,POR,0,MIN,14,1,2,1,0,1,26.78333333,0,1,6,16,2,7,0,0,2,1,3,16,15,17,20.2
2024-25,202411080MEM,11/8/2024,MEM vs WAS,Jake LaRavia,laravja01,45,MEM,1,WAS,9,5,5,1,0,2,26.86666667,3,2,3,7,2,4,1,1,2,1,10,14,14,19,23.5
2024-25,202411080CHO,11/8/2024,CHO vs IND,Cody Martin,martico01,37,CHO,1,IND,15,5,4,1,0,0,26.9,1,4,6,11,3,6,0,0,0,1,9,19,20,24,30
2024-25,202411080MIN,11/8/2024,MIN vs POR,Jerami Grant,grantje01,64,POR,0,MIN,12,1,0,0,2,0,26.93333333,0,1,4,10,2,4,2,3,1,2,1,12,13,13,19.2
2024-25,202411080CHO,11/8/2024,CHO vs IND,Tre Mann,manntr01,50,CHO,1,IND,14,2,4,1,0,3,27.01666667,1,1,6,13,2,5,0,0,1,1,6,18,16,20,22.4
2024-25,202411080OKC,11/8/2024,OKC vs HOU,Alperen Sengun,sengual01,72,HOU,0,OKC,11,9,6,1,0,2,27.18333333,4,5,3,12,0,1,5,6,5,1,15,17,20,26,31.8
2024-25,202411080MIN,11/8/2024,MIN vs POR,Nickeil Alexander-Walker,alexani01,91,MIN,1,POR,9,6,3,2,0,3,27.2,1,5,3,4,1,2,2,2,1,2,9,12,15,18,23.7
2024-25,202411080BOS,11/8/2024,BOS vs BRK,Ben Simmons,simmobe01,22,BRK,0,BOS,8,6,8,1,0,3,27.28333333,1,5,4,6,0,0,0,0,1,1,14,16,14,22,27.2
2024-25,202411080DET,11/8/2024,DET vs ATL,Garrison Mathews,mathega01,75,ATL,0,DET,8,2,1,1,0,0,27.33333333,1,1,2,5,1,4,3,3,0,1,3,9,10,11,14.9
2024-25,202411080MEM,11/8/2024,MEM vs WAS,Scotty Pippen Jr.,pippesc02,31,MEM,1,WAS,11,10,11,1,0,2,27.58333333,1,9,4,8,0,2,3,4,3,1,21,22,21,32,40.5
2024-25,202411080NYK,11/8/2024,NYK vs MIL,Taurean Prince,princta02,88,MIL,0,NYK,3,5,2,0,0,2,27.61666667,0,5,1,4,1,3,0,0,2,0,7,5,8,10,10
2024-25,202411080OKC,11/8/2024,OKC vs HOU,Jalen Green,greenja05,91,HOU,0,OKC,14,4,2,0,0,1,27.7,0,4,5,14,2,8,2,2,1,0,6,16,18,20,20.8
2024-25,202411080LAL,11/8/2024,LAL vs PHI,Cam Reddish,reddica01,53,LAL,1,PHI,3,5,2,1,1,1,27.81666667,0,5,1,1,1,1,0,0,1,2,7,5,8,10,17
2024-25,202411080BOS,11/8/2024,BOS vs BRK,Nic Claxton,claxtni01,79,BRK,0,BOS,2,10,3,0,2,0,28,1,9,1,3,0,0,0,0,1,2,13,5,12,15,24.5
2024-25,202411080NYK,11/8/2024,NYK vs MIL,Miles McBride,mcbrimi01,76,NYK,1,MIL,14,5,2,0,0,0,28.01666667,1,4,5,11,2,6,2,2,0,0,7,16,19,21,23
2024-25,202411080MEM,11/8/2024,MEM vs WAS,Jaren Jackson Jr.,jacksja02,74,MEM,1,WAS,39,6,1,1,1,3,28.31666667,2,4,14,28,5,12,6,7,4,2,7,40,45,46,50.7
2024-25,202411080DAL,11/8/2024,DAL vs PHO,Spencer Dinwiddie,dinwisp01,84,DAL,1,PHO,3,0,2,1,0,0,28.35,0,0,1,2,1,1,0,0,1,1,2,5,3,5,9
2024-25,202411080MEM,11/8/2024,MEM vs WAS,Corey Kispert,kispeco01,87,WAS,0,MEM,14,2,1,1,0,1,28.58333333,0,2,3,7,1,3,7,9,3,1,3,15,16,17,19.9
2024-25,202411080SAC,11/8/2024,SAC vs LAC,Amir Coffey,coffeam01,79,LAC,0,SAC,14,1,1,1,0,0,28.65,0,1,5,11,2,6,2,2,2,1,2,15,15,16,19.7
2024-25,202411080CHO,11/8/2024,CHO vs IND,Moussa Diabate,diabamo01,20,CHO,1,IND,0,15,0,1,3,2,28.98333333,4,11,0,1,0,0,0,0,1,4,15,0,15,15,28
2024-25,202411080OKC,11/8/2024,OKC vs HOU,Shai Gilgeous-Alexander,gilgesh01,84,OKC,1,HOU,29,5,4,1,1,3,29.03333333,1,4,11,16,1,2,6,7,2,2,9,33,34,38,44
2024-25,202411080ORL,11/8/2024,ORL vs NOP,Kentavious Caldwell-Pope,caldwke01,86,ORL,1,NOP,7,3,5,4,1,0,29.05,0,3,3,9,0,4,1,1,1,5,8,12,10,15,33.1
2024-25,202411080MIN,11/8/2024,MIN vs POR,Donte DiVincenzo,divindo01,90,MIN,1,POR,14,3,7,1,0,1,29.05,1,2,4,12,4,11,2,2,1,1,10,21,17,24,30.1
2024-25,202411080CLE,11/8/2024,CLE vs GSW,Jonathan Kuminga,kuminjo01,83,GSW,0,CLE,21,5,5,2,1,3,29.08333333,1,4,7,14,3,7,4,6,2,3,10,26,26,31,40.5
2024-25,202411080DAL,11/8/2024,DAL vs PHO,Royce O'Neale,onealro01,88,PHO,0,DAL,18,5,2,0,0,0,29.11666667,1,4,7,8,4,4,0,1,2,0,7,20,23,25,27
2024-25,202411080OKC,11/8/2024,OKC vs HOU,Chet Holmgren,holmgch01,91,OKC,1,HOU,29,5,1,0,3,1,29.15,1,4,8,14,4,6,9,10,1,3,6,30,34,35,44.5
2024-25,202411080DET,11/8/2024,DET vs ATL,Tim Hardaway Jr.,hardati02,89,DET,1,ATL,7,5,4,3,0,3,29.21666667,0,5,2,4,1,2,2,4,3,3,9,11,12,16,25
2024-25,202411080DAL,11/8/2024,DAL vs PHO,Naji Marshall,marshna01,75,DAL,1,PHO,18,5,0,0,0,3,29.31666667,2,3,7,12,2,6,2,2,2,0,5,18,23,23,21
2024-25,202411080DET,11/8/2024,DET vs ATL,Jaden Ivey,iveyja01,87,DET,1,ATL,18,3,3,1,3,4,29.48333333,2,1,7,13,1,4,3,7,4,4,6,21,21,24,34.1
2024-25,202411080OKC,11/8/2024,OKC vs HOU,Aaron Wiggins,wiggiaa01,87,OKC,1,HOU,8,5,5,1,1,0,29.71666667,1,4,3,9,2,3,0,0,1,2,10,13,13,18,27.5
2024-25,202411080LAL,11/8/2024,LAL vs PHI,Austin Reaves,reaveau01,92,LAL,1,PHI,20,6,7,0,1,2,29.93333333,0,6,7,13,6,10,0,0,1,1,13,27,26,33,38.7
2024-25,202411080MIN,11/8/2024,MIN vs POR,Anthony Edwards,edwaran01,88,MIN,1,POR,37,6,5,1,1,6,30.11666667,0,6,12,21,9,15,4,5,2,2,11,42,43,48,51.7
2024-25,202411080CLE,11/8/2024,CLE vs GSW,Jarrett Allen,allenja01,87,CLE,1,GSW,13,12,3,0,1,3,30.28333333,4,8,5,7,0,0,3,5,1,1,15,16,25,28,31.9
2024-25,202411080CLE,11/8/2024,CLE vs GSW,Darius Garland,garlada01,67,CLE,1,GSW,27,3,6,3,0,4,30.28333333,0,3,9,17,6,11,3,4,0,3,9,33,30,36,44.6
2024-25,202411080LAL,11/8/2024,LAL vs PHI,Kelly Oubre Jr.,oubreke01,76,PHI,0,LAL,9,6,2,0,0,0,30.33333333,3,3,4,16,0,4,1,2,0,0,8,11,15,17,19.2
2024-25,202411080OKC,11/8/2024,OKC vs HOU,Fred VanVleet,vanvlfr01,82,HOU,0,OKC,11,3,2,1,0,1,30.43333333,1,2,4,9,2,4,1,2,1,1,5,13,14,16,19.6
2024-25,202411080LAL,11/8/2024,LAL vs PHI,Jared McCain,mccaija01,8,PHI,0,LAL,18,1,2,1,0,2,30.51666667,0,1,6,17,4,9,2,2,1,1,3,20,19,21,23.2
2024-25,202411080DET,11/8/2024,DET vs ATL,Tobias Harris,harrito02,80,DET,1,ATL,22,6,2,0,3,0,30.56666667,0,6,7,13,5,8,3,4,1,3,8,24,28,30,41.2
2024-25,202411080SAC,11/8/2024,SAC vs LAC,Derrick Jones Jr.,jonesde02,85,LAC,0,SAC,14,4,0,2,0,2,30.63333333,0,4,5,8,4,5,0,0,2,2,4,14,18,18,22.8
2024-25,202411080CHO,11/8/2024,CHO vs IND,Grant Williams,willigr01,85,CHO,1,IND,8,9,1,1,1,3,30.66666667,2,7,3,8,0,5,2,2,3,2,10,9,17,18,23.3
2024-25,202411080CHO,11/8/2024,CHO vs IND,Ben Sheppard,sheppbe01,67,IND,0,CHO,2,3,3,1,0,0,30.96666667,0,3,1,7,0,4,0,0,5,1,6,5,5,8,13.1
2024-25,202411080BOS,11/8/2024,BOS vs BRK,Dorian Finney-Smith,finnedo01,77,BRK,0,BOS,5,5,2,0,1,1,31.08333333,2,3,2,6,1,3,0,0,5,1,7,7,10,12,16
2024-25,202411080DAL,11/8/2024,DAL vs PHO,Tyus Jones,jonesty01,75,PHO,0,DAL,17,2,5,1,0,3,31.11666667,0,2,7,13,3,5,0,0,3,1,7,22,19,24,26.9
2024-25,202411080SAC,11/8/2024,SAC vs LAC,Malik Monk,monkma01,81,SAC,1,LAC,17,1,3,2,2,1,31.16666667,0,1,6,13,0,3,5,5,2,4,4,20,18,21,33.7
2024-25,202411080MEM,11/8/2024,MEM vs WAS,Bilal Coulibaly,coulibi01,70,WAS,0,MEM,10,3,3,2,2,4,31.33333333,1,2,4,9,0,3,2,2,4,4,6,13,13,16,26.1
2024-25,202411080BOS,11/8/2024,BOS vs BRK,Al Horford,horfoal01,74,BOS,1,BRK,13,10,0,1,1,1,31.38333333,1,9,5,12,3,9,0,0,2,2,10,13,23,23,30
2024-25,202411080ORL,11/8/2024,ORL vs NOP,Jeremiah Robinson-Earl,robinje02,49,NOP,0,ORL,12,4,0,3,0,3,31.55,2,2,4,12,0,2,4,4,3,3,4,12,16,16,22.8
2024-25,202411080LAL,11/8/2024,LAL vs PHI,Kyle Lowry,lowryky01,68,PHI,0,LAL,5,3,6,0,1,1,31.56666667,0,3,1,7,1,6,2,2,1,1,9,11,8,14,19.6
2024-25,202411080OKC,11/8/2024,OKC vs HOU,Jalen Williams,willija06,80,OKC,1,HOU,14,5,3,0,1,3,31.65,0,5,7,11,0,1,0,0,3,1,8,17,19,22,24.5
2024-25,202411080NYK,11/8/2024,NYK vs MIL,Jalen Brunson,brunsja01,85,NYK,1,MIL,15,2,9,1,0,0,31.75,1,1,6,14,0,5,3,4,2,1,11,24,17,26,33.9
2024-25,202411080CHO,11/8/2024,CHO vs IND,Myles Turner,turnemy01,86,IND,0,CHO,12,10,1,1,2,3,31.86666667,4,6,5,13,1,3,1,4,2,3,11,13,22,23,31.5
2024-25,202411080NYK,11/8/2024,NYK vs MIL,Karl-Anthony Towns,townska01,70,NYK,1,MIL,32,11,5,0,0,2,32.05,3,8,12,20,4,8,4,5,4,0,16,37,43,48,50.7
2024-25,202411080NYK,11/8/2024,NYK vs MIL,OG Anunoby,anunoog01,58,NYK,1,MIL,14,6,5,3,2,2,32.11666667,0,6,4,12,1,8,5,6,4,5,11,19,20,25,41.7
2024-25,202411080NYK,11/8/2024,NYK vs MIL,Giannis Antetokounmpo,antetgi01,81,MIL,0,NYK,24,12,2,0,2,1,32.2,3,9,11,21,0,1,2,6,2,2,14,26,36,38,46.4
2024-25,202411080MIN,11/8/2024,MIN vs POR,Scoot Henderson,hendesc01,72,POR,0,MIN,16,4,3,1,0,3,32.4,2,2,6,14,0,1,4,4,4,1,7,19,20,23,25.3
2024-25,202411080MIN,11/8/2024,MIN vs POR,Julius Randle,randlju01,55,MIN,1,POR,22,6,4,0,1,2,32.4,3,3,8,18,3,6,3,4,1,1,10,26,28,32,36.2
2024-25,202411080ORL,11/8/2024,ORL vs NOP,Franz Wagner,wagnefr01,82,ORL,1,NOP,27,5,6,2,0,2,32.43333333,2,3,9,18,2,5,7,8,2,2,11,33,32,38,46
2024-25,202411080MEM,11/8/2024,MEM vs WAS,Santi Aldama,aldamsa01,71,MEM,1,WAS,12,5,4,1,0,1,32.46666667,1,4,5,13,0,5,2,2,1,1,9,16,17,21,26
2024-25,202411080DET,11/8/2024,DET vs ATL,Isaiah Stewart,stewais01,56,DET,1,ATL,10,11,3,0,1,1,32.63333333,4,7,5,8,0,0,0,0,2,1,14,13,21,24,29.7
2024-25,202411080ORL,11/8/2024,ORL vs NOP,Jalen Suggs,suggsja01,85,ORL,1,NOP,7,6,3,1,2,5,32.71666667,0,6,3,9,1,6,0,0,1,3,9,10,13,16,22.7
2024-25,202411080LAL,11/8/2024,LAL vs PHI,Rui Hachimura,hachiru01,77,LAL,1,PHI,9,4,1,0,0,1,32.83333333,1,3,3,8,3,6,0,0,5,0,5,10,13,14,14.3
2024-25,202411080DEN,11/8/2024,DEN vs MIA,Peyton Watson,watsope01,89,DEN,1,MIA,16,5,1,1,1,0,32.86666667,2,3,7,11,2,3,0,0,3,2,6,17,21,22,29.5
2024-25,202411080NYK,11/8/2024,NYK vs MIL,Josh Hart,hartjo01,89,NYK,1,MIL,11,9,7,0,0,0,33.1,2,7,4,5,1,1,2,2,3,0,16,18,20,27,32.3
2024-25,202411080CHO,11/8/2024,CHO vs IND,LaMelo Ball,ballla01,31,CHO,1,IND,31,7,6,1,1,1,33.23333333,1,6,10,29,5,18,6,8,2,2,13,37,38,44,53.4
2024-25,202411080CHO,11/8/2024,CHO vs IND,Brandon Miller,millebr02,79,CHO,1,IND,29,6,6,1,1,1,33.41666667,0,6,10,17,7,11,2,2,1,2,12,35,35,41,50.2
2024-25,202411080MEM,11/8/2024,MEM vs WAS,Carlton Carrington,carrica01,7,WAS,0,MEM,10,10,8,4,0,4,33.43333333,1,9,4,11,1,5,1,2,3,4,18,18,20,28,42
2024-25,202411080DET,11/8/2024,DET vs ATL,Malik Beasley,beaslma01,89,DET,1,ATL,22,2,1,0,0,2,33.53333333,2,0,8,14,3,9,3,5,2,0,3,23,24,25,23.9
2024-25,202411080CHO,11/8/2024,CHO vs IND,Pascal Siakam,siakapa01,89,IND,0,CHO,27,4,3,3,0,2,33.61666667,0,4,11,17,5,7,0,2,2,3,7,30,31,34,43.3
2024-25,202411080BOS,11/8/2024,BOS vs BRK,Payton Pritchard,pritcpa01,92,BOS,1,BRK,20,1,0,1,0,1,33.63333333,0,1,6,11,3,7,5,5,2,1,1,20,21,21,23.2
2024-25,202411080DAL,11/8/2024,DAL vs PHO,Jusuf Nurkic,nurkiju01,85,PHO,0,DAL,15,10,0,2,0,1,33.66666667,3,7,6,12,2,4,1,2,4,2,10,15,25,25,32
2024-25,202411080DAL,11/8/2024,DAL vs PHO,Klay Thompson,thompkl01,86,DAL,1,PHO,12,4,2,0,0,1,33.76666667,0,4,4,13,1,7,3,3,3,0,6,14,16,18,18.8
2024-25,202411080LAL,11/8/2024,LAL vs PHI,LeBron James,jamesle01,81,LAL,1,PHI,21,12,13,0,3,2,33.8,0,12,9,14,2,4,1,1,0,3,25,34,33,46,61.9
2024-25,202411080CHO,11/8/2024,CHO vs IND,Tyrese Haliburton,halibty01,79,IND,0,CHO,6,7,9,1,1,2,34.21666667,1,6,2,11,0,4,2,2,1,2,16,15,13,22,31.9
2024-25,202411080MEM,11/8/2024,MEM vs WAS,Kyshawn George,georgky01,7,WAS,0,MEM,17,6,3,1,2,1,34.33333333,0,6,6,12,3,8,2,2,3,3,9,20,23,26,36.7
2024-25,202411080NYK,11/8/2024,NYK vs MIL,Damian Lillard,lillada01,82,MIL,0,NYK,19,6,6,0,0,1,34.43333333,1,5,6,15,0,4,7,7,0,0,12,25,25,31,34.2
2024-25,202411080DAL,11/8/2024,DAL vs PHO,Devin Booker,bookede01,77,PHO,0,DAL,13,6,12,0,0,0,34.53333333,2,4,5,13,1,8,2,2,2,0,18,25,19,31,38.2
2024-25,202411080SAC,11/8/2024,SAC vs LAC,James Harden,hardeja01,81,LAC,0,SAC,22,4,8,2,0,7,34.53333333,0,4,5,16,3,6,9,9,2,2,12,30,26,34,37.8
2024-25,202411080DEN,11/8/2024,DEN vs MIA,Terry Rozier,roziete01,69,MIA,0,DEN,15,3,4,1,0,1,34.75,2,1,6,13,2,3,1,1,1,1,7,19,18,22,26.6
2024-25,202411080ORL,11/8/2024,ORL vs NOP,Jose Alvarado,alvarjo01,66,NOP,0,ORL,21,5,5,3,0,3,34.8,1,4,7,18,4,11,3,6,0,3,10,26,26,31,40.5
2024-25,202411080DEN,11/8/2024,DEN vs MIA,Jamal Murray,murraja01,65,DEN,1,MIA,28,4,6,0,0,4,34.91666667,0,4,9,17,4,10,6,6,0,0,10,34,32,38,37.8
2024-25,202411080DEN,11/8/2024,DEN vs MIA,Haywood Highsmith,highsha01,72,MIA,0,DEN,15,0,2,0,0,0,35.06666667,0,0,6,10,3,6,0,0,5,0,2,17,15,17,18
2024-25,202411080BOS,11/8/2024,BOS vs BRK,Sam Hauser,hausesa01,86,BOS,1,BRK,8,4,3,3,0,0,35.21666667,1,3,3,11,2,10,0,0,1,3,7,11,12,15,26.3
2024-25,202411080DEN,11/8/2024,DEN vs MIA,Christian Braun,braunch01,91,DEN,1,MIA,21,6,2,0,1,1,35.23333333,1,5,7,9,3,4,4,6,1,1,8,23,27,29,33.2
2024-25,202411080LAL,11/8/2024,LAL vs PHI,Anthony Davis,davisan02,85,LAL,1,PHI,31,9,1,0,4,3,35.48333333,3,6,11,20,2,3,7,8,2,4,10,32,40,41,52.3
2024-25,202411080CHO,11/8/2024,CHO vs IND,Bennedict Mathurin,mathube01,69,IND,0,CHO,22,6,2,2,0,1,36.05,1,5,8,16,2,2,4,5,2,2,8,24,28,30,37.2
2024-25,202411080DET,11/8/2024,DET vs ATL,Cade Cunningham,cunnica01,72,DET,1,ATL,22,11,13,1,1,7,36.26666667,1,10,8,17,1,4,5,5,2,2,24,35,33,46,53.7
2024-25,202411080DEN,11/8/2024,DEN vs MIA,Michael Porter Jr.,portemi01,90,DEN,1,MIA,21,5,4,2,1,2,36.41666667,0,5,8,15,5,10,0,0,2,3,9,25,26,30,40
2024-25,202411080DAL,11/8/2024,DAL vs PHO,Bradley Beal,bealbr01,60,PHO,0,DAL,15,4,3,0,0,1,36.43333333,2,2,6,17,1,7,2,2,3,0,7,18,19,22,23.3
2024-25,202411080NYK,11/8/2024,NYK vs MIL,Mikal Bridges,bridgmi01,90,NYK,1,MIL,17,3,3,1,1,1,36.53333333,1,2,7,18,3,11,0,0,1,2,6,20,20,23,30.1
2024-25,202411080SAC,11/8/2024,SAC vs LAC,Ivica Zubac,zubaciv01,77,LAC,0,SAC,13,15,5,0,2,1,36.61666667,7,8,6,9,0,0,1,2,3,2,20,18,28,33,43.5
2024-25,202411080BOS,11/8/2024,BOS vs BRK,Jrue Holiday,holidjr01,79,BOS,1,BRK,17,2,5,0,0,3,36.93333333,0,2,8,14,0,4,1,1,0,0,7,22,19,24,23.9
2024-25,202411080DAL,11/8/2024,DAL vs PHO,Kevin Durant,duranke01,84,PHO,0,DAL,26,5,4,1,2,1,36.96666667,1,4,8,14,3,6,7,7,2,3,9,30,31,35,46
2024-25,202411080DET,11/8/2024,DET vs ATL,Jalen Johnson,johnsja05,66,ATL,0,DET,20,9,1,0,1,1,37.16666667,0,9,8,19,2,6,2,2,2,1,10,21,29,30,34.3
2024-25,202411080BOS,11/8/2024,BOS vs BRK,Dennis Schroder,schrode01,89,BRK,0,BOS,20,3,3,4,0,4,37.46666667,0,3,9,23,2,8,0,0,2,4,6,23,23,26,36.1
2024-25,202411080SAC,11/8/2024,SAC vs LAC,Domantas Sabonis,sabondo01,91,SAC,1,LAC,23,12,6,1,0,2,37.55,0,12,9,12,0,2,5,6,4,1,18,29,35,41,47.4
2024-25,202411080SAC,11/8/2024,SAC vs LAC,De'Aaron Fox,foxde01,83,SAC,1,LAC,31,3,0,1,0,7,37.65,1,2,12,20,2,5,5,6,4,1,3,31,34,34,30.6
2024-25,202411080BOS,11/8/2024,BOS vs BRK,Cam Thomas,thomaca02,75,BRK,0,BOS,31,3,1,1,0,2,38,0,3,11,22,4,9,5,7,5,1,4,32,34,35,37.1
2024-25,202411080ORL,11/8/2024,ORL vs NOP,Brandon Boston Jr.,bostobr01,39,NOP,0,ORL,26,6,3,2,0,0,38.21666667,0,6,10,17,2,4,4,4,0,2,9,29,32,35,43.7
2024-25,202411080DET,11/8/2024,DET vs ATL,Dyson Daniels,daniedy01,69,ATL,0,DET,18,3,2,7,2,2,38.46666667,1,2,7,17,2,6,2,2,4,9,5,20,21,23,49.6
2024-25,202411080DEN,11/8/2024,DEN vs MIA,Bam Adebayo,adebaba01,79,MIA,0,DEN,20,9,4,2,0,3,38.7,2,7,7,18,1,5,5,6,3,2,13,24,29,33,39.8
2024-25,202411080SAC,11/8/2024,SAC vs LAC,Keegan Murray,murrake02,86,SAC,1,LAC,7,10,2,0,1,0,39.26666667,4,6,2,10,0,6,3,3,2,1,12,9,17,19,25
2024-25,202411080SAC,11/8/2024,SAC vs LAC,Norman Powell,powelno01,85,LAC,0,SAC,31,12,2,1,0,3,39.3,2,10,10,23,5,9,6,7,2,1,14,33,43,45,48.4
2024-25,202411080BOS,11/8/2024,BOS vs BRK,Cameron Johnson,johnsca02,67,BRK,0,BOS,18,8,4,0,0,0,39.58333333,2,6,6,13,3,8,3,3,2,0,12,22,26,30,33.6
2024-25,202411080SAC,11/8/2024,SAC vs LAC,DeMar DeRozan,derozde01,88,SAC,1,LAC,13,1,6,2,0,2,39.6,0,1,5,12,0,2,3,4,1,2,7,19,14,20,27.2
2024-25,202411080DEN,11/8/2024,DEN vs MIA,Nikola Jokic,jokicni01,88,DEN,1,MIA,30,11,14,2,0,5,39.98333333,2,9,11,13,1,1,7,7,2,2,25,44,41,55,65.2
2024-25,202411080DEN,11/8/2024,DEN vs MIA,Tyler Herro,herroty01,50,MIA,0,DEN,24,7,11,0,0,1,40.21666667,1,6,10,21,4,10,0,0,0,0,18,35,31,42,47.9
2024-25,202411080DAL,11/8/2024,DAL vs PHO,Kyrie Irving,irvinky01,67,DAL,1,PHO,29,7,6,3,0,2,40.76666667,2,5,10,17,2,6,7,9,1,3,13,35,36,42,53.4
2024-25,202411080DET,11/8/2024,DET vs ATL,Trae Young,youngtr01,64,ATL,0,DET,35,2,13,2,0,3,41,0,2,11,25,6,12,7,8,2,2,15,48,37,50,59.9
2024-25,202411080DAL,11/8/2024,DAL vs PHO,Luka Doncic,doncilu01,79,DAL,1,PHO,30,7,7,1,0,3,42.18333333,0,7,11,25,5,12,3,3,3,1,14,37,37,44,48.9
2024-25,202411080BOS,11/8/2024,BOS vs BRK,Jayson Tatum,tatumja01,84,BOS,1,BRK,33,9,6,2,1,3,42.35,0,9,11,25,5,13,6,7,3,3,15,39,42,48,58.8
2024-25,202411080BOS,11/8/2024,BOS vs BRK,Derrick White,whitede01,83,BOS,1,BRK,14,3,6,0,3,3,42.51666667,1,2,5,11,1,6,3,4,3,3,9,20,17,23,32.6
2024-25,202411070CHI,11/7/2024,CHI vs MIN,Julian Phillips,phillju01,49,CHI,1,MIN,6,1,0,1,0,0,10.56666667,0,1,2,2,1,1,1,2,2,1,1,6,7,7,10.2
2024-25,202411070SAS,11/7/2024,SAS vs POR,Donovan Clingan,clingdo01,9,POR,0,SAS,0,4,2,1,1,1,11.71666667,4,0,0,2,0,1,0,0,2,2,6,2,4,6,12.8
2024-25,202411070SAS,11/7/2024,SAS vs POR,Zach Collins,colliza01,78,SAS,1,POR,14,2,3,0,0,1,15.16666667,1,1,6,7,2,3,0,0,4,0,5,17,16,19,19.9
2024-25,202411070CHI,11/7/2024,CHI vs MIN,Jalen Smith,smithja04,69,CHI,1,MIN,9,6,0,1,0,1,15.76666667,2,4,4,7,1,4,0,0,1,1,6,9,15,15,18.2
2024-25,202411070MIL,11/7/2024,MIL vs UTA,Patty Mills,millspa02,40,UTA,0,MIL,5,1,2,2,0,1,16.05,0,1,2,5,1,3,0,0,2,2,3,7,6,8,14.2
2024-25,202411070SAS,11/7/2024,SAS vs POR,Dalano Banton,bantoda01,61,POR,0,SAS,4,3,3,1,0,0,16.33333333,1,2,1,8,0,2,2,4,0,1,6,7,7,10,15.1
2024-25,202411070MIL,11/7/2024,MIL vs UTA,Johnny Juzang,juzanjo01,25,UTA,0,MIL,12,1,1,1,1,0,16.4,0,1,4,6,3,4,1,1,3,2,2,13,13,14,20.7
2024-25,202411070CHI,11/7/2024,CHI vs MIN,Dalen Terry,terryda01,68,CHI,1,MIN,6,3,1,1,1,2,16.43333333,1,2,3,4,0,0,0,0,1,2,4,7,9,10,15.1
2024-25,202411070MIL,11/7/2024,MIL vs UTA,Pat Connaughton,connapa01,84,MIL,1,UTA,3,0,1,0,0,1,16.78333333,0,0,0,2,0,2,3,4,0,0,1,4,3,4,3.5
2024-25,202411070CHI,11/7/2024,CHI vs MIN,Matas Buzelis,buzelma01,8,CHI,1,MIN,2,3,0,2,2,2,16.83333333,1,2,1,3,0,2,0,0,1,4,3,2,5,5,15.6
2024-25,202411070CHI,11/7/2024,CHI vs MIN,Naz Reid,reidna01,89,MIN,0,CHI,4,2,1,1,0,0,17.68333333,1,1,2,7,0,3,0,0,2,1,3,5,6,7,10.9
2024-25,202411070MIL,11/7/2024,MIL vs UTA,Drew Eubanks,eubandr01,81,UTA,0,MIL,4,7,2,0,0,1,18.16666667,3,4,1,3,0,1,2,2,2,0,9,6,11,13,14.4
2024-25,202411070CHI,11/7/2024,CHI vs MIN,Talen Horton-Tucker,hortota01,58,CHI,1,MIN,13,5,2,0,0,0,18.31666667,1,4,5,9,2,3,1,2,0,0,7,15,18,20,22
2024-25,202411070MIL,11/7/2024,MIL vs UTA,A.J. Green,greenaj01,63,MIL,1,UTA,12,0,2,1,0,1,18.41666667,0,0,4,6,4,6,0,0,0,1,2,14,12,14,17
2024-25,202411070SAS,11/7/2024,SAS vs POR,Shaedon Sharpe,sharpsh01,33,POR,0,SAS,13,2,1,0,1,1,20.18333333,1,1,6,9,1,4,0,0,2,1,3,14,15,16,18.9
2024-25,202411070SAS,11/7/2024,SAS vs POR,Scoot Henderson,hendesc01,71,POR,0,SAS,11,3,3,1,0,2,20.41666667,1,2,5,12,1,2,0,0,0,1,6,14,14,17,20.1
2024-25,202411070MIL,11/7/2024,MIL vs UTA,Jordan Clarkson,clarkjo01,61,UTA,0,MIL,18,4,2,0,0,4,20.76666667,0,4,5,11,4,9,4,4,0,0,6,20,22,24,21.8
2024-25,202411070SAS,11/7/2024,SAS vs POR,Blake Wesley,weslebl01,69,SAS,1,POR,10,1,8,2,0,2,21.21666667,0,1,4,4,0,0,2,2,2,2,9,18,11,19,27.2
2024-25,202411070CHI,11/7/2024,CHI vs MIN,Nickeil Alexander-Walker,alexani01,90,MIN,0,CHI,5,1,0,1,0,1,22.08333333,0,1,2,5,1,3,0,0,1,1,1,5,6,6,8.2
2024-25,202411070SAS,11/7/2024,SAS vs POR,Malaki Branham,branhma01,84,SAS,1,POR,17,1,3,0,0,2,22.2,0,1,6,8,3,5,2,2,1,0,4,20,18,21,20.7
2024-25,202411070SAS,11/7/2024,SAS vs POR,Harrison Barnes,barneha02,91,SAS,1,POR,11,7,2,0,0,2,23.93333333,4,3,4,9,1,4,2,4,1,0,9,13,18,20,20.4
2024-25,202411070MIL,11/7/2024,MIL vs UTA,Taurean Prince,princta02,87,MIL,1,UTA,6,4,1,0,1,0,24.76666667,1,3,2,5,2,4,0,0,0,1,5,7,10,11,15.3
2024-25,202411070SAS,11/7/2024,SAS vs POR,Deni Avdija,avdijde01,84,POR,0,SAS,9,7,5,0,0,1,24.8,2,5,3,5,1,3,2,5,0,0,12,14,16,21,23.9
2024-25,202411070MIL,11/7/2024,MIL vs UTA,Walker Kessler,kesslwa01,72,UTA,0,MIL,6,8,0,0,3,2,24.85,3,5,3,3,0,0,0,0,3,3,8,6,14,14,22.6
2024-25,202411070MIL,11/7/2024,MIL vs UTA,Keyonte George,georgke01,83,UTA,0,MIL,10,3,3,0,0,2,25.35,0,3,3,11,3,7,1,2,3,0,6,13,13,16,16.1
2024-25,202411070SAS,11/7/2024,SAS vs POR,Stephon Castle,castlst01,9,SAS,1,POR,14,3,6,0,0,0,25.38333333,1,2,6,11,0,3,2,2,1,0,9,20,17,23,26.6
2024-25,202411070MIL,11/7/2024,MIL vs UTA,Cody Williams,willico04,8,UTA,0,MIL,6,2,1,0,1,1,25.38333333,0,2,2,5,2,4,0,0,1,1,3,7,8,9,11.9
2024-25,202411070MIL,11/7/2024,MIL vs UTA,John Collins,collijo01,76,UTA,0,MIL,11,3,1,0,0,4,25.43333333,0,3,4,7,0,1,3,3,1,0,4,12,14,15,12.1
2024-25,202411070CHI,11/7/2024,CHI vs MIN,Mike Conley,conlemi01,84,MIN,0,CHI,14,2,11,0,0,0,26.25,0,2,5,9,3,6,1,1,2,0,13,25,16,27,32.9
2024-25,202411070MIL,11/7/2024,MIL vs UTA,Bobby Portis,portibo01,90,MIL,1,UTA,19,6,0,0,0,0,26.6,3,3,7,15,3,6,2,3,3,0,6,19,25,25,26.2
2024-25,202411070CHI,11/7/2024,CHI vs MIN,Donte DiVincenzo,divindo01,89,MIN,0,CHI,13,4,4,3,1,2,27.18333333,0,4,4,12,3,10,2,2,3,4,8,17,17,21,33.8
2024-25,202411070MIL,11/7/2024,MIL vs UTA,Collin Sexton,sextoco01,86,UTA,0,MIL,14,2,7,0,0,3,27.23333333,0,2,5,12,2,4,2,2,3,0,9,21,16,23,23.9
2024-25,202411070SAS,11/7/2024,SAS vs POR,Chris Paul,paulch01,67,SAS,1,POR,6,2,6,2,0,1,27.48333333,0,2,2,6,1,4,1,1,1,2,8,12,8,14,22.4
2024-25,202411070MIL,11/7/2024,MIL vs UTA,Andre Jackson Jr.,jacksan01,64,MIL,1,UTA,7,3,4,4,0,0,28.31666667,0,3,3,4,1,1,0,0,4,4,7,11,10,14,28.6
2024-25,202411070MIL,11/7/2024,MIL vs UTA,Lauri Markkanen,markkla01,60,UTA,0,MIL,8,7,4,2,0,2,28.51666667,2,5,3,10,2,6,0,0,1,2,11,12,15,19,26.4
2024-25,202411070CHI,11/7/2024,CHI vs MIN,Josh Giddey,giddejo01,89,CHI,1,MIN,9,6,13,0,0,0,29.75,1,5,3,12,1,4,2,3,1,0,19,22,15,28,35.7
2024-25,202411070MIL,11/7/2024,MIL vs UTA,Giannis Antetokounmpo,antetgi01,80,MIL,1,UTA,31,16,2,1,1,4,30.2,6,10,11,21,0,0,9,12,5,2,18,33,47,49,55.2
2024-25,202411070CHI,11/7/2024,CHI vs MIN,Nikola Vucevic,vucevni01,85,CHI,1,MIN,25,5,2,0,1,2,30.43333333,2,3,11,15,3,5,0,2,4,1,7,27,30,32,35
2024-25,202411070SAS,11/7/2024,SAS vs POR,Keldon Johnson,johnske04,78,SAS,1,POR,17,11,3,0,0,0,30.53333333,2,9,6,13,2,5,3,4,4,0,14,20,28,31,34.7
2024-25,202411070SAS,11/7/2024,SAS vs POR,Deandre Ayton,aytonde01,64,POR,0,SAS,21,10,0,2,1,2,30.78333333,2,8,10,15,1,2,0,0,2,3,10,21,31,31,40
2024-25,202411070CHI,11/7/2024,CHI vs MIN,Patrick Williams,willipa01,52,CHI,1,MIN,12,0,1,3,0,2,31.25,0,0,4,9,2,4,2,2,2,3,1,13,12,13,20.5
2024-25,202411070CHI,11/7/2024,CHI vs MIN,Rudy Gobert,goberru01,84,MIN,0,CHI,21,9,3,0,1,2,31.78333333,3,6,9,11,0,0,3,3,4,1,12,24,30,33,37.3
2024-25,202411070MIL,11/7/2024,MIL vs UTA,Brook Lopez,lopezbr01,87,MIL,1,UTA,1,5,2,2,1,2,32.35,1,4,0,2,0,2,1,2,2,3,7,3,6,8,17
2024-25,202411070SAS,11/7/2024,SAS vs POR,Victor Wembanyama,wembavi01,80,SAS,1,POR,12,8,2,4,3,4,32.35,2,6,4,13,2,6,2,3,0,7,10,14,20,22,41.6
2024-25,202411070SAS,11/7/2024,SAS vs POR,Anfernee Simons,simonan01,55,POR,0,SAS,19,0,7,1,0,3,32.75,0,0,7,16,3,9,2,2,2,1,7,26,19,26,29.5
2024-25,202411070SAS,11/7/2024,SAS vs POR,Julian Champagnie,champju02,83,SAS,1,POR,14,6,2,1,0,1,32.86666667,1,5,5,10,4,8,0,0,0,1,8,16,20,22,26.2
2024-25,202411070CHI,11/7/2024,CHI vs MIN,Ayo Dosunmu,dosunay01,85,CHI,1,MIN,13,3,2,1,0,1,33.06666667,2,1,5,11,1,3,2,2,4,1,5,15,16,18,21.6
2024-25,202411070CHI,11/7/2024,CHI vs MIN,Jaden McDaniels,mcdanja02,80,MIN,0,CHI,19,2,0,0,1,1,33.08333333,0,2,6,7,3,3,4,4,1,1,2,19,21,21,23.4
2024-25,202411070CHI,11/7/2024,CHI vs MIN,Coby White,whiteco01,88,CHI,1,MIN,24,0,8,0,0,3,33.98333333,0,0,9,15,4,9,2,2,4,0,8,32,24,32,33
2024-25,202411070SAS,11/7/2024,SAS vs POR,Toumani Camara,camarto01,79,POR,0,SAS,4,9,1,1,0,2,34.53333333,3,6,2,7,0,3,0,0,3,1,10,5,13,14,17.3
2024-25,202411070CHI,11/7/2024,CHI vs MIN,Anthony Edwards,edwaran01,87,MIN,0,CHI,33,8,6,0,1,2,34.81666667,3,5,13,23,5,9,2,2,2,1,14,39,41,47,52.6
2024-25,202411070CHI,11/7/2024,CHI vs MIN,Julius Randle,randlju01,54,MIN,0,CHI,22,10,3,1,0,4,35.35,2,8,8,15,1,4,5,5,1,1,13,25,32,35,37.5
2024-25,202411070SAS,11/7/2024,SAS vs POR,Jerami Grant,grantje01,63,POR,0,SAS,21,3,1,0,0,2,36.93333333,0,3,6,10,1,4,8,11,3,0,4,22,24,25,24.1
2024-25,202411070MIL,11/7/2024,MIL vs UTA,Damian Lillard,lillada01,81,MIL,1,UTA,34,4,7,4,0,0,37.03333333,0,4,12,22,4,11,6,7,2,4,11,41,38,45,61.3
2024-25,202411060DEN,11/6/2024,DEN vs OKC,Zeke Nnaji,nnajize01,62,DEN,1,OKC,3,2,0,0,0,0,10,1,1,1,2,0,1,1,2,0,0,2,3,5,5,5.4
2024-25,202411060LAC,11/6/2024,LAC vs PHI,Guerschon Yabusele,yabusgu01,7,PHI,0,LAC,4,1,0,0,0,0,10.2,1,0,2,3,0,1,0,0,1,0,1,4,5,5,5.2
2024-25,202411060DEN,11/6/2024,DEN vs OKC,Ousmane Dieng,diengou01,41,OKC,0,DEN,6,4,0,0,0,0,10.45,2,2,2,2,1,1,1,2,2,0,4,6,10,10,10.8
2024-25,202411060SAC,11/6/2024,SAC vs TOR,Trey Lyles,lylestr01,66,SAC,1,TOR,0,1,1,0,0,0,10.51666667,0,1,0,1,0,1,0,0,0,0,2,1,1,2,2.7
2024-25,202411060ATL,11/6/2024,ATL vs NYK,David Roddy,roddyda01,72,ATL,1,NYK,0,2,1,0,0,0,11.15,1,1,0,1,0,1,0,0,0,0,3,1,2,3,3.9
2024-25,202411060IND,11/6/2024,IND vs ORL,Ben Sheppard,sheppbe01,66,IND,1,ORL,6,0,0,0,0,0,11.33333333,0,0,2,3,2,3,0,0,3,0,0,6,6,6,6
2024-25,202411060CHO,11/6/2024,CHO vs DET,Seth Curry,curryse01,51,CHO,1,DET,0,2,0,0,0,0,11.48333333,0,2,0,3,0,2,0,0,0,0,2,0,2,2,2.4
2024-25,202411060LAC,11/6/2024,LAC vs PHI,Kevin Porter Jr.,porteke02,8,LAC,1,PHI,2,2,3,0,0,2,11.51666667,0,2,1,4,0,1,0,1,0,0,5,5,4,7,6.9
2024-25,202411060CHO,11/6/2024,CHO vs DET,Tidjane Salaun,salauti01,6,CHO,1,DET,3,1,0,0,0,0,11.96666667,0,1,1,1,1,1,0,0,0,0,1,3,4,4,4.2
2024-25,202411060LAC,11/6/2024,LAC vs PHI,Jared McCain,mccaija01,7,PHI,0,LAC,5,1,2,1,0,0,12,0,1,2,4,0,1,1,1,1,1,3,7,6,8,12.2
2024-25,202411060PHO,11/6/2024,PHO vs MIA,Mason Plumlee,plumlma01,54,PHO,1,MIA,4,3,2,0,0,0,12.13333333,1,2,2,2,0,0,0,0,0,0,5,6,7,9,10.6
2024-25,202411060CHO,11/6/2024,CHO vs DET,Paul Reed,reedpa01,85,DET,0,CHO,13,2,0,2,1,1,12.3,0,2,6,6,0,0,1,2,3,3,2,13,15,15,23.4
2024-25,202411060ATL,11/6/2024,ATL vs NYK,Keaton Wallace,wallake01,7,ATL,1,NYK,7,0,0,1,0,1,12.73333333,0,0,3,7,1,3,0,0,1,1,0,7,7,7,9
2024-25,202411060MEM,11/6/2024,MEM vs LAL,Christian Koloko,kolokch01,1,LAL,0,MEM,2,2,0,0,1,0,13.33333333,1,1,1,2,0,0,0,0,1,1,2,2,4,4,7.4
2024-25,202411060BOS,11/6/2024,BOS vs GSW,Moses Moody,moodymo01,74,GSW,0,BOS,9,6,0,1,0,0,13.43333333,3,3,3,5,1,2,2,2,1,1,6,9,15,15,19.2
2024-25,202411060DAL,11/6/2024,DAL vs CHI,Jaden Hardy,hardyja02,80,DAL,1,CHI,11,0,2,0,0,1,13.48333333,0,0,4,10,3,7,0,0,1,0,2,13,11,13,13
2024-25,202411060PHO,11/6/2024,PHO vs MIA,Kel'el Ware,wareke01,3,MIA,0,PHO,7,3,0,2,1,1,13.58333333,0,3,3,6,1,1,0,0,2,3,3,7,10,10,18.6
2024-25,202411060BOS,11/6/2024,BOS vs GSW,Lindy Waters III,waterli01,46,GSW,0,BOS,0,2,1,0,0,0,13.9,0,2,0,2,0,1,0,0,0,0,3,1,2,3,3.9
2024-25,202411060MEM,11/6/2024,MEM vs LAL,Jay Huff,huffja01,29,MEM,1,LAL,11,3,4,0,1,2,13.98333333,1,2,4,7,3,6,0,0,0,1,7,15,14,18,21.6
2024-25,202411060IND,11/6/2024,IND vs ORL,Gary Harris,harriga01,62,ORL,0,IND,5,1,0,0,0,1,14.3,0,1,2,3,1,2,0,0,0,0,1,5,6,6,5.2
2024-25,202411060BOS,11/6/2024,BOS vs GSW,Luke Kornet,kornelu01,72,BOS,1,GSW,2,3,2,0,0,0,14.35,2,1,0,2,0,0,2,2,1,0,5,4,5,7,8.6
2024-25,202411060SAC,11/6/2024,SAC vs TOR,Alex Len,lenal01,54,SAC,1,TOR,3,6,0,0,4,1,14.41666667,0,6,1,1,0,0,1,2,1,4,6,3,9,9,21.2
2024-25,202411060IND,11/6/2024,IND vs ORL,Moritz Wagner,wagnemo01,89,ORL,0,IND,14,1,1,1,0,1,14.6,0,1,4,8,0,1,6,7,1,1,2,15,15,16,18.7
2024-25,202411060MEM,11/6/2024,MEM vs LAL,Zach Edey,edeyza01,9,MEM,1,LAL,8,7,0,0,0,3,14.7,4,3,3,5,0,0,2,2,2,0,7,8,15,15,13.4
2024-25,202411060PHO,11/6/2024,PHO vs MIA,Duncan Robinson,robindu01,74,MIA,0,PHO,9,1,0,0,1,0,14.83333333,0,1,3,8,3,6,0,0,0,1,1,9,10,10,13.2
2024-25,202411060CHO,11/6/2024,CHO vs DET,Taj Gibson,gibsota01,23,CHO,1,DET,7,4,0,0,2,1,14.91666667,1,3,3,4,0,0,1,1,3,2,4,7,11,11,16.8
2024-25,202411060HOU,11/6/2024,HOU vs SAS,Zach Collins,colliza01,77,SAS,0,HOU,6,1,3,0,0,2,15.11666667,0,1,2,5,1,2,1,2,0,0,4,9,7,10,9.7
2024-25,202411060HOU,11/6/2024,HOU vs SAS,Sandro Mamukelashvili,mamuksa01,52,SAS,0,HOU,10,7,1,0,2,2,15.11666667,3,4,4,5,2,3,0,0,0,2,8,11,17,18,23.9
2024-25,202411060DAL,11/6/2024,DAL vs CHI,Julian Phillips,phillju01,48,CHI,0,DAL,8,2,0,0,0,0,15.3,2,0,4,5,0,1,0,3,1,0,2,8,10,10,10.4
2024-25,202411060IND,11/6/2024,IND vs ORL,Jonathan Isaac,isaacjo01,64,ORL,0,IND,9,6,0,0,1,1,15.5,2,4,4,4,0,0,1,2,0,1,6,9,15,15,18.2
2024-25,202411060SAC,11/6/2024,SAC vs TOR,Jamison Battle,battlja01,8,TOR,0,SAC,6,2,2,0,0,2,15.51666667,0,2,2,7,2,5,0,0,4,0,4,8,8,10,9.4
2024-25,202411060CHO,11/6/2024,CHO vs DET,Ron Holland,hollaro01,9,DET,0,CHO,8,4,0,0,0,1,15.53333333,1,3,3,5,2,3,0,0,1,0,4,8,12,12,11.8
2024-25,202411060DAL,11/6/2024,DAL vs CHI,Quentin Grimes,grimequ01,59,DAL,1,CHI,7,6,2,0,0,0,15.66666667,1,5,3,6,1,3,0,0,2,0,8,9,13,15,17.2
2024-25,202411060DAL,11/6/2024,DAL vs CHI,Jalen Smith,smithja04,68,CHI,0,DAL,2,5,0,1,0,1,15.75,0,5,1,5,0,3,0,0,4,1,5,2,7,7,10
2024-25,202411060SAC,11/6/2024,SAC vs TOR,Jamal Shead,sheadja01,9,TOR,0,SAC,5,1,2,0,1,1,15.78333333,0,1,2,5,0,1,1,1,2,1,3,7,6,8,11.2
2024-25,202411060NOP,11/6/2024,NOP vs CLE,Ty Jerome,jeromty01,11,CLE,0,NOP,11,3,5,2,0,1,15.8,1,2,4,7,2,2,1,2,1,2,8,16,14,19,27.1
2024-25,202411060BOS,11/6/2024,BOS vs GSW,Kevon Looney,looneke01,82,GSW,0,BOS,6,10,0,0,0,0,15.86666667,6,4,3,5,0,0,0,0,4,0,10,6,16,16,18
2024-25,202411060HOU,11/6/2024,HOU vs SAS,Blake Wesley,weslebl01,68,SAS,0,HOU,5,0,2,1,0,1,15.86666667,0,0,2,8,1,2,0,0,2,1,2,7,5,7,10
2024-25,202411060PHO,11/6/2024,PHO vs MIA,Alec Burks,burksal01,71,MIA,0,PHO,5,2,4,1,0,0,16.01666667,0,2,2,4,1,2,0,0,1,1,6,9,7,11,16.4
2024-25,202411060DAL,11/6/2024,DAL vs CHI,Talen Horton-Tucker,hortota01,57,CHI,0,DAL,8,2,4,0,1,0,16.06666667,0,2,4,7,0,2,0,0,1,1,6,12,10,14,19.4
2024-25,202411060BOS,11/6/2024,BOS vs GSW,Trayce Jackson-Davis,jackstr02,76,GSW,0,BOS,8,2,1,0,0,1,16.18333333,1,1,4,6,0,0,0,0,1,0,3,9,10,11,10.9
2024-25,202411060IND,11/6/2024,IND vs ORL,T.J. McConnell,mccontj01,80,IND,1,ORL,15,0,5,1,0,4,16.65,0,0,7,7,1,1,0,0,2,1,5,20,15,20,21.5
2024-25,202411060LAC,11/6/2024,LAC vs PHI,Eric Gordon,gordoer01,75,PHI,0,LAC,1,1,2,0,0,4,16.75,1,0,0,2,0,1,1,2,1,0,3,3,2,4,1.2
2024-25,202411060IND,11/6/2024,IND vs ORL,Obi Toppin,toppiob01,91,IND,1,ORL,4,0,1,0,0,0,16.93333333,0,0,2,3,0,0,0,0,1,0,1,5,4,5,5.5
2024-25,202411060DEN,11/6/2024,DEN vs OKC,Aaron Wiggins,wiggiaa01,86,OKC,0,DEN,13,2,1,0,0,0,17.35,1,1,5,9,2,4,1,1,0,0,3,14,15,16,16.9
2024-25,202411060BOS,11/6/2024,BOS vs GSW,Jonathan Kuminga,kuminjo01,82,GSW,0,BOS,10,4,1,0,0,1,17.95,0,4,4,10,2,3,0,0,3,0,5,11,14,15,15.3
2024-25,202411060SAC,11/6/2024,SAC vs TOR,Jonathan Mogbo,mogbojo01,9,TOR,0,SAC,5,5,3,1,0,1,18.08333333,4,1,2,3,0,1,1,2,3,1,8,8,10,13,17.5
2024-25,202411060MEM,11/6/2024,MEM vs LAL,Luke Kennard,kennalu01,40,MEM,1,LAL,6,1,2,0,0,0,18.25,0,1,2,4,1,2,1,2,2,0,3,8,7,9,10.2
2024-25,202411060LAC,11/6/2024,LAC vs PHI,Kris Dunn,dunnkr01,74,LAC,1,PHI,4,1,5,2,0,2,18.26666667,1,0,2,3,0,1,0,0,3,2,6,9,5,10,16.7
2024-25,202411060HOU,11/6/2024,HOU vs SAS,Harrison Barnes,barneha02,90,SAS,0,HOU,2,1,1,0,0,2,18.3,0,1,1,4,0,1,0,0,0,0,2,3,3,4,2.7
2024-25,202411060BOS,11/6/2024,BOS vs GSW,Gary Payton II,paytoga02,52,GSW,0,BOS,6,3,1,1,2,2,18.3,2,1,3,4,0,1,0,1,2,3,4,7,9,10,18.1
2024-25,202411060LAC,11/6/2024,LAC vs PHI,KJ Martin,martike04,67,PHI,0,LAC,10,4,0,1,0,0,18.45,0,4,5,6,0,0,0,0,1,1,4,10,14,14,17.8
2024-25,202411060HOU,11/6/2024,HOU vs SAS,Jock Landale,landajo01,61,HOU,1,SAS,11,6,0,1,0,1,18.46666667,4,2,5,12,1,1,0,0,2,1,6,11,17,17,20.2
2024-25,202411060NOP,11/6/2024,NOP vs CLE,Jordan Hawkins,hawkijo01,75,NOP,1,CLE,7,4,1,0,1,1,18.5,0,4,1,7,1,4,4,4,0,1,5,8,11,12,15.3
2024-25,202411060DEN,11/6/2024,DEN vs OKC,Hunter Tyson,tysonhu01,23,DEN,1,OKC,2,4,0,1,0,2,18.66666667,0,4,1,2,0,1,0,0,4,1,4,2,6,6,7.8
2024-25,202411060NOP,11/6/2024,NOP vs CLE,Yves Missi,missiyv01,9,NOP,1,CLE,10,4,0,0,3,1,18.78333333,3,1,4,8,0,0,2,3,1,3,4,10,14,14,22.8
2024-25,202411060MEM,11/6/2024,MEM vs LAL,Brandon Clarke,clarkbr01,15,MEM,1,LAL,6,3,0,0,0,0,19.16666667,0,3,2,6,0,0,2,2,1,0,3,6,9,9,9.6
2024-25,202411060NOP,11/6/2024,NOP vs CLE,Sam Merrill,merrisa01,70,CLE,0,NOP,9,2,0,0,0,2,19.2,1,1,3,6,3,6,0,0,3,0,2,9,11,11,9.4
2024-25,202411060HOU,11/6/2024,HOU vs SAS,Keldon Johnson,johnske04,77,SAS,0,HOU,10,4,1,1,1,0,19.35,2,2,4,6,0,0,2,2,1,2,5,11,14,15,22.3
2024-25,202411060MEM,11/6/2024,MEM vs LAL,Max Christie,chrisma02,76,LAL,0,MEM,8,3,3,1,0,0,19.36666667,1,2,3,8,1,2,1,1,0,1,6,11,11,14,19.1
2024-25,202411060DAL,11/6/2024,DAL vs CHI,Dwight Powell,poweldw01,70,DAL,1,CHI,5,5,3,2,1,1,19.6,1,4,1,1,0,0,3,4,3,3,8,8,10,13,23.5
2024-25,202411060DAL,11/6/2024,DAL vs CHI,Olivier-Maxence Prosper,prospol01,45,DAL,1,CHI,6,1,0,0,0,1,19.68333333,1,0,3,8,0,1,0,0,3,0,1,6,7,7,6.2
2024-25,202411060HOU,11/6/2024,HOU vs SAS,Malaki Branham,branhma01,83,SAS,0,HOU,10,4,2,0,0,1,19.81666667,0,4,3,6,1,1,3,5,0,0,6,12,14,16,16.8
2024-25,202411060ATL,11/6/2024,ATL vs NYK,Garrison Mathews,mathega01,74,ATL,1,NYK,9,3,2,1,0,0,19.81666667,1,2,2,5,2,4,3,3,1,1,5,11,12,14,18.6
2024-25,202411060BOS,11/6/2024,BOS vs GSW,Kyle Anderson,anderky01,87,GSW,0,BOS,11,5,4,0,1,0,19.88333333,0,5,3,9,3,4,2,2,1,1,9,15,16,20,26
2024-25,202411060LAC,11/6/2024,LAC vs PHI,Kyle Lowry,lowryky01,67,PHI,0,LAC,0,2,4,1,0,2,19.9,1,1,0,3,0,3,0,0,2,1,6,4,2,6,9.4
2024-25,202411060HOU,11/6/2024,HOU vs SAS,Chris Paul,paulch01,66,SAS,0,HOU,10,2,4,0,0,2,19.98333333,1,1,3,7,3,7,1,1,3,0,6,14,12,16,16.4
2024-25,202411060CHO,11/6/2024,CHO vs DET,Simone Fontecchio,fontesi01,75,DET,0,CHO,7,5,1,0,0,0,20.01666667,1,4,3,4,1,2,0,0,0,0,6,8,12,13,14.5
2024-25,202411060ATL,11/6/2024,ATL vs NYK,Onyeka Okongwu,okongon01,62,ATL,1,NYK,2,4,5,1,0,0,20.13333333,2,2,1,6,0,1,0,0,2,1,9,7,6,11,17.3
2024-25,202411060HOU,11/6/2024,HOU vs SAS,Reed Sheppard,sheppre01,8,HOU,1,SAS,5,2,3,0,0,2,20.15,1,1,2,5,1,3,0,0,1,0,5,8,7,10,9.9
2024-25,202411060LAC,11/6/2024,LAC vs PHI,Nicolas Batum,batumni01,68,LAC,1,PHI,7,2,0,3,0,0,20.25,1,1,3,6,1,3,0,0,1,3,2,7,9,9,18.4
2024-25,202411060DEN,11/6/2024,DEN vs OKC,Cason Wallace,wallaca01,90,OKC,0,DEN,4,2,2,2,0,1,20.26666667,0,2,2,8,0,3,0,0,4,2,4,6,6,8,14.4
2024-25,202411060LAC,11/6/2024,LAC vs PHI,Terance Mann,mannte01,83,LAC,1,PHI,7,2,2,1,0,0,20.68333333,1,1,3,6,1,3,0,0,2,1,4,9,9,11,15.4
2024-25,202411060NOP,11/6/2024,NOP vs CLE,Georges Niang,niangge01,91,CLE,0,NOP,9,2,2,0,1,0,21.11666667,0,2,4,8,1,5,0,0,2,1,4,11,11,13,17.4
2024-25,202411060SAC,11/6/2024,SAC vs TOR,Malik Monk,monkma01,80,SAC,1,TOR,13,5,1,2,0,1,21.21666667,0,5,4,12,1,4,4,5,1,2,6,14,18,19,25.5
2024-25,202411060CHO,11/6/2024,CHO vs DET,Tre Mann,manntr01,49,CHO,1,DET,4,3,2,1,0,1,21.23333333,0,3,2,7,0,4,0,0,1,1,5,6,7,9,12.6
2024-25,202411060PHO,11/6/2024,PHO vs MIA,Pelle Larsson,larsspe01,4,MIA,0,PHO,6,0,3,0,0,1,21.38333333,0,0,2,5,0,3,2,3,3,0,3,9,6,9,9.5
2024-25,202411060DAL,11/6/2024,DAL vs CHI,Naji Marshall,marshna01,74,DAL,1,CHI,8,2,2,2,0,2,21.38333333,1,1,4,7,0,1,0,0,0,2,4,10,10,12,17.4
2024-25,202411060MEM,11/6/2024,MEM vs LAL,D'Angelo Russell,russeda01,85,LAL,0,MEM,12,1,3,2,0,1,21.55,0,1,4,12,2,9,2,2,2,2,4,15,13,16,22.7
2024-25,202411060DEN,11/6/2024,DEN vs OKC,Alex Caruso,carusal01,79,OKC,0,DEN,2,6,4,4,2,0,21.58333333,1,5,1,9,0,3,0,0,5,6,10,6,8,12,33.2
2024-25,202411060PHO,11/6/2024,PHO vs MIA,Grayson Allen,allengr01,81,PHO,1,MIA,12,2,0,0,0,1,21.65,0,2,3,10,3,9,3,4,0,0,2,12,14,14,13.4
2024-25,202411060BOS,11/6/2024,BOS vs GSW,Sam Hauser,hausesa01,85,BOS,1,GSW,6,5,1,0,0,0,21.78333333,0,5,2,5,2,5,0,0,1,0,6,7,11,12,13.5
2024-25,202411060HOU,11/6/2024,HOU vs SAS,Tari Eason,easonta01,30,HOU,1,SAS,12,4,1,1,1,0,21.81666667,3,1,5,7,1,2,1,2,1,2,5,13,16,17,24.3
2024-25,202411060DAL,11/6/2024,DAL vs CHI,Spencer Dinwiddie,dinwisp01,83,DAL,1,CHI,3,3,4,0,0,2,22.3,1,2,1,8,0,6,1,2,2,0,7,7,6,10,10.6
2024-25,202411060PHO,11/6/2024,PHO vs MIA,Royce O'Neale,onealro01,87,PHO,1,MIA,6,7,2,1,1,1,22.8,3,4,2,6,2,4,0,0,2,2,9,8,13,15,22.4
2024-25,202411060DAL,11/6/2024,DAL vs CHI,Matas Buzelis,buzelma01,7,CHI,0,DAL,13,9,0,2,1,1,22.85,3,6,4,9,3,4,2,2,0,3,9,13,22,22,31.8
2024-25,202411060SAC,11/6/2024,SAC vs TOR,Keon Ellis,elliske01,64,SAC,1,TOR,8,3,1,2,0,0,23.11666667,3,0,2,4,1,3,3,3,2,2,4,9,11,12,19.1
2024-25,202411060IND,11/6/2024,IND vs ORL,Jarace Walker,walkeja02,42,IND,1,ORL,17,6,0,2,1,0,23.23333333,1,5,7,7,3,3,0,0,1,3,6,17,23,23,33.2
2024-25,202411060IND,11/6/2024,IND vs ORL,Tristan Da Silva,dasiltr01,5,ORL,0,IND,5,0,3,0,0,1,23.26666667,0,0,2,4,1,2,0,0,3,0,3,8,5,8,8.5
2024-25,202411060MEM,11/6/2024,MEM vs LAL,Gabe Vincent,vincega01,19,LAL,0,MEM,6,1,1,0,0,2,23.35,0,1,2,8,1,6,1,2,1,0,2,7,7,8,6.7
2024-25,202411060DAL,11/6/2024,DAL vs CHI,Patrick Williams,willipa01,51,CHI,0,DAL,8,6,1,0,0,4,23.43333333,0,6,2,4,2,4,2,2,2,0,7,9,14,15,12.7
2024-25,202411060DAL,11/6/2024,DAL vs CHI,Daniel Gafford,gaffoda01,82,DAL,1,CHI,17,7,1,0,3,0,23.53333333,2,5,7,9,0,0,3,4,1,3,8,18,24,25,35.9
2024-25,202411060SAC,11/6/2024,SAC vs TOR,Kevin Huerter,huertke01,70,SAC,1,TOR,11,4,2,0,0,2,23.56666667,1,3,4,7,1,4,2,2,4,0,6,13,15,17,16.8
2024-25,202411060LAC,11/6/2024,LAC vs PHI,Paul George,georgpa01,76,PHI,0,LAC,18,7,2,3,1,4,23.6,3,4,7,9,2,3,2,2,4,4,9,20,25,27,37.4
2024-25,202411060DAL,11/6/2024,DAL vs CHI,Dalen Terry,terryda01,67,CHI,0,DAL,10,4,1,2,0,3,23.7,3,1,3,7,1,3,3,4,1,2,5,11,14,15,19.3
2024-25,202411060LAC,11/6/2024,LAC vs PHI,Derrick Jones Jr.,jonesde02,84,LAC,1,PHI,14,4,2,0,0,0,23.85,1,3,5,6,1,2,3,3,2,0,6,16,18,20,21.8
2024-25,202411060NOP,11/6/2024,NOP vs CLE,Isaac Okoro,okorois01,78,CLE,0,NOP,7,4,3,0,0,0,23.85,1,3,3,3,1,1,0,0,0,0,7,10,11,14,16.3
2024-25,202411060SAC,11/6/2024,SAC vs TOR,Gradey Dick,dickgr01,69,TOR,0,SAC,7,4,2,0,0,0,23.88333333,1,3,3,10,0,5,1,2,4,0,6,9,11,13,14.8
2024-25,202411060HOU,11/6/2024,HOU vs SAS,Jabari Smith Jr.,smithja05,84,HOU,1,SAS,12,4,0,0,0,0,24.03333333,2,2,6,8,0,1,0,0,1,0,4,12,16,16,16.8
2024-25,202411060MEM,11/6/2024,MEM vs LAL,Ja Morant,moranja01,17,MEM,1,LAL,20,4,5,1,1,5,24.15,0,4,7,17,2,3,4,5,2,2,9,25,24,29,33.3
2024-25,202411060CHO,11/6/2024,CHO vs DET,Josh Green,greenjo02,63,CHO,1,DET,0,2,1,0,0,1,24.21666667,1,1,0,4,0,2,0,0,3,0,3,1,2,3,2.9
2024-25,202411060HOU,11/6/2024,HOU vs SAS,Alperen Sengun,sengual01,71,HOU,1,SAS,16,5,4,1,2,1,24.26666667,0,5,8,15,0,1,0,1,1,3,9,20,21,25,36
2024-25,202411060HOU,11/6/2024,HOU vs SAS,Amen Thompson,thompam01,70,HOU,1,SAS,8,6,4,2,1,1,24.3,1,5,4,4,0,0,0,2,1,3,10,12,14,18,29.2
2024-25,202411060CHO,11/6/2024,CHO vs DET,Malik Beasley,beaslma01,88,DET,0,CHO,5,1,5,2,0,0,24.33333333,0,1,2,11,1,7,0,0,1,2,6,10,6,11,19.7
2024-25,202411060SAC,11/6/2024,SAC vs TOR,Chris Boucher,bouchch01,59,TOR,0,SAC,17,4,0,0,0,0,24.53333333,1,3,7,11,3,6,0,0,1,0,4,17,21,21,21.8
2024-25,202411060LAC,11/6/2024,LAC vs PHI,Amir Coffey,coffeam01,78,LAC,1,PHI,11,3,0,0,0,0,24.55,2,1,4,8,2,3,1,1,0,0,3,11,14,14,14.6
2024-25,202411060HOU,11/6/2024,HOU vs SAS,Dillon Brooks,brookdi01,80,HOU,1,SAS,10,2,0,1,0,0,24.56666667,0,2,4,9,1,3,1,1,2,1,2,10,12,12,15.4
2024-25,202411060LAC,11/6/2024,LAC vs PHI,Kelly Oubre Jr.,oubreke01,75,PHI,0,LAC,18,2,3,1,0,3,24.58333333,0,2,8,12,1,3,1,1,5,1,5,21,20,23,24.9
2024-25,202411060HOU,11/6/2024,HOU vs SAS,Victor Wembanyama,wembavi01,79,SAS,0,HOU,15,6,0,1,3,4,24.68333333,1,5,6,14,1,6,2,2,0,4,6,15,21,21,30.2
2024-25,202411060DAL,11/6/2024,DAL vs CHI,Klay Thompson,thompkl01,85,DAL,1,CHI,13,6,1,0,0,1,24.81666667,1,5,5,10,3,7,0,0,1,0,7,14,19,20,20.7
2024-25,202411060DAL,11/6/2024,DAL vs CHI,Nikola Vucevic,vucevni01,84,CHI,0,DAL,14,10,3,1,0,2,24.85,3,7,7,10,0,2,0,0,2,1,13,17,24,27,31.5
2024-25,202411060DAL,11/6/2024,DAL vs CHI,Ayo Dosunmu,dosunay01,84,CHI,0,DAL,6,5,4,0,0,2,24.86666667,1,4,2,13,2,10,0,0,3,0,9,10,11,15,16
2024-25,202411060DEN,11/6/2024,DEN vs OKC,Isaiah Joe,joeis01,86,OKC,0,DEN,11,5,3,1,0,0,25.06666667,4,1,4,11,3,9,0,0,3,1,8,14,16,19,24.5
2024-25,202411060HOU,11/6/2024,HOU vs SAS,Stephon Castle,castlst01,8,SAS,0,HOU,5,2,0,3,0,0,25.38333333,0,2,2,8,1,5,0,0,1,3,2,5,7,7,16.4
2024-25,202411060HOU,11/6/2024,HOU vs SAS,Fred VanVleet,vanvlfr01,81,HOU,1,SAS,21,7,10,2,0,3,25.4,0,7,10,11,1,2,0,0,2,2,17,31,28,38,47.4
2024-25,202411060NOP,11/6/2024,NOP vs CLE,Jeremiah Robinson-Earl,robinje02,48,NOP,1,CLE,4,5,1,0,1,0,25.55,1,4,1,3,0,1,2,2,1,1,6,5,9,10,14.5
2024-25,202411060MEM,11/6/2024,MEM vs LAL,Scotty Pippen Jr.,pippesc02,30,MEM,1,LAL,14,6,4,1,1,4,25.56666667,1,5,5,9,3,4,1,2,3,2,10,18,20,24,29.2
2024-25,202411060DEN,11/6/2024,DEN vs OKC,Luguentz Dort,dortlu01,87,OKC,0,DEN,11,6,3,3,2,1,25.65,0,6,3,6,3,5,2,2,4,5,9,14,17,20,36.7
2024-25,202411060MEM,11/6/2024,MEM vs LAL,Cam Reddish,reddica01,52,LAL,0,MEM,15,6,2,2,0,0,25.93333333,2,4,5,7,2,2,3,4,3,2,8,17,21,23,31.2
2024-25,202411060CHO,11/6/2024,CHO vs DET,Isaiah Stewart,stewais01,55,DET,0,CHO,6,7,6,0,1,1,25.98333333,1,6,3,6,0,1,0,2,2,1,13,12,13,19,25.4
2024-25,202411060CHO,11/6/2024,CHO vs DET,Grant Williams,willigr01,84,CHO,1,DET,12,7,2,2,1,3,26.5,0,7,4,9,2,7,2,2,1,3,9,14,19,21,29.4
2024-25,202411060MEM,11/6/2024,MEM vs LAL,Dalton Knecht,knechda01,8,LAL,0,MEM,3,4,2,1,0,1,26.86666667,3,1,1,7,1,7,0,0,2,1,6,5,7,9,12.8
2024-25,202411060IND,11/6/2024,IND vs ORL,Anthony Black,blackan01,78,ORL,0,IND,12,0,6,2,0,1,26.98333333,0,0,4,7,0,1,4,6,4,2,6,18,12,18,26
2024-25,202411060DEN,11/6/2024,DEN vs OKC,Julian Strawther,strawju01,58,DEN,1,OKC,9,5,6,0,0,2,27.28333333,2,3,3,11,1,7,2,2,4,0,11,15,14,20,22
2024-25,202411060CHO,11/6/2024,CHO vs DET,Cody Martin,martico01,36,CHO,1,DET,7,4,3,0,1,0,27.55,1,3,3,6,1,2,0,0,0,1,7,10,11,14,19.3
2024-25,202411060DAL,11/6/2024,DAL vs CHI,Kyrie Irving,irvinky01,66,DAL,1,CHI,17,6,2,3,0,1,27.7,0,6,7,11,1,3,2,2,0,3,8,19,23,25,35.2
2024-25,202411060NOP,11/6/2024,NOP vs CLE,Caris LeVert,leverca01,75,CLE,0,NOP,16,6,6,1,0,1,27.78333333,2,4,7,13,2,4,0,0,0,1,12,22,22,28,34.2
2024-25,202411060DAL,11/6/2024,DAL vs CHI,Josh Giddey,giddejo01,88,CHI,0,DAL,10,3,6,1,0,5,27.85,1,2,3,9,1,3,3,4,1,1,9,16,13,19,20.6
2024-25,202411060ATL,11/6/2024,ATL vs NYK,Clint Capela,capelca01,82,ATL,1,NYK,18,6,1,0,0,1,27.86666667,4,2,8,8,0,0,2,2,3,0,7,19,24,25,25.7
2024-25,202411060MEM,11/6/2024,MEM vs LAL,Jaylen Wells,wellsja01,9,MEM,1,LAL,20,3,1,1,0,1,28.03333333,0,3,7,10,5,7,1,2,0,1,4,21,23,24,27.1
2024-25,202411060HOU,11/6/2024,HOU vs SAS,Julian Champagnie,champju02,82,SAS,0,HOU,13,3,2,0,0,2,28.11666667,0,3,5,9,3,6,0,0,2,0,5,15,16,18,17.6
2024-25,202411060BOS,11/6/2024,BOS vs GSW,Neemias Queta,quetane01,36,BOS,1,GSW,14,8,0,0,2,1,28.13333333,5,3,6,11,0,0,2,4,2,2,8,14,22,22,28.6
2024-25,202411060ATL,11/6/2024,ATL vs NYK,Miles McBride,mcbrimi01,75,NYK,0,ATL,16,4,7,0,1,3,28.43333333,0,4,5,9,4,6,2,2,3,1,11,23,20,27,31.3
2024-25,202411060NOP,11/6/2024,NOP vs CLE,Evan Mobley,mobleev01,59,CLE,0,NOP,15,9,3,0,3,1,28.51666667,5,4,7,16,0,1,1,3,6,3,12,18,24,27,38.3
2024-25,202411060BOS,11/6/2024,BOS vs GSW,Buddy Hield,hieldbu01,93,GSW,0,BOS,16,6,1,0,1,0,28.53333333,1,5,6,11,4,7,0,0,3,1,7,17,22,23,27.7
2024-25,202411060CHO,11/6/2024,CHO vs DET,Brandon Miller,millebr02,78,CHO,1,DET,19,6,4,0,0,3,28.53333333,2,4,6,16,3,11,4,4,2,0,10,23,25,29,29.2
2024-25,202411060DAL,11/6/2024,DAL vs CHI,Coby White,whiteco01,87,CHI,0,DAL,8,1,5,1,0,4,28.55,0,1,3,13,1,7,1,2,1,1,6,13,9,14,15.7
2024-25,202411060MEM,11/6/2024,MEM vs LAL,Jake LaRavia,laravja01,44,MEM,1,LAL,13,5,8,1,0,1,28.81666667,2,3,6,11,1,3,0,1,2,1,13,21,18,26,33
2024-25,202411060NOP,11/6/2024,NOP vs CLE,Zion Williamson,willizi01,76,NOP,1,CLE,29,8,4,1,1,4,29.2,2,6,9,18,0,0,11,13,3,2,12,33,37,41,46.6
2024-25,202411060NOP,11/6/2024,NOP vs CLE,Javonte Green,greenja02,18,NOP,1,CLE,11,3,0,3,0,0,29.6,0,3,4,6,1,2,2,2,1,3,3,11,14,14,23.6
2024-25,202411060IND,11/6/2024,IND vs ORL,Goga Bitadze,bitadgo01,67,ORL,0,IND,10,12,2,1,3,2,29.81666667,4,8,5,10,0,2,0,0,5,4,14,12,22,24,37.4
2024-25,202411060BOS,11/6/2024,BOS vs GSW,Al Horford,horfoal01,73,BOS,1,GSW,10,7,3,2,0,3,29.83333333,2,5,4,9,2,6,0,0,1,2,10,13,17,20,25.9
2024-25,202411060NOP,11/6/2024,NOP vs CLE,Darius Garland,garlada01,66,CLE,0,NOP,14,1,9,1,1,3,29.96666667,0,1,5,10,4,6,0,0,2,2,10,23,15,24,31.7
2024-25,202411060BOS,11/6/2024,BOS vs GSW,Draymond Green,greendr01,63,GSW,0,BOS,9,6,4,0,0,2,30.31666667,2,4,2,8,0,4,5,6,1,0,10,13,15,19,20.2
2024-25,202411060PHO,11/6/2024,PHO vs MIA,Haywood Highsmith,highsha01,71,MIA,0,PHO,19,7,0,2,0,0,30.6,2,5,7,8,2,3,3,3,3,2,7,19,26,26,33.4
2024-25,202411060LAC,11/6/2024,LAC vs PHI,Caleb Martin,martica02,71,PHI,0,LAC,14,2,2,1,0,1,30.75,0,2,4,10,1,4,5,10,1,1,4,16,16,18,21.4
2024-25,202411060HOU,11/6/2024,HOU vs SAS,Jalen Green,greenja05,90,HOU,1,SAS,21,5,4,0,1,3,31,0,5,6,14,4,9,5,6,1,1,9,25,26,30,33
2024-25,202411060CHO,11/6/2024,CHO vs DET,Tim Hardaway Jr.,hardati02,88,DET,0,CHO,13,3,3,0,0,1,31.06666667,0,3,5,10,3,7,0,0,0,0,6,16,16,19,20.1
2024-25,202411060BOS,11/6/2024,BOS vs GSW,Andrew Wiggins,wiggian01,77,GSW,0,BOS,16,2,0,0,0,2,31.21666667,0,2,6,14,0,3,4,6,1,0,2,16,18,18,16.4
2024-25,202411060MEM,11/6/2024,MEM vs LAL,Santi Aldama,aldamsa01,70,MEM,1,LAL,11,12,3,1,0,0,31.33333333,3,9,4,10,1,5,2,2,1,1,15,14,23,26,32.9
2024-25,202411060IND,11/6/2024,IND vs ORL,Andrew Nembhard,nembhan01,75,IND,1,ORL,5,2,5,1,0,1,31.35,0,2,2,8,1,2,0,0,3,1,7,10,7,12,16.9
2024-25,202411060LAC,11/6/2024,LAC vs PHI,Tyrese Maxey,maxeyty01,77,PHI,0,LAC,12,1,1,1,0,3,31.56666667,0,1,5,13,1,6,1,1,3,1,2,13,13,14,14.7
2024-25,202411060PHO,11/6/2024,PHO vs MIA,Bradley Beal,bealbr01,59,PHO,1,MIA,7,2,3,2,2,1,31.73333333,1,1,3,9,1,4,0,0,4,4,5,10,9,12,24.9
2024-25,202411060PHO,11/6/2024,PHO vs MIA,Terry Rozier,roziete01,68,MIA,0,PHO,7,7,5,1,0,2,31.93333333,1,6,2,10,1,7,2,2,1,1,12,12,14,19,23.9
2024-25,202411060CHO,11/6/2024,CHO vs DET,Tobias Harris,harrito02,79,DET,0,CHO,14,7,3,1,1,1,31.95,0,7,7,12,0,3,0,1,5,2,10,17,21,24,31.9
2024-25,202411060CHO,11/6/2024,CHO vs DET,LaMelo Ball,ballla01,30,CHO,1,DET,25,6,8,2,0,2,31.98333333,2,4,10,23,5,12,0,0,3,2,14,33,31,39,48.2
2024-25,202411060MEM,11/6/2024,MEM vs LAL,Jaren Jackson Jr.,jacksja02,73,MEM,1,LAL,20,6,1,0,3,1,32.1,1,5,8,13,1,4,3,3,2,3,7,21,26,27,36.7
2024-25,202411060BOS,11/6/2024,BOS vs GSW,Payton Pritchard,pritcpa01,91,BOS,1,GSW,16,3,3,0,0,2,32.16666667,2,1,5,13,3,11,3,3,4,0,6,19,19,22,22.1
2024-25,202411060DEN,11/6/2024,DEN vs OKC,Russell Westbrook,westbru01,76,DEN,1,OKC,29,6,6,1,0,4,32.16666667,1,5,10,15,3,4,6,9,4,1,12,35,35,41,44.2
2024-25,202411060DAL,11/6/2024,DAL vs CHI,Luka Doncic,doncilu01,78,DAL,1,CHI,27,7,13,4,0,5,32.31666667,0,7,8,19,3,8,8,9,3,4,20,40,34,47,61.9
2024-25,202411060SAC,11/6/2024,SAC vs TOR,Ochai Agbaji,agbajoc01,87,TOR,0,SAC,12,2,2,1,0,0,32.35,0,2,4,9,2,7,2,3,3,1,4,14,14,16,20.4
2024-25,202411060SAC,11/6/2024,SAC vs TOR,Davion Mitchell,mitchda01,81,TOR,0,SAC,20,3,6,1,0,1,32.36666667,1,2,8,11,2,3,2,2,2,1,9,26,23,29,34.6
2024-25,202411060LAC,11/6/2024,LAC vs PHI,Andre Drummond,drumman01,86,PHI,0,LAC,9,10,1,0,1,1,32.48333333,4,6,4,6,1,1,0,2,2,1,11,10,19,20,24.5
2024-25,202411060SAC,11/6/2024,SAC vs TOR,RJ Barrett,barrerj01,64,TOR,0,SAC,23,3,3,2,0,3,32.55,0,3,9,19,1,5,4,5,2,2,6,26,26,29,34.1
2024-25,202411060BOS,11/6/2024,BOS vs GSW,Jrue Holiday,holidjr01,78,BOS,1,GSW,6,9,8,0,0,1,32.56666667,1,8,3,11,0,6,0,0,1,0,17,14,15,23,27.8
2024-25,202411060PHO,11/6/2024,PHO vs MIA,Tyus Jones,jonesty01,74,PHO,1,MIA,5,1,8,0,0,1,32.86666667,0,1,2,7,1,3,0,0,1,0,9,13,6,14,17.2
2024-25,202411060PHO,11/6/2024,PHO vs MIA,Jusuf Nurkic,nurkiju01,84,PHO,1,MIA,20,18,1,1,2,2,33.21666667,4,14,6,8,3,3,5,6,4,3,19,21,38,39,50.1
2024-25,202411060LAC,11/6/2024,LAC vs PHI,Ivica Zubac,zubaciv01,76,LAC,1,PHI,15,9,3,1,0,1,33.28333333,2,7,7,9,0,0,1,1,1,1,12,18,24,27,32.3
2024-25,202411060IND,11/6/2024,IND vs ORL,Pascal Siakam,siakapa01,88,IND,1,ORL,17,4,3,0,0,0,33.48333333,1,3,6,13,0,3,5,5,3,0,7,20,21,24,26.3
2024-25,202411060CHO,11/6/2024,CHO vs DET,Jaden Ivey,iveyja01,86,DET,0,CHO,21,4,5,0,1,3,33.55,2,2,8,16,3,5,2,2,2,1,9,26,25,30,33.3
2024-25,202411060SAC,11/6/2024,SAC vs TOR,Domantas Sabonis,sabondo01,90,SAC,1,TOR,17,11,13,1,0,0,33.56666667,4,7,6,6,0,0,5,5,0,1,24,30,28,41,52.7
2024-25,202411060NOP,11/6/2024,NOP vs CLE,Donovan Mitchell,mitchdo01,64,CLE,0,NOP,29,4,3,1,1,2,33.71666667,0,4,10,20,3,9,6,6,1,2,7,32,33,36,42.3
2024-25,202411060SAC,11/6/2024,SAC vs TOR,De'Aaron Fox,foxde01,82,SAC,1,TOR,21,1,2,1,0,1,33.76666667,0,1,5,17,2,8,9,10,2,1,3,23,22,24,27.2
2024-25,202411060IND,11/6/2024,IND vs ORL,Bennedict Mathurin,mathube01,68,IND,1,ORL,20,11,1,1,0,2,33.91666667,1,10,3,7,1,3,13,14,4,1,12,21,31,32,35.7
2024-25,202411060LAC,11/6/2024,LAC vs PHI,James Harden,hardeja01,80,LAC,1,PHI,18,4,6,3,1,6,33.95,0,4,5,15,1,6,7,9,1,4,10,24,22,28,37.8
2024-25,202411060BOS,11/6/2024,BOS vs GSW,Stephen Curry,curryst01,79,GSW,0,BOS,27,7,9,4,1,3,34.38333333,0,7,8,17,4,9,7,7,2,5,16,36,34,43,60.9
2024-25,202411060PHO,11/6/2024,PHO vs MIA,Bam Adebayo,adebaba01,78,MIA,0,PHO,12,12,6,5,1,1,34.41666667,7,5,5,21,0,1,2,2,2,6,18,18,24,30,52.4
2024-25,202411060DEN,11/6/2024,DEN vs OKC,Peyton Watson,watsope01,88,DEN,1,OKC,10,3,3,1,3,2,34.48333333,0,3,4,9,1,4,1,4,3,4,6,13,13,16,28.1
2024-25,202411060SAC,11/6/2024,SAC vs TOR,Jakob Poeltl,poeltja01,59,TOR,0,SAC,10,8,4,2,0,3,34.61666667,1,7,5,8,0,0,0,0,2,2,12,14,18,22,28.6
2024-25,202411060MEM,11/6/2024,MEM vs LAL,Jaxson Hayes,hayesja02,79,LAL,0,MEM,8,10,1,0,0,1,34.66666667,2,8,3,6,0,0,2,2,5,0,11,9,18,19,20.5
2024-25,202411060LAC,11/6/2024,LAC vs PHI,Norman Powell,powelno01,84,LAC,1,PHI,26,1,6,1,0,3,34.71666667,0,1,8,10,6,8,4,4,4,1,7,32,27,33,36.2
2024-25,202411060NOP,11/6/2024,NOP vs CLE,Jarrett Allen,allenja01,86,CLE,0,NOP,16,14,2,1,2,0,34.8,2,12,7,10,0,0,2,2,5,3,16,18,30,32,44.8
2024-25,202411060MEM,11/6/2024,MEM vs LAL,Austin Reaves,reaveau01,91,LAL,0,MEM,19,3,5,3,0,1,34.93333333,0,3,7,17,2,9,3,4,1,3,8,24,22,27,38.1
2024-25,202411060CHO,11/6/2024,CHO vs DET,Miles Bridges,bridgmi02,77,CHO,1,DET,27,7,2,0,0,0,35,1,6,8,14,2,3,9,9,3,0,9,29,34,36,38.4
2024-25,202411060SAC,11/6/2024,SAC vs TOR,Keegan Murray,murrake02,85,SAC,1,TOR,22,12,3,0,1,1,35,7,5,9,17,3,8,1,2,2,1,15,25,34,37,42.9
2024-25,202411060PHO,11/6/2024,PHO vs MIA,Tyler Herro,herroty01,49,MIA,0,PHO,28,3,6,0,0,3,35.01666667,0,3,9,15,5,9,5,5,3,0,9,34,31,37,37.6
2024-25,202411060ATL,11/6/2024,ATL vs NYK,Trae Young,youngtr01,63,ATL,1,NYK,23,6,10,2,0,2,35.25,2,4,7,21,3,9,6,8,2,2,16,33,29,39,49.2
2024-25,202411060SAC,11/6/2024,SAC vs TOR,DeMar DeRozan,derozde01,87,SAC,1,TOR,27,2,3,1,0,3,35.26666667,0,2,11,21,2,4,3,3,1,1,5,30,29,32,33.9
2024-25,202411060NOP,11/6/2024,NOP vs CLE,Jose Alvarado,alvarjo01,65,NOP,1,CLE,27,2,5,3,0,1,35.31666667,0,2,10,14,7,7,0,0,4,3,7,32,29,34,44.9
2024-25,202411060MEM,11/6/2024,MEM vs LAL,LeBron James,jamesle01,80,LAL,0,MEM,39,7,6,1,0,5,35.41666667,0,7,15,24,6,11,3,4,2,1,13,45,46,52,54.4
2024-25,202411060DEN,11/6/2024,DEN vs OKC,Chet Holmgren,holmgch01,90,OKC,0,DEN,15,10,0,0,1,3,35.53333333,3,7,5,14,2,3,3,3,3,1,10,15,25,25,27
2024-25,202411060IND,11/6/2024,IND vs ORL,Jalen Suggs,suggsja01,84,ORL,0,IND,15,5,6,1,1,5,35.66666667,1,4,6,10,1,3,2,2,3,2,11,21,20,26,31
2024-25,202411060DEN,11/6/2024,DEN vs OKC,Jalen Williams,willija06,79,OKC,0,DEN,29,10,9,3,0,1,36.05,2,8,11,20,4,8,3,5,4,3,19,38,39,48,62.5
2024-25,202411060BOS,11/6/2024,BOS vs GSW,Derrick White,whitede01,82,BOS,1,GSW,26,6,3,2,0,1,36.3,1,5,8,19,7,16,3,3,5,2,9,29,32,35,42.7
2024-25,202411060IND,11/6/2024,IND vs ORL,Myles Turner,turnemy01,85,IND,1,ORL,17,10,2,1,2,3,36.43333333,1,9,6,17,1,6,4,5,3,3,12,19,27,29,38
2024-25,202411060DEN,11/6/2024,DEN vs OKC,Christian Braun,braunch01,90,DEN,1,OKC,24,8,0,2,1,2,36.53333333,1,7,7,14,4,8,6,6,2,3,8,24,32,32,40.6
2024-25,202411060IND,11/6/2024,IND vs ORL,Tyrese Haliburton,halibty01,78,IND,1,ORL,17,3,4,1,0,1,36.65,0,3,6,11,3,5,2,2,4,1,7,21,20,24,28.6
2024-25,202411060ATL,11/6/2024,ATL vs NYK,Jalen Brunson,brunsja01,84,NYK,0,ATL,21,3,4,0,0,3,36.75,0,3,8,18,4,11,1,2,3,0,7,25,24,28,27.6
2024-25,202411060BOS,11/6/2024,BOS vs GSW,Jayson Tatum,tatumja01,83,BOS,1,GSW,32,4,2,1,1,4,36.75,0,4,10,20,5,10,7,9,3,2,6,34,36,38,41.8
2024-25,202411060ATL,11/6/2024,ATL vs NYK,Dyson Daniels,daniedy01,68,ATL,1,NYK,6,5,2,4,1,2,36.76666667,1,4,3,16,0,4,0,0,3,5,7,8,11,13,28
2024-25,202411060PHO,11/6/2024,PHO vs MIA,Jimmy Butler,butleji01,67,MIA,0,PHO,15,7,3,1,0,2,36.91666667,3,4,6,13,0,2,3,3,1,1,10,18,22,25,28.9
2024-25,202411060ATL,11/6/2024,ATL vs NYK,Zaccharie Risacher,risacza01,9,ATL,1,NYK,33,7,3,3,2,0,37,1,6,11,18,6,10,5,9,1,5,10,36,40,43,60.9
2024-25,202411060PHO,11/6/2024,PHO vs MIA,Kevin Durant,duranke01,83,PHO,1,MIA,32,8,3,1,1,6,37.21666667,0,8,13,23,4,11,2,3,1,2,11,35,40,43,46.1
2024-25,202411060IND,11/6/2024,IND vs ORL,Kentavious Caldwell-Pope,caldwke01,85,ORL,0,IND,13,5,2,1,0,0,37.38333333,2,3,5,10,2,5,1,1,1,1,7,15,18,20,25
2024-25,202411060CHO,11/6/2024,CHO vs DET,Cade Cunningham,cunnica01,71,DET,0,CHO,20,10,10,0,0,2,37.7,1,9,9,23,0,4,2,2,5,0,20,30,30,40,45
2024-25,202411060ATL,11/6/2024,ATL vs NYK,Karl-Anthony Towns,townska01,69,NYK,0,ATL,34,16,1,1,3,3,38.01666667,5,11,11,23,5,9,7,7,2,4,17,35,50,51,63.7
2024-25,202411060ATL,11/6/2024,ATL vs NYK,Josh Hart,hartjo01,88,NYK,0,ATL,14,8,8,1,1,3,38.06666667,1,7,6,9,2,4,0,0,6,2,16,22,22,30,38.6
2024-25,202411060NOP,11/6/2024,NOP vs CLE,Brandon Boston Jr.,bostobr01,38,NOP,1,CLE,14,2,5,0,1,0,38.38333333,2,0,4,11,2,5,4,4,1,1,7,19,16,21,26.9
2024-25,202411060ATL,11/6/2024,ATL vs NYK,Mikal Bridges,bridgmi01,89,NYK,0,ATL,10,2,5,1,0,2,38.63333333,0,2,4,10,2,7,0,0,2,1,7,15,12,17,20.9
2024-25,202411060NOP,11/6/2024,NOP vs CLE,Brandon Ingram,ingrabr01,73,NOP,1,CLE,20,5,5,1,1,2,38.68333333,0,5,9,20,2,8,0,0,2,2,10,25,25,30,37.5
2024-25,202411060DEN,11/6/2024,DEN vs OKC,Shai Gilgeous-Alexander,gilgesh01,83,OKC,0,DEN,28,2,6,1,1,8,38.81666667,0,2,10,19,0,3,8,10,1,2,8,34,30,36,37.4
2024-25,202411060PHO,11/6/2024,PHO vs MIA,Devin Booker,bookede01,76,PHO,1,MIA,22,4,9,0,0,3,38.88333333,1,3,9,17,2,7,2,3,1,0,13,31,26,35,37.3
2024-25,202411060ATL,11/6/2024,ATL vs NYK,Jalen Johnson,johnsja05,65,ATL,1,NYK,23,15,7,0,1,2,39.25,4,11,10,18,3,6,0,0,1,1,22,30,38,45,52.5
2024-25,202411060IND,11/6/2024,IND vs ORL,Franz Wagner,wagnefr01,81,ORL,0,IND,28,8,6,0,0,3,39.36666667,1,7,10,23,2,7,6,8,4,0,14,34,36,42,43.6
2024-25,202411060DEN,11/6/2024,DEN vs OKC,Nikola Jokic,jokicni01,87,DEN,1,OKC,23,20,16,2,2,5,39.46666667,7,13,9,20,1,3,4,6,2,4,36,39,43,59,78
2024-25,202411060ATL,11/6/2024,ATL vs NYK,OG Anunoby,anunoog01,57,NYK,0,ATL,15,6,3,1,0,0,41.36666667,1,5,5,13,3,8,2,2,1,1,9,18,21,24,29.7
2024-25,202411060DEN,11/6/2024,DEN vs OKC,Michael Porter Jr.,portemi01,89,DEN,1,OKC,24,7,3,1,0,1,41.36666667,1,6,7,16,6,10,4,4,3,1,10,27,31,34,38.9
2024-25,202411040DAL,11/4/2024,DAL vs IND,Quentin Grimes,grimequ01,58,DAL,1,IND,0,1,0,1,0,0,10.05,0,1,0,1,0,1,0,0,1,1,1,0,1,1,4.2
2024-25,202411040MIA,11/4/2024,MIA vs SAC,Alex Len,lenal01,53,SAC,0,MIA,0,1,1,1,1,1,10.05,0,1,0,1,0,1,0,0,1,2,2,1,1,2,7.7
2024-25,202411040CHI,11/4/2024,CHI vs UTA,Brice Sensabaugh,sensabr01,39,UTA,0,CHI,2,1,0,0,0,3,10.15,0,1,1,3,0,2,0,0,0,0,1,2,3,3,0.2
2024-25,202411040MIN,11/4/2024,MIN vs CHO,Seth Curry,curryse01,50,CHO,0,MIN,4,2,0,0,0,0,10.18333333,2,0,2,4,0,1,0,0,1,0,2,4,6,6,6.4
2024-25,202411040PHO,11/4/2024,PHO vs PHI,Ryan Dunn,dunnry01,7,PHO,1,PHI,0,4,1,0,0,0,10.45,0,4,0,3,0,3,0,0,1,0,5,1,4,5,6.3
2024-25,202411040MIA,11/4/2024,MIA vs SAC,Jordan McLaughlin,mclaujo01,61,SAC,0,MIA,3,2,1,1,0,0,10.76666667,0,2,1,2,1,1,0,0,1,1,3,4,5,6,9.9
2024-25,202411040BRK,11/4/2024,BRK vs MEM,Brandon Clarke,clarkbr01,14,MEM,0,BRK,2,0,1,2,0,0,10.83333333,0,0,1,2,0,0,0,0,2,2,1,3,2,3,9.5
2024-25,202411040OKC,11/4/2024,OKC vs ORL,Jonathan Isaac,isaacjo01,63,ORL,0,OKC,4,1,0,0,0,1,10.98333333,1,0,1,3,0,2,2,2,1,0,1,4,5,5,4.2
2024-25,202411040MIN,11/4/2024,MIN vs CHO,Moussa Diabate,diabamo01,18,CHO,0,MIN,2,5,0,0,0,1,11.08333333,1,4,1,1,0,0,0,0,0,0,5,2,7,7,7
2024-25,202411040OKC,11/4/2024,OKC vs ORL,Jett Howard,howarje01,26,ORL,0,OKC,0,0,0,0,1,0,11.18333333,0,0,0,2,0,2,0,0,0,1,0,0,0,0,3
2024-25,202411040BRK,11/4/2024,BRK vs MEM,Shake Milton,miltosh01,55,BRK,1,MEM,5,4,0,0,0,1,11.53333333,2,2,1,2,1,2,2,2,0,0,4,5,9,9,8.8
2024-25,202411040NOP,11/4/2024,NOP vs POR,Dalano Banton,bantoda01,60,POR,0,NOP,20,1,1,2,0,1,12,0,1,8,9,2,3,2,2,0,2,2,21,21,22,27.7
2024-25,202411040MIA,11/4/2024,MIA vs SAC,Thomas Bryant,bryanth01,44,MIA,1,SAC,2,5,0,0,0,0,12.01666667,1,4,1,3,0,1,0,0,0,0,5,2,7,7,8
2024-25,202411040MIA,11/4/2024,MIA vs SAC,Nikola Jovic,jovicni01,52,MIA,1,SAC,4,1,0,0,0,0,12.06666667,1,0,1,4,0,1,2,2,2,0,1,4,5,5,5.2
2024-25,202411040NOP,11/4/2024,NOP vs POR,Jamal Cain,cainja01,31,NOP,1,POR,2,5,0,0,1,3,12.16666667,1,4,1,5,0,2,0,0,1,1,5,2,7,7,8
2024-25,202411040LAC,11/4/2024,LAC vs SAS,Jeremy Sochan,sochaje01,81,SAS,0,LAC,4,3,1,1,0,2,12.35,1,2,2,3,0,1,0,0,2,1,4,5,7,8,10.1
2024-25,202411040OKC,11/4/2024,OKC vs ORL,Ajay Mitchell,mitchaj01,7,OKC,1,ORL,4,1,1,0,0,1,12.41666667,0,1,2,4,0,1,0,0,0,0,2,5,5,6,5.7
2024-25,202411040DEN,11/4/2024,DEN vs TOR,Jamison Battle,battlja01,7,TOR,0,DEN,5,2,0,0,0,0,12.46666667,1,1,2,6,1,4,0,0,1,0,2,5,7,7,7.4
2024-25,202411040MIA,11/4/2024,MIA vs SAC,Alec Burks,burksal01,70,MIA,1,SAC,2,0,0,1,0,0,12.7,0,0,0,3,0,1,2,2,0,1,0,2,2,2,5
2024-25,202411040CHI,11/4/2024,CHI vs UTA,Patty Mills,millspa02,39,UTA,0,CHI,6,1,5,0,0,0,12.88333333,0,1,1,3,1,3,3,3,1,0,6,11,7,12,14.7
2024-25,202411040DET,11/4/2024,DET vs LAL,Simone Fontecchio,fontesi01,74,DET,1,LAL,0,2,1,1,0,0,12.93333333,0,2,0,3,0,2,0,0,4,1,3,1,2,3,6.9
2024-25,202411040WAS,11/4/2024,WAS vs GSW,Brandin Podziemski,podzibr01,81,GSW,0,WAS,2,4,1,1,0,1,13.1,0,4,1,3,0,1,0,0,2,1,5,3,6,7,10.3
2024-25,202411040MIA,11/4/2024,MIA vs SAC,Duncan Robinson,robindu01,73,MIA,1,SAC,9,3,3,0,0,0,13.55,0,3,3,5,3,3,0,0,1,0,6,12,12,15,17.1
2024-25,202411040HOU,11/4/2024,HOU vs NYK,Steven Adams,adamsst01,3,HOU,1,NYK,4,5,3,0,0,1,13.65,3,2,1,4,0,0,2,4,1,0,8,7,9,12,13.5
2024-25,202411040DEN,11/4/2024,DEN vs TOR,Chris Boucher,bouchch01,58,TOR,0,DEN,2,4,1,1,1,2,13.75,1,3,1,3,0,1,0,0,1,2,5,3,6,7,12.3
2024-25,202411040DEN,11/4/2024,DEN vs TOR,Zeke Nnaji,nnajize01,61,DEN,1,TOR,2,1,1,0,1,0,13.76666667,1,0,1,3,0,1,0,0,0,1,2,3,3,4,7.7
2024-25,202411040WAS,11/4/2024,WAS vs GSW,Lindy Waters III,waterli01,45,GSW,0,WAS,3,3,1,0,0,0,13.86666667,1,2,1,4,1,3,0,0,2,0,4,4,6,7,8.1
2024-25,202411040LAC,11/4/2024,LAC vs SAS,Zach Collins,colliza01,76,SAS,0,LAC,4,3,1,2,0,0,13.9,2,1,0,5,0,3,4,4,2,2,4,5,7,8,15.1
2024-25,202411040DET,11/4/2024,DET vs LAL,Cam Reddish,reddica01,51,LAL,0,DET,0,5,0,1,0,0,14.01666667,0,5,0,0,0,0,0,0,2,1,5,0,5,5,9
2024-25,202411040DAL,11/4/2024,DAL vs IND,Jarace Walker,walkeja02,41,IND,0,DAL,3,5,2,0,0,1,14.28333333,1,4,1,3,1,2,0,2,2,0,7,5,8,10,11
2024-25,202411040PHO,11/4/2024,PHO vs PHI,Mason Plumlee,plumlma01,53,PHO,1,PHI,5,3,1,0,0,0,14.35,1,2,2,3,0,0,1,2,1,0,4,6,8,9,10.1
2024-25,202411040HOU,11/4/2024,HOU vs NYK,Reed Sheppard,sheppre01,7,HOU,1,NYK,7,2,0,0,0,0,14.45,0,2,3,8,1,4,0,0,0,0,2,7,9,9,9.4
2024-25,202411040CLE,11/4/2024,CLE vs MIL,Taurean Prince,princta02,86,MIL,0,CLE,3,1,3,0,0,0,14.7,0,1,1,1,1,1,0,0,3,0,4,6,4,7,8.7
2024-25,202411040WAS,11/4/2024,WAS vs GSW,Moses Moody,moodymo01,73,GSW,0,WAS,10,1,1,1,0,0,14.98333333,1,0,3,7,1,4,3,3,0,1,2,11,11,12,15.7
2024-25,202411040PHO,11/4/2024,PHO vs PHI,Andre Drummond,drumman01,85,PHI,0,PHO,8,5,0,3,0,5,15.05,0,5,3,5,0,0,2,2,2,3,5,8,13,13,18
2024-25,202411040DEN,11/4/2024,DEN vs TOR,Hunter Tyson,tysonhu01,22,DEN,1,TOR,0,1,0,1,1,0,15.06666667,0,1,0,1,0,1,0,0,2,2,1,0,1,1,7.2
2024-25,202411040CHI,11/4/2024,CHI vs UTA,Jalen Smith,smithja04,67,CHI,1,UTA,8,3,1,1,1,0,15.11666667,2,1,3,9,2,5,0,0,3,2,4,9,11,12,19.1
2024-25,202411040DAL,11/4/2024,DAL vs IND,Daniel Gafford,gaffoda01,81,DAL,1,IND,8,4,0,0,0,0,15.13333333,1,3,3,3,0,0,2,2,3,0,4,8,12,12,12.8
2024-25,202411040HOU,11/4/2024,HOU vs NYK,Jericho Sims,simsje01,51,NYK,0,HOU,0,4,1,0,0,1,15.56666667,1,3,0,0,0,0,0,0,4,0,5,1,4,5,5.3
2024-25,202411040ATL,11/4/2024,ATL vs BOS,Luke Kornet,kornelu01,71,BOS,0,ATL,2,7,0,1,1,0,15.66666667,2,5,1,2,0,0,0,0,3,2,7,2,9,9,16.4
2024-25,202411040CHI,11/4/2024,CHI vs UTA,Julian Phillips,phillju01,47,CHI,1,UTA,0,1,1,2,0,0,15.8,1,0,0,2,0,1,0,0,2,2,2,1,1,2,8.7
2024-25,202411040WAS,11/4/2024,WAS vs GSW,Kyle Anderson,anderky01,86,GSW,0,WAS,6,3,1,0,2,0,15.91666667,1,2,1,3,0,0,4,6,2,2,4,7,9,10,17.1
2024-25,202411040MIN,11/4/2024,MIN vs CHO,Taj Gibson,gibsota01,22,CHO,0,MIN,5,4,0,1,0,0,16.1,1,3,2,4,1,2,0,0,1,1,4,5,9,9,12.8
2024-25,202411040NOP,11/4/2024,NOP vs POR,Donovan Clingan,clingdo01,8,POR,0,NOP,4,3,0,0,3,2,16.15,0,3,1,1,0,0,2,2,4,3,3,4,7,7,14.6
2024-25,202411040CHI,11/4/2024,CHI vs UTA,Drew Eubanks,eubandr01,80,UTA,0,CHI,4,4,1,0,0,0,16.33333333,0,4,2,4,0,0,0,0,0,0,5,5,8,9,10.3
2024-25,202411040WAS,11/4/2024,WAS vs GSW,Gary Payton II,paytoga02,51,GSW,0,WAS,6,3,3,0,0,1,16.38333333,1,2,3,3,0,0,0,0,2,0,6,9,9,12,13.1
2024-25,202411040MIA,11/4/2024,MIA vs SAC,Trey Lyles,lylestr01,65,SAC,0,MIA,5,1,0,0,0,1,16.45,1,0,2,4,1,3,0,0,3,0,1,5,6,6,5.2
2024-25,202411040DET,11/4/2024,DET vs LAL,Ron Holland,hollaro01,8,DET,1,LAL,12,4,0,2,0,0,16.65,1,3,4,9,0,5,4,4,1,2,4,12,16,16,22.8
2024-25,202411040DAL,11/4/2024,DAL vs IND,Ben Sheppard,sheppbe01,65,IND,0,DAL,3,1,2,0,0,2,16.7,1,0,1,3,1,3,0,0,2,0,3,5,4,6,5.2
2024-25,202411040ATL,11/4/2024,ATL vs BOS,Clint Capela,capelca01,81,ATL,1,BOS,2,5,1,0,0,1,16.78333333,0,5,1,3,0,0,0,0,1,0,6,3,7,8,8.5
2024-25,202411040NOP,11/4/2024,NOP vs POR,Javonte Green,greenja02,17,NOP,1,POR,0,1,0,0,0,0,16.8,1,0,0,1,0,0,0,0,2,0,1,0,1,1,1.2
2024-25,202411040CHI,11/4/2024,CHI vs UTA,Kyle Filipowski,filipky01,6,UTA,0,CHI,7,5,2,0,0,1,17.21666667,1,4,3,5,1,2,0,0,3,0,7,9,12,14,15
2024-25,202411040OKC,11/4/2024,OKC vs ORL,Aaron Wiggins,wiggiaa01,85,OKC,1,ORL,11,5,1,3,0,0,17.41666667,2,3,4,9,1,3,2,2,1,3,6,12,16,17,27.5
2024-25,202411040DEN,11/4/2024,DEN vs TOR,Jamal Shead,sheadja01,8,TOR,0,DEN,8,2,3,1,0,0,17.45,0,2,3,4,1,1,1,1,4,1,5,11,10,13,17.9
2024-25,202411040PHO,11/4/2024,PHO vs PHI,Eric Gordon,gordoer01,74,PHI,0,PHO,10,1,1,1,1,0,17.65,0,1,3,6,2,4,2,2,1,2,2,11,11,12,18.7
2024-25,202411040CHI,11/4/2024,CHI vs UTA,Dalen Terry,terryda01,66,CHI,1,UTA,4,2,4,0,1,1,17.71666667,2,0,2,5,0,2,0,1,2,1,6,8,6,10,14.4
2024-25,202411040LAC,11/4/2024,LAC vs SAS,Malaki Branham,branhma01,82,SAS,0,LAC,7,0,0,1,0,1,17.73333333,0,0,2,7,1,3,2,2,0,1,0,7,7,7,9
2024-25,202411040DET,11/4/2024,DET vs LAL,Gabe Vincent,vincega01,18,LAL,0,DET,0,0,0,1,0,1,17.76666667,0,0,0,0,0,0,0,0,0,1,0,0,0,0,2
2024-25,202411040WAS,11/4/2024,WAS vs GSW,Kevon Looney,looneke01,81,GSW,0,WAS,4,10,2,0,0,0,17.96666667,5,5,2,6,0,0,0,0,3,0,12,6,14,16,19
2024-25,202411040WAS,11/4/2024,WAS vs GSW,Andrew Wiggins,wiggian01,76,GSW,0,WAS,5,4,2,0,2,0,17.98333333,1,3,1,9,0,6,3,4,3,2,6,7,9,11,18.8
2024-25,202411040CHI,11/4/2024,CHI vs UTA,Johnny Juzang,juzanjo01,24,UTA,0,CHI,8,1,2,0,0,0,18.2,0,1,3,6,2,5,0,0,2,0,3,10,9,11,12.2
2024-25,202411040NOP,11/4/2024,NOP vs POR,Rayan Rupert,ruperra01,46,POR,0,NOP,6,2,0,1,0,0,18.65,1,1,3,5,0,1,0,1,1,1,2,6,8,8,11.4
2024-25,202411040CLE,11/4/2024,CLE vs MIL,Ty Jerome,jeromty01,10,CLE,1,MIL,6,0,1,2,0,0,18.73333333,0,0,3,4,0,1,0,1,0,2,1,7,6,7,13.5
2024-25,202411040MIN,11/4/2024,MIN vs CHO,Cody Martin,martico01,35,CHO,0,MIN,6,3,1,2,0,1,19.01666667,0,3,2,4,0,1,2,2,3,2,4,7,9,10,16.1
2024-25,202411040ATL,11/4/2024,ATL vs BOS,Jordan Walsh,walshjo01,16,BOS,0,ATL,2,4,0,2,1,2,19.15,1,3,1,3,0,2,0,1,1,3,4,2,6,6,13.8
2024-25,202411040LAC,11/4/2024,LAC vs SAS,Terance Mann,mannte01,82,LAC,1,SAS,5,2,1,0,0,0,19.33333333,0,2,2,4,1,2,0,0,1,0,3,6,7,8,8.9
2024-25,202411040LAC,11/4/2024,LAC vs SAS,Kevin Porter Jr.,porteke02,7,LAC,1,SAS,6,8,7,1,0,2,19.46666667,2,6,3,10,0,2,0,0,0,1,15,13,14,21,27.1
2024-25,202411040ATL,11/4/2024,ATL vs BOS,Sam Hauser,hausesa01,84,BOS,0,ATL,10,2,1,1,0,1,19.5,1,1,4,11,2,8,0,0,1,1,3,11,12,13,15.9
2024-25,202411040NOP,11/4/2024,NOP vs POR,Daniel Theis,theisda01,68,NOP,1,POR,4,4,1,0,1,1,19.58333333,1,3,2,4,0,2,0,0,1,1,5,5,8,9,12.3
2024-25,202411040LAC,11/4/2024,LAC vs SAS,Stephon Castle,castlst01,7,SAS,0,LAC,11,4,1,0,1,1,19.91666667,1,3,4,10,0,3,3,4,0,1,5,12,15,16,19.3
2024-25,202411040LAC,11/4/2024,LAC vs SAS,Nicolas Batum,batumni01,67,LAC,1,SAS,3,1,2,0,0,0,20.1,0,1,1,5,1,3,0,0,2,0,3,5,4,6,7.2
2024-25,202411040DAL,11/4/2024,DAL vs IND,T.J. McConnell,mccontj01,79,IND,0,DAL,12,3,2,1,1,1,20.1,1,2,6,10,0,0,0,0,0,2,5,14,15,17,23.6
2024-25,202411040BRK,11/4/2024,BRK vs MEM,Keon Johnson,johnske07,12,BRK,1,MEM,6,4,3,0,0,2,20.5,0,4,2,7,2,3,0,0,5,0,7,9,10,13,13.3
2024-25,202411040DEN,11/4/2024,DEN vs TOR,Jonathan Mogbo,mogbojo01,8,TOR,0,DEN,4,6,2,0,0,0,20.56666667,3,3,2,4,0,0,0,2,2,0,8,6,10,12,14.2
2024-25,202411040OKC,11/4/2024,OKC vs ORL,Anthony Black,blackan01,77,ORL,0,OKC,3,3,2,2,0,3,20.61666667,1,2,1,8,0,5,1,2,0,2,5,5,6,8,12.6
2024-25,202411040ATL,11/4/2024,ATL vs BOS,Keaton Wallace,wallake01,6,ATL,1,BOS,6,4,2,4,2,2,20.7,0,4,2,5,0,1,2,2,1,6,6,8,10,12,29.8
2024-25,202411040NOP,11/4/2024,NOP vs POR,Deni Avdija,avdijde01,83,POR,0,NOP,7,6,3,0,0,0,20.75,2,4,2,5,0,1,3,4,2,0,9,10,13,16,18.7
2024-25,202411040OKC,11/4/2024,OKC vs ORL,Alex Caruso,carusal01,78,OKC,1,ORL,3,0,5,1,0,2,20.81666667,0,0,1,3,1,2,0,0,4,1,5,8,3,8,11.5
2024-25,202411040CLE,11/4/2024,CLE vs MIL,Gary Trent Jr.,trentga02,78,MIL,0,CLE,4,2,1,0,0,1,20.86666667,0,2,1,7,0,3,2,2,3,0,3,5,6,7,6.9
2024-25,202411040MIN,11/4/2024,MIN vs CHO,Tre Mann,manntr01,48,CHO,0,MIN,10,4,6,1,0,1,20.98333333,1,3,4,8,0,0,2,2,3,1,10,16,14,20,25.8
2024-25,202411040MIA,11/4/2024,MIA vs SAC,Josh Richardson,richajo01,45,MIA,1,SAC,0,2,1,2,0,3,21.05,1,1,0,4,0,3,0,0,4,2,3,1,2,3,6.9
2024-25,202411040MIN,11/4/2024,MIN vs CHO,Nickeil Alexander-Walker,alexani01,89,MIN,1,CHO,6,2,3,0,0,2,21.15,0,2,1,6,1,3,3,4,2,0,5,9,8,11,10.9
2024-25,202411040MIN,11/4/2024,MIN vs CHO,Brandon Miller,millebr02,77,CHO,0,MIN,10,2,1,0,1,1,21.16666667,0,2,3,10,2,7,2,2,2,1,3,11,12,13,15.9
2024-25,202411040BRK,11/4/2024,BRK vs MEM,Ziaire Williams,willizi02,59,BRK,1,MEM,2,2,1,2,0,0,21.21666667,1,1,0,2,0,2,2,2,1,2,3,3,4,5,11.9
2024-25,202411040OKC,11/4/2024,OKC vs ORL,Moritz Wagner,wagnemo01,88,ORL,0,OKC,9,7,1,2,1,4,21.26666667,0,7,2,5,0,2,5,6,2,3,8,10,16,17,23.9
2024-25,202411040WAS,11/4/2024,WAS vs GSW,Jonas Valanciunas,valanjo01,88,WAS,1,GSW,16,12,7,0,0,1,21.41666667,3,9,6,10,0,0,4,4,1,0,19,23,28,35,39.9
2024-25,202411040OKC,11/4/2024,OKC vs ORL,Chet Holmgren,holmgch01,89,OKC,1,ORL,14,9,1,0,2,2,21.5,2,7,5,10,1,2,3,5,1,2,10,15,23,24,30.3
2024-25,202411040MIN,11/4/2024,MIN vs CHO,Grant Williams,willigr01,83,CHO,0,MIN,5,3,1,2,0,1,21.75,0,3,2,4,1,3,0,0,2,2,4,6,8,9,15.1
2024-25,202411040LAC,11/4/2024,LAC vs SAS,Derrick Jones Jr.,jonesde02,83,LAC,1,SAS,10,2,2,0,1,1,21.78333333,1,1,4,10,2,6,0,1,4,1,4,12,12,14,17.4
2024-25,202411040ATL,11/4/2024,ATL vs BOS,Al Horford,horfoal01,72,BOS,0,ATL,9,5,3,2,2,0,22,1,4,3,4,1,2,2,2,1,4,8,12,14,17,31.5
2024-25,202411040MIN,11/4/2024,MIN vs CHO,Tidjane Salaun,salauti01,5,CHO,0,MIN,5,2,1,1,0,2,22.06666667,0,2,2,10,1,7,0,0,3,1,3,6,7,8,9.9
2024-25,202411040HOU,11/4/2024,HOU vs NYK,Jabari Smith Jr.,smithja05,83,HOU,1,NYK,7,6,1,0,0,1,22.23333333,0,6,3,8,1,5,0,0,2,0,7,8,13,14,14.7
2024-25,202411040MIN,11/4/2024,MIN vs CHO,Jaden McDaniels,mcdanja02,79,MIN,1,CHO,9,3,0,0,2,0,22.43333333,1,2,3,10,1,5,2,4,3,2,3,9,12,12,18.6
2024-25,202411040OKC,11/4/2024,OKC vs ORL,Isaiah Joe,joeis01,85,OKC,1,ORL,13,4,1,0,0,0,22.45,0,4,4,8,3,6,2,3,0,0,5,14,17,18,19.3
2024-25,202411040CLE,11/4/2024,CLE vs MIL,Pat Connaughton,connapa01,83,MIL,0,CLE,7,4,5,2,0,0,22.48333333,0,4,3,4,1,1,0,0,3,2,9,12,11,16,25.3
2024-25,202411040ATL,11/4/2024,ATL vs BOS,Onyeka Okongwu,okongon01,61,ATL,1,BOS,18,10,0,2,0,1,22.86666667,5,5,8,12,0,3,2,2,2,2,10,18,28,28,35
2024-25,202411040DAL,11/4/2024,DAL vs IND,Spencer Dinwiddie,dinwisp01,82,DAL,1,IND,14,3,1,0,0,0,23.03333333,0,3,6,8,2,3,0,0,4,0,4,15,17,18,19.1
2024-25,202411040NOP,11/4/2024,NOP vs POR,Jaylen Nowell,nowelja01,15,NOP,1,POR,11,2,1,1,0,1,23.16666667,1,1,4,12,2,4,1,2,2,1,3,12,13,14,16.9
2024-25,202411040ATL,11/4/2024,ATL vs BOS,Neemias Queta,quetane01,35,BOS,0,ATL,10,7,0,1,1,0,23.18333333,2,5,4,7,0,0,2,2,2,2,7,10,17,17,24.4
2024-25,202411040ATL,11/4/2024,ATL vs BOS,Trae Young,youngtr01,62,ATL,1,BOS,2,0,6,1,0,3,23.25,0,0,1,10,0,6,0,0,2,1,6,8,2,8,11
2024-25,202411040MIN,11/4/2024,MIN vs CHO,Mike Conley,conlemi01,83,MIN,1,CHO,11,5,4,0,1,0,23.33333333,1,4,4,8,3,5,0,0,0,1,9,15,16,20,26
2024-25,202411040WAS,11/4/2024,WAS vs GSW,Trayce Jackson-Davis,jackstr02,75,GSW,0,WAS,12,6,3,0,1,0,23.36666667,1,5,6,11,0,0,0,0,1,1,9,15,18,21,26.7
2024-25,202411040ATL,11/4/2024,ATL vs BOS,Jrue Holiday,holidjr01,77,BOS,0,ATL,16,3,2,0,1,1,23.5,0,3,7,11,2,6,0,0,0,1,5,18,19,21,24.6
2024-25,202411040PHO,11/4/2024,PHO vs PHI,Royce O'Neale,onealro01,86,PHO,1,PHI,15,5,0,1,1,0,23.66666667,3,2,6,9,3,4,0,0,3,2,5,15,20,20,27
2024-25,202411040PHO,11/4/2024,PHO vs PHI,Grayson Allen,allengr01,80,PHO,1,PHI,14,2,0,0,0,0,23.7,1,1,3,6,2,4,6,6,1,0,2,14,16,16,16.4
2024-25,202411040ATL,11/4/2024,ATL vs BOS,Dyson Daniels,daniedy01,67,ATL,1,BOS,8,2,3,1,0,1,23.75,0,2,4,9,0,1,0,0,2,1,5,11,10,13,16.9
2024-25,202411040DET,11/4/2024,DET vs LAL,Jalen Duren,durenja01,69,DET,1,LAL,11,14,1,1,1,2,23.85,8,6,5,7,0,0,1,1,5,2,15,12,25,26,33.3
2024-25,202411040WAS,11/4/2024,WAS vs GSW,Stephen Curry,curryst01,78,GSW,0,WAS,24,3,6,0,0,2,24.08333333,1,2,7,15,4,9,6,6,1,0,9,30,27,33,34.6
2024-25,202411040DAL,11/4/2024,DAL vs IND,Obi Toppin,toppiob01,90,IND,0,DAL,11,6,2,0,0,0,24.25,1,5,5,8,1,3,0,0,2,0,8,13,17,19,21.2
2024-25,202411040MIA,11/4/2024,MIA vs SAC,Malik Monk,monkma01,79,SAC,0,MIA,12,1,0,0,0,1,24.33333333,0,1,6,11,0,3,0,0,4,0,1,12,13,13,12.2
2024-25,202411040MIN,11/4/2024,MIN vs CHO,LaMelo Ball,ballla01,29,CHO,0,MIN,19,2,2,1,0,5,24.6,0,2,6,15,2,8,5,7,3,1,4,21,21,23,22.4
2024-25,202411040NOP,11/4/2024,NOP vs POR,Scoot Henderson,hendesc01,70,POR,0,NOP,5,2,5,2,0,5,24.66666667,0,2,2,6,0,3,1,2,2,2,7,10,7,12,15.9
2024-25,202411040HOU,11/4/2024,HOU vs NYK,Tari Eason,easonta01,29,HOU,1,NYK,7,5,1,0,1,0,24.7,2,3,3,7,0,2,1,2,3,1,6,8,12,13,17.5
2024-25,202411040DET,11/4/2024,DET vs LAL,Isaiah Stewart,stewais01,54,DET,1,LAL,8,9,2,0,2,0,24.7,4,5,3,7,0,0,2,2,3,2,11,10,17,19,27.8
2024-25,202411040CLE,11/4/2024,CLE vs MIL,Andre Jackson Jr.,jacksan01,63,MIL,0,CLE,7,7,2,0,1,2,24.91666667,1,6,2,7,2,5,1,2,0,1,9,9,14,16,19.4
2024-25,202411040MIN,11/4/2024,MIN vs CHO,Miles Bridges,bridgmi02,76,CHO,0,MIN,10,6,4,0,0,1,25,1,5,4,13,1,6,1,2,1,0,10,14,16,20,22.2
2024-25,202411040MIN,11/4/2024,MIN vs CHO,Julius Randle,randlju01,53,MIN,1,CHO,13,4,4,2,0,1,25.16666667,3,1,4,10,1,4,4,6,1,2,8,17,17,21,28.8
2024-25,202411040WAS,11/4/2024,WAS vs GSW,Jonathan Kuminga,kuminjo01,81,GSW,0,WAS,15,6,2,1,0,0,25.28333333,3,3,7,15,0,2,1,4,0,1,8,17,21,23,28.2
2024-25,202411040MIA,11/4/2024,MIA vs SAC,Pelle Larsson,larsspe01,3,MIA,1,SAC,13,2,2,1,0,0,25.36666667,1,1,4,6,3,5,2,3,2,1,4,15,15,17,21.4
2024-25,202411040LAC,11/4/2024,LAC vs SAS,Kris Dunn,dunnkr01,73,LAC,1,SAS,11,3,1,0,2,0,25.43333333,0,3,4,9,2,5,1,2,5,2,4,12,14,15,22.1
2024-25,202411040ATL,11/4/2024,ATL vs BOS,Payton Pritchard,pritcpa01,90,BOS,0,ATL,18,3,4,1,0,3,25.48333333,0,3,7,12,3,8,1,1,1,1,7,22,21,25,27.6
2024-25,202411040LAC,11/4/2024,LAC vs SAS,Amir Coffey,coffeam01,77,LAC,1,SAS,21,6,1,1,0,0,25.53333333,1,5,8,10,5,6,0,0,2,1,7,22,27,28,32.7
2024-25,202411040DEN,11/4/2024,DEN vs TOR,Julian Strawther,strawju01,57,DEN,1,TOR,13,2,3,2,1,1,25.61666667,0,2,4,10,2,4,3,4,2,3,5,16,15,18,27.9
2024-25,202411040MIN,11/4/2024,MIN vs CHO,Josh Green,greenjo02,62,CHO,0,MIN,8,0,0,0,0,0,25.81666667,0,0,3,6,1,3,1,1,3,0,0,8,8,8,8
2024-25,202411040MIN,11/4/2024,MIN vs CHO,Naz Reid,reidna01,88,MIN,1,CHO,25,9,2,1,1,1,25.98333333,2,7,9,13,5,7,2,2,3,2,11,27,34,36,43.8
2024-25,202411040ATL,11/4/2024,ATL vs BOS,Garrison Mathews,mathega01,73,ATL,1,BOS,10,0,2,0,1,0,26.03333333,0,0,4,5,2,3,0,1,1,1,2,12,10,12,16
2024-25,202411040HOU,11/4/2024,HOU vs NYK,Miles McBride,mcbrimi01,74,NYK,0,HOU,0,0,2,2,1,0,26.28333333,0,0,0,9,0,5,0,0,3,3,2,2,0,2,12
2024-25,202411040CLE,11/4/2024,CLE vs MIL,Isaac Okoro,okorois01,77,CLE,1,MIL,5,3,2,1,0,1,26.3,2,1,2,5,1,3,0,0,4,1,5,7,8,10,13.6
2024-25,202411040CLE,11/4/2024,CLE vs MIL,Georges Niang,niangge01,90,CLE,1,MIL,9,4,2,1,0,0,26.31666667,0,4,3,6,3,6,0,0,5,1,6,11,13,15,19.8
2024-25,202411040NOP,11/4/2024,NOP vs POR,Yves Missi,missiyv01,8,NOP,1,POR,4,7,3,0,0,0,26.53333333,2,5,1,1,0,0,2,2,2,0,10,7,11,14,16.9
2024-25,202411040WAS,11/4/2024,WAS vs GSW,Alex Sarr,sarral01,6,WAS,1,GSW,10,11,2,0,3,1,26.58333333,3,8,3,10,0,4,4,6,3,3,13,12,21,23,34.2
2024-25,202411040BRK,11/4/2024,BRK vs MEM,Nic Claxton,claxtni01,78,BRK,1,MEM,10,8,3,2,1,0,26.63333333,2,6,5,8,0,0,0,2,1,3,11,13,18,21,33.1
2024-25,202411040OKC,11/4/2024,OKC vs ORL,Goga Bitadze,bitadgo01,66,ORL,0,OKC,11,9,4,1,1,1,26.73333333,3,6,5,8,0,1,1,2,2,2,13,15,20,24,32.8
2024-25,202411040CHI,11/4/2024,CHI vs UTA,Patrick Williams,willipa01,50,CHI,1,UTA,13,2,2,0,1,1,26.73333333,0,2,5,11,3,6,0,0,6,1,4,15,15,17,20.4
2024-25,202411040OKC,11/4/2024,OKC vs ORL,Cason Wallace,wallaca01,89,OKC,1,ORL,4,4,1,0,1,1,26.98333333,0,4,2,6,0,1,0,0,3,1,5,5,8,9,12.3
2024-25,202411040CLE,11/4/2024,CLE vs MIL,Sam Merrill,merrisa01,69,CLE,1,MIL,12,5,2,2,0,2,27.3,0,5,5,10,2,6,0,0,1,2,7,14,17,19,25
2024-25,202411040WAS,11/4/2024,WAS vs GSW,Buddy Hield,hieldbu01,92,GSW,0,WAS,20,5,2,2,1,0,27.65,0,5,7,14,3,8,3,4,2,3,7,22,25,27,38
2024-25,202411040PHO,11/4/2024,PHO vs PHI,Kyle Lowry,lowryky01,66,PHI,0,PHO,13,2,7,1,1,0,27.76666667,2,0,5,8,3,6,0,0,1,2,9,20,15,22,31.9
2024-25,202411040OKC,11/4/2024,OKC vs ORL,Luguentz Dort,dortlu01,86,OKC,1,ORL,6,3,1,2,0,2,27.9,1,2,2,6,2,4,0,0,3,2,4,7,9,10,15.1
2024-25,202411040BRK,11/4/2024,BRK vs MEM,Dorian Finney-Smith,finnedo01,76,BRK,1,MEM,17,6,3,1,0,4,28,5,1,6,10,5,8,0,0,5,1,9,20,23,26,27.7
2024-25,202411040LAC,11/4/2024,LAC vs SAS,Keldon Johnson,johnske04,76,SAS,0,LAC,10,5,1,0,0,0,28.13333333,1,4,5,8,0,0,0,0,2,0,6,11,15,16,17.5
2024-25,202411040MIN,11/4/2024,MIN vs CHO,Donte DiVincenzo,divindo01,88,MIN,1,CHO,14,5,3,2,2,4,28.28333333,0,5,5,9,3,6,1,1,4,4,8,17,19,22,32.5
2024-25,202411040CHI,11/4/2024,CHI vs UTA,Talen Horton-Tucker,hortota01,56,CHI,1,UTA,10,6,4,0,0,0,28.31666667,1,5,2,7,0,3,6,7,3,0,10,14,16,20,23.2
2024-25,202411040BRK,11/4/2024,BRK vs MEM,Jalen Wilson,wilsoja03,51,BRK,1,MEM,13,6,4,0,0,0,28.33333333,1,5,5,12,0,6,3,4,2,0,10,17,19,23,26.2
2024-25,202411040PHO,11/4/2024,PHO vs PHI,Jusuf Nurkic,nurkiju01,83,PHO,1,PHI,15,15,2,2,1,5,28.41666667,1,14,5,8,1,3,4,6,4,3,17,17,30,32,40
2024-25,202411040DET,11/4/2024,DET vs LAL,Malik Beasley,beaslma01,87,DET,1,LAL,7,4,1,0,0,1,28.48333333,1,3,2,10,1,5,2,2,3,0,5,8,11,12,12.3
2024-25,202411040PHO,11/4/2024,PHO vs PHI,Tyus Jones,jonesty01,73,PHO,1,PHI,4,2,5,0,0,2,28.58333333,1,1,2,5,0,2,0,0,1,0,7,9,6,11,11.9
2024-25,202411040MIA,11/4/2024,MIA vs SAC,Keon Ellis,elliske01,63,SAC,0,MIA,7,3,2,3,0,0,28.61666667,2,1,3,6,1,3,0,1,4,3,5,9,10,12,22.6
2024-25,202411040BRK,11/4/2024,BRK vs MEM,Zach Edey,edeyza01,8,MEM,0,BRK,25,12,1,0,4,2,28.68333333,5,7,11,12,1,1,2,4,1,4,13,26,37,38,50.9
2024-25,202411040DAL,11/4/2024,DAL vs IND,Andrew Nembhard,nembhan01,74,IND,0,DAL,11,3,3,0,0,0,28.8,1,2,4,9,1,2,2,2,3,0,6,14,14,17,19.1
2024-25,202411040WAS,11/4/2024,WAS vs GSW,Draymond Green,greendr01,62,GSW,0,WAS,18,8,5,0,1,2,28.88333333,1,7,5,7,3,4,5,7,2,1,13,23,26,31,36.1
2024-25,202411040MIN,11/4/2024,MIN vs CHO,Anthony Edwards,edwaran01,86,MIN,1,CHO,21,5,1,1,0,1,29.08333333,0,5,6,11,4,6,5,7,1,1,6,22,26,27,30.5
2024-25,202411040WAS,11/4/2024,WAS vs GSW,Corey Kispert,kispeco01,86,WAS,1,GSW,4,5,1,0,1,0,29.18333333,1,4,2,7,0,4,0,0,1,1,6,5,9,10,14.5
2024-25,202411040ATL,11/4/2024,ATL vs BOS,David Roddy,roddyda01,71,ATL,1,BOS,11,6,3,0,0,2,29.2,0,6,4,7,1,3,2,2,1,0,9,14,17,20,20.7
2024-25,202411040ATL,11/4/2024,ATL vs BOS,Derrick White,whitede01,81,BOS,0,ATL,21,6,6,2,1,3,29.31666667,2,4,8,16,4,9,1,2,3,3,12,27,27,33,43.2
2024-25,202411040MIN,11/4/2024,MIN vs CHO,Rudy Gobert,goberru01,83,MIN,1,CHO,8,8,4,0,1,1,29.85,2,6,4,5,0,0,0,0,2,1,12,12,16,20,25.6
2024-25,202411040CHI,11/4/2024,CHI vs UTA,Cody Williams,willico04,7,UTA,0,CHI,11,5,4,1,0,0,29.9,2,3,5,8,0,1,1,4,1,1,9,15,16,20,26
2024-25,202411040CHI,11/4/2024,CHI vs UTA,Josh Giddey,giddejo01,87,CHI,1,UTA,15,2,7,1,0,3,30.01666667,0,2,5,11,1,4,4,5,0,1,9,22,17,24,27.9
2024-25,202411040PHO,11/4/2024,PHO vs PHI,Guerschon Yabusele,yabusgu01,6,PHI,0,PHO,19,7,6,0,1,2,30.01666667,3,4,6,14,5,11,2,2,4,1,13,25,26,32,37.4
2024-25,202411040DET,11/4/2024,DET vs LAL,Tobias Harris,harrito02,78,DET,1,LAL,15,7,1,1,1,2,30.05,0,7,7,15,1,7,0,0,5,2,8,16,22,23,28.9
2024-25,202411040MIA,11/4/2024,MIA vs SAC,Terry Rozier,roziete01,67,MIA,1,SAC,10,5,4,0,0,2,30.06666667,0,5,3,6,3,6,1,2,2,0,9,14,15,19,20
2024-25,202411040ATL,11/4/2024,ATL vs BOS,Zaccharie Risacher,risacza01,8,ATL,1,BOS,15,3,2,0,0,2,30.13333333,1,2,6,15,1,6,2,2,2,0,5,17,18,20,19.6
2024-25,202411040DEN,11/4/2024,DEN vs TOR,Davion Mitchell,mitchda01,80,TOR,0,DEN,13,1,8,1,0,0,30.41666667,0,1,5,11,2,7,1,1,2,1,9,21,14,22,29.2
2024-25,202411040ATL,11/4/2024,ATL vs BOS,Jayson Tatum,tatumja01,82,BOS,0,ATL,28,6,9,2,0,1,30.48333333,0,6,10,21,6,14,2,3,0,2,15,37,34,43,53.7
2024-25,202411040DEN,11/4/2024,DEN vs TOR,Peyton Watson,watsope01,87,DEN,1,TOR,16,3,1,2,2,1,30.56666667,1,2,4,7,1,2,7,9,5,4,4,17,19,20,32.1
2024-25,202411040ATL,11/4/2024,ATL vs BOS,Jalen Johnson,johnsja05,64,ATL,1,BOS,20,11,4,1,0,6,30.58333333,2,9,7,20,2,7,4,5,0,1,15,24,31,35,36.2
2024-25,202411040CHI,11/4/2024,CHI vs UTA,John Collins,collijo01,75,UTA,0,CHI,28,13,5,0,1,2,30.78333333,3,10,12,17,2,4,2,2,3,1,18,33,41,46,52.1
2024-25,202411040HOU,11/4/2024,HOU vs NYK,Dillon Brooks,brookdi01,79,HOU,1,NYK,13,3,0,0,0,0,30.8,2,1,4,9,3,5,2,2,5,0,3,13,16,16,16.6
2024-25,202411040OKC,11/4/2024,OKC vs ORL,Kentavious Caldwell-Pope,caldwke01,84,ORL,0,OKC,6,5,2,4,1,1,30.81666667,0,5,1,7,1,4,3,3,1,5,7,8,11,13,29
2024-25,202411040BRK,11/4/2024,BRK vs MEM,Scotty Pippen Jr.,pippesc02,29,MEM,0,BRK,14,4,3,0,0,2,31.05,0,4,6,13,2,6,0,0,5,0,7,17,18,21,21.3
2024-25,202411040CLE,11/4/2024,CLE vs MIL,Donovan Mitchell,mitchdo01,63,CLE,1,MIL,14,4,4,2,0,4,31.08333333,0,4,5,15,3,7,1,2,0,2,8,18,18,22,26.8
2024-25,202411040BRK,11/4/2024,BRK vs MEM,Santi Aldama,aldamsa01,69,MEM,0,BRK,9,6,5,0,0,2,31.28333333,2,4,4,12,0,6,1,1,1,0,11,14,15,20,21.7
2024-25,202411040PHO,11/4/2024,PHO vs PHI,Paul George,georgpa01,75,PHI,0,PHO,15,5,4,1,0,6,31.6,0,5,4,14,1,7,6,7,3,1,9,19,20,24,24
2024-25,202411040HOU,11/4/2024,HOU vs NYK,Jalen Green,greenja05,89,HOU,1,NYK,15,4,3,1,0,3,31.61666667,0,4,5,15,2,8,3,3,1,1,7,18,19,22,24.3
2024-25,202411040BRK,11/4/2024,BRK vs MEM,Jake LaRavia,laravja01,43,MEM,0,BRK,6,5,6,2,0,1,31.63333333,1,4,2,5,1,3,1,2,1,2,11,12,11,17,26
2024-25,202411040CHI,11/4/2024,CHI vs UTA,Walker Kessler,kesslwa01,71,UTA,0,CHI,12,16,2,0,3,3,31.65,6,10,6,7,0,0,0,2,5,3,18,14,28,30,40.2
2024-25,202411040DAL,11/4/2024,DAL vs IND,Bennedict Mathurin,mathube01,67,IND,0,DAL,16,7,3,1,0,0,31.8,0,7,7,13,1,4,1,3,3,1,10,19,23,26,31.9
2024-25,202411040NOP,11/4/2024,NOP vs POR,Deandre Ayton,aytonde01,63,POR,0,NOP,19,13,0,1,0,1,31.85,5,8,9,14,1,1,0,2,1,1,13,19,32,32,36.6
2024-25,202411040CLE,11/4/2024,CLE vs MIL,Evan Mobley,mobleev01,58,CLE,1,MIL,17,5,3,0,3,0,31.85,1,4,6,15,1,3,4,6,1,3,8,20,22,25,36.5
2024-25,202411040DET,11/4/2024,DET vs LAL,Tim Hardaway Jr.,hardati02,87,DET,1,LAL,19,0,1,0,0,0,32.18333333,0,0,7,12,4,8,1,1,0,0,1,20,19,20,20.5
2024-25,202411040HOU,11/4/2024,HOU vs NYK,Karl-Anthony Towns,townska01,68,NYK,0,HOU,17,19,0,0,1,3,32.41666667,9,10,7,17,0,2,3,4,4,1,19,17,36,36,39.8
2024-25,202411040BRK,11/4/2024,BRK vs MEM,Jaren Jackson Jr.,jacksja02,72,MEM,0,BRK,15,5,1,1,2,3,32.43333333,2,3,5,11,3,5,2,2,4,3,6,16,20,21,28.5
2024-25,202411040DEN,11/4/2024,DEN vs TOR,Jakob Poeltl,poeltja01,58,TOR,0,DEN,24,11,3,3,0,2,32.43333333,6,5,11,18,0,0,2,4,6,3,14,27,35,38,48.7
2024-25,202411040PHO,11/4/2024,PHO vs PHI,Kelly Oubre Jr.,oubreke01,74,PHI,0,PHO,11,4,1,2,0,1,32.48333333,1,3,4,10,1,5,2,2,6,2,5,12,15,16,22.3
2024-25,202411040BRK,11/4/2024,BRK vs MEM,Ja Morant,moranja01,16,MEM,0,BRK,25,5,9,0,0,3,32.56666667,1,4,10,22,1,3,4,4,0,0,14,34,30,39,41.5
2024-25,202411040DEN,11/4/2024,DEN vs TOR,RJ Barrett,barrerj01,63,TOR,0,DEN,16,6,10,1,0,5,32.6,1,5,5,21,2,11,4,5,4,1,16,26,22,32,36.2
2024-25,202411040CHI,11/4/2024,CHI vs UTA,Nikola Vucevic,vucevni01,83,CHI,1,UTA,23,10,6,1,3,0,32.88333333,1,9,9,17,2,5,3,3,1,4,16,29,33,39,56
2024-25,202411040DEN,11/4/2024,DEN vs TOR,Ochai Agbaji,agbajoc01,86,TOR,0,DEN,16,5,4,2,0,0,32.9,1,4,6,11,2,4,2,3,3,2,9,20,21,25,34
2024-25,202411040DAL,11/4/2024,DAL vs IND,Myles Turner,turnemy01,84,IND,0,DAL,30,11,0,1,1,2,32.91666667,1,10,10,17,5,8,5,5,2,2,11,30,41,41,47.2
2024-25,202411040WAS,11/4/2024,WAS vs GSW,Carlton Carrington,carrica01,6,WAS,1,GSW,16,8,7,0,0,1,32.98333333,0,8,7,12,1,3,1,1,5,0,15,23,24,31,35.1
2024-25,202411040BRK,11/4/2024,BRK vs MEM,Jaylen Wells,wellsja01,8,MEM,0,BRK,6,5,3,0,1,1,33.01666667,1,4,3,12,0,5,0,0,2,1,8,9,11,14,18.5
2024-25,202411040DET,11/4/2024,DET vs LAL,D'Angelo Russell,russeda01,84,LAL,0,DET,11,3,8,1,0,3,33.03333333,1,2,4,14,2,5,1,2,2,1,11,19,14,22,26.6
2024-25,202411040LAC,11/4/2024,LAC vs SAS,James Harden,hardeja01,79,LAC,1,SAS,17,8,4,1,3,2,33.33333333,2,6,6,10,3,5,2,4,3,4,12,21,25,29,42.6
2024-25,202411040HOU,11/4/2024,HOU vs NYK,Alperen Sengun,sengual01,70,HOU,1,NYK,25,14,5,0,4,4,33.36666667,2,12,11,15,0,3,3,3,2,4,19,30,39,44,57.3
2024-25,202411040HOU,11/4/2024,HOU vs NYK,Amen Thompson,thompam01,69,HOU,1,NYK,12,9,3,1,0,0,33.36666667,1,8,5,8,0,1,2,2,3,1,12,15,21,24,30.3
2024-25,202411040NOP,11/4/2024,NOP vs POR,Brandon Ingram,ingrabr01,72,NOP,1,POR,27,5,7,1,0,4,33.45,0,5,11,24,1,8,4,5,3,1,12,34,32,39,42.5
2024-25,202411040LAC,11/4/2024,LAC vs SAS,Chris Paul,paulch01,65,SAS,0,LAC,14,6,10,2,0,4,33.48333333,0,6,6,11,2,7,0,0,3,2,16,24,20,30,38.2
2024-25,202411040BRK,11/4/2024,BRK vs MEM,Cam Thomas,thomaca02,74,BRK,1,MEM,13,2,6,1,0,3,33.58333333,0,2,6,17,0,4,1,1,2,1,8,19,15,21,24.4
2024-25,202411040DAL,11/4/2024,DAL vs IND,Naji Marshall,marshna01,73,DAL,1,IND,20,5,6,1,0,0,33.71666667,1,4,8,9,2,2,2,2,2,1,11,26,25,31,38
2024-25,202411040WAS,11/4/2024,WAS vs GSW,Jordan Poole,poolejo01,84,WAS,1,GSW,24,1,3,3,4,1,33.71666667,0,1,8,20,2,10,6,7,3,7,4,27,25,28,49.7
2024-25,202411040MIA,11/4/2024,MIA vs SAC,Tyler Herro,herroty01,48,MIA,1,SAC,27,6,3,0,1,4,33.75,0,6,9,18,5,11,4,5,2,1,9,30,33,36,37.7
2024-25,202411040NOP,11/4/2024,NOP vs POR,Jose Alvarado,alvarjo01,64,NOP,1,POR,18,1,6,0,0,1,33.76666667,1,0,4,14,3,9,7,7,3,0,7,24,19,25,27.2
2024-25,202411040OKC,11/4/2024,OKC vs ORL,Tristan Da Silva,dasiltr01,4,ORL,0,OKC,9,3,2,0,0,1,33.78333333,0,3,4,12,1,4,0,0,2,0,5,11,12,14,14.6
2024-25,202411040DAL,11/4/2024,DAL vs IND,Klay Thompson,thompkl01,84,DAL,1,IND,16,2,3,0,0,2,33.9,0,2,6,12,4,8,0,0,0,0,5,19,18,21,20.9
2024-25,202411040NOP,11/4/2024,NOP vs POR,Jeremiah Robinson-Earl,robinje02,47,NOP,1,POR,12,5,1,1,0,0,33.93333333,2,3,5,7,2,4,0,0,3,1,6,13,17,18,22.5
2024-25,202411040CLE,11/4/2024,CLE vs MIL,A.J. Green,greenaj01,62,MIL,0,CLE,21,6,1,0,0,1,33.96666667,0,6,7,9,7,9,0,0,0,0,7,22,27,28,28.7
2024-25,202411040PHO,11/4/2024,PHO vs PHI,Bradley Beal,bealbr01,58,PHO,1,PHI,17,5,3,2,0,2,34.03333333,0,5,7,10,3,5,0,0,2,2,8,20,22,25,31.5
2024-25,202411040LAC,11/4/2024,LAC vs SAS,Norman Powell,powelno01,83,LAC,1,SAS,23,1,3,3,0,1,34.05,0,1,7,15,5,8,4,5,1,3,4,26,24,27,36.7
2024-25,202411040DEN,11/4/2024,DEN vs TOR,Russell Westbrook,westbru01,75,DEN,1,TOR,21,6,6,1,1,4,34.05,1,5,6,10,1,5,8,10,4,2,12,27,27,33,39.2
2024-25,202411040NOP,11/4/2024,NOP vs POR,Anfernee Simons,simonan01,54,POR,0,NOP,24,1,4,1,0,2,34.1,0,1,10,17,3,8,1,1,1,1,5,28,25,29,32.2
2024-25,202411040LAC,11/4/2024,LAC vs SAS,Victor Wembanyama,wembavi01,78,SAS,0,LAC,24,13,3,3,9,2,34.1,2,11,9,22,2,9,4,4,3,12,16,27,37,40,78.1
2024-25,202411040BRK,11/4/2024,BRK vs MEM,Dennis Schroder,schrode01,88,BRK,1,MEM,20,2,6,1,0,3,34.13333333,0,2,7,15,2,7,4,5,4,1,8,26,22,28,31.4
2024-25,202411040OKC,11/4/2024,OKC vs ORL,Franz Wagner,wagnefr01,80,ORL,0,OKC,22,4,2,2,0,5,34.15,2,2,8,17,1,4,5,6,2,2,6,24,26,28,30.8
2024-25,202411040CHI,11/4/2024,CHI vs UTA,Collin Sexton,sextoco01,85,UTA,0,CHI,24,2,5,1,1,1,34.28333333,0,2,7,18,4,7,6,6,2,2,7,29,26,31,38.9
2024-25,202411040CHI,11/4/2024,CHI vs UTA,Coby White,whiteco01,86,CHI,1,UTA,28,4,6,2,0,3,34.28333333,0,4,10,19,6,9,2,2,4,2,10,34,32,38,44.8
2024-25,202411040OKC,11/4/2024,OKC vs ORL,Jalen Williams,willija06,78,OKC,1,ORL,23,4,1,3,1,1,34.53333333,0,4,10,17,3,7,0,0,3,4,5,24,27,28,40.3
2024-25,202411040CLE,11/4/2024,CLE vs MIL,Jarrett Allen,allenja01,85,CLE,1,MIL,14,15,6,2,1,0,34.7,1,14,7,14,0,0,0,2,0,3,21,20,29,35,50
2024-25,202411040CLE,11/4/2024,CLE vs MIL,Darius Garland,garlada01,65,CLE,1,MIL,39,2,8,0,0,2,34.75,1,1,15,22,7,11,2,2,1,0,10,47,41,49,51.4
2024-25,202411040DET,11/4/2024,DET vs LAL,Rui Hachimura,hachiru01,76,LAL,0,DET,8,4,1,0,1,0,34.76666667,0,4,2,6,2,2,2,2,2,1,5,9,12,13,17.3
2024-25,202411040CHI,11/4/2024,CHI vs UTA,Ayo Dosunmu,dosunay01,83,CHI,1,UTA,25,5,5,0,1,1,34.8,3,2,9,13,0,2,7,7,2,1,10,30,30,35,40.5
2024-25,202411040DAL,11/4/2024,DAL vs IND,P.J. Washington,washipj01,80,DAL,1,IND,8,11,0,0,3,2,34.85,1,10,3,11,0,5,2,4,2,3,11,8,19,19,28.2
2024-25,202411040OKC,11/4/2024,OKC vs ORL,Jalen Suggs,suggsja01,83,ORL,0,OKC,19,6,6,0,1,2,34.98333333,0,6,6,13,1,4,6,6,4,1,12,25,25,31,36.2
2024-25,202411040OKC,11/4/2024,OKC vs ORL,Shai Gilgeous-Alexander,gilgesh01,82,OKC,1,ORL,21,6,9,1,0,4,35.06666667,0,6,8,16,1,3,4,4,4,1,15,30,27,36,40.7
2024-25,202411040DET,11/4/2024,DET vs LAL,Jaden Ivey,iveyja01,85,DET,1,LAL,26,4,4,1,1,4,35.33333333,1,3,10,16,1,2,5,7,3,2,8,30,30,34,38.8
2024-25,202411040DAL,11/4/2024,DAL vs IND,Tyrese Haliburton,halibty01,77,IND,0,DAL,25,4,12,2,1,2,35.53333333,0,4,10,16,2,8,3,6,1,3,16,37,29,41,54.8
2024-25,202411040DAL,11/4/2024,DAL vs IND,Pascal Siakam,siakapa01,87,IND,0,DAL,23,6,4,0,0,1,35.58333333,1,5,10,16,1,2,2,2,1,0,10,27,29,33,35.2
2024-25,202411040DEN,11/4/2024,DEN vs TOR,Gradey Dick,dickgr01,68,TOR,0,DEN,26,2,5,3,2,4,35.68333333,0,2,10,20,4,9,2,2,0,5,7,31,28,33,46.9
2024-25,202411040NOP,11/4/2024,NOP vs POR,Jerami Grant,grantje01,62,POR,0,NOP,16,3,4,2,1,0,35.71666667,1,2,5,15,2,7,4,4,0,3,7,20,19,23,34.6
2024-25,202411040CLE,11/4/2024,CLE vs MIL,Brook Lopez,lopezbr01,86,MIL,0,CLE,13,6,0,4,2,1,35.71666667,1,5,6,12,1,5,0,0,1,6,6,13,19,19,37.2
2024-25,202411040HOU,11/4/2024,HOU vs NYK,Fred VanVleet,vanvlfr01,80,HOU,1,NYK,19,2,5,2,1,1,35.78333333,1,1,8,14,1,5,2,2,3,3,7,24,21,26,36.9
2024-25,202411040DET,11/4/2024,DET vs LAL,Cade Cunningham,cunnica01,70,DET,1,LAL,17,11,11,0,0,3,35.8,2,9,7,17,1,5,2,5,1,0,22,28,28,39,43.7
2024-25,202411040MIA,11/4/2024,MIA vs SAC,Jimmy Butler,butleji01,66,MIA,1,SAC,27,2,6,2,0,1,35.9,1,1,9,19,1,2,8,11,1,2,8,33,29,35,43.4
2024-25,202411040MIA,11/4/2024,MIA vs SAC,Bam Adebayo,adebaba01,77,MIA,1,SAC,16,8,5,3,4,0,35.95,3,5,7,15,0,1,2,5,1,7,13,21,24,29,54.1
2024-25,202411040MIA,11/4/2024,MIA vs SAC,DeMar DeRozan,derozde01,86,SAC,0,MIA,26,3,6,0,2,1,35.98333333,1,2,10,18,1,2,5,5,4,2,9,32,29,35,43.6
2024-25,202411040DEN,11/4/2024,DEN vs TOR,Christian Braun,braunch01,89,DEN,1,TOR,17,4,0,1,0,0,36.03333333,1,3,7,11,1,1,2,4,2,1,4,17,21,21,24.8
2024-25,202411040BRK,11/4/2024,BRK vs MEM,Cameron Johnson,johnsca02,66,BRK,1,MEM,20,3,2,0,0,0,36.05,1,2,8,11,3,4,1,2,2,0,5,22,23,25,26.6
2024-25,202411040DEN,11/4/2024,DEN vs TOR,Michael Porter Jr.,portemi01,88,DEN,1,TOR,19,9,3,1,1,2,36.25,4,5,7,16,3,10,2,3,2,2,12,22,28,31,38.3
2024-25,202411040NOP,11/4/2024,NOP vs POR,Toumani Camara,camarto01,78,POR,0,NOP,16,5,4,1,1,0,36.51666667,2,3,6,12,2,5,2,4,4,2,9,20,21,25,34
2024-25,202411040LAC,11/4/2024,LAC vs SAS,Ivica Zubac,zubaciv01,75,LAC,1,SAS,17,13,4,0,0,4,36.71666667,10,3,6,17,0,0,5,5,3,0,17,21,30,34,34.6
2024-25,202411040NOP,11/4/2024,NOP vs POR,Brandon Boston Jr.,bostobr01,37,NOP,1,POR,20,3,4,2,1,2,36.81666667,0,3,9,15,2,6,0,0,3,3,7,24,23,27,36.6
2024-25,202411040MIA,11/4/2024,MIA vs SAC,De'Aaron Fox,foxde01,81,SAC,0,MIA,28,6,5,0,0,4,37.05,2,4,11,21,3,6,3,4,4,0,11,33,34,39,38.7
2024-25,202411040CLE,11/4/2024,CLE vs MIL,Damian Lillard,lillada01,80,MIL,0,CLE,36,2,7,0,0,8,37.33333333,1,1,11,22,5,9,9,9,1,0,9,43,38,45,40.9
2024-25,202411040LAC,11/4/2024,LAC vs SAS,Harrison Barnes,barneha02,89,SAS,0,LAC,4,6,3,0,0,0,37.56666667,5,1,1,4,0,3,2,2,1,0,9,7,10,13,15.7
2024-25,202411040HOU,11/4/2024,HOU vs NYK,Josh Hart,hartjo01,87,NYK,0,HOU,12,4,7,1,0,1,37.83333333,0,4,4,9,0,2,4,4,3,1,11,19,16,23,29.3
2024-25,202411040WAS,11/4/2024,WAS vs GSW,Kyshawn George,georgky01,6,WAS,1,GSW,20,6,4,1,0,1,37.85,1,5,7,19,6,17,0,0,5,1,10,24,26,30,35.2
2024-25,202411040MIA,11/4/2024,MIA vs SAC,Domantas Sabonis,sabondo01,89,SAC,0,MIA,16,16,7,0,0,3,37.91666667,3,13,6,12,2,4,2,2,4,0,23,23,32,39,42.7
2024-25,202411040DEN,11/4/2024,DEN vs TOR,Nikola Jokic,jokicni01,86,DEN,1,TOR,28,14,13,1,2,7,38.2,5,9,10,22,1,5,7,8,2,3,27,41,42,55,66.3
2024-25,202411040PHO,11/4/2024,PHO vs PHI,Devin Booker,bookede01,75,PHO,1,PHI,13,3,6,1,1,2,38.21666667,2,1,3,18,0,6,7,7,1,2,9,19,16,22,29.6
2024-25,202411040LAC,11/4/2024,LAC vs SAS,Julian Champagnie,champju02,81,SAS,0,LAC,21,5,2,0,0,0,38.21666667,0,5,7,12,5,10,2,3,3,0,7,23,26,28,30
2024-25,202411040PHO,11/4/2024,PHO vs PHI,Kevin Durant,duranke01,82,PHO,1,PHI,35,4,6,0,1,3,38.55,0,4,14,20,2,5,5,5,2,1,10,41,39,45,48.8
2024-25,202411040CHI,11/4/2024,CHI vs UTA,Keyonte George,georgke01,82,UTA,0,CHI,33,1,9,1,1,2,38.58333333,0,1,8,18,6,12,11,13,1,2,10,42,34,43,51.7
2024-25,202411040MIA,11/4/2024,MIA vs SAC,Keegan Murray,murrake02,84,SAC,0,MIA,14,6,1,0,1,1,38.78333333,2,4,5,11,1,4,3,3,3,1,7,15,20,21,24.7
2024-25,202411040CLE,11/4/2024,CLE vs MIL,Bobby Portis,portibo01,89,MIL,0,CLE,21,18,1,0,3,1,38.88333333,3,15,10,21,0,2,1,2,3,3,19,22,39,40,52.1
2024-25,202411040DET,11/4/2024,DET vs LAL,Anthony Davis,davisan02,84,LAL,0,DET,37,9,4,0,0,3,39,1,8,13,23,0,4,11,14,2,0,13,41,46,50,50.8
2024-25,202411040PHO,11/4/2024,PHO vs PHI,Caleb Martin,martica02,70,PHI,0,PHO,5,10,5,1,0,0,39.03333333,3,7,2,6,1,3,0,0,2,1,15,10,15,20,27.5
2024-25,202411040WAS,11/4/2024,WAS vs GSW,Bilal Coulibaly,coulibi01,69,WAS,1,GSW,9,4,2,0,0,3,39.21666667,0,4,3,11,1,4,2,2,2,0,6,11,13,15,13.8
2024-25,202411040DET,11/4/2024,DET vs LAL,Austin Reaves,reaveau01,90,LAL,0,DET,17,4,4,2,0,4,39.35,1,3,7,17,3,10,0,1,4,2,8,21,21,25,29.8
2024-25,202411040HOU,11/4/2024,HOU vs NYK,OG Anunoby,anunoog01,56,NYK,0,HOU,21,6,2,1,2,0,39.58333333,1,5,7,14,5,6,2,3,2,3,8,23,27,29,40.2
2024-25,202411040DAL,11/4/2024,DAL vs IND,Kyrie Irving,irvinky01,65,DAL,1,IND,27,5,4,0,0,2,39.6,2,3,11,21,3,7,2,2,3,0,9,31,32,36,37
2024-25,202411040DET,11/4/2024,DET vs LAL,LeBron James,jamesle01,79,LAL,0,DET,20,8,11,2,0,1,40,1,7,7,16,1,2,5,5,1,2,19,31,28,39,51.1
2024-25,202411040HOU,11/4/2024,HOU vs NYK,Mikal Bridges,bridgmi01,88,NYK,0,HOU,15,3,0,1,0,4,40.35,1,2,6,14,3,8,0,1,0,1,3,15,18,18,17.6
2024-25,202411040PHO,11/4/2024,PHO vs PHI,Tyrese Maxey,maxeyty01,76,PHI,0,PHO,32,3,2,1,1,0,40.93333333,0,3,12,22,6,14,2,3,3,2,5,34,35,37,44.6
2024-25,202411040DAL,11/4/2024,DAL vs IND,Luka Doncic,doncilu01,77,DAL,1,IND,34,7,15,2,0,2,42.33333333,0,7,9,24,4,10,12,15,3,2,22,49,41,56,68.9
2024-25,202411040HOU,11/4/2024,HOU vs NYK,Jalen Brunson,brunsja01,83,NYK,0,HOU,29,3,8,1,0,1,42.41666667,1,2,9,24,2,4,9,9,2,1,11,37,32,40,46.6
2024-25,202411030BRK,11/3/2024,BRK vs DET,Ron Holland,hollaro01,7,DET,0,BRK,0,0,1,0,0,0,10.33333333,0,0,0,1,0,0,0,0,2,0,1,1,0,1,1.5
2024-25,202411030BRK,11/3/2024,BRK vs DET,Keon Johnson,johnske07,11,BRK,1,DET,5,1,0,1,1,0,12.91666667,0,1,1,1,0,0,3,4,3,2,1,5,6,6,12.2
2024-25,202411030BRK,11/3/2024,BRK vs DET,Isaiah Stewart,stewais01,53,DET,0,BRK,2,5,0,0,2,1,13.7,0,5,0,0,0,0,2,2,6,2,5,2,7,7,13
2024-25,202411030DAL,11/3/2024,DAL vs ORL,Gary Harris,harriga01,61,ORL,0,DAL,4,1,0,0,0,1,14.31666667,1,0,2,6,0,3,0,0,0,0,1,4,5,5,4.2
2024-25,202411030DAL,11/3/2024,DAL vs ORL,Cole Anthony,anthoco01,87,ORL,0,DAL,9,3,3,1,0,1,14.36666667,0,3,3,6,1,2,2,4,2,1,6,12,12,15,19.1
2024-25,202411030DAL,11/3/2024,DAL vs ORL,Spencer Dinwiddie,dinwisp01,81,DAL,1,ORL,0,0,2,0,1,0,15.81666667,0,0,0,1,0,1,0,0,1,1,2,2,0,2,6
2024-25,202411030DAL,11/3/2024,DAL vs ORL,Jonathan Isaac,isaacjo01,62,ORL,0,DAL,3,5,1,1,1,0,15.93333333,2,3,1,6,0,4,1,2,3,2,6,4,8,9,16.5
2024-25,202411030BRK,11/3/2024,BRK vs DET,Ziaire Williams,willizi02,58,BRK,1,DET,4,2,0,0,0,0,16.01666667,0,2,2,5,0,3,0,0,3,0,2,4,6,6,6.4
2024-25,202411030BRK,11/3/2024,BRK vs DET,Noah Clowney,clownno01,30,BRK,1,DET,4,2,1,0,0,0,16.71666667,1,1,1,3,1,2,1,2,2,0,3,5,6,7,7.9
2024-25,202411030DAL,11/3/2024,DAL vs ORL,Quentin Grimes,grimequ01,57,DAL,1,ORL,5,3,0,2,0,1,17.45,0,3,2,4,1,2,0,0,2,2,3,5,8,8,13.6
2024-25,202411030NOP,11/3/2024,NOP vs ATL,Daniel Theis,theisda01,67,NOP,1,ATL,7,3,0,1,0,2,17.63333333,0,3,3,4,1,1,0,0,2,1,3,7,10,10,11.6
2024-25,202411030NOP,11/3/2024,NOP vs ATL,Jamal Cain,cainja01,30,NOP,1,ATL,14,3,0,0,0,0,17.86666667,2,1,4,7,3,5,3,4,1,0,3,14,17,17,17.6
2024-25,202411030DAL,11/3/2024,DAL vs ORL,Dereck Lively II,livelde01,61,DAL,1,ORL,11,11,1,0,0,2,20.08333333,4,7,5,7,0,0,1,3,3,0,12,12,22,23,23.7
2024-25,202411030DAL,11/3/2024,DAL vs ORL,Daniel Gafford,gaffoda01,80,DAL,1,ORL,18,8,0,1,0,3,20.11666667,3,5,9,13,0,0,0,1,3,1,8,18,26,26,27.6
2024-25,202411030NOP,11/3/2024,NOP vs ATL,Garrison Mathews,mathega01,72,ATL,0,NOP,11,3,1,0,0,2,20.26666667,0,3,3,7,3,6,2,2,4,0,4,12,14,15,14.1
2024-25,202411030DAL,11/3/2024,DAL vs ORL,Moritz Wagner,wagnemo01,87,ORL,0,DAL,10,6,0,0,0,1,20.5,0,6,3,10,0,4,4,4,4,0,6,10,16,16,16.2
2024-25,202411030NOP,11/3/2024,NOP vs ATL,Clint Capela,capelca01,80,ATL,0,NOP,8,4,0,0,1,0,20.65,0,4,4,5,0,0,0,0,1,1,4,8,12,12,15.8
2024-25,202411030DAL,11/3/2024,DAL vs ORL,Anthony Black,blackan01,76,ORL,0,DAL,2,4,2,0,0,6,20.71666667,2,2,1,2,0,0,0,0,2,0,6,4,6,8,3.8
2024-25,202411030DAL,11/3/2024,DAL vs ORL,Naji Marshall,marshna01,72,DAL,1,ORL,4,5,5,2,0,1,21.26666667,0,5,2,5,0,2,0,0,1,2,10,9,9,14,22.5
2024-25,202411030BRK,11/3/2024,BRK vs DET,Jalen Wilson,wilsoja03,50,BRK,1,DET,8,3,2,0,0,0,21.81666667,1,2,3,6,1,1,1,2,0,0,5,10,11,13,14.6
2024-25,202411030BRK,11/3/2024,BRK vs DET,Nic Claxton,claxtni01,77,BRK,1,DET,8,1,5,1,0,3,21.93333333,0,1,2,4,0,0,4,12,5,1,6,13,9,14,16.7
2024-25,202411030NOP,11/3/2024,NOP vs ATL,Keaton Wallace,wallake01,5,ATL,0,NOP,6,2,1,2,0,2,21.95,1,1,3,7,0,1,0,0,2,2,3,7,8,9,13.9
2024-25,202411030DAL,11/3/2024,DAL vs ORL,Jett Howard,howarje01,25,ORL,0,DAL,12,1,0,1,0,2,22.13333333,0,1,4,12,2,8,2,2,1,1,1,12,13,13,14.2
2024-25,202411030BRK,11/3/2024,BRK vs DET,Tim Hardaway Jr.,hardati02,86,DET,0,BRK,14,0,2,0,0,0,22.51666667,0,0,5,9,3,6,1,1,4,0,2,16,14,16,17
2024-25,202411030NOP,11/3/2024,NOP vs ATL,Javonte Green,greenja02,16,NOP,1,ATL,3,2,1,1,0,0,23.51666667,0,2,1,2,0,1,1,1,2,1,3,4,5,6,9.9
2024-25,202411030BRK,11/3/2024,BRK vs DET,Simone Fontecchio,fontesi01,73,DET,0,BRK,7,8,1,0,0,0,23.91666667,2,6,1,6,1,4,4,5,1,0,9,8,15,16,18.1
2024-25,202411030BRK,11/3/2024,BRK vs DET,Ben Simmons,simmobe01,21,BRK,1,DET,4,6,6,1,0,3,24.46666667,0,6,2,4,0,0,0,0,2,1,12,10,10,16,20.2
2024-25,202411030NOP,11/3/2024,NOP vs ATL,Dyson Daniels,daniedy01,66,ATL,0,NOP,16,5,3,1,0,2,24.81666667,2,3,7,10,2,5,0,0,3,1,8,19,21,24,27.5
2024-25,202411030NOP,11/3/2024,NOP vs ATL,Jeremiah Robinson-Earl,robinje02,46,NOP,1,ATL,6,7,2,1,0,1,24.91666667,6,1,2,8,2,3,0,0,1,1,9,8,13,15,19.4
2024-25,202411030NOP,11/3/2024,NOP vs ATL,Larry Nance Jr.,nancela02,65,ATL,0,NOP,14,6,0,1,0,1,24.96666667,2,4,6,8,2,3,0,0,0,1,6,14,20,20,23.2
2024-25,202411030DAL,11/3/2024,DAL vs ORL,Franz Wagner,wagnefr01,79,ORL,0,DAL,13,6,6,2,0,2,25.18333333,1,5,6,15,1,2,0,0,3,2,12,19,19,25,33.2
2024-25,202411030NOP,11/3/2024,NOP vs ATL,David Roddy,roddyda01,70,ATL,0,NOP,8,3,3,0,0,1,25.85,1,2,3,3,2,2,0,0,1,0,6,11,11,14,15.1
2024-25,202411030NOP,11/3/2024,NOP vs ATL,Yves Missi,missiyv01,7,NOP,1,ATL,4,6,3,1,1,1,25.91666667,3,3,2,6,0,0,0,0,0,2,9,7,10,13,20.7
2024-25,202411030DAL,11/3/2024,DAL vs ORL,Kentavious Caldwell-Pope,caldwke01,83,ORL,0,DAL,7,3,1,0,0,0,26,1,2,2,6,2,6,1,1,3,0,4,8,10,11,12.1
2024-25,202411030BRK,11/3/2024,BRK vs DET,Dorian Finney-Smith,finnedo01,75,BRK,1,DET,9,3,0,2,1,2,28.38333333,2,1,3,5,2,3,1,1,3,3,3,9,12,12,19.6
2024-25,202411030DAL,11/3/2024,DAL vs ORL,Kyrie Irving,irvinky01,64,DAL,1,ORL,17,2,3,2,0,1,28.43333333,0,2,5,11,1,2,6,7,2,2,5,20,19,22,28.9
2024-25,202411030DAL,11/3/2024,DAL vs ORL,P.J. Washington,washipj01,79,DAL,1,ORL,7,4,2,1,0,1,28.43333333,1,3,3,4,1,2,0,0,1,1,6,9,11,13,16.8
2024-25,202411030NOP,11/3/2024,NOP vs ATL,Jose Alvarado,alvarjo01,63,NOP,1,ATL,9,3,7,1,0,1,28.56666667,1,2,3,12,1,7,2,2,2,1,10,16,12,19,25.1
2024-25,202411030DAL,11/3/2024,DAL vs ORL,Klay Thompson,thompkl01,83,DAL,1,ORL,9,5,4,0,2,1,28.6,1,4,4,10,1,5,0,0,0,2,9,13,14,18,26
2024-25,202411030DAL,11/3/2024,DAL vs ORL,Jalen Suggs,suggsja01,82,ORL,0,DAL,10,4,2,1,2,0,28.65,1,3,4,13,1,5,1,2,2,3,6,12,14,16,26.8
2024-25,202411030BRK,11/3/2024,BRK vs DET,Malik Beasley,beaslma01,86,DET,0,BRK,18,1,1,2,0,0,29.31666667,0,1,6,15,4,11,2,3,3,2,2,19,19,20,26.7
2024-25,202411030NOP,11/3/2024,NOP vs ATL,Brandon Ingram,ingrabr01,71,NOP,1,ATL,32,7,2,1,1,6,29.5,1,6,12,19,4,8,4,5,4,2,9,34,39,41,43.4
2024-25,202411030NOP,11/3/2024,NOP vs ATL,Zaccharie Risacher,risacza01,7,ATL,0,NOP,11,5,1,3,0,2,29.86666667,1,4,4,13,1,5,2,2,3,3,6,12,16,17,25.5
2024-25,202411030BRK,11/3/2024,BRK vs DET,Cameron Johnson,johnsca02,65,BRK,1,DET,26,1,3,1,1,0,30.06666667,0,1,9,19,3,12,5,6,3,2,4,29,27,30,37.7
2024-25,202411030NOP,11/3/2024,NOP vs ATL,Brandon Boston Jr.,bostobr01,36,NOP,1,ATL,14,5,4,0,0,2,30.15,3,2,4,10,1,3,5,6,2,0,9,18,19,23,24
2024-25,202411030DAL,11/3/2024,DAL vs ORL,Tristan Da Silva,dasiltr01,3,ORL,0,DAL,7,5,2,0,1,0,31.11666667,1,4,2,7,1,4,2,2,0,1,7,9,12,14,19
2024-25,202411030BRK,11/3/2024,BRK vs DET,Cam Thomas,thomaca02,73,BRK,1,DET,17,2,2,0,0,3,31.13333333,0,2,6,17,1,7,4,4,0,0,4,19,19,21,19.4
2024-25,202411030NOP,11/3/2024,NOP vs ATL,Jordan Hawkins,hawkijo01,74,NOP,1,ATL,19,3,3,0,1,4,31.28333333,1,2,7,18,3,8,2,2,2,1,6,22,22,25,26.1
2024-25,202411030NOP,11/3/2024,NOP vs ATL,Trae Young,youngtr01,61,ATL,0,NOP,23,4,12,1,0,2,31.35,1,3,8,15,5,10,2,2,1,1,16,35,27,39,46.8
2024-25,202411030DAL,11/3/2024,DAL vs ORL,Luka Doncic,doncilu01,76,DAL,1,ORL,32,9,7,0,0,4,31.71666667,1,8,11,22,5,13,5,7,3,0,16,39,41,48,49.3
2024-25,202411030BRK,11/3/2024,BRK vs DET,Jalen Duren,durenja01,68,DET,0,BRK,13,17,4,1,3,4,33.25,3,14,5,5,0,0,3,4,3,4,21,17,30,34,47.4
2024-25,202411030BRK,11/3/2024,BRK vs DET,Dennis Schroder,schrode01,87,BRK,1,DET,7,5,4,3,0,2,33.35,0,5,3,7,1,3,0,0,3,3,9,11,12,16,26
2024-25,202411030BRK,11/3/2024,BRK vs DET,Tobias Harris,harrito02,77,DET,0,BRK,18,5,6,0,0,1,34.63333333,3,2,8,13,1,4,1,1,1,0,11,24,23,29,32
2024-25,202411030BRK,11/3/2024,BRK vs DET,Jaden Ivey,iveyja01,84,DET,0,BRK,15,5,5,1,1,4,35.1,0,5,4,15,1,7,6,7,2,2,10,20,20,25,30.5
2024-25,202411030BRK,11/3/2024,BRK vs DET,Cade Cunningham,cunnica01,69,DET,0,BRK,19,6,5,0,0,7,35.43333333,1,5,8,13,1,4,2,3,3,0,11,24,25,30,26.7
2024-25,202411030NOP,11/3/2024,NOP vs ATL,Jalen Johnson,johnsja05,63,ATL,0,NOP,29,9,8,2,2,4,37.9,2,7,12,20,0,4,5,6,2,4,17,37,38,46,59.8
2024-25,202411020SAS,11/2/2024,SAS vs MIN,Josh Minott,minotjo01,33,MIN,0,SAS,4,2,0,0,0,1,10.16666667,0,2,2,4,0,2,0,0,2,0,2,4,6,6,5.4
2024-25,202411020TOR,11/2/2024,TOR vs SAC,Ja'Kobe Walter,walteja01,2,TOR,1,SAC,0,2,1,0,0,0,10.33333333,1,1,0,1,0,0,0,2,2,0,3,1,2,3,3.9
2024-25,202411020HOU,11/2/2024,HOU vs GSW,Gary Payton II,paytoga02,50,GSW,0,HOU,3,1,0,1,0,0,10.55,0,1,1,2,1,1,0,0,2,1,1,3,4,4,7.2
2024-25,202411020PHO,11/2/2024,PHO vs POR,Dalano Banton,bantoda01,59,POR,0,PHO,12,1,2,2,1,1,11.68333333,1,0,5,7,2,4,0,0,2,3,3,14,13,15,24.2
2024-25,202411020TOR,11/2/2024,TOR vs SAC,Trey Lyles,lylestr01,64,SAC,0,TOR,5,4,0,0,0,1,12.55,1,3,2,5,1,2,0,0,1,0,4,5,9,9,8.8
2024-25,202411020HOU,11/2/2024,HOU vs GSW,Trayce Jackson-Davis,jackstr02,74,GSW,0,HOU,6,3,3,0,0,0,12.6,0,3,3,3,0,0,0,0,3,0,6,9,9,12,14.1
2024-25,202411020SAS,11/2/2024,SAS vs MIN,Zach Collins,colliza01,75,SAS,1,MIN,7,1,5,1,1,2,12.75,0,1,2,3,1,2,2,2,2,2,6,12,8,13,19.7
2024-25,202411020PHI,11/2/2024,PHI vs MEM,Brandon Clarke,clarkbr01,13,MEM,0,PHI,4,1,0,1,1,0,13.05,0,1,2,4,0,0,0,2,2,2,1,4,5,5,11.2
2024-25,202411020PHO,11/2/2024,PHO vs POR,Kris Murray,murrakr01,69,POR,0,PHO,3,4,1,1,0,0,13.35,1,3,1,4,1,2,0,0,2,1,5,4,7,8,12.3
2024-25,202411020CHO,11/2/2024,CHO vs BOS,Jordan Walsh,walshjo01,15,BOS,0,CHO,0,0,0,1,0,0,13.35,0,0,0,2,0,2,0,0,0,1,0,0,0,0,3
2024-25,202411020WAS,11/2/2024,WAS vs MIA,Pelle Larsson,larsspe01,2,MIA,0,WAS,7,1,2,1,0,2,13.63333333,0,1,3,4,1,2,0,0,1,1,3,9,8,10,12.2
2024-25,202411020PHO,11/2/2024,PHO vs POR,Donovan Clingan,clingdo01,7,POR,0,PHO,3,4,0,0,1,1,13.7,2,2,1,3,0,1,1,2,2,1,4,3,7,7,9.8
2024-25,202411020PHO,11/2/2024,PHO vs POR,Ryan Dunn,dunnry01,6,PHO,1,POR,0,2,2,1,0,1,13.7,1,1,0,4,0,3,0,0,1,1,4,2,2,4,7.4
2024-25,202411020WAS,11/2/2024,WAS vs MIA,Thomas Bryant,bryanth01,43,MIA,0,WAS,4,9,0,0,2,0,13.76666667,3,6,1,4,0,1,2,2,1,2,9,4,13,13,20.8
2024-25,202411020TOR,11/2/2024,TOR vs SAC,Jamal Shead,sheadja01,7,TOR,1,SAC,0,0,6,0,0,1,14.06666667,0,0,0,3,0,1,0,0,2,0,6,6,0,6,8
2024-25,202411020DEN,11/2/2024,DEN vs UTA,DeAndre Jordan,jordade01,37,DEN,1,UTA,6,9,1,0,0,4,14.16666667,6,3,3,7,0,0,0,2,2,0,10,7,15,16,14.3
2024-25,202411020SAS,11/2/2024,SAS vs MIN,Malaki Branham,branhma01,81,SAS,1,MIN,6,2,1,0,0,2,14.18333333,0,2,2,4,0,2,2,2,1,0,3,7,8,9,7.9
2024-25,202411020PHI,11/2/2024,PHI vs MEM,Jay Huff,huffja01,27,MEM,0,PHI,20,5,1,0,1,0,14.18333333,1,4,7,10,5,7,1,1,1,1,6,21,25,26,30.5
2024-25,202411020CHO,11/2/2024,CHO vs BOS,Moussa Diabate,diabamo01,17,CHO,1,BOS,1,4,1,0,0,1,14.45,1,3,0,0,0,0,1,2,3,0,5,2,5,6,6.3
2024-25,202411020TOR,11/2/2024,TOR vs SAC,Doug McDermott,mcderdo01,68,SAC,0,TOR,4,1,0,0,0,0,14.85,0,1,1,2,1,2,1,2,2,0,1,4,5,5,5.2
2024-25,202411020SAS,11/2/2024,SAS vs MIN,Stephon Castle,castlst01,6,SAS,1,MIN,3,3,0,0,0,0,15.45,0,3,1,5,1,3,0,2,1,0,3,3,6,6,6.6
2024-25,202411020TOR,11/2/2024,TOR vs SAC,Jamison Battle,battlja01,6,TOR,1,SAC,9,1,3,0,0,0,15.46666667,1,0,3,6,3,6,0,0,0,0,4,12,10,13,14.7
2024-25,202411020MIL,11/2/2024,MIL vs CLE,Andre Jackson Jr.,jacksan01,62,MIL,1,CLE,3,1,1,0,0,3,15.46666667,0,1,1,3,1,2,0,0,3,0,2,4,4,5,2.7
2024-25,202411020CHO,11/2/2024,CHO vs BOS,Neemias Queta,quetane01,34,BOS,0,CHO,4,3,1,0,0,0,15.46666667,0,3,2,4,0,0,0,0,3,0,4,5,7,8,9.1
2024-25,202411020DEN,11/2/2024,DEN vs UTA,Svi Mykhailiuk,mykhasv01,42,UTA,0,DEN,6,1,2,1,0,2,15.48333333,0,1,2,6,2,5,0,0,2,1,3,8,7,9,11.2
2024-25,202411020LAC,11/2/2024,LAC vs OKC,Alex Caruso,carusal01,77,OKC,0,LAC,5,2,0,2,0,0,15.66666667,0,2,2,6,1,5,0,0,4,2,2,5,7,7,13.4
2024-25,202411020CHO,11/2/2024,CHO vs BOS,Tidjane Salaun,salauti01,4,CHO,1,BOS,0,1,0,0,0,0,15.75,0,1,0,3,0,2,0,0,0,0,1,0,1,1,1.2
2024-25,202411020DEN,11/2/2024,DEN vs UTA,Patty Mills,millspa02,38,UTA,0,DEN,0,1,2,0,0,1,15.83333333,0,1,0,3,0,3,0,0,0,0,3,2,1,3,3.2
2024-25,202411020WAS,11/2/2024,WAS vs MIA,Jonas Valanciunas,valanjo01,87,WAS,1,MIA,4,7,1,1,1,2,16.01666667,2,5,2,8,0,0,0,1,4,2,8,5,11,12,17.9
2024-25,202411020DEN,11/2/2024,DEN vs UTA,Brice Sensabaugh,sensabr01,38,UTA,0,DEN,10,0,1,1,0,3,16.05,0,0,3,6,2,4,2,2,1,1,1,11,10,11,11.5
2024-25,202411020WAS,11/2/2024,WAS vs MIA,Josh Richardson,richajo01,44,MIA,0,WAS,0,1,1,0,0,0,16.16666667,1,0,0,4,0,2,0,0,3,0,2,1,1,2,2.7
2024-25,202411020TOR,11/2/2024,TOR vs SAC,Jonathan Mogbo,mogbojo01,7,TOR,1,SAC,6,6,1,1,1,3,16.25,5,1,2,3,0,0,2,4,6,2,7,7,12,13,17.7
2024-25,202411020HOU,11/2/2024,HOU vs GSW,Aaron Holiday,holidaa01,80,HOU,1,GSW,6,0,4,1,0,1,16.4,0,0,2,4,2,3,0,0,0,1,4,10,6,10,14
2024-25,202411020PHO,11/2/2024,PHO vs POR,Mason Plumlee,plumlma01,52,PHO,1,POR,0,6,2,0,2,1,16.5,1,5,0,2,0,0,0,2,0,2,8,2,6,8,15.2
2024-25,202411020PHI,11/2/2024,PHI vs MEM,Jared McCain,mccaija01,5,PHI,1,MEM,19,4,1,1,0,1,16.6,1,3,8,16,2,6,1,1,1,1,5,20,23,24,27.3
2024-25,202411020HOU,11/2/2024,HOU vs GSW,Moses Moody,moodymo01,72,GSW,0,HOU,9,0,2,0,0,0,16.71666667,0,0,2,2,2,2,3,5,0,0,2,11,9,11,12
2024-25,202411020PHO,11/2/2024,PHO vs POR,Scoot Henderson,hendesc01,69,POR,0,PHO,7,2,1,0,0,1,17.01666667,0,2,3,11,1,3,0,0,0,0,3,8,9,10,9.9
2024-25,202411020MIL,11/2/2024,MIL vs CLE,Delon Wright,wrighde01,53,MIL,1,CLE,0,1,0,0,0,1,17.03333333,0,1,0,1,0,1,0,0,2,0,1,0,1,1,0.2
2024-25,202411020HOU,11/2/2024,HOU vs GSW,Lindy Waters III,waterli01,44,GSW,0,HOU,2,1,3,0,0,0,17.45,0,1,1,4,0,2,0,0,0,0,4,5,3,6,7.7
2024-25,202411020WAS,11/2/2024,WAS vs MIA,Johnny Davis,davisjo06,54,WAS,1,MIA,9,7,1,1,0,0,17.68333333,1,6,4,5,0,0,1,2,1,1,8,10,16,17,21.9
2024-25,202411020DEN,11/2/2024,DEN vs UTA,Kyle Filipowski,filipky01,5,UTA,0,DEN,2,6,0,0,0,2,17.71666667,0,6,1,3,0,2,0,0,3,0,6,2,8,8,7.2
2024-25,202411020PHO,11/2/2024,PHO vs POR,Grayson Allen,allengr01,79,PHO,1,POR,18,2,0,0,3,2,18.53333333,1,1,7,12,4,7,0,0,1,3,2,18,20,20,27.4
2024-25,202411020PHI,11/2/2024,PHI vs MEM,Guerschon Yabusele,yabusgu01,5,PHI,1,MEM,9,3,0,1,0,0,18.68333333,0,3,3,6,3,6,0,0,2,1,3,9,12,12,15.6
2024-25,202411020LAC,11/2/2024,LAC vs OKC,Kevin Porter Jr.,porteke02,6,LAC,1,OKC,7,4,4,0,0,2,18.86666667,1,3,3,7,1,1,0,1,1,0,8,11,11,15,15.8
2024-25,202411020DEN,11/2/2024,DEN vs UTA,Julian Strawther,strawju01,56,DEN,1,UTA,19,2,0,2,0,1,19,1,1,7,11,3,6,2,2,5,2,2,19,21,21,26.4
2024-25,202411020CHO,11/2/2024,CHO vs BOS,Cody Martin,martico01,34,CHO,1,BOS,11,4,1,1,0,2,19.01666667,0,4,4,8,1,4,2,2,0,1,5,12,15,16,18.3
2024-25,202411020DEN,11/2/2024,DEN vs UTA,Drew Eubanks,eubandr01,79,UTA,0,DEN,5,6,1,1,2,2,19.53333333,1,5,2,4,0,1,1,1,1,3,7,6,11,12,20.7
2024-25,202411020LAC,11/2/2024,LAC vs OKC,Nicolas Batum,batumni01,66,LAC,1,OKC,4,2,2,0,1,0,19.55,0,2,1,5,1,4,1,2,0,1,4,6,6,8,12.4
2024-25,202411020DEN,11/2/2024,DEN vs UTA,Peyton Watson,watsope01,86,DEN,1,UTA,8,4,1,3,0,2,19.56666667,3,1,2,9,0,1,4,4,2,3,5,9,12,13,21.3
2024-25,202411020LAC,11/2/2024,LAC vs OKC,Kris Dunn,dunnkr01,72,LAC,1,OKC,11,4,4,1,0,2,19.61666667,1,3,4,8,2,5,1,3,3,1,8,15,15,19,22.8
2024-25,202411020CHO,11/2/2024,CHO vs BOS,Sam Hauser,hausesa01,83,BOS,0,CHO,8,7,1,0,0,0,19.65,3,4,3,7,2,6,0,0,1,0,8,9,15,16,17.9
2024-25,202411020DEN,11/2/2024,DEN vs UTA,Cody Williams,willico04,6,UTA,0,DEN,4,1,0,0,0,0,19.71666667,1,0,2,11,0,5,0,0,1,0,1,4,5,5,5.2
2024-25,202411020WAS,11/2/2024,WAS vs MIA,Tyler Herro,herroty01,47,MIA,0,WAS,15,6,1,0,0,2,19.75,0,6,5,9,2,4,3,6,6,0,7,16,21,22,21.7
2024-25,202411020LAC,11/2/2024,LAC vs OKC,Amir Coffey,coffeam01,76,LAC,1,OKC,4,1,0,2,0,4,20.13333333,0,1,1,2,0,1,2,2,1,2,1,4,5,5,7.2
2024-25,202411020MIL,11/2/2024,MIL vs CLE,Bobby Portis,portibo01,88,MIL,1,CLE,10,8,0,0,0,2,20.16666667,1,7,5,10,0,2,0,0,2,0,8,10,18,18,17.6
2024-25,202411020PHI,11/2/2024,PHI vs MEM,KJ Martin,martike04,65,PHI,1,MEM,4,3,1,0,3,0,20.3,0,3,1,2,0,0,2,2,3,3,4,5,7,8,18.1
2024-25,202411020HOU,11/2/2024,HOU vs GSW,Kevon Looney,looneke01,80,GSW,0,HOU,7,7,2,1,1,0,20.51666667,2,5,1,3,0,0,5,8,3,2,9,9,14,16,24.4
2024-25,202411020HOU,11/2/2024,HOU vs GSW,Alperen Sengun,sengual01,69,HOU,1,GSW,14,10,4,0,1,2,20.63333333,3,7,5,10,0,1,4,6,3,1,14,18,24,28,33
2024-25,202411020MIL,11/2/2024,MIL vs CLE,Georges Niang,niangge01,89,CLE,0,MIL,3,4,2,0,1,2,20.66666667,0,4,1,5,0,4,1,2,2,1,6,5,7,9,11.8
2024-25,202411020SAS,11/2/2024,SAS vs MIN,Mike Conley,conlemi01,82,MIN,0,SAS,5,3,3,3,0,2,20.88333333,1,2,2,4,1,3,0,0,2,3,6,8,8,11,20.1
2024-25,202411020PHI,11/2/2024,PHI vs MEM,Kyle Lowry,lowryky01,65,PHI,1,MEM,10,3,1,2,0,1,20.91666667,1,2,3,4,3,4,1,2,1,2,4,11,13,14,20.1
2024-25,202411020CHO,11/2/2024,CHO vs BOS,Josh Green,greenjo02,61,CHO,1,BOS,12,0,0,2,0,0,21.21666667,0,0,4,6,4,5,0,0,2,2,0,12,12,12,18
2024-25,202411020DEN,11/2/2024,DEN vs UTA,John Collins,collijo01,74,UTA,0,DEN,15,5,5,1,1,2,21.78333333,0,5,5,9,1,1,4,5,4,2,10,20,20,25,32.5
2024-25,202411020PHI,11/2/2024,PHI vs MEM,Zach Edey,edeyza01,7,MEM,0,PHI,10,10,1,1,1,3,21.98333333,5,5,4,7,0,0,2,2,3,2,11,11,20,21,26.5
2024-25,202411020LAC,11/2/2024,LAC vs OKC,Derrick Jones Jr.,jonesde02,82,LAC,1,OKC,2,3,0,0,0,2,22.08333333,1,2,1,9,0,5,0,0,4,0,3,2,5,5,3.6
2024-25,202411020MIL,11/2/2024,MIL vs CLE,Sam Merrill,merrisa01,68,CLE,0,MIL,17,1,1,0,1,0,22.08333333,0,1,6,10,5,9,0,0,0,1,2,18,18,19,22.7
2024-25,202411020CHO,11/2/2024,CHO vs BOS,Tre Mann,manntr01,47,CHO,1,BOS,10,1,3,0,0,1,22.4,0,1,4,9,1,2,1,1,2,0,4,13,11,14,14.7
2024-25,202411020LAC,11/2/2024,LAC vs OKC,Isaiah Joe,joeis01,84,OKC,0,LAC,12,2,1,1,0,0,22.41666667,1,1,4,8,4,8,0,0,0,1,3,13,14,15,18.9
2024-25,202411020PHI,11/2/2024,PHI vs MEM,Eric Gordon,gordoer01,73,PHI,1,MEM,10,1,2,0,0,2,22.43333333,1,0,4,6,2,3,0,0,1,0,3,12,11,13,12.2
2024-25,202411020MIL,11/2/2024,MIL vs CLE,Dean Wade,wadede01,61,CLE,0,MIL,8,4,2,1,0,1,22.83333333,1,3,3,8,2,7,0,0,3,1,6,10,12,14,17.8
2024-25,202411020PHO,11/2/2024,PHO vs POR,Royce O'Neale,onealro01,85,PHO,1,POR,3,7,3,1,1,1,22.93333333,1,6,1,6,1,5,0,0,1,2,10,6,10,13,20.9
2024-25,202411020WAS,11/2/2024,WAS vs MIA,Nikola Jovic,jovicni01,51,MIA,0,WAS,3,6,1,3,0,1,22.98333333,0,6,1,7,1,5,0,0,0,3,7,4,9,10,19.7
2024-25,202411020SAS,11/2/2024,SAS vs MIN,Rudy Gobert,goberru01,82,MIN,0,SAS,10,3,1,0,0,0,23.1,1,2,3,8,0,0,4,4,2,0,4,11,13,14,15.1
2024-25,202411020SAS,11/2/2024,SAS vs MIN,Nickeil Alexander-Walker,alexani01,88,MIN,0,SAS,6,3,6,0,1,2,23.9,1,2,3,7,0,4,0,1,1,1,9,12,9,15,19.6
2024-25,202411020PHO,11/2/2024,PHO vs POR,Jusuf Nurkic,nurkiju01,82,PHO,1,POR,3,15,0,0,0,2,24.01666667,2,13,1,6,1,3,0,0,3,0,15,3,18,18,19
2024-25,202411020HOU,11/2/2024,HOU vs GSW,Kyle Anderson,anderky01,85,GSW,0,HOU,9,3,2,1,1,1,24.15,0,3,4,10,1,4,0,0,0,2,5,11,12,14,20.6
2024-25,202411020LAC,11/2/2024,LAC vs OKC,Terance Mann,mannte01,81,LAC,1,OKC,11,6,2,1,0,1,24.55,2,4,2,6,1,2,6,6,2,1,8,13,17,19,23.2
2024-25,202411020LAC,11/2/2024,LAC vs OKC,Cason Wallace,wallaca01,88,OKC,0,LAC,7,4,1,0,1,0,24.63333333,0,4,3,4,1,2,0,0,2,1,5,8,11,12,16.3
2024-25,202411020WAS,11/2/2024,WAS vs MIA,Jaime Jaquez Jr.,jaqueja01,80,MIA,0,WAS,8,10,1,0,0,1,24.71666667,3,7,4,12,0,3,0,0,1,0,11,9,18,19,20.5
2024-25,202411020TOR,11/2/2024,TOR vs SAC,Chris Boucher,bouchch01,57,TOR,1,SAC,24,5,1,0,0,0,24.95,0,5,9,13,4,6,2,3,1,0,6,25,29,30,31.5
2024-25,202411020DEN,11/2/2024,DEN vs UTA,Hunter Tyson,tysonhu01,21,DEN,1,UTA,7,4,4,0,0,0,25.16666667,1,3,2,5,0,2,3,3,2,0,8,11,11,15,17.8
2024-25,202411020DEN,11/2/2024,DEN vs UTA,Collin Sexton,sextoco01,84,UTA,0,DEN,10,1,4,1,0,4,25.55,0,1,2,6,1,3,5,5,2,1,5,14,11,15,16.2
2024-25,202411020PHI,11/2/2024,PHI vs MEM,Jake LaRavia,laravja01,42,MEM,0,PHI,8,2,2,0,0,3,26.16666667,0,2,3,5,2,4,0,0,5,0,4,10,10,12,10.4
2024-25,202411020SAS,11/2/2024,SAS vs MIN,Naz Reid,reidna01,87,MIN,0,SAS,11,4,2,0,0,0,26.25,0,4,4,8,2,5,1,2,1,0,6,13,15,17,18.8
2024-25,202411020DEN,11/2/2024,DEN vs UTA,Aaron Gordon,gordoaa01,79,DEN,1,UTA,12,6,5,0,0,0,26.26666667,2,4,5,9,2,3,0,0,2,0,11,17,18,23,26.7
2024-25,202411020HOU,11/2/2024,HOU vs GSW,Jonathan Kuminga,kuminjo01,80,GSW,0,HOU,23,6,1,0,0,4,26.43333333,1,5,7,12,2,3,7,10,0,0,7,24,29,30,27.7
2024-25,202411020TOR,11/2/2024,TOR vs SAC,Keon Ellis,elliske01,62,SAC,0,TOR,8,1,0,2,2,0,26.51666667,1,0,3,6,1,4,1,1,2,4,1,8,9,9,21.2
2024-25,202411020WAS,11/2/2024,WAS vs MIA,Kyshawn George,georgky01,5,WAS,1,MIA,6,8,1,1,3,2,26.7,1,7,2,9,0,6,2,2,3,4,9,7,14,15,27.1
2024-25,202411020DEN,11/2/2024,DEN vs UTA,Johnny Juzang,juzanjo01,23,UTA,0,DEN,17,2,1,2,0,2,26.81666667,2,0,4,9,3,7,6,6,3,2,3,18,19,20,24.9
2024-25,202411020WAS,11/2/2024,WAS vs MIA,Alex Sarr,sarral01,5,WAS,1,MIA,17,6,3,0,4,1,27,1,5,7,11,1,4,2,2,2,4,9,20,23,26,39.7
2024-25,202411020CHO,11/2/2024,CHO vs BOS,Al Horford,horfoal01,71,BOS,0,CHO,0,6,5,1,0,1,27.13333333,2,4,0,4,0,3,0,0,3,1,11,5,6,11,16.7
2024-25,202411020PHI,11/2/2024,PHI vs MEM,Kelly Oubre Jr.,oubreke01,73,PHI,1,MEM,14,4,0,2,1,0,27.25,1,3,5,15,4,10,0,0,5,3,4,14,18,18,27.8
2024-25,202411020HOU,11/2/2024,HOU vs GSW,Dillon Brooks,brookdi01,78,HOU,1,GSW,7,5,2,1,0,2,27.3,1,4,3,9,1,4,0,0,6,1,7,9,12,14,17
2024-25,202411020PHI,11/2/2024,PHI vs MEM,Caleb Martin,martica02,69,PHI,1,MEM,9,3,3,1,1,2,27.7,1,2,1,7,0,3,7,10,1,2,6,12,12,15,21.1
2024-25,202411020SAS,11/2/2024,SAS vs MIN,Donte DiVincenzo,divindo01,87,MIN,0,SAS,14,2,2,0,0,1,27.86666667,1,1,5,7,3,5,1,1,2,0,4,16,16,18,18.4
2024-25,202411020MIL,11/2/2024,MIL vs CLE,Isaac Okoro,okorois01,76,CLE,0,MIL,13,8,1,1,0,0,28.1,2,6,4,5,3,4,2,2,5,1,9,14,21,22,27.1
2024-25,202411020LAC,11/2/2024,LAC vs OKC,Ivica Zubac,zubaciv01,74,LAC,1,OKC,9,12,0,1,1,1,28.4,3,9,4,10,0,0,1,5,2,2,12,9,21,21,28.4
2024-25,202411020SAS,11/2/2024,SAS vs MIN,Julian Champagnie,champju02,80,SAS,1,MIN,7,6,3,0,1,0,28.66666667,1,5,3,9,1,7,0,0,2,1,9,10,13,16,21.7
2024-25,202411020PHO,11/2/2024,PHO vs POR,Tyus Jones,jonesty01,72,PHO,1,POR,15,5,6,1,0,1,28.71666667,2,3,5,10,3,7,2,2,1,1,11,21,20,26,32
2024-25,202411020WAS,11/2/2024,WAS vs MIA,Alec Burks,burksal01,69,MIA,0,WAS,15,3,3,1,0,1,28.95,2,1,5,8,5,7,0,0,1,1,6,18,18,21,25.1
2024-25,202411020PHI,11/2/2024,PHI vs MEM,Scotty Pippen Jr.,pippesc02,28,MEM,0,PHI,12,4,13,1,0,2,29.03333333,0,4,4,9,1,2,3,3,3,1,17,25,16,29,37.3
2024-25,202411020CHO,11/2/2024,CHO vs BOS,Payton Pritchard,pritcpa01,89,BOS,0,CHO,22,3,2,0,0,1,29.1,1,2,8,15,6,12,0,0,3,0,5,24,25,27,27.6
2024-25,202411020PHI,11/2/2024,PHI vs MEM,Andre Drummond,drumman01,84,PHI,1,MEM,4,9,2,1,0,4,29.28333333,2,7,1,7,0,1,2,2,3,1,11,6,13,15,16.8
2024-25,202411020SAS,11/2/2024,SAS vs MIN,Keldon Johnson,johnske04,75,SAS,1,MIN,25,8,0,2,0,0,29.3,2,6,10,17,3,8,2,2,1,2,8,25,33,33,40.6
2024-25,202411020DEN,11/2/2024,DEN vs UTA,Michael Porter Jr.,portemi01,87,DEN,1,UTA,20,5,2,0,0,0,29.31666667,0,5,7,12,4,6,2,2,1,0,7,22,25,27,29
2024-25,202411020LAC,11/2/2024,LAC vs OKC,Chet Holmgren,holmgch01,88,OKC,0,LAC,10,14,4,1,1,3,29.35,1,13,3,9,1,4,3,4,0,2,18,14,24,28,35.8
2024-25,202411020DEN,11/2/2024,DEN vs UTA,Walker Kessler,kesslwa01,70,UTA,0,DEN,18,14,0,0,5,2,29.35,4,10,5,6,0,0,8,12,4,5,14,18,32,32,47.8
2024-25,202411020CHO,11/2/2024,CHO vs BOS,Luke Kornet,kornelu01,70,BOS,0,CHO,19,4,3,1,2,2,29.6,1,3,6,6,0,0,7,7,2,3,7,22,23,26,35.3
2024-25,202411020DEN,11/2/2024,DEN vs UTA,Nikola Jokic,jokicni01,85,DEN,1,UTA,27,16,9,1,0,5,29.7,5,11,10,18,3,4,4,4,1,1,25,36,43,52,57.7
2024-25,202411020LAC,11/2/2024,LAC vs OKC,Luguentz Dort,dortlu01,85,OKC,0,LAC,16,4,3,0,0,0,29.73333333,1,3,6,12,1,4,3,4,4,0,7,19,20,23,25.3
2024-25,202411020SAS,11/2/2024,SAS vs MIN,Julius Randle,randlju01,52,MIN,0,SAS,21,5,2,1,0,3,29.83333333,1,4,8,15,0,3,5,6,3,1,7,23,26,28,30
2024-25,202411020SAS,11/2/2024,SAS vs MIN,Jaden McDaniels,mcdanja02,78,MIN,0,SAS,7,3,1,1,1,0,29.91666667,1,2,3,9,1,6,0,0,3,2,4,8,10,11,18.1
2024-25,202411020LAC,11/2/2024,LAC vs OKC,Aaron Wiggins,wiggiaa01,84,OKC,0,LAC,12,5,2,3,0,0,30.36666667,0,5,5,12,2,4,0,0,1,3,7,14,17,19,30
2024-25,202411020PHO,11/2/2024,PHO vs POR,Deandre Ayton,aytonde01,62,POR,0,PHO,10,13,2,0,0,0,30.43333333,1,12,3,13,1,2,3,3,2,0,15,12,23,25,28.6
2024-25,202411020WAS,11/2/2024,WAS vs MIA,Corey Kispert,kispeco01,85,WAS,1,MIA,4,3,1,1,0,1,30.65,0,3,1,10,0,6,2,2,0,1,4,5,7,8,11.1
2024-25,202411020WAS,11/2/2024,WAS vs MIA,Jimmy Butler,butleji01,65,MIA,0,WAS,18,8,4,0,0,4,30.68333333,6,2,6,13,0,0,6,8,2,0,12,22,26,30,29.6
2024-25,202411020WAS,11/2/2024,WAS vs MIA,Jordan Poole,poolejo01,83,WAS,1,MIA,21,0,3,2,2,4,30.85,0,0,8,18,2,8,3,4,4,4,3,24,21,24,33.5
2024-25,202411020WAS,11/2/2024,WAS vs MIA,Bam Adebayo,adebaba01,76,MIA,0,WAS,32,14,2,1,1,1,30.96666667,5,9,12,24,3,5,5,6,3,2,16,34,46,48,56.8
2024-25,202411020SAS,11/2/2024,SAS vs MIN,Victor Wembanyama,wembavi01,77,SAS,1,MIN,17,6,3,1,2,3,30.98333333,1,5,7,15,1,7,2,2,4,3,9,20,23,26,34.7
2024-25,202411020PHI,11/2/2024,PHI vs MEM,Jaren Jackson Jr.,jacksja02,71,MEM,0,PHI,27,6,0,3,2,0,31,2,4,11,16,2,3,3,4,3,5,6,27,33,33,49.2
2024-25,202411020CHO,11/2/2024,CHO vs BOS,Miles Bridges,bridgmi02,75,CHO,1,BOS,6,8,5,2,0,3,31.3,0,8,2,6,1,2,1,2,1,2,13,11,14,19,26.1
2024-25,202411020LAC,11/2/2024,LAC vs OKC,Shai Gilgeous-Alexander,gilgesh01,81,OKC,0,LAC,25,3,9,0,1,3,31.33333333,0,3,7,14,2,4,9,9,2,1,12,34,28,37,42.1
2024-25,202411020WAS,11/2/2024,WAS vs MIA,Terry Rozier,roziete01,66,MIA,0,WAS,12,3,4,0,0,0,31.33333333,1,2,4,13,3,7,1,2,0,0,7,16,15,19,21.6
2024-25,202411020HOU,11/2/2024,HOU vs GSW,Andrew Wiggins,wiggian01,75,GSW,0,HOU,15,3,2,1,0,2,31.33333333,1,2,3,9,2,4,7,10,0,1,5,17,18,20,22.6
2024-25,202411020CHO,11/2/2024,CHO vs BOS,Brandon Miller,millebr02,76,CHO,1,BOS,16,4,6,2,1,0,31.35,0,4,6,18,3,9,1,2,4,3,10,22,20,26,38.8
2024-25,202411020PHI,11/2/2024,PHI vs MEM,Ja Morant,moranja01,15,MEM,0,PHI,18,6,12,2,0,6,31.4,0,6,6,13,0,2,6,8,1,2,18,30,24,36,43.2
2024-25,202411020DEN,11/2/2024,DEN vs UTA,Russell Westbrook,westbru01,74,DEN,1,UTA,5,3,7,5,0,4,31.4,1,2,2,11,1,4,0,4,4,5,10,12,8,15,30.1
2024-25,202411020MIL,11/2/2024,MIL vs CLE,Evan Mobley,mobleev01,57,CLE,0,MIL,14,7,5,0,0,1,31.58333333,1,6,7,13,0,1,0,0,4,0,12,19,21,26,28.9
2024-25,202411020MIL,11/2/2024,MIL vs CLE,Taurean Prince,princta02,85,MIL,1,CLE,16,6,0,1,0,0,31.66666667,1,5,6,7,4,5,0,0,1,1,6,16,22,22,26.2
2024-25,202411020LAC,11/2/2024,LAC vs OKC,Norman Powell,powelno01,82,LAC,1,OKC,24,2,2,2,0,4,31.88333333,0,2,9,14,3,6,3,3,1,2,4,26,26,28,31.4
2024-25,202411020HOU,11/2/2024,HOU vs GSW,Buddy Hield,hieldbu01,91,GSW,0,HOU,27,7,2,1,1,3,32.03333333,1,6,9,14,6,10,3,4,2,2,9,29,34,36,41.4
2024-25,202411020DEN,11/2/2024,DEN vs UTA,Keyonte George,georgke01,81,UTA,0,DEN,16,2,8,0,0,2,32.16666667,0,2,6,14,4,11,0,0,1,0,10,24,18,26,28.4
2024-25,202411020PHO,11/2/2024,PHO vs POR,Deni Avdija,avdijde01,82,POR,0,PHO,13,6,2,2,2,1,32.31666667,2,4,4,12,2,5,3,3,2,4,8,15,19,21,34.2
2024-25,202411020MIL,11/2/2024,MIL vs CLE,Jarrett Allen,allenja01,84,CLE,0,MIL,15,12,1,1,0,2,32.41666667,2,10,6,10,0,0,3,6,2,1,13,16,27,28,31.9
2024-25,202411020LAC,11/2/2024,LAC vs OKC,James Harden,hardeja01,78,LAC,1,OKC,12,13,7,3,3,2,32.43333333,0,13,4,13,2,9,2,2,2,6,20,19,25,32,54.1
2024-25,202411020SAS,11/2/2024,SAS vs MIN,Chris Paul,paulch01,64,SAS,1,MIN,15,4,13,0,0,1,32.5,1,3,5,9,3,6,2,2,1,0,17,28,19,32,38.3
2024-25,202411020DEN,11/2/2024,DEN vs UTA,Christian Braun,braunch01,88,DEN,1,UTA,17,2,3,2,0,1,32.81666667,0,2,6,11,3,5,2,2,3,2,5,20,19,22,28.9
2024-25,202411020SAS,11/2/2024,SAS vs MIN,Jeremy Sochan,sochaje01,80,SAS,1,MIN,19,10,4,1,1,3,32.96666667,1,9,7,10,1,2,4,5,4,2,14,23,29,33,40
2024-25,202411020WAS,11/2/2024,WAS vs MIA,Bilal Coulibaly,coulibi01,68,WAS,1,MIA,22,8,2,0,0,0,33.46666667,3,5,8,12,2,2,4,6,4,0,10,24,30,32,34.6
2024-25,202411020CHO,11/2/2024,CHO vs BOS,Grant Williams,willigr01,82,CHO,1,BOS,5,3,2,0,0,0,33.55,0,3,2,6,1,4,0,0,5,0,5,7,8,10,11.6
2024-25,202411020MIL,11/2/2024,MIL vs CLE,Darius Garland,garlada01,64,CLE,0,MIL,11,3,10,0,0,0,33.56666667,2,1,5,13,1,5,0,0,2,0,13,21,14,24,29.6
2024-25,202411020HOU,11/2/2024,HOU vs GSW,Jalen Green,greenja05,88,HOU,1,GSW,7,1,3,1,1,1,33.68333333,0,1,2,13,1,5,2,2,4,2,4,10,8,11,17.7
2024-25,202411020HOU,11/2/2024,HOU vs GSW,Amen Thompson,thompam01,68,HOU,1,GSW,18,11,4,1,0,0,33.7,3,8,8,15,0,2,2,4,2,1,15,22,29,33,40.2
2024-25,202411020CHO,11/2/2024,CHO vs BOS,Derrick White,whitede01,80,BOS,0,CHO,18,8,2,1,2,3,33.71666667,1,7,5,17,4,13,4,4,2,3,10,20,26,28,36.6
2024-25,202411020CHO,11/2/2024,CHO vs BOS,Jayson Tatum,tatumja01,81,BOS,0,CHO,29,7,3,0,0,5,33.73333333,0,7,7,15,1,9,14,17,3,0,10,32,36,39,36.9
2024-25,202411020TOR,11/2/2024,TOR vs SAC,Jakob Poeltl,poeltja01,57,TOR,1,SAC,13,9,2,2,1,4,33.81666667,3,6,5,8,0,0,3,4,6,3,11,15,22,24,31.8
2024-25,202411020PHO,11/2/2024,PHO vs POR,Bradley Beal,bealbr01,57,PHO,1,POR,15,7,4,1,1,0,33.95,1,6,5,13,3,8,2,4,1,2,11,19,22,26,35.4
2024-25,202411020MIL,11/2/2024,MIL vs CLE,Gary Trent Jr.,trentga02,77,MIL,1,CLE,3,1,1,1,0,3,34.01666667,0,1,1,10,1,7,0,0,3,1,2,4,4,5,5.7
2024-25,202411020LAC,11/2/2024,LAC vs OKC,Jalen Williams,willija06,77,OKC,0,LAC,15,7,4,2,0,4,34.03333333,0,7,5,16,3,5,2,2,4,2,11,19,22,26,31.4
2024-25,202411020PHO,11/2/2024,PHO vs POR,Toumani Camara,camarto01,77,POR,0,PHO,7,10,1,2,0,0,34.4,5,5,3,9,1,3,0,0,2,2,11,8,17,18,26.5
2024-25,202411020MIL,11/2/2024,MIL vs CLE,Brook Lopez,lopezbr01,85,MIL,1,CLE,6,6,2,0,2,3,34.53333333,2,4,2,7,2,7,0,0,2,2,8,8,12,14,19.2
2024-25,202411020MIL,11/2/2024,MIL vs CLE,Donovan Mitchell,mitchdo01,62,CLE,0,MIL,30,3,4,0,0,1,34.55,2,1,11,25,4,8,4,4,1,0,7,34,33,37,38.6
2024-25,202411020PHI,11/2/2024,PHI vs MEM,Santi Aldama,aldamsa01,68,MEM,0,PHI,10,13,4,1,1,1,34.81666667,1,12,5,12,0,5,0,0,1,2,17,14,23,27,36.6
2024-25,202411020CHO,11/2/2024,CHO vs BOS,Jrue Holiday,holidjr01,76,BOS,0,CHO,13,5,6,0,0,3,35.31666667,0,5,5,12,3,7,0,0,0,0,11,19,18,24,25
2024-25,202411020HOU,11/2/2024,HOU vs GSW,Tari Eason,easonta01,28,HOU,1,GSW,27,9,1,4,3,3,35.33333333,6,3,11,19,3,5,2,4,5,7,10,28,36,37,57.3
2024-25,202411020HOU,11/2/2024,HOU vs GSW,Draymond Green,greendr01,61,GSW,0,HOU,14,11,3,0,0,1,35.48333333,4,7,4,8,1,3,5,9,6,0,14,17,25,28,30.7
2024-25,202411020SAS,11/2/2024,SAS vs MIN,Anthony Edwards,edwaran01,85,MIN,0,SAS,21,5,2,2,0,3,35.55,0,5,8,17,3,7,2,4,0,2,7,23,26,28,33
2024-25,202411020TOR,11/2/2024,TOR vs SAC,Ochai Agbaji,agbajoc01,85,TOR,1,SAC,22,5,2,2,1,1,35.6,0,5,9,12,4,5,0,0,3,3,7,24,27,29,39
2024-25,202411020PHO,11/2/2024,PHO vs POR,Devin Booker,bookede01,74,PHO,1,POR,28,9,9,0,0,1,36.03333333,3,6,9,23,2,10,8,9,1,0,18,37,37,46,51.3
2024-25,202411020PHI,11/2/2024,PHI vs MEM,Jaylen Wells,wellsja01,7,MEM,0,PHI,15,5,2,0,0,1,36.23333333,2,3,6,11,2,4,1,1,3,0,7,17,20,22,23
2024-25,202411020WAS,11/2/2024,WAS vs MIA,Carlton Carrington,carrica01,5,WAS,1,MIA,4,4,8,4,0,0,37,0,4,2,9,0,5,0,0,3,4,12,12,8,16,32.8
2024-25,202411020TOR,11/2/2024,TOR vs SAC,Davion Mitchell,mitchda01,79,TOR,1,SAC,4,4,7,5,0,5,37.08333333,0,4,2,6,0,2,0,0,4,5,11,11,8,15,29.3
2024-25,202411020CHO,11/2/2024,CHO vs BOS,LaMelo Ball,ballla01,28,CHO,1,BOS,36,4,6,3,0,6,37.13333333,2,2,15,26,6,12,0,0,6,3,10,42,40,46,52.8
2024-25,202411020HOU,11/2/2024,HOU vs GSW,Jabari Smith Jr.,smithja05,82,HOU,1,GSW,21,7,0,1,0,0,37.31666667,2,5,7,18,5,13,2,2,2,1,7,21,28,28,32.4
2024-25,202411020PHI,11/2/2024,PHI vs MEM,Tyrese Maxey,maxeyty01,75,PHI,1,MEM,23,2,6,3,0,3,37.46666667,0,2,8,19,4,9,3,3,2,3,8,29,25,31,40.4
2024-25,202411020TOR,11/2/2024,TOR vs SAC,Gradey Dick,dickgr01,67,TOR,1,SAC,22,5,2,2,0,3,37.53333333,0,5,6,17,3,8,7,7,0,2,7,24,27,29,34
2024-25,202411020HOU,11/2/2024,HOU vs GSW,Brandin Podziemski,podzibr01,80,GSW,0,HOU,12,5,6,0,1,3,37.73333333,0,5,5,11,0,3,2,4,6,1,11,18,17,23,27
2024-25,202411020PHO,11/2/2024,PHO vs POR,Kevin Durant,duranke01,81,PHO,1,POR,21,9,2,0,0,3,37.86666667,1,8,7,16,3,8,4,5,1,0,11,23,30,32,31.8
2024-25,202411020SAS,11/2/2024,SAS vs MIN,Harrison Barnes,barneha02,88,SAS,1,MIN,14,3,3,1,0,0,37.93333333,1,2,6,10,2,5,0,0,0,1,6,17,17,20,25.1
2024-25,202411020TOR,11/2/2024,TOR vs SAC,Malik Monk,monkma01,78,SAC,0,TOR,21,4,4,2,0,1,38.36666667,0,4,9,16,3,7,0,0,3,2,8,25,25,29,36.8
2024-25,202411020MIL,11/2/2024,MIL vs CLE,Damian Lillard,lillada01,79,MIL,1,CLE,41,4,9,0,1,1,38.56666667,0,4,13,24,10,15,5,8,4,1,13,50,45,54,61.3
2024-25,202411020TOR,11/2/2024,TOR vs SAC,Keegan Murray,murrake02,83,SAC,0,TOR,16,10,2,1,1,1,38.6,3,7,6,12,2,6,2,4,6,2,12,18,26,28,36
2024-25,202411020MIL,11/2/2024,MIL vs CLE,Giannis Antetokounmpo,antetgi01,79,MIL,1,CLE,34,16,9,1,0,0,38.86666667,6,10,15,27,0,0,4,7,5,1,25,43,50,59,69.7
2024-25,202411020PHO,11/2/2024,PHO vs POR,Jerami Grant,grantje01,61,POR,0,PHO,20,7,2,1,1,1,39.1,0,7,8,23,2,9,2,2,2,2,9,22,27,29,36.4
2024-25,202411020TOR,11/2/2024,TOR vs SAC,RJ Barrett,barrerj01,62,TOR,1,SAC,31,9,6,1,0,2,39.9,2,7,10,26,3,9,8,11,1,1,15,37,40,46,51.8
2024-25,202411020HOU,11/2/2024,HOU vs GSW,Fred VanVleet,vanvlfr01,79,HOU,1,GSW,11,3,5,1,1,0,40.11666667,1,2,2,12,1,8,6,6,6,2,8,16,14,19,28.1
2024-25,202411020PHO,11/2/2024,PHO vs POR,Anfernee Simons,simonan01,53,POR,0,PHO,20,8,6,2,0,1,40.55,2,6,8,25,4,13,0,1,2,2,14,26,28,34,43.6
2024-25,202411020TOR,11/2/2024,TOR vs SAC,Domantas Sabonis,sabondo01,88,SAC,0,TOR,17,20,10,1,0,3,42.8,7,13,5,10,0,1,7,8,5,1,30,27,37,47,56
2024-25,202411020TOR,11/2/2024,TOR vs SAC,DeMar DeRozan,derozde01,85,SAC,0,TOR,33,3,4,3,0,6,42.88333333,0,3,12,27,2,7,7,7,1,3,7,37,36,40,45.6
2024-25,202411020TOR,11/2/2024,TOR vs SAC,De'Aaron Fox,foxde01,80,SAC,0,TOR,24,6,1,5,0,5,43.23333333,3,3,8,22,0,11,8,10,2,5,7,25,30,31,42.7
2024-25,202411010NOP,11/1/2024,NOP vs IND,Aaron Nesmith,nesmiaa01,79,IND,0,NOP,12,1,1,0,0,1,10.06666667,0,1,5,5,2,2,0,0,0,0,2,13,13,14,13.7
2024-25,202411010POR,11/1/2024,POR vs OKC,Jabari Walker,walkeja01,78,POR,1,OKC,2,3,3,1,0,1,10.85,2,1,1,4,0,1,0,1,0,1,6,5,5,8,12.1
2024-25,202411010POR,11/1/2024,POR vs OKC,Dillon Jones,jonesdi01,5,OKC,0,POR,7,4,2,0,0,0,11.81666667,2,2,3,5,1,3,0,0,4,0,6,9,11,13,14.8
2024-25,202411010DET,11/1/2024,DET vs NYK,Cameron Payne,payneca01,83,NYK,0,DET,4,1,3,0,0,0,12.23333333,0,1,2,6,0,2,0,0,2,0,4,7,5,8,9.7
2024-25,202411010POR,11/1/2024,POR vs OKC,Donovan Clingan,clingdo01,6,POR,1,OKC,3,7,0,0,1,0,12.53333333,3,4,1,3,0,0,1,2,3,1,7,3,10,10,14.4
2024-25,202411010NOP,11/1/2024,NOP vs IND,Daniel Theis,theisda01,66,NOP,1,IND,3,5,1,0,0,0,13.23333333,2,3,1,3,1,1,0,0,0,0,6,4,8,9,10.5
2024-25,202411010TOR,11/1/2024,TOR vs LAL,Max Christie,chrisma02,74,LAL,0,TOR,7,5,1,0,0,2,13.25,2,3,1,1,0,0,5,5,0,0,6,8,12,13,12.5
2024-25,202411010NOP,11/1/2024,NOP vs IND,Jarace Walker,walkeja02,40,IND,0,NOP,5,2,1,1,0,0,13.5,1,1,2,6,1,3,0,0,1,1,3,6,7,8,11.9
2024-25,202411010MIN,11/1/2024,MIN vs DEN,Peyton Watson,watsope01,85,DEN,0,MIN,2,1,0,1,0,0,13.53333333,1,0,1,6,0,2,0,0,1,1,1,2,3,3,6.2
2024-25,202411010BRK,11/1/2024,BRK vs CHI,Jalen Smith,smithja04,66,CHI,0,BRK,5,5,0,0,1,1,13.58333333,1,4,2,4,1,3,0,0,1,1,5,5,10,10,13
2024-25,202411010BRK,11/1/2024,BRK vs CHI,Dalen Terry,terryda01,65,CHI,0,BRK,5,2,1,0,1,0,13.65,0,2,2,3,0,0,1,2,1,1,3,6,7,8,11.9
2024-25,202411010BRK,11/1/2024,BRK vs CHI,Julian Phillips,phillju01,46,CHI,0,BRK,2,2,1,0,0,0,13.91666667,1,1,0,2,0,2,2,2,2,0,3,3,4,5,5.9
2024-25,202411010TOR,11/1/2024,TOR vs LAL,Chris Boucher,bouchch01,56,TOR,1,LAL,9,2,1,0,0,0,13.93333333,0,2,3,6,0,3,3,4,3,0,3,10,11,12,12.9
2024-25,202411010TOR,11/1/2024,TOR vs LAL,Jamal Shead,sheadja01,6,TOR,1,LAL,4,1,1,0,0,1,14.8,0,1,2,7,0,3,0,0,2,0,2,5,5,6,5.7
2024-25,202411010TOR,11/1/2024,TOR vs LAL,Jaxson Hayes,hayesja02,77,LAL,0,TOR,4,6,0,0,2,0,15.03333333,3,3,1,1,0,0,2,2,3,2,6,4,10,10,17.2
2024-25,202411010BRK,11/1/2024,BRK vs CHI,Noah Clowney,clownno01,29,BRK,1,CHI,7,4,1,0,2,0,15.11666667,2,2,2,4,0,2,3,4,0,2,5,8,11,12,19.3
2024-25,202411010CHO,11/1/2024,CHO vs BOS,Nick Richards,richani01,72,CHO,1,BOS,1,3,1,0,2,1,15.55,1,2,0,1,0,0,1,2,1,2,4,2,4,5,11.1
2024-25,202411010NOP,11/1/2024,NOP vs IND,Isaiah Jackson,jacksis01,65,IND,0,NOP,6,8,1,0,1,0,15.58333333,0,8,3,3,0,0,0,2,1,1,9,7,14,15,20.1
2024-25,202411010CHO,11/1/2024,CHO vs BOS,Moussa Diabate,diabamo01,16,CHO,1,BOS,7,7,1,0,0,1,15.78333333,6,1,3,4,0,0,1,2,2,0,8,8,14,15,15.9
2024-25,202411010MIN,11/1/2024,MIN vs DEN,Julian Strawther,strawju01,55,DEN,0,MIN,4,1,1,1,0,1,16.05,1,0,1,4,0,2,2,3,5,1,2,5,5,6,8.7
2024-25,202411010CLE,11/1/2024,CLE vs ORL,Georges Niang,niangge01,88,CLE,1,ORL,7,3,2,0,0,1,16.11666667,0,3,3,5,1,2,0,0,2,0,5,9,10,12,12.6
2024-25,202411010DET,11/1/2024,DET vs NYK,Jericho Sims,simsje01,50,NYK,0,DET,0,6,0,0,1,2,16.36666667,3,3,0,1,0,0,0,0,3,1,6,0,6,6,8.2
2024-25,202411010DET,11/1/2024,DET vs NYK,Isaiah Stewart,stewais01,52,DET,1,NYK,2,2,2,1,2,0,16.46666667,1,1,1,3,0,2,0,0,2,3,4,4,4,6,16.4
2024-25,202411010CLE,11/1/2024,CLE vs ORL,Jonathan Isaac,isaacjo01,61,ORL,0,CLE,5,4,0,2,1,1,16.58333333,2,2,2,6,1,4,0,0,1,3,4,5,9,9,17.8
2024-25,202411010POR,11/1/2024,POR vs OKC,Ajay Mitchell,mitchaj01,5,OKC,0,POR,8,2,2,0,0,1,17.21666667,2,0,3,6,2,3,0,0,4,0,4,10,10,12,12.4
2024-25,202411010POR,11/1/2024,POR vs OKC,Alex Caruso,carusal01,76,OKC,0,POR,6,3,2,0,0,0,17.38333333,1,2,3,5,0,2,0,0,4,0,5,8,9,11,12.6
2024-25,202411010CLE,11/1/2024,CLE vs ORL,Jett Howard,howarje01,24,ORL,0,CLE,9,3,0,0,1,0,17.45,0,3,3,7,3,6,0,0,0,1,3,9,12,12,15.6
2024-25,202411010CHO,11/1/2024,CHO vs BOS,Sam Hauser,hausesa01,82,BOS,0,CHO,6,5,2,0,0,1,17.51666667,1,4,2,3,2,3,0,0,0,0,7,8,11,13,14
2024-25,202411010DET,11/1/2024,DET vs NYK,Jalen Duren,durenja01,67,DET,1,NYK,5,7,2,0,1,3,18.31666667,1,6,2,2,0,0,1,2,1,1,9,7,12,14,16.4
2024-25,202411010POR,11/1/2024,POR vs OKC,Chet Holmgren,holmgch01,87,OKC,0,POR,6,1,3,1,5,2,18.38333333,0,1,1,3,0,2,4,4,4,6,4,9,7,10,27.7
2024-25,202411010CHO,11/1/2024,CHO vs BOS,Seth Curry,curryse01,49,CHO,1,BOS,8,2,0,1,0,0,18.6,0,2,3,3,2,2,0,0,5,1,2,8,10,10,13.4
2024-25,202411010NOP,11/1/2024,NOP vs IND,Obi Toppin,toppiob01,89,IND,0,NOP,7,5,0,0,0,2,18.78333333,1,4,3,6,1,3,0,0,2,0,5,7,12,12,11
2024-25,202411010NOP,11/1/2024,NOP vs IND,Javonte Green,greenja02,15,NOP,1,IND,7,4,0,1,1,0,18.81666667,0,4,3,4,1,1,0,0,0,2,4,7,11,11,17.8
2024-25,202411010DET,11/1/2024,DET vs NYK,Jaden Ivey,iveyja01,83,DET,1,NYK,10,5,2,0,0,4,18.88333333,2,3,4,9,2,4,0,0,2,0,7,12,15,17,15
2024-25,202411010CHO,11/1/2024,CHO vs BOS,Tidjane Salaun,salauti01,3,CHO,1,BOS,9,6,1,0,0,0,19.01666667,1,5,3,5,3,5,0,0,0,0,7,10,15,16,17.7
2024-25,202411010TOR,11/1/2024,TOR vs LAL,Dalton Knecht,knechda01,6,LAL,0,TOR,5,3,1,0,0,1,19.11666667,1,2,2,5,1,3,0,0,2,0,4,6,8,9,9.1
2024-25,202411010ATL,11/1/2024,ATL vs SAC,Onyeka Okongwu,okongon01,60,ATL,1,SAC,11,4,1,1,1,0,19.2,1,3,4,5,0,1,3,4,2,2,5,12,15,16,23.3
2024-25,202411010ATL,11/1/2024,ATL vs SAC,Trey Lyles,lylestr01,63,SAC,0,ATL,5,5,2,1,1,1,19.23333333,1,4,1,7,1,6,2,2,2,2,7,7,10,12,19
2024-25,202411010POR,11/1/2024,POR vs OKC,Ousmane Dieng,diengou01,38,OKC,0,POR,11,3,2,0,1,0,19.31666667,1,2,4,10,1,5,2,2,2,1,5,13,14,16,20.6
2024-25,202411010CLE,11/1/2024,CLE vs ORL,Isaac Okoro,okorois01,75,CLE,1,ORL,9,1,0,1,0,0,19.35,1,0,3,7,2,4,1,2,0,1,1,9,10,10,13.2
2024-25,202411010ATL,11/1/2024,ATL vs SAC,Keon Ellis,elliske01,61,SAC,0,ATL,12,1,2,0,1,0,19.4,1,0,4,5,2,3,2,2,1,1,3,14,13,15,19.2
2024-25,202411010BRK,11/1/2024,BRK vs CHI,Ziaire Williams,willizi02,57,BRK,1,CHI,10,3,0,1,0,0,19.51666667,1,2,5,9,0,2,0,0,3,1,3,10,13,13,16.6
2024-25,202411010ATL,11/1/2024,ATL vs SAC,Zaccharie Risacher,risacza01,6,ATL,1,SAC,3,1,0,0,0,1,19.88333333,0,1,1,9,1,6,0,0,3,0,1,3,4,4,3.2
2024-25,202411010DET,11/1/2024,DET vs NYK,Marcus Sasser,sassema01,74,DET,1,NYK,2,0,1,1,0,1,19.91666667,0,0,1,2,0,1,0,0,1,1,1,3,2,3,5.5
2024-25,202411010DET,11/1/2024,DET vs NYK,Simone Fontecchio,fontesi01,72,DET,1,NYK,12,4,0,0,0,2,19.93333333,0,4,5,7,2,4,0,1,0,0,4,12,16,16,14.8
2024-25,202411010CLE,11/1/2024,CLE vs ORL,Sam Merrill,merrisa01,67,CLE,1,ORL,6,2,1,0,0,0,20.06666667,0,2,2,3,2,3,0,0,3,0,3,7,8,9,9.9
2024-25,202411010CLE,11/1/2024,CLE vs ORL,Tristan Da Silva,dasiltr01,2,ORL,0,CLE,17,5,2,0,0,0,20.13333333,2,3,6,8,3,3,2,3,3,0,7,19,22,24,26
2024-25,202411010CLE,11/1/2024,CLE vs ORL,Gary Harris,harriga01,60,ORL,0,CLE,0,1,0,1,0,1,20.31666667,0,1,0,4,0,2,0,0,1,1,1,0,1,1,3.2
2024-25,202411010TOR,11/1/2024,TOR vs LAL,Gabe Vincent,vincega01,17,LAL,0,TOR,2,3,2,0,0,0,20.53333333,1,2,1,6,0,4,0,0,4,0,5,4,5,7,8.6
2024-25,202411010TOR,11/1/2024,TOR vs LAL,Jonathan Mogbo,mogbojo01,6,TOR,1,LAL,6,6,3,2,0,0,20.95,4,2,2,6,0,1,2,3,5,2,9,9,12,15,23.7
2024-25,202411010CLE,11/1/2024,CLE vs ORL,Ty Jerome,jeromty01,8,CLE,1,ORL,9,6,2,2,0,0,21,0,6,3,9,1,3,2,2,0,2,8,11,15,17,25.2
2024-25,202411010NOP,11/1/2024,NOP vs IND,T.J. McConnell,mccontj01,78,IND,0,NOP,10,3,9,1,0,2,21.81666667,0,3,5,9,0,1,0,0,1,1,12,19,13,22,28.1
2024-25,202411010TOR,11/1/2024,TOR vs LAL,Ja'Kobe Walter,walteja01,1,TOR,1,LAL,5,6,1,0,1,0,21.86666667,2,4,1,8,0,3,3,3,3,1,7,6,11,12,16.7
2024-25,202411010CLE,11/1/2024,CLE vs ORL,Donovan Mitchell,mitchdo01,61,CLE,1,ORL,22,3,1,0,0,1,22.06666667,0,3,9,15,2,5,2,2,5,0,4,23,25,26,26.1
2024-25,202411010MIN,11/1/2024,MIN vs DEN,Jamal Murray,murraja01,64,DEN,0,MIN,6,2,3,1,0,0,22.26666667,0,2,2,7,0,3,2,2,0,1,5,9,8,11,15.9
2024-25,202411010POR,11/1/2024,POR vs OKC,Kris Murray,murrakr01,68,POR,1,OKC,9,3,0,1,0,1,22.28333333,1,2,3,7,1,3,2,5,3,1,3,9,12,12,14.6
2024-25,202411010BRK,11/1/2024,BRK vs CHI,Jalen Wilson,wilsoja03,49,BRK,1,CHI,7,1,3,1,0,2,22.28333333,0,1,3,8,1,5,0,0,1,1,4,10,8,11,13.7
2024-25,202411010CLE,11/1/2024,CLE vs ORL,Caris LeVert,leverca01,74,CLE,1,ORL,13,3,7,0,0,2,22.33333333,0,3,5,12,2,7,1,2,2,0,10,20,16,23,25.1
2024-25,202411010DET,11/1/2024,DET vs NYK,Ron Holland,hollaro01,6,DET,1,NYK,9,2,1,1,0,3,22.45,0,2,4,6,0,2,1,1,1,1,3,10,11,12,12.9
2024-25,202411010CHO,11/1/2024,CHO vs BOS,Josh Green,greenjo02,60,CHO,1,BOS,3,1,1,0,0,1,22.75,0,1,1,4,1,3,0,2,4,0,2,4,4,5,4.7
2024-25,202411010POR,11/1/2024,POR vs OKC,Cason Wallace,wallaca01,87,OKC,0,POR,13,1,3,1,1,1,22.75,0,1,5,7,3,5,0,0,0,2,4,16,14,17,23.7
2024-25,202411010NOP,11/1/2024,NOP vs IND,Brandon Boston Jr.,bostobr01,35,NOP,1,IND,14,2,2,2,0,0,22.8,0,2,6,9,2,4,0,0,2,2,4,16,16,18,25.4
2024-25,202411010POR,11/1/2024,POR vs OKC,Rayan Rupert,ruperra01,44,POR,1,OKC,14,2,0,1,1,0,22.86666667,0,2,5,9,4,7,0,0,2,2,2,14,16,16,22.4
2024-25,202411010POR,11/1/2024,POR vs OKC,Aaron Wiggins,wiggiaa01,83,OKC,0,POR,13,8,2,1,0,1,22.95,4,4,5,10,3,5,0,0,1,1,10,15,21,23,27.6
2024-25,202411010POR,11/1/2024,POR vs OKC,Deni Avdija,avdijde01,81,POR,1,OKC,11,3,4,1,0,6,23,1,2,5,10,1,3,0,1,2,1,7,15,14,18,17.6
2024-25,202411010MIN,11/1/2024,MIN vs DEN,Naz Reid,reidna01,86,MIN,1,DEN,16,3,2,0,3,1,23.48333333,1,2,7,10,1,3,1,1,4,3,5,18,19,21,30.6
2024-25,202411010CHO,11/1/2024,CHO vs BOS,Luke Kornet,kornelu01,69,BOS,0,CHO,5,4,1,1,2,0,23.51666667,2,2,2,2,0,0,1,2,1,3,5,6,9,10,20.3
2024-25,202411010MIN,11/1/2024,MIN vs DEN,Nickeil Alexander-Walker,alexani01,87,MIN,1,DEN,8,2,5,3,1,0,23.63333333,0,2,2,6,2,4,2,2,1,4,7,13,10,15,29.9
2024-25,202411010ATL,11/1/2024,ATL vs SAC,Kevin Huerter,huertke01,69,SAC,0,ATL,10,2,4,1,0,1,24.33333333,1,1,4,13,2,8,0,0,3,1,6,14,12,16,20.4
2024-25,202411010POR,11/1/2024,POR vs OKC,Toumani Camara,camarto01,76,POR,1,OKC,13,3,2,2,0,2,24.35,0,3,4,7,3,5,2,2,2,2,5,15,16,18,23.6
2024-25,202411010CLE,11/1/2024,CLE vs ORL,Dean Wade,wadede01,60,CLE,1,ORL,5,3,2,0,0,0,24.36666667,1,2,1,3,1,2,2,3,1,0,5,7,8,10,11.6
2024-25,202411010BRK,11/1/2024,BRK vs CHI,Nic Claxton,claxtni01,76,BRK,1,CHI,12,9,2,1,0,1,24.46666667,4,5,6,8,0,0,0,0,4,1,11,14,21,23,27.8
2024-25,202411010CHO,11/1/2024,CHO vs BOS,Neemias Queta,quetane01,33,BOS,0,CHO,12,6,1,0,0,2,24.48333333,4,2,6,6,0,0,0,0,2,0,7,13,18,19,18.7
2024-25,202411010DET,11/1/2024,DET vs NYK,Tim Hardaway Jr.,hardati02,85,DET,1,NYK,8,1,3,0,0,1,24.56666667,1,0,3,9,2,7,0,0,1,0,4,11,9,12,12.7
2024-25,202411010POR,11/1/2024,POR vs OKC,Scoot Henderson,hendesc01,68,POR,1,OKC,8,3,5,0,0,2,24.58333333,1,2,3,8,1,4,1,2,1,0,8,13,11,16,17.1
2024-25,202411010MIN,11/1/2024,MIN vs DEN,Donte DiVincenzo,divindo01,86,MIN,1,DEN,7,8,6,1,0,3,24.93333333,1,7,2,7,2,7,1,2,1,1,14,13,15,21,25.6
2024-25,202411010MIN,11/1/2024,MIN vs DEN,Russell Westbrook,westbru01,73,DEN,0,MIN,5,6,5,2,1,4,25.33333333,3,3,1,8,0,3,3,4,2,3,11,10,11,16,24.7
2024-25,202411010DET,11/1/2024,DET vs NYK,Malik Beasley,beaslma01,85,DET,1,NYK,8,0,1,1,0,3,25.35,0,0,3,9,2,6,0,0,0,1,1,9,8,9,9.5
2024-25,202411010POR,11/1/2024,POR vs OKC,Luguentz Dort,dortlu01,84,OKC,0,POR,8,5,2,4,2,0,25.46666667,1,4,3,9,1,4,1,1,1,6,7,10,13,15,35
2024-25,202411010DET,11/1/2024,DET vs NYK,Tobias Harris,harrito02,76,DET,1,NYK,13,8,3,1,3,3,25.55,0,8,5,8,1,2,2,2,1,4,11,16,21,24,36.1
2024-25,202411010BRK,11/1/2024,BRK vs CHI,Ben Simmons,simmobe01,20,BRK,1,CHI,8,8,11,0,2,3,25.56666667,0,8,4,5,0,0,0,0,3,2,19,19,16,27,37.1
2024-25,202411010CHO,11/1/2024,CHO vs BOS,Cody Martin,martico01,33,CHO,1,BOS,7,3,1,1,1,1,25.91666667,1,2,3,9,1,3,0,0,2,2,4,8,10,11,17.1
2024-25,202411010NOP,11/1/2024,NOP vs IND,Yves Missi,missiyv01,6,NOP,1,IND,4,10,0,0,1,0,26.16666667,6,4,2,5,0,0,0,0,2,1,10,4,14,14,19
2024-25,202411010MIN,11/1/2024,MIN vs DEN,Jaden McDaniels,mcdanja02,77,MIN,1,DEN,10,0,1,1,2,3,26.26666667,0,0,4,7,2,4,0,0,5,3,1,11,10,11,17.5
2024-25,202411010POR,11/1/2024,POR vs OKC,Jalen Williams,willija06,76,OKC,0,POR,22,5,4,4,0,3,26.26666667,1,4,8,12,4,6,2,2,2,4,9,26,27,31,43
2024-25,202411010MIN,11/1/2024,MIN vs DEN,Mike Conley,conlemi01,81,MIN,1,DEN,9,0,5,1,0,1,26.31666667,0,0,2,7,2,5,3,4,4,1,5,14,9,14,18.5
2024-25,202411010POR,11/1/2024,POR vs OKC,Isaiah Joe,joeis01,83,OKC,0,POR,12,5,2,2,0,2,26.58333333,0,5,4,9,3,8,1,2,4,2,7,14,17,19,25
2024-25,202411010BRK,11/1/2024,BRK vs CHI,Ayo Dosunmu,dosunay01,82,CHI,0,BRK,10,7,3,0,0,3,27.15,0,7,3,11,2,7,2,2,4,0,10,13,17,20,19.9
2024-25,202411010ATL,11/1/2024,ATL vs SAC,David Roddy,roddyda01,69,ATL,1,SAC,8,8,2,2,1,1,27.31666667,0,8,3,10,2,6,0,0,2,3,10,10,16,18,28.6
2024-25,202411010DET,11/1/2024,DET vs NYK,Karl-Anthony Towns,townska01,67,NYK,0,DET,21,11,7,2,1,1,27.46666667,3,8,8,18,3,6,2,3,1,3,18,28,32,39,52.7
2024-25,202411010CLE,11/1/2024,CLE vs ORL,Anthony Black,blackan01,75,ORL,0,CLE,7,2,6,0,0,2,27.5,0,2,3,8,1,3,0,0,2,0,8,13,9,15,16.4
2024-25,202411010CLE,11/1/2024,CLE vs ORL,Kentavious Caldwell-Pope,caldwke01,82,ORL,0,CLE,7,1,1,1,0,0,27.5,0,1,2,3,1,2,2,2,3,1,2,8,8,9,12.7
2024-25,202411010CLE,11/1/2024,CLE vs ORL,Moritz Wagner,wagnemo01,86,ORL,0,CLE,14,5,0,2,0,2,27.56666667,0,5,5,9,0,2,4,7,0,2,5,14,19,19,24
2024-25,202411010BRK,11/1/2024,BRK vs CHI,Dorian Finney-Smith,finnedo01,74,BRK,1,CHI,9,5,0,2,1,0,27.58333333,1,4,4,8,1,4,0,0,5,3,5,9,14,14,24
2024-25,202411010CHO,11/1/2024,CHO vs BOS,Payton Pritchard,pritcpa01,88,BOS,0,CHO,7,2,3,5,0,1,27.83333333,0,2,1,6,0,5,5,6,0,5,5,10,9,12,27.9
2024-25,202411010POR,11/1/2024,POR vs OKC,Deandre Ayton,aytonde01,61,POR,1,OKC,14,5,2,2,0,2,28.06666667,3,2,7,11,0,0,0,0,1,2,7,16,19,21,27
2024-25,202411010POR,11/1/2024,POR vs OKC,Jerami Grant,grantje01,60,POR,1,OKC,17,3,2,0,1,1,28.28333333,0,3,5,11,3,7,4,5,1,1,5,19,20,22,25.6
2024-25,202411010DET,11/1/2024,DET vs NYK,Miles McBride,mcbrimi01,73,NYK,0,DET,10,3,2,4,0,0,28.33333333,1,2,4,12,2,8,0,1,2,4,5,12,13,15,28.6
2024-25,202411010BRK,11/1/2024,BRK vs CHI,Patrick Williams,willipa01,49,CHI,0,BRK,6,6,1,1,0,3,28.36666667,1,5,2,8,0,4,2,2,1,1,7,7,12,13,14.7
2024-25,202411010POR,11/1/2024,POR vs OKC,Shai Gilgeous-Alexander,gilgesh01,80,OKC,0,POR,30,7,6,1,0,3,28.38333333,1,6,12,18,1,6,5,6,1,1,13,36,37,43,47.4
2024-25,202411010CLE,11/1/2024,CLE vs ORL,Jarrett Allen,allenja01,83,CLE,1,ORL,2,11,1,1,1,2,28.46666667,2,9,1,3,0,0,0,0,2,2,12,3,13,14,20.7
2024-25,202411010POR,11/1/2024,POR vs OKC,Anfernee Simons,simonan01,52,POR,1,OKC,9,4,6,0,1,2,28.46666667,0,4,1,8,1,3,6,6,0,1,10,15,13,19,23.8
2024-25,202411010CLE,11/1/2024,CLE vs ORL,Darius Garland,garlada01,63,CLE,1,ORL,25,3,4,1,1,3,28.55,1,2,8,16,3,9,6,6,5,2,7,29,28,32,37.6
2024-25,202411010ATL,11/1/2024,ATL vs SAC,Clint Capela,capelca01,79,ATL,1,SAC,15,10,1,0,0,0,28.8,3,7,7,9,0,0,1,1,4,0,11,16,25,26,28.5
2024-25,202411010ATL,11/1/2024,ATL vs SAC,Malik Monk,monkma01,77,SAC,0,ATL,9,4,6,0,0,1,28.88333333,0,4,3,9,0,3,3,4,0,0,10,15,13,19,21.8
2024-25,202411010ATL,11/1/2024,ATL vs SAC,Keaton Wallace,wallake01,4,ATL,1,SAC,14,3,3,1,1,1,29.3,0,3,5,9,4,8,0,0,3,2,6,17,17,20,27.1
2024-25,202411010CHO,11/1/2024,CHO vs BOS,Tre Mann,manntr01,46,CHO,1,BOS,23,4,5,0,1,3,29.51666667,1,3,10,18,3,6,0,0,0,1,9,28,27,32,35.3
2024-25,202411010ATL,11/1/2024,ATL vs SAC,Garrison Mathews,mathega01,71,ATL,1,SAC,23,1,2,2,1,0,29.6,0,1,8,15,7,13,0,0,3,3,3,25,24,26,36.2
2024-25,202411010CLE,11/1/2024,CLE vs ORL,Evan Mobley,mobleev01,56,CLE,1,ORL,14,12,3,1,1,3,29.75,1,11,6,11,1,3,1,1,1,2,15,17,26,29,35.9
2024-25,202411010NOP,11/1/2024,NOP vs IND,Myles Turner,turnemy01,83,IND,0,NOP,12,4,2,0,1,4,29.91666667,0,4,5,12,2,5,0,0,4,1,6,14,16,18,18.8
2024-25,202411010CLE,11/1/2024,CLE vs ORL,Franz Wagner,wagnefr01,78,ORL,0,CLE,17,8,6,1,0,4,30.06666667,2,6,8,19,0,2,1,3,3,1,14,23,25,31,34.6
2024-25,202411010CHO,11/1/2024,CHO vs BOS,Grant Williams,willigr01,81,CHO,1,BOS,6,7,3,1,1,2,30.4,2,5,2,6,2,5,0,0,5,2,10,9,13,16,22.9
2024-25,202411010DET,11/1/2024,DET vs NYK,Jalen Brunson,brunsja01,82,NYK,0,DET,36,1,5,2,0,2,30.66666667,0,1,14,22,6,8,2,4,2,2,6,41,37,42,48.7
2024-25,202411010TOR,11/1/2024,TOR vs LAL,Davion Mitchell,mitchda01,78,TOR,1,LAL,10,3,5,0,2,3,30.93333333,0,3,4,9,2,6,0,0,4,2,8,15,13,18,24.1
2024-25,202411010CHO,11/1/2024,CHO vs BOS,LaMelo Ball,ballla01,27,CHO,1,BOS,31,2,4,1,0,4,31.13333333,0,2,12,25,5,14,2,3,6,1,6,35,33,37,38.4
2024-25,202411010CHO,11/1/2024,CHO vs BOS,Miles Bridges,bridgmi02,74,CHO,1,BOS,14,7,3,1,0,1,31.33333333,0,7,5,16,2,10,2,3,1,1,10,17,21,24,28.9
2024-25,202411010TOR,11/1/2024,TOR vs LAL,Gradey Dick,dickgr01,66,TOR,1,LAL,31,7,3,1,0,1,31.58333333,2,5,13,26,5,11,0,0,2,1,10,34,38,41,45.9
2024-25,202411010NOP,11/1/2024,NOP vs IND,Pascal Siakam,siakapa01,86,IND,0,NOP,16,5,6,1,1,2,31.71666667,1,4,7,13,2,5,0,0,6,2,11,22,21,27,35
2024-25,202411010BRK,11/1/2024,BRK vs CHI,Cameron Johnson,johnsca02,64,BRK,1,CHI,14,6,5,1,0,0,31.75,0,6,5,11,2,7,2,2,1,1,11,19,20,25,31.7
2024-25,202411010BRK,11/1/2024,BRK vs CHI,Cam Thomas,thomaca02,72,BRK,1,CHI,32,0,4,1,0,2,31.75,0,0,11,23,4,11,6,7,1,1,4,36,32,36,39
2024-25,202411010TOR,11/1/2024,TOR vs LAL,RJ Barrett,barrerj01,61,TOR,1,LAL,33,5,12,0,0,4,31.8,1,4,14,22,3,5,2,2,3,0,17,45,38,50,53
2024-25,202411010CHO,11/1/2024,CHO vs BOS,Jrue Holiday,holidjr01,75,BOS,0,CHO,14,5,1,1,0,0,31.95,0,5,5,12,3,6,1,2,2,1,6,15,19,20,24.5
2024-25,202411010DET,11/1/2024,DET vs NYK,Cade Cunningham,cunnica01,68,DET,1,NYK,22,6,6,0,1,1,32.08333333,0,6,10,19,2,4,0,0,1,1,12,28,28,34,40.2
2024-25,202411010NOP,11/1/2024,NOP vs IND,Bennedict Mathurin,mathube01,66,IND,0,NOP,19,6,3,0,0,1,32.26666667,2,4,7,15,1,2,4,5,3,0,9,22,25,28,29.7
2024-25,202411010NOP,11/1/2024,NOP vs IND,Jose Alvarado,alvarjo01,62,NOP,1,IND,12,6,7,2,0,0,32.41666667,1,5,5,12,2,5,0,0,4,2,13,19,18,25,35.7
2024-25,202411010TOR,11/1/2024,TOR vs LAL,D'Angelo Russell,russeda01,83,LAL,0,TOR,19,3,6,0,0,2,32.46666667,0,3,7,13,3,6,2,2,4,0,9,25,22,28,29.6
2024-25,202411010DET,11/1/2024,DET vs NYK,OG Anunoby,anunoog01,55,NYK,0,DET,21,4,6,2,0,0,32.78333333,2,2,8,15,3,5,2,2,0,2,10,27,25,31,40.8
2024-25,202411010NOP,11/1/2024,NOP vs IND,Ben Sheppard,sheppbe01,64,IND,0,NOP,20,3,1,0,0,0,32.95,0,3,7,12,6,11,0,0,1,0,4,21,23,24,25.1
2024-25,202411010BRK,11/1/2024,BRK vs CHI,Dennis Schroder,schrode01,86,BRK,1,CHI,9,7,7,3,0,2,33.16666667,1,6,4,12,1,3,0,0,1,3,14,16,16,23,34.9
2024-25,202411010ATL,11/1/2024,ATL vs SAC,Domantas Sabonis,sabondo01,87,SAC,0,ATL,15,14,6,0,0,3,33.18333333,3,11,5,11,0,0,5,5,6,0,20,21,29,35,37.8
2024-25,202411010TOR,11/1/2024,TOR vs LAL,Rui Hachimura,hachiru01,75,LAL,0,TOR,9,5,1,0,0,1,33.21666667,1,4,3,12,2,5,1,1,0,0,6,10,14,15,15.5
2024-25,202411010BRK,11/1/2024,BRK vs CHI,Josh Giddey,giddejo01,86,CHI,0,BRK,11,6,8,2,0,4,33.38333333,3,3,5,17,0,4,1,4,1,2,14,19,17,25,32.2
2024-25,202411010NOP,11/1/2024,NOP vs IND,Tyrese Haliburton,halibty01,76,IND,0,NOP,11,2,11,0,0,2,33.4,1,1,2,8,1,6,6,6,2,0,13,22,13,24,27.9
2024-25,202411010TOR,11/1/2024,TOR vs LAL,Ochai Agbaji,agbajoc01,84,TOR,1,LAL,8,2,3,1,0,0,33.73333333,0,2,4,9,0,3,0,0,4,1,5,11,10,13,17.9
2024-25,202411010BRK,11/1/2024,BRK vs CHI,Zach LaVine,lavinza01,31,CHI,0,BRK,21,1,2,1,0,2,33.95,0,1,7,17,5,9,2,2,1,1,3,23,22,24,26.2
2024-25,202411010BRK,11/1/2024,BRK vs CHI,Nikola Vucevic,vucevni01,82,CHI,0,BRK,28,11,3,1,1,0,33.95,3,8,10,11,3,4,5,5,0,2,14,31,39,42,51.7
2024-25,202411010TOR,11/1/2024,TOR vs LAL,Austin Reaves,reaveau01,89,LAL,0,TOR,20,1,6,2,1,1,34.3,0,1,4,13,0,6,12,14,3,3,7,26,21,27,38.2
2024-25,202411010BRK,11/1/2024,BRK vs CHI,Coby White,whiteco01,85,CHI,0,BRK,21,4,4,0,0,3,34.31666667,1,3,6,13,5,9,4,5,4,0,8,25,25,29,28.8
2024-25,202411010DET,11/1/2024,DET vs NYK,Mikal Bridges,bridgmi01,87,NYK,0,DET,15,7,3,3,1,0,34.66666667,0,7,6,13,3,6,0,0,0,4,10,18,22,25,39.9
2024-25,202411010CHO,11/1/2024,CHO vs BOS,Derrick White,whitede01,79,BOS,0,CHO,17,2,5,1,1,0,35.08333333,0,2,6,16,3,10,2,2,4,2,7,22,19,24,32.9
2024-25,202411010TOR,11/1/2024,TOR vs LAL,Jakob Poeltl,poeltja01,56,TOR,1,LAL,19,12,6,0,3,2,35.1,6,6,9,14,0,0,1,1,3,3,18,25,31,37,49.4
2024-25,202411010NOP,11/1/2024,NOP vs IND,Brandon Ingram,ingrabr01,70,NOP,1,IND,26,6,7,1,2,2,35.3,2,4,10,25,3,8,3,3,3,3,13,33,32,39,50.7
2024-25,202411010CHO,11/1/2024,CHO vs BOS,Jayson Tatum,tatumja01,80,BOS,0,CHO,32,11,3,3,1,5,35.63333333,1,10,9,19,3,9,11,13,1,4,14,35,43,46,56.7
2024-25,202411010TOR,11/1/2024,TOR vs LAL,Anthony Davis,davisan02,83,LAL,0,TOR,38,11,2,3,2,3,35.71666667,1,10,14,20,0,0,10,11,0,5,13,40,49,51,66.2
2024-25,202411010MIN,11/1/2024,MIN vs DEN,Christian Braun,braunch01,87,DEN,0,MIN,14,7,2,0,0,2,35.75,2,5,5,11,1,3,3,3,4,0,9,16,21,23,23.4
2024-25,202411010MIN,11/1/2024,MIN vs DEN,Rudy Gobert,goberru01,81,MIN,1,DEN,17,14,3,1,2,2,35.96666667,4,10,7,10,0,0,3,4,3,3,17,20,31,34,45.3
2024-25,202411010ATL,11/1/2024,ATL vs SAC,Jalen Johnson,johnsja05,62,ATL,1,SAC,14,5,9,2,0,3,36,1,4,4,10,2,6,4,6,3,2,14,23,19,28,36.5
2024-25,202411010TOR,11/1/2024,TOR vs LAL,LeBron James,jamesle01,78,LAL,0,TOR,27,6,10,1,0,0,36.25,0,6,9,17,5,8,4,6,1,1,16,37,33,43,52.2
2024-25,202411010CHO,11/1/2024,CHO vs BOS,Jaylen Brown,brownja02,76,BOS,0,CHO,25,6,5,1,1,1,36.5,3,3,8,19,0,6,9,10,3,2,11,30,31,36,44.7
2024-25,202411010MIN,11/1/2024,MIN vs DEN,Julius Randle,randlju01,51,MIN,1,DEN,23,6,7,0,0,3,36.55,1,5,8,13,2,5,5,5,3,0,13,30,29,36,37.7
2024-25,202411010CLE,11/1/2024,CLE vs ORL,Jalen Suggs,suggsja01,81,ORL,0,CLE,28,8,7,3,1,3,36.55,1,7,10,20,1,7,7,8,2,4,15,35,36,43,57.1
2024-25,202411010NOP,11/1/2024,NOP vs IND,Jordan Hawkins,hawkijo01,73,NOP,1,IND,23,4,1,0,0,0,36.71666667,0,4,7,17,2,8,7,8,1,0,5,24,27,28,29.3
2024-25,202411010NOP,11/1/2024,NOP vs IND,Zion Williamson,willizi01,75,NOP,1,IND,34,6,10,2,0,3,36.9,1,5,14,20,1,2,5,8,3,2,16,44,40,50,59.2
2024-25,202411010DET,11/1/2024,DET vs NYK,Josh Hart,hartjo01,86,NYK,0,DET,13,9,4,2,0,3,37.08333333,3,6,6,9,1,3,0,0,2,2,13,17,22,26,32.8
2024-25,202411010ATL,11/1/2024,ATL vs SAC,De'Aaron Fox,foxde01,79,SAC,0,ATL,31,7,3,4,0,6,37.13333333,0,7,11,16,4,6,5,6,3,4,10,34,38,41,49.9
2024-25,202411010MIN,11/1/2024,MIN vs DEN,Aaron Gordon,gordoaa01,78,DEN,0,MIN,31,11,2,1,0,0,38.05,4,7,11,18,5,7,4,5,2,1,13,33,42,44,50.2
2024-25,202411010MIN,11/1/2024,MIN vs DEN,Anthony Edwards,edwaran01,84,MIN,1,DEN,29,4,4,1,1,2,38.3,0,4,11,23,7,14,0,0,1,2,8,33,33,37,43.8
2024-25,202411010ATL,11/1/2024,ATL vs SAC,DeMar DeRozan,derozde01,84,SAC,0,ATL,27,8,2,3,1,1,38.78333333,1,7,9,16,1,1,8,10,2,4,10,29,35,37,50.6
2024-25,202411010ATL,11/1/2024,ATL vs SAC,Keegan Murray,murrake02,82,SAC,0,ATL,14,10,3,0,1,1,38.86666667,3,7,6,12,1,6,1,1,3,1,13,17,24,27,32.5
2024-25,202411010MIN,11/1/2024,MIN vs DEN,Michael Porter Jr.,portemi01,86,DEN,0,MIN,26,6,4,2,0,3,38.88333333,2,4,11,18,3,7,1,2,2,2,10,30,32,36,42.2
2024-25,202411010MIN,11/1/2024,MIN vs DEN,Nikola Jokic,jokicni01,84,DEN,0,MIN,26,9,13,3,1,3,39.7,2,7,8,16,2,3,8,10,1,4,22,39,35,48,65.3
2024-25,202411010ATL,11/1/2024,ATL vs SAC,Trae Young,youngtr01,60,ATL,1,SAC,25,5,12,0,0,5,42.3,1,4,8,21,3,9,6,7,2,0,17,37,30,42,44
2024-25,202410310DAL,10/31/2024,DAL vs HOU,Quentin Grimes,grimequ01,56,DAL,1,HOU,1,1,0,0,0,0,10.18333333,0,1,0,1,0,1,1,3,2,0,1,1,2,2,2.2
2024-25,202410310LAC,10/31/2024,LAC vs PHO,Amir Coffey,coffeam01,75,LAC,1,PHO,7,1,0,0,0,0,10.46666667,0,1,2,3,1,1,2,3,3,0,1,7,8,8,8.2
2024-25,202410310UTA,10/31/2024,UTA vs SAS,Sandro Mamukelashvili,mamuksa01,49,SAS,0,UTA,10,1,0,0,0,0,10.65,0,1,4,5,1,2,1,1,0,0,1,10,11,11,11.2
2024-25,202410310UTA,10/31/2024,UTA vs SAS,Zach Collins,colliza01,74,SAS,0,UTA,0,2,0,0,0,1,11.16666667,1,1,0,3,0,1,0,0,1,0,2,0,2,2,1.4
2024-25,202410310DAL,10/31/2024,DAL vs HOU,Jaden Hardy,hardyja02,78,DAL,1,HOU,2,2,1,1,0,1,11.26666667,1,1,1,3,0,1,0,0,2,1,3,3,4,5,7.9
2024-25,202410310MEM,10/31/2024,MEM vs MIL,Brandon Clarke,clarkbr01,12,MEM,1,MIL,7,2,2,0,0,0,11.68333333,0,2,3,3,0,0,1,1,1,0,4,9,9,11,12.4
2024-25,202410310DAL,10/31/2024,DAL vs HOU,Spencer Dinwiddie,dinwisp01,80,DAL,1,HOU,4,1,3,0,0,0,12.25,0,1,0,5,0,3,4,4,0,0,4,7,5,8,9.7
2024-25,202410310UTA,10/31/2024,UTA vs SAS,Johnny Juzang,juzanjo01,22,UTA,1,SAS,0,2,0,0,0,1,13.31666667,0,2,0,2,0,1,0,0,1,0,2,0,2,2,1.4
2024-25,202410310UTA,10/31/2024,UTA vs SAS,Brice Sensabaugh,sensabr01,37,UTA,1,SAS,5,3,1,0,0,2,14.51666667,0,3,2,3,1,2,0,0,0,0,4,6,8,9,8.1
2024-25,202410310DAL,10/31/2024,DAL vs HOU,Dereck Lively II,livelde01,60,DAL,1,HOU,6,3,2,0,1,1,15,1,2,2,4,0,0,2,2,5,1,5,8,9,11,14.6
2024-25,202410310DAL,10/31/2024,DAL vs HOU,Daniel Gafford,gaffoda01,79,DAL,1,HOU,6,3,1,0,2,1,15.08333333,1,2,3,4,0,0,0,0,4,2,4,7,9,10,16.1
2024-25,202410310MEM,10/31/2024,MEM vs MIL,Pat Connaughton,connapa01,81,MIL,0,MEM,3,3,2,0,0,1,15.91666667,0,3,1,7,1,5,0,0,2,0,5,5,6,8,8.6
2024-25,202410310UTA,10/31/2024,UTA vs SAS,Patty Mills,millspa02,37,UTA,1,SAS,9,1,1,1,0,3,16.36666667,1,0,3,7,3,6,0,0,0,1,2,10,10,11,11.7
2024-25,202410310MEM,10/31/2024,MEM vs MIL,Jay Huff,huffja01,26,MEM,1,MIL,4,2,1,0,1,1,16.58333333,0,2,1,4,0,2,2,2,4,1,3,5,6,7,9.9
2024-25,202410310UTA,10/31/2024,UTA vs SAS,Malaki Branham,branhma01,80,SAS,0,UTA,6,2,1,3,0,1,16.6,0,2,1,5,1,2,3,4,1,3,3,7,8,9,17.9
2024-25,202410310LAC,10/31/2024,LAC vs PHO,Kevin Porter Jr.,porteke02,5,LAC,1,PHO,14,5,2,0,1,2,17.36666667,1,4,6,12,0,3,2,2,2,1,7,16,19,21,24
2024-25,202410310LAC,10/31/2024,LAC vs PHO,Mason Plumlee,plumlma01,51,PHO,0,LAC,8,6,0,2,1,2,17.38333333,4,2,3,7,0,0,2,4,3,3,6,8,14,14,22.2
2024-25,202410310DAL,10/31/2024,DAL vs HOU,Amen Thompson,thompam01,67,HOU,0,DAL,10,4,1,1,0,1,17.96666667,2,2,4,5,0,0,2,2,2,1,5,11,14,15,18.3
2024-25,202410310MEM,10/31/2024,MEM vs MIL,Gary Trent Jr.,trentga02,76,MIL,0,MEM,9,2,0,1,0,0,18.15,0,2,4,12,0,7,1,1,1,1,2,9,11,11,14.4
2024-25,202410310DAL,10/31/2024,DAL vs HOU,Tari Eason,easonta01,27,HOU,0,DAL,15,4,2,0,1,0,18.7,2,2,6,10,1,2,2,3,1,1,6,17,19,21,25.8
2024-25,202410310MEM,10/31/2024,MEM vs MIL,Andre Jackson Jr.,jacksan01,61,MIL,0,MEM,2,5,1,2,1,2,18.78333333,1,4,1,2,0,1,0,2,5,3,6,3,7,8,16.5
2024-25,202410310LAC,10/31/2024,LAC vs PHO,Grayson Allen,allengr01,78,PHO,0,LAC,2,5,3,4,0,0,18.91666667,0,5,1,8,0,5,0,0,1,4,8,5,7,10,24.5
2024-25,202410310UTA,10/31/2024,UTA vs SAS,Kyle Filipowski,filipky01,4,UTA,1,SAS,12,5,1,0,0,2,20.11666667,1,4,5,8,2,4,0,0,3,0,6,13,17,18,17.5
2024-25,202410310UTA,10/31/2024,UTA vs SAS,Drew Eubanks,eubandr01,78,UTA,1,SAS,6,5,1,0,2,3,20.43333333,3,2,2,3,0,0,2,2,4,2,6,7,11,12,16.5
2024-25,202410310MEM,10/31/2024,MEM vs MIL,Delon Wright,wrighde01,52,MIL,0,MEM,8,1,2,0,1,0,20.7,0,1,3,4,2,2,0,0,2,1,3,10,9,11,15.2
2024-25,202410310UTA,10/31/2024,UTA vs SAS,Stephon Castle,castlst01,5,SAS,0,UTA,8,4,1,1,0,0,20.93333333,2,2,3,8,1,2,1,2,4,1,5,9,12,13,17.3
2024-25,202410310UTA,10/31/2024,UTA vs SAS,Jordan Clarkson,clarkjo01,60,UTA,1,SAS,3,3,1,2,0,3,21.11666667,0,3,1,6,0,4,1,2,1,2,4,4,6,7,11.1
2024-25,202410310LAC,10/31/2024,LAC vs PHO,Nicolas Batum,batumni01,65,LAC,1,PHO,3,5,3,0,4,1,21.5,1,4,1,4,1,3,0,0,2,4,8,6,8,11,24.5
2024-25,202410310DAL,10/31/2024,DAL vs HOU,Naji Marshall,marshna01,71,DAL,1,HOU,4,2,3,0,1,1,21.63333333,0,2,2,3,0,1,0,0,2,1,5,7,6,9,12.9
2024-25,202410310LAC,10/31/2024,LAC vs PHO,Jusuf Nurkic,nurkiju01,81,PHO,0,LAC,11,3,2,0,0,3,23.08333333,0,3,3,6,1,2,4,4,2,0,5,13,14,16,14.6
2024-25,202410310LAC,10/31/2024,LAC vs PHO,Kris Dunn,dunnkr01,71,LAC,1,PHO,6,4,2,0,0,0,23.53333333,3,1,2,5,2,2,0,0,3,0,6,8,10,12,13.8
2024-25,202410310MEM,10/31/2024,MEM vs MIL,Brook Lopez,lopezbr01,84,MIL,0,MEM,12,3,1,0,0,0,23.58333333,0,3,4,8,3,6,1,2,4,0,4,13,15,16,17.1
2024-25,202410310UTA,10/31/2024,UTA vs SAS,Cody Williams,willico04,5,UTA,1,SAS,2,5,2,0,0,1,23.61666667,1,4,0,6,0,5,2,2,0,0,7,4,7,9,10
2024-25,202410310MEM,10/31/2024,MEM vs MIL,Zach Edey,edeyza01,6,MEM,1,MIL,10,8,0,1,1,1,23.71666667,2,6,5,9,0,0,0,0,3,2,8,10,18,18,24.6
2024-25,202410310LAC,10/31/2024,LAC vs PHO,Derrick Jones Jr.,jonesde02,81,LAC,1,PHO,11,3,2,3,0,0,24.31666667,1,2,4,10,1,3,2,2,5,3,5,13,14,16,26.6
2024-25,202410310UTA,10/31/2024,UTA vs SAS,Harrison Barnes,barneha02,87,SAS,0,UTA,8,2,0,0,1,0,24.36666667,0,2,2,6,0,3,4,4,0,1,2,8,10,10,13.4
2024-25,202410310UTA,10/31/2024,UTA vs SAS,Collin Sexton,sextoco01,83,UTA,1,SAS,16,3,3,2,0,1,24.71666667,0,3,5,11,0,0,6,6,5,2,6,19,19,22,29.1
2024-25,202410310MEM,10/31/2024,MEM vs MIL,Bobby Portis,portibo01,87,MIL,0,MEM,11,7,0,1,0,1,24.93333333,5,2,5,14,1,5,0,0,2,1,7,11,18,18,21.4
2024-25,202410310UTA,10/31/2024,UTA vs SAS,Julian Champagnie,champju02,79,SAS,0,UTA,6,6,2,3,0,0,25.16666667,2,4,3,7,0,1,0,0,0,3,8,8,12,14,25.2
2024-25,202410310MEM,10/31/2024,MEM vs MIL,Jaren Jackson Jr.,jacksja02,70,MEM,1,MIL,13,5,2,0,0,3,26.15,0,5,5,12,0,4,3,3,4,0,7,15,18,20,19
2024-25,202410310MEM,10/31/2024,MEM vs MIL,Scotty Pippen Jr.,pippesc02,27,MEM,1,MIL,16,3,1,1,0,3,26.9,0,3,5,8,1,3,5,5,2,1,4,17,19,20,21.1
2024-25,202410310MEM,10/31/2024,MEM vs MIL,Taurean Prince,princta02,84,MIL,0,MEM,5,2,3,4,0,1,27.4,0,2,2,8,1,6,0,0,2,4,5,8,7,10,22.9
2024-25,202410310UTA,10/31/2024,UTA vs SAS,Walker Kessler,kesslwa01,69,UTA,1,SAS,6,11,1,0,3,1,27.56666667,4,7,3,9,0,0,0,0,1,3,12,7,17,18,28.7
2024-25,202410310UTA,10/31/2024,UTA vs SAS,Keldon Johnson,johnske04,74,SAS,0,UTA,13,4,0,1,0,2,27.73333333,2,2,3,10,1,6,6,7,2,1,4,13,17,17,18.8
2024-25,202410310UTA,10/31/2024,UTA vs SAS,John Collins,collijo01,73,UTA,1,SAS,14,11,3,1,1,2,27.88333333,4,7,6,13,0,1,2,2,3,2,14,17,25,28,35.7
2024-25,202410310LAC,10/31/2024,LAC vs PHO,Royce O'Neale,onealro01,84,PHO,0,LAC,21,7,1,1,1,0,28.61666667,1,6,7,8,5,6,2,2,3,2,8,22,28,29,36.9
2024-25,202410310MEM,10/31/2024,MEM vs MIL,Ja Morant,moranja01,14,MEM,1,MIL,26,10,14,1,0,3,28.9,1,9,9,16,2,5,6,7,0,1,24,40,36,50,59
2024-25,202410310DAL,10/31/2024,DAL vs HOU,Jabari Smith Jr.,smithja05,81,HOU,0,DAL,14,6,0,1,0,0,29.3,3,3,5,10,1,5,3,4,3,1,6,14,20,20,24.2
2024-25,202410310UTA,10/31/2024,UTA vs SAS,Keyonte George,georgke01,80,UTA,1,SAS,15,4,5,0,0,7,30.35,1,3,5,14,1,9,4,5,1,0,9,20,19,24,20.3
2024-25,202410310DAL,10/31/2024,DAL vs HOU,Klay Thompson,thompkl01,82,DAL,1,HOU,12,1,1,1,0,0,30.48333333,0,1,5,13,2,9,0,0,1,1,2,13,13,14,17.7
2024-25,202410310LAC,10/31/2024,LAC vs PHO,Norman Powell,powelno01,81,LAC,1,PHO,23,2,2,1,0,2,30.63333333,0,2,9,21,4,11,1,2,1,1,4,25,25,27,29.4
2024-25,202410310UTA,10/31/2024,UTA vs SAS,Jeremy Sochan,sochaje01,79,SAS,0,UTA,11,5,3,2,1,1,31.11666667,2,3,5,13,1,4,0,2,2,3,8,14,16,19,29.5
2024-25,202410310LAC,10/31/2024,LAC vs PHO,Terance Mann,mannte01,80,LAC,1,PHO,8,4,2,1,0,0,31.18333333,3,1,4,8,0,2,0,0,3,1,6,10,12,14,18.8
2024-25,202410310UTA,10/31/2024,UTA vs SAS,Chris Paul,paulch01,63,SAS,0,UTA,19,7,10,2,0,1,32.38333333,0,7,8,13,3,7,0,0,2,2,17,29,26,36,47.4
2024-25,202410310MEM,10/31/2024,MEM vs MIL,Jake LaRavia,laravja01,41,MEM,1,MIL,11,10,3,2,0,1,32.71666667,1,9,3,6,1,3,4,6,4,2,13,14,21,24,32.5
2024-25,202410310MEM,10/31/2024,MEM vs MIL,Santi Aldama,aldamsa01,67,MEM,1,MIL,19,9,2,1,0,3,33.1,2,7,7,14,1,4,4,4,1,1,11,21,28,30,32.8
2024-25,202410310LAC,10/31/2024,LAC vs PHO,Tyus Jones,jonesty01,71,PHO,0,LAC,7,3,11,0,0,1,33.16666667,0,3,3,8,1,4,0,0,3,0,14,18,10,21,26.1
2024-25,202410310MEM,10/31/2024,MEM vs MIL,Damian Lillard,lillada01,78,MIL,0,MEM,4,2,6,1,0,1,33.35,1,1,1,12,0,6,2,2,3,1,8,10,6,12,17.4
2024-25,202410310MEM,10/31/2024,MEM vs MIL,Giannis Antetokounmpo,antetgi01,78,MIL,0,MEM,37,11,4,1,1,1,33.51666667,1,10,17,22,0,0,3,8,4,2,15,41,48,52,61.2
2024-25,202410310UTA,10/31/2024,UTA vs SAS,Victor Wembanyama,wembavi01,76,SAS,0,UTA,25,9,7,5,5,3,33.56666667,2,7,9,20,4,13,3,3,3,10,16,32,34,41,73.3
2024-25,202410310LAC,10/31/2024,LAC vs PHO,Ryan Dunn,dunnry01,5,PHO,0,LAC,16,4,0,1,0,0,34.3,1,3,6,12,4,9,0,0,5,1,4,16,20,20,23.8
2024-25,202410310DAL,10/31/2024,DAL vs HOU,Alperen Sengun,sengual01,68,HOU,0,DAL,17,12,4,0,1,1,34.78333333,6,6,5,16,0,1,7,9,3,1,16,21,29,33,39.4
2024-25,202410310LAC,10/31/2024,LAC vs PHO,Ivica Zubac,zubaciv01,73,LAC,1,PHO,22,12,1,1,0,2,35.53333333,5,7,9,10,0,0,4,5,1,1,13,23,34,35,38.9
2024-25,202410310MEM,10/31/2024,MEM vs MIL,Jaylen Wells,wellsja01,6,MEM,1,MIL,16,7,1,0,0,1,35.61666667,1,6,5,9,3,6,3,3,2,0,8,17,23,24,24.9
2024-25,202410310LAC,10/31/2024,LAC vs PHO,James Harden,hardeja01,77,LAC,1,PHO,25,10,13,2,2,6,35.68333333,0,10,8,19,3,10,6,7,2,4,23,38,35,48,62.5
2024-25,202410310DAL,10/31/2024,DAL vs HOU,Jalen Green,greenja05,87,HOU,0,DAL,23,12,4,1,1,5,36.31666667,0,12,9,21,3,8,2,3,4,2,16,27,35,39,44.4
2024-25,202410310DAL,10/31/2024,DAL vs HOU,P.J. Washington,washipj01,78,DAL,1,HOU,6,9,1,3,3,1,37.41666667,1,8,3,6,0,2,0,2,3,6,10,7,15,16,35.3
2024-25,202410310DAL,10/31/2024,DAL vs HOU,Luka Doncic,doncilu01,75,DAL,1,HOU,29,5,2,1,0,1,37.51666667,0,5,12,25,3,7,2,4,5,1,7,31,34,36,40
2024-25,202410310LAC,10/31/2024,LAC vs PHO,Devin Booker,bookede01,73,PHO,0,LAC,40,5,8,3,0,2,37.76666667,1,4,11,18,5,9,13,15,1,3,13,48,45,53,65
2024-25,202410310LAC,10/31/2024,LAC vs PHO,Kevin Durant,duranke01,80,PHO,0,LAC,18,5,4,1,2,4,38.68333333,0,5,7,13,2,4,2,3,1,3,9,22,23,27,35
2024-25,202410310DAL,10/31/2024,DAL vs HOU,Fred VanVleet,vanvlfr01,78,HOU,0,DAL,4,5,4,0,0,0,39.3,2,3,2,13,0,7,0,0,3,0,9,8,9,13,16
2024-25,202410310DAL,10/31/2024,DAL vs HOU,Dillon Brooks,brookdi01,77,HOU,0,DAL,17,4,2,0,1,0,40.9,1,3,6,15,2,9,3,4,1,1,6,19,21,23,27.8
2024-25,202410310DAL,10/31/2024,DAL vs HOU,Kyrie Irving,irvinky01,63,DAL,1,HOU,28,8,7,0,0,3,42.83333333,4,4,10,20,5,6,3,3,2,0,15,35,36,43,45.1
2024-25,202410300GSW,10/30/2024,GSW vs NOP,Brandon Boston Jr.,bostobr01,34,NOP,0,GSW,1,3,2,2,0,1,10.25,0,3,0,3,0,1,1,2,0,2,5,3,4,6,12.6
2024-25,202410300PHI,10/30/2024,PHI vs DET,Jalen Duren,durenja01,66,DET,0,PHI,0,6,1,0,0,2,10.71666667,3,3,0,0,0,0,0,2,6,0,7,1,6,7,6.7
2024-25,202410300CHI,10/30/2024,CHI vs ORL,Jett Howard,howarje01,23,ORL,0,CHI,3,2,0,0,1,0,11.01666667,0,2,1,4,1,4,0,0,1,1,2,3,5,5,8.4
2024-25,202410300CHI,10/30/2024,CHI vs ORL,Dalen Terry,terryda01,64,CHI,1,ORL,2,2,0,0,0,0,11.05,0,2,1,6,0,2,0,0,2,0,2,2,4,4,4.4
2024-25,202410300LAC,10/30/2024,LAC vs POR,Donovan Clingan,clingdo01,5,POR,0,LAC,7,6,0,1,1,1,11.11666667,3,3,3,5,1,1,0,0,4,2,6,7,13,13,19.2
2024-25,202410300MIA,10/30/2024,MIA vs NYK,Cameron Payne,payneca01,82,NYK,0,MIA,0,1,5,1,1,0,11.63333333,0,1,0,1,0,1,0,0,1,2,6,5,1,6,14.7
2024-25,202410300GSW,10/30/2024,GSW vs NOP,Yves Missi,missiyv01,5,NOP,0,GSW,0,3,1,0,0,0,12.03333333,2,1,0,5,0,0,0,0,0,0,4,1,3,4,5.1
2024-25,202410300OKC,10/30/2024,OKC vs SAS,Zach Collins,colliza01,73,SAS,0,OKC,3,4,1,0,1,2,12.46666667,2,2,1,3,1,2,0,0,1,1,5,4,7,8,10.3
2024-25,202410300PHI,10/30/2024,PHI vs DET,Ron Holland,hollaro01,5,DET,0,PHI,6,3,0,0,0,0,12.91666667,0,3,3,4,0,0,0,0,1,0,3,6,9,9,9.6
2024-25,202410300OKC,10/30/2024,OKC vs SAS,Blake Wesley,weslebl01,65,SAS,0,OKC,5,1,0,0,0,2,12.95,0,1,2,5,0,2,1,2,0,0,1,5,6,6,4.2
2024-25,202410300LAC,10/30/2024,LAC vs POR,Nicolas Batum,batumni01,64,LAC,1,POR,5,2,4,2,0,0,13.01666667,0,2,2,4,1,3,0,0,1,2,6,9,7,11,19.4
2024-25,202410300MEM,10/30/2024,MEM vs BRK,Noah Clowney,clownno01,28,BRK,0,MEM,5,2,0,0,0,0,13.65,0,2,2,8,1,5,0,0,5,0,2,5,7,7,7.4
2024-25,202410300IND,10/30/2024,IND vs BOS,Neemias Queta,quetane01,32,BOS,0,IND,2,9,1,0,1,0,13.65,4,5,1,2,0,0,0,0,0,1,10,3,11,12,17.3
2024-25,202410300IND,10/30/2024,IND vs BOS,Sam Hauser,hausesa01,81,BOS,0,IND,5,2,1,1,1,1,13.83333333,0,2,2,6,1,4,0,0,0,2,3,6,7,8,13.9
2024-25,202410300CHI,10/30/2024,CHI vs ORL,Jonathan Isaac,isaacjo01,60,ORL,0,CHI,8,5,1,1,0,1,13.9,2,3,2,5,2,4,2,2,0,1,6,9,13,14,17.5
2024-25,202410300MIA,10/30/2024,MIA vs NYK,Duncan Robinson,robindu01,72,MIA,1,NYK,5,2,0,0,0,1,13.9,0,2,2,7,1,5,0,0,0,0,2,5,7,7,6.4
2024-25,202410300CHO,10/30/2024,CHO vs TOR,Jamison Battle,battlja01,5,TOR,0,CHO,0,3,0,0,0,0,14.05,0,3,0,2,0,2,0,0,2,0,3,0,3,3,3.6
2024-25,202410300CHI,10/30/2024,CHI vs ORL,Julian Phillips,phillju01,45,CHI,1,ORL,4,1,0,1,0,2,14.11666667,0,1,1,4,1,4,1,2,1,1,1,4,5,5,6.2
2024-25,202410300WAS,10/30/2024,WAS vs ATL,Keaton Wallace,wallake01,3,ATL,0,WAS,8,1,2,0,0,0,14.7,0,1,3,3,2,2,0,0,0,0,3,10,9,11,12.2
2024-25,202410300LAC,10/30/2024,LAC vs POR,Kevin Porter Jr.,porteke02,4,LAC,1,POR,10,6,1,2,0,5,15.05,1,5,5,11,0,4,0,0,1,2,7,11,16,17,19.7
2024-25,202410300MIA,10/30/2024,MIA vs NYK,Thomas Bryant,bryanth01,42,MIA,1,NYK,6,3,0,0,0,0,15.11666667,1,2,2,3,2,3,0,0,2,0,3,6,9,9,9.6
2024-25,202410300GSW,10/30/2024,GSW vs NOP,Kyle Anderson,anderky01,84,GSW,1,NOP,10,4,2,0,1,0,15.3,1,3,4,4,1,1,1,2,1,1,6,12,14,16,20.8
2024-25,202410300IND,10/30/2024,IND vs BOS,Luke Kornet,kornelu01,68,BOS,0,IND,8,9,2,0,0,0,15.7,7,2,1,5,0,0,6,6,2,0,11,10,17,19,21.8
2024-25,202410300MEM,10/30/2024,MEM vs BRK,Keon Johnson,johnske07,9,BRK,0,MEM,4,7,1,1,0,0,15.85,2,5,2,4,0,2,0,0,1,1,8,5,11,12,16.9
2024-25,202410300PHI,10/30/2024,PHI vs DET,Eric Gordon,gordoer01,72,PHI,1,DET,3,0,1,0,0,0,16.06666667,0,0,1,3,0,2,1,1,1,0,1,4,3,4,4.5
2024-25,202410300CHI,10/30/2024,CHI vs ORL,Moritz Wagner,wagnemo01,85,ORL,0,CHI,7,6,1,0,0,2,16.11666667,0,6,1,4,1,2,4,4,1,0,7,8,13,14,13.7
2024-25,202410300CLE,10/30/2024,CLE vs LAL,Gabe Vincent,vincega01,16,LAL,0,CLE,5,0,0,0,0,1,16.15,0,0,2,5,1,3,0,0,0,0,0,5,5,5,4
2024-25,202410300CHO,10/30/2024,CHO vs TOR,Tidjane Salaun,salauti01,2,CHO,1,TOR,3,3,3,1,0,0,16.16666667,1,2,1,3,0,2,1,2,0,1,6,6,6,9,14.1
2024-25,202410300CLE,10/30/2024,CLE vs LAL,Ty Jerome,jeromty01,7,CLE,1,LAL,14,2,4,1,0,0,16.33333333,0,2,5,7,2,3,2,2,1,1,6,18,16,20,25.4
2024-25,202410300MIA,10/30/2024,MIA vs NYK,Dru Smith,smithdr01,12,MIA,1,NYK,2,4,0,0,3,0,16.36666667,0,4,1,4,0,1,0,0,0,3,4,2,6,6,15.8
2024-25,202410300LAC,10/30/2024,LAC vs POR,Kai Jones,joneska01,4,LAC,1,POR,7,5,1,0,2,0,16.68333333,3,2,2,2,0,0,3,5,2,2,6,8,12,13,20.5
2024-25,202410300MEM,10/30/2024,MEM vs BRK,Desmond Bane,banede01,47,MEM,1,BRK,10,6,0,0,0,2,16.71666667,1,5,3,7,1,2,3,3,1,0,6,10,16,16,15.2
2024-25,202410300CHO,10/30/2024,CHO vs TOR,Chris Boucher,bouchch01,55,TOR,0,CHO,13,4,1,0,1,1,16.76666667,1,3,6,10,1,4,0,0,1,1,5,14,17,18,21.3
2024-25,202410300PHI,10/30/2024,PHI vs DET,Simone Fontecchio,fontesi01,71,DET,0,PHI,2,4,2,0,0,1,17.45,1,3,0,1,0,1,2,2,1,0,6,4,6,8,8.8
2024-25,202410300OKC,10/30/2024,OKC vs SAS,Aaron Wiggins,wiggiaa01,82,OKC,1,SAS,4,3,3,0,0,1,17.86666667,0,3,2,8,0,3,0,0,0,0,6,7,7,10,11.1
2024-25,202410300LAC,10/30/2024,LAC vs POR,Kris Dunn,dunnkr01,70,LAC,1,POR,6,2,2,0,0,1,18.28333333,0,2,3,3,0,0,0,0,1,0,4,8,8,10,10.4
2024-25,202410300CHI,10/30/2024,CHI vs ORL,Gary Harris,harriga01,59,ORL,0,CHI,0,2,1,0,0,0,18.36666667,1,1,0,3,0,2,0,0,0,0,3,1,2,3,3.9
2024-25,202410300MEM,10/30/2024,MEM vs BRK,Zach Edey,edeyza01,5,MEM,1,BRK,13,2,1,1,0,1,18.43333333,2,0,6,9,0,0,1,2,2,1,3,14,15,16,18.9
2024-25,202410300OKC,10/30/2024,OKC vs SAS,Ousmane Dieng,diengou01,37,OKC,1,SAS,5,5,3,2,0,0,18.58333333,1,4,2,5,1,4,0,0,2,2,8,8,10,13,21.5
2024-25,202410300OKC,10/30/2024,OKC vs SAS,Isaiah Joe,joeis01,82,OKC,1,SAS,6,1,2,1,0,0,18.7,0,1,2,3,2,3,0,0,1,1,3,8,7,9,13.2
2024-25,202410300CLE,10/30/2024,CLE vs LAL,Evan Mobley,mobleev01,55,CLE,1,LAL,25,5,0,0,0,3,18.75,1,4,12,16,0,0,1,1,5,0,5,25,30,30,28
2024-25,202410300LAC,10/30/2024,LAC vs POR,Kris Murray,murrakr01,67,POR,0,LAC,5,8,2,2,1,1,18.75,3,5,2,4,1,2,0,0,1,3,10,7,13,15,25.6
2024-25,202410300PHI,10/30/2024,PHI vs DET,Guerschon Yabusele,yabusgu01,4,PHI,1,DET,8,2,2,2,1,2,18.76666667,0,2,3,4,2,3,0,0,4,3,4,10,10,12,20.4
2024-25,202410300CLE,10/30/2024,CLE vs LAL,Jaxson Hayes,hayesja02,76,LAL,0,CLE,6,3,2,1,0,1,19.06666667,2,1,2,2,0,0,2,2,2,1,5,8,9,11,14.6
2024-25,202410300MEM,10/30/2024,MEM vs BRK,John Konchar,konchjo01,58,MEM,1,BRK,3,3,0,0,1,1,19.2,0,3,1,2,1,2,0,0,0,1,3,3,6,6,8.6
2024-25,202410300LAC,10/30/2024,LAC vs POR,Terance Mann,mannte01,79,LAC,1,POR,4,4,3,0,0,1,19.33333333,3,1,2,5,0,2,0,0,4,0,7,7,8,11,12.3
2024-25,202410300IND,10/30/2024,IND vs BOS,Al Horford,horfoal01,70,BOS,0,IND,8,4,1,1,0,1,19.38333333,1,3,3,6,2,4,0,0,1,1,5,9,12,13,16.3
2024-25,202410300CHO,10/30/2024,CHO vs TOR,Jamal Shead,sheadja01,5,TOR,0,CHO,7,2,9,1,0,1,19.56666667,1,1,2,6,1,2,2,3,1,1,11,16,9,18,24.9
2024-25,202410300PHI,10/30/2024,PHI vs DET,Kyle Lowry,lowryky01,64,PHI,1,DET,3,3,2,2,1,1,19.63333333,0,3,1,3,1,2,0,0,2,3,5,5,6,8,17.6
2024-25,202410300OKC,10/30/2024,OKC vs SAS,Malaki Branham,branhma01,79,SAS,0,OKC,15,3,0,0,0,1,19.86666667,0,3,6,11,3,4,0,0,0,0,3,15,18,18,17.6
2024-25,202410300CLE,10/30/2024,CLE vs LAL,Isaac Okoro,okorois01,74,CLE,1,LAL,3,0,0,1,0,0,19.98333333,0,0,1,3,1,2,0,0,5,1,0,3,3,3,6
2024-25,202410300OKC,10/30/2024,OKC vs SAS,Julian Champagnie,champju02,78,SAS,0,OKC,3,3,0,1,0,3,20.03333333,0,3,1,5,1,4,0,0,0,1,3,3,6,6,6.6
2024-25,202410300MEM,10/30/2024,MEM vs BRK,Scotty Pippen Jr.,pippesc02,26,MEM,1,BRK,5,0,4,1,0,3,20.03333333,0,0,1,4,0,2,3,3,4,1,4,9,5,9,11
2024-25,202410300MEM,10/30/2024,MEM vs BRK,Brandon Clarke,clarkbr01,11,MEM,1,BRK,13,3,1,2,0,0,20.1,2,1,5,5,0,0,3,3,0,2,4,14,16,17,24.1
2024-25,202410300OKC,10/30/2024,OKC vs SAS,Stephon Castle,castlst01,4,SAS,0,OKC,0,2,1,0,1,0,20.16666667,0,2,0,5,0,3,0,0,0,1,3,1,2,3,6.9
2024-25,202410300GSW,10/30/2024,GSW vs NOP,Trayce Jackson-Davis,jackstr02,73,GSW,1,NOP,15,9,2,0,1,0,20.2,1,8,7,9,0,0,1,2,1,1,11,17,24,26,31.8
2024-25,202410300IND,10/30/2024,IND vs BOS,Ben Sheppard,sheppbe01,63,IND,1,BOS,7,6,2,1,1,1,20.86666667,2,4,3,6,1,3,0,0,0,2,8,9,13,15,22.2
2024-25,202410300CLE,10/30/2024,CLE vs LAL,Sam Merrill,merrisa01,66,CLE,1,LAL,3,0,3,2,0,0,21.26666667,0,0,1,4,1,4,0,0,2,2,3,6,3,6,13.5
2024-25,202410300CLE,10/30/2024,CLE vs LAL,Georges Niang,niangge01,87,CLE,1,LAL,5,2,2,1,0,2,21.55,1,1,2,4,1,3,0,0,3,1,4,7,7,9,11.4
2024-25,202410300IND,10/30/2024,IND vs BOS,T.J. McConnell,mccontj01,77,IND,1,BOS,10,2,3,1,0,1,21.58333333,0,2,5,11,0,1,0,0,1,1,5,13,12,15,18.9
2024-25,202410300PHI,10/30/2024,PHI vs DET,Jared McCain,mccaija01,4,PHI,1,DET,12,3,3,0,0,1,21.81666667,1,2,3,9,0,1,6,6,0,0,6,15,15,18,19.1
2024-25,202410300CLE,10/30/2024,CLE vs LAL,Caris LeVert,leverca01,73,CLE,1,LAL,16,0,6,1,0,1,21.83333333,0,0,6,8,4,6,0,0,2,1,6,22,16,22,27
2024-25,202410300OKC,10/30/2024,OKC vs SAS,Ajay Mitchell,mitchaj01,4,OKC,1,SAS,12,4,0,2,0,0,21.86666667,0,4,5,6,1,1,1,2,0,2,4,12,16,16,22.8
2024-25,202410300OKC,10/30/2024,OKC vs SAS,Alex Caruso,carusal01,75,OKC,1,SAS,0,2,2,4,0,1,21.9,0,2,0,5,0,3,0,0,0,4,4,2,2,4,16.4
2024-25,202410300MEM,10/30/2024,MEM vs BRK,Santi Aldama,aldamsa01,66,MEM,1,BRK,2,3,0,2,0,1,22.05,0,3,1,5,0,2,0,0,2,2,3,2,5,5,10.6
2024-25,202410300CLE,10/30/2024,CLE vs LAL,Darius Garland,garlada01,62,CLE,1,LAL,12,0,10,2,0,2,22.18333333,0,0,5,14,2,7,0,0,3,2,10,22,12,22,31
2024-25,202410300CHO,10/30/2024,CHO vs TOR,Josh Green,greenjo02,59,CHO,1,TOR,9,2,3,0,2,0,22.41666667,1,1,3,6,3,4,0,0,3,2,5,12,11,14,21.9
2024-25,202410300CLE,10/30/2024,CLE vs LAL,Dalton Knecht,knechda01,5,LAL,0,CLE,18,3,1,0,0,1,22.48333333,0,3,6,12,2,7,4,4,1,0,4,19,21,22,22.1
2024-25,202410300PHI,10/30/2024,PHI vs DET,KJ Martin,martike04,64,PHI,1,DET,6,2,0,0,1,0,22.5,0,2,2,4,0,0,2,2,2,1,2,6,8,8,11.4
2024-25,202410300CHI,10/30/2024,CHI vs ORL,Franz Wagner,wagnefr01,77,ORL,0,CHI,7,3,4,1,1,0,22.58333333,1,2,3,8,0,3,1,1,2,2,7,11,10,14,22.6
2024-25,202410300GSW,10/30/2024,GSW vs NOP,Jeremiah Robinson-Earl,robinje02,44,NOP,0,GSW,9,5,3,0,0,1,22.66666667,2,3,3,4,0,1,3,3,2,0,8,12,14,17,18.5
2024-25,202410300MEM,10/30/2024,MEM vs BRK,Jaylen Wells,wellsja01,5,MEM,1,BRK,9,1,4,0,1,4,22.96666667,0,1,3,7,2,6,1,2,1,1,5,13,10,14,15.2
2024-25,202410300CHO,10/30/2024,CHO vs TOR,Grant Williams,willigr01,80,CHO,1,TOR,17,2,5,2,0,2,22.96666667,1,1,5,6,3,4,4,4,4,2,7,22,19,24,30.9
2024-25,202410300WAS,10/30/2024,WAS vs ATL,Alex Sarr,sarral01,4,WAS,1,ATL,11,5,2,1,4,1,23.11666667,0,5,3,9,2,5,3,4,2,5,7,13,16,18,34
2024-25,202410300WAS,10/30/2024,WAS vs ATL,Garrison Mathews,mathega01,70,ATL,0,WAS,6,1,2,2,0,0,23.16666667,0,1,2,5,2,4,0,0,4,2,3,8,7,9,16.2
2024-25,202410300CHI,10/30/2024,CHI vs ORL,Anthony Black,blackan01,74,ORL,0,CHI,4,3,6,1,3,1,23.2,1,2,1,5,0,2,2,2,3,4,9,10,7,13,27.6
2024-25,202410300GSW,10/30/2024,GSW vs NOP,Jamal Cain,cainja01,28,NOP,0,GSW,7,2,1,1,1,1,23.86666667,1,1,3,4,0,1,1,2,4,2,3,8,9,10,15.9
2024-25,202410300WAS,10/30/2024,WAS vs ATL,Clint Capela,capelca01,78,ATL,0,WAS,12,5,0,0,0,2,23.88333333,0,5,5,7,0,0,2,2,2,0,5,12,17,17,16
2024-25,202410300CHO,10/30/2024,CHO vs TOR,Miles Bridges,bridgmi02,73,CHO,1,TOR,7,3,2,0,1,2,23.9,0,3,2,11,1,7,2,2,0,1,5,9,10,12,14.6
2024-25,202410300LAC,10/30/2024,LAC vs POR,Scoot Henderson,hendesc01,67,POR,0,LAC,14,3,6,1,0,3,24.08333333,0,3,5,8,2,3,2,3,4,1,9,20,17,23,26.6
2024-25,202410300MEM,10/30/2024,MEM vs BRK,Ziaire Williams,willizi02,56,BRK,0,MEM,17,1,3,4,1,3,24.1,0,1,6,10,1,4,4,5,3,5,4,20,18,21,34.7
2024-25,202410300WAS,10/30/2024,WAS vs ATL,Onyeka Okongwu,okongon01,59,ATL,0,WAS,2,3,2,0,0,0,24.11666667,1,2,1,5,0,4,0,0,1,0,5,4,5,7,8.6
2024-25,202410300CLE,10/30/2024,CLE vs LAL,D'Angelo Russell,russeda01,82,LAL,0,CLE,10,3,5,0,0,0,24.13333333,1,2,2,7,0,3,6,6,0,0,8,15,13,18,21.1
2024-25,202410300MEM,10/30/2024,MEM vs BRK,Ben Simmons,simmobe01,19,BRK,0,MEM,8,5,3,1,0,2,24.51666667,2,3,4,5,0,0,0,0,5,1,8,11,13,16,19.5
2024-25,202410300IND,10/30/2024,IND vs BOS,Jrue Holiday,holidjr01,74,BOS,0,IND,8,3,4,0,0,3,24.66666667,1,2,3,9,1,3,1,2,2,0,7,12,11,15,14.6
2024-25,202410300CHO,10/30/2024,CHO vs TOR,Cody Martin,martico01,32,CHO,1,TOR,25,4,2,1,0,0,24.83333333,1,3,9,11,4,6,3,4,4,1,6,27,29,31,35.8
2024-25,202410300WAS,10/30/2024,WAS vs ATL,Jonas Valanciunas,valanjo01,86,WAS,1,ATL,22,8,6,0,0,3,24.88333333,1,7,8,10,1,1,5,6,3,0,14,28,30,36,37.6
2024-25,202410300MIA,10/30/2024,MIA vs NYK,Miles McBride,mcbrimi01,72,NYK,0,MIA,10,3,2,2,1,2,25.03333333,1,2,3,8,2,5,2,2,1,3,5,12,13,15,23.6
2024-25,202410300OKC,10/30/2024,OKC vs SAS,Luguentz Dort,dortlu01,83,OKC,1,SAS,20,6,1,0,2,0,25.08333333,3,3,7,9,6,8,0,0,1,2,7,21,26,27,34.7
2024-25,202410300IND,10/30/2024,IND vs BOS,Isaiah Jackson,jacksis01,64,IND,1,BOS,10,5,0,2,2,1,25.11666667,2,3,3,5,0,0,4,4,6,4,5,10,15,15,27
2024-25,202410300CHO,10/30/2024,CHO vs TOR,Jonathan Mogbo,mogbojo01,5,TOR,0,CHO,11,4,2,1,2,1,25.28333333,2,2,5,7,0,0,1,2,2,3,6,13,15,17,26.8
2024-25,202410300PHI,10/30/2024,PHI vs DET,Malik Beasley,beaslma01,84,DET,0,PHI,11,3,3,0,0,1,25.5,2,1,4,11,3,10,0,1,1,0,6,14,14,17,18.1
2024-25,202410300MEM,10/30/2024,MEM vs BRK,Jake LaRavia,laravja01,40,MEM,1,BRK,3,7,5,0,1,2,25.63333333,5,2,1,10,0,2,1,2,3,1,12,8,10,15,19.9
2024-25,202410300GSW,10/30/2024,GSW vs NOP,Javonte Green,greenja02,14,NOP,0,GSW,5,5,2,3,2,1,25.68333333,2,3,1,5,1,4,2,2,1,5,7,7,10,12,28
2024-25,202410300OKC,10/30/2024,OKC vs SAS,Chris Paul,paulch01,62,SAS,0,OKC,14,5,9,1,1,3,26.2,1,4,5,9,3,7,1,1,1,2,14,23,19,28,36.5
2024-25,202410300CLE,10/30/2024,CLE vs LAL,Dean Wade,wadede01,59,CLE,1,LAL,8,3,2,3,0,1,26.45,0,3,3,7,2,6,0,2,2,3,5,10,11,13,22.6
2024-25,202410300CHO,10/30/2024,CHO vs TOR,Seth Curry,curryse01,48,CHO,1,TOR,7,2,1,0,0,2,26.53333333,2,0,2,4,1,2,2,2,0,0,3,8,9,10,8.9
2024-25,202410300OKC,10/30/2024,OKC vs SAS,Jalen Williams,willija06,75,OKC,1,SAS,12,7,8,4,1,1,26.7,0,7,5,13,1,3,1,2,3,5,15,20,19,27,46.4
2024-25,202410300MEM,10/30/2024,MEM vs BRK,Jalen Wilson,wilsoja03,48,BRK,0,MEM,12,7,2,0,0,2,26.85,3,4,5,7,1,3,1,2,1,0,9,14,19,21,21.4
2024-25,202410300LAC,10/30/2024,LAC vs POR,Amir Coffey,coffeam01,74,LAC,1,POR,9,0,0,0,0,0,26.93333333,0,0,4,7,1,3,0,0,2,0,0,9,9,9,9
2024-25,202410300MIA,10/30/2024,MIA vs NYK,Nikola Jovic,jovicni01,50,MIA,1,NYK,10,6,1,0,0,0,27,1,5,4,7,2,4,0,2,1,0,7,11,16,17,18.7
2024-25,202410300GSW,10/30/2024,GSW vs NOP,Jonathan Kuminga,kuminjo01,79,GSW,1,NOP,16,4,2,1,0,1,27.25,2,2,6,12,0,1,4,5,4,1,6,18,20,22,25.8
2024-25,202410300OKC,10/30/2024,OKC vs SAS,Victor Wembanyama,wembavi01,75,SAS,0,OKC,6,8,2,0,3,4,27.25,1,7,1,5,0,3,4,4,0,3,10,8,14,16,23.6
2024-25,202410300CLE,10/30/2024,CLE vs LAL,Max Christie,chrisma02,73,LAL,0,CLE,6,1,1,1,0,0,27.26666667,0,1,1,6,1,5,3,4,0,1,2,7,7,8,11.7
2024-25,202410300MIA,10/30/2024,MIA vs NYK,Jaime Jaquez Jr.,jaqueja01,79,MIA,1,NYK,8,8,4,0,0,1,27.3,2,6,2,10,0,2,4,8,4,0,12,12,16,20,22.6
2024-25,202410300OKC,10/30/2024,OKC vs SAS,Shai Gilgeous-Alexander,gilgesh01,79,OKC,1,SAS,18,4,5,1,0,1,27.58333333,0,4,7,20,2,10,2,2,1,1,9,23,22,27,32.3
2024-25,202410300OKC,10/30/2024,OKC vs SAS,Chet Holmgren,holmgch01,86,OKC,1,SAS,19,5,2,2,2,5,27.81666667,0,5,7,10,3,3,2,2,3,4,7,21,24,26,35
2024-25,202410300PHI,10/30/2024,PHI vs DET,Andre Drummond,drumman01,83,PHI,1,DET,9,11,0,1,0,1,27.83333333,4,7,3,5,0,0,3,6,3,1,11,9,20,20,24.2
2024-25,202410300CLE,10/30/2024,CLE vs LAL,Austin Reaves,reaveau01,88,LAL,0,CLE,7,2,3,0,0,4,27.83333333,0,2,2,6,1,4,2,2,0,0,5,10,9,12,9.9
2024-25,202410300MEM,10/30/2024,MEM vs BRK,Dorian Finney-Smith,finnedo01,73,BRK,0,MEM,7,5,4,2,0,3,28.1,1,4,3,8,1,4,0,0,4,2,9,11,12,16,22
2024-25,202410300CHO,10/30/2024,CHO vs TOR,Tre Mann,manntr01,45,CHO,1,TOR,27,1,4,2,1,2,28.21666667,0,1,10,19,4,8,3,3,5,3,5,31,28,32,41.2
2024-25,202410300CLE,10/30/2024,CLE vs LAL,Rui Hachimura,hachiru01,74,LAL,0,CLE,8,5,2,1,0,2,28.28333333,0,5,4,6,0,1,0,0,1,1,7,10,13,15,18
2024-25,202410300MEM,10/30/2024,MEM vs BRK,Jaren Jackson Jr.,jacksja02,69,MEM,1,BRK,30,4,0,3,0,2,28.3,0,4,10,12,3,3,7,10,4,3,4,30,34,34,41.8
2024-25,202410300CHI,10/30/2024,CHI vs ORL,Wendell Carter Jr.,cartewe01,60,ORL,0,CHI,14,7,2,1,1,0,28.41666667,0,7,5,10,0,4,4,4,4,2,9,16,21,23,31.4
2024-25,202410300CHO,10/30/2024,CHO vs TOR,Davion Mitchell,mitchda01,77,TOR,0,CHO,11,2,11,0,0,2,28.43333333,1,1,5,11,0,5,1,2,4,0,13,22,13,24,27.9
2024-25,202410300CHO,10/30/2024,CHO vs TOR,Ochai Agbaji,agbajoc01,83,TOR,0,CHO,10,3,3,0,2,2,28.81666667,0,3,3,6,1,3,3,3,1,2,6,13,13,16,22.1
2024-25,202410300CLE,10/30/2024,CLE vs LAL,LeBron James,jamesle01,77,LAL,0,CLE,26,6,3,0,0,6,28.96666667,1,5,9,13,1,3,7,7,2,0,9,29,32,35,31.7
2024-25,202410300GSW,10/30/2024,GSW vs NOP,Buddy Hield,hieldbu01,90,GSW,1,NOP,21,2,3,1,1,0,29,2,0,8,19,4,12,1,1,1,2,5,24,23,26,33.9
2024-25,202410300LAC,10/30/2024,LAC vs POR,Deni Avdija,avdijde01,80,POR,0,LAC,13,10,2,1,2,2,29.03333333,0,10,3,8,1,3,6,6,2,3,12,15,23,25,35
2024-25,202410300CHI,10/30/2024,CHI vs ORL,Ayo Dosunmu,dosunay01,81,CHI,1,ORL,12,4,4,0,1,0,29.13333333,0,4,6,8,0,1,0,1,1,1,8,16,16,20,25.8
2024-25,202410300MEM,10/30/2024,MEM vs BRK,Ja Morant,moranja01,13,MEM,1,BRK,14,8,11,0,0,5,29.13333333,2,6,5,16,1,6,3,4,3,0,19,25,22,33,35.1
2024-25,202410300OKC,10/30/2024,OKC vs SAS,Cason Wallace,wallaca01,86,OKC,1,SAS,9,1,2,2,1,1,29.13333333,1,0,4,9,1,3,0,0,3,3,3,11,10,12,21.2
2024-25,202410300OKC,10/30/2024,OKC vs SAS,Keldon Johnson,johnske04,73,SAS,0,OKC,9,7,2,2,0,3,29.43333333,1,6,4,11,1,5,0,0,1,2,9,11,16,18,23.4
2024-25,202410300OKC,10/30/2024,OKC vs SAS,Harrison Barnes,barneha02,86,SAS,0,OKC,18,4,1,1,0,1,29.68333333,4,0,7,12,2,3,2,2,0,1,5,19,22,23,26.3
2024-25,202410300CHI,10/30/2024,CHI vs ORL,Patrick Williams,willipa01,48,CHI,1,ORL,10,7,2,1,0,1,29.78333333,1,6,3,8,3,5,1,2,0,1,9,12,17,19,23.4
2024-25,202410300GSW,10/30/2024,GSW vs NOP,Lindy Waters III,waterli01,43,GSW,1,NOP,3,1,3,1,1,0,29.96666667,0,1,1,5,1,5,0,0,1,2,4,6,4,7,14.7
2024-25,202410300GSW,10/30/2024,GSW vs NOP,Moses Moody,moodymo01,71,GSW,1,NOP,8,4,3,0,0,3,30.1,1,3,3,9,2,6,0,0,3,0,7,11,12,15,14.3
2024-25,202410300GSW,10/30/2024,GSW vs NOP,Draymond Green,greendr01,60,GSW,1,NOP,14,4,6,1,5,3,30.11666667,1,3,5,11,3,5,1,1,5,6,10,20,18,24,42.8
2024-25,202410300IND,10/30/2024,IND vs BOS,Aaron Nesmith,nesmiaa01,78,IND,1,BOS,12,8,3,0,1,1,30.36666667,1,7,5,9,2,4,0,0,6,1,11,15,20,23,28.1
2024-25,202410300CLE,10/30/2024,CLE vs LAL,Donovan Mitchell,mitchdo01,60,CLE,1,LAL,24,3,7,3,0,2,30.45,1,2,10,20,4,10,0,0,3,3,10,31,27,34,45.1
2024-25,202410300PHI,10/30/2024,PHI vs DET,Tim Hardaway Jr.,hardati02,84,DET,0,PHI,16,0,3,0,0,1,30.55,0,0,5,9,5,7,1,2,2,0,3,19,16,19,19.5
2024-25,202410300CLE,10/30/2024,CLE vs LAL,Jarrett Allen,allenja01,82,CLE,1,LAL,20,17,1,0,2,0,30.66666667,3,14,9,12,0,0,2,2,0,2,18,21,37,38,47.9
2024-25,202410300PHI,10/30/2024,PHI vs DET,Kelly Oubre Jr.,oubreke01,72,PHI,1,DET,13,7,1,0,0,1,30.9,2,5,5,14,2,6,1,2,2,0,8,14,20,21,21.9
2024-25,202410300CHI,10/30/2024,CHI vs ORL,Josh Giddey,giddejo01,85,CHI,1,ORL,20,11,5,1,0,1,31.15,1,10,6,11,4,4,4,6,2,1,16,25,31,36,42.7
2024-25,202410300LAC,10/30/2024,LAC vs POR,Ivica Zubac,zubaciv01,72,LAC,1,POR,6,12,1,1,2,0,31.23333333,4,8,2,7,0,0,2,6,4,3,13,7,18,19,30.9
2024-25,202410300CLE,10/30/2024,CLE vs LAL,Anthony Davis,davisan02,82,LAL,0,CLE,22,13,2,2,0,4,31.33333333,1,12,9,17,0,1,4,8,1,2,15,24,35,37,42.6
2024-25,202410300OKC,10/30/2024,OKC vs SAS,Jeremy Sochan,sochaje01,78,SAS,0,OKC,17,9,4,1,0,1,31.35,3,6,7,16,0,1,3,4,3,1,13,21,26,30,35.8
2024-25,202410300WAS,10/30/2024,WAS vs ATL,Kyshawn George,georgky01,4,WAS,1,ATL,11,2,4,3,0,0,31.55,0,2,5,10,1,5,0,0,4,3,6,15,13,17,28.4
2024-25,202410300LAC,10/30/2024,LAC vs POR,James Harden,hardeja01,76,LAC,1,POR,19,5,10,3,0,5,31.71666667,0,5,6,18,5,11,2,4,2,3,15,29,24,34,44
2024-25,202410300WAS,10/30/2024,WAS vs ATL,David Roddy,roddyda01,68,ATL,0,WAS,17,4,1,2,0,4,31.76666667,0,4,5,10,1,4,6,6,4,2,5,18,21,22,25.3
2024-25,202410300WAS,10/30/2024,WAS vs ATL,Jordan Poole,poolejo01,82,WAS,1,ATL,24,3,9,3,0,5,32.3,1,2,6,17,4,9,8,8,4,3,12,33,27,36,45.1
2024-25,202410300GSW,10/30/2024,GSW vs NOP,Brandon Ingram,ingrabr01,69,NOP,0,GSW,14,5,6,0,0,2,32.36666667,1,4,5,11,2,6,2,2,2,0,11,20,19,25,27
2024-25,202410300CHO,10/30/2024,CHO vs TOR,LaMelo Ball,ballla01,26,CHO,1,TOR,19,3,6,2,0,6,32.4,0,3,7,20,4,12,1,1,4,2,9,25,22,28,31.6
2024-25,202410300PHI,10/30/2024,PHI vs DET,Caleb Martin,martica02,68,PHI,1,DET,7,5,1,0,0,2,32.58333333,1,4,2,10,1,3,2,4,4,0,6,8,12,13,12.5
2024-25,202410300LAC,10/30/2024,LAC vs POR,Derrick Jones Jr.,jonesde02,80,LAC,1,POR,9,8,2,1,1,0,32.68333333,2,6,4,11,1,3,0,0,1,2,10,11,17,19,27.6
2024-25,202410300GSW,10/30/2024,GSW vs NOP,Zion Williamson,willizi01,74,NOP,0,GSW,12,12,4,0,1,4,32.73333333,6,6,5,20,0,1,2,7,3,1,16,16,24,28,31.4
2024-25,202410300WAS,10/30/2024,WAS vs ATL,Carlton Carrington,carrica01,4,WAS,1,ATL,16,6,6,0,0,2,32.86666667,0,6,5,8,1,2,5,5,3,0,12,22,22,28,30.2
2024-25,202410300MIA,10/30/2024,MIA vs NYK,Bam Adebayo,adebaba01,75,MIA,1,NYK,11,3,4,1,0,1,32.88333333,1,2,3,7,0,2,5,6,3,1,7,15,14,18,22.6
2024-25,202410300CHO,10/30/2024,CHO vs TOR,Nick Richards,richani01,71,CHO,1,TOR,24,14,4,1,4,1,33.13333333,7,7,10,14,0,0,4,7,3,5,18,28,38,42,60.8
2024-25,202410300MEM,10/30/2024,MEM vs BRK,Cam Thomas,thomaca02,71,BRK,0,MEM,19,2,2,1,0,3,33.3,0,2,4,12,1,6,10,11,2,1,4,21,21,23,24.4
2024-25,202410300CHO,10/30/2024,CHO vs TOR,RJ Barrett,barrerj01,60,TOR,0,CHO,31,4,8,2,0,3,33.33333333,1,3,10,18,4,6,7,12,3,2,12,39,35,43,50.8
2024-25,202410300IND,10/30/2024,IND vs BOS,Obi Toppin,toppiob01,88,IND,1,BOS,18,7,3,1,1,2,33.41666667,3,4,6,15,2,7,4,4,2,2,10,21,25,28,34.9
2024-25,202410300LAC,10/30/2024,LAC vs POR,Deandre Ayton,aytonde01,60,POR,0,LAC,15,12,1,1,1,1,33.55,3,9,7,15,1,3,0,0,2,2,13,16,27,28,35.9
2024-25,202410300LAC,10/30/2024,LAC vs POR,Jerami Grant,grantje01,59,POR,0,LAC,8,3,1,0,0,2,33.71666667,2,1,3,14,2,7,0,0,2,0,4,9,11,12,11.1
2024-25,202410300MEM,10/30/2024,MEM vs BRK,Dennis Schroder,schrode01,85,BRK,0,MEM,33,2,8,1,0,2,33.93333333,0,2,11,14,6,9,5,5,1,1,10,41,35,43,48.4
2024-25,202410300CHI,10/30/2024,CHI vs ORL,Kentavious Caldwell-Pope,caldwke01,81,ORL,0,CHI,8,1,1,1,0,0,33.95,1,0,3,9,2,7,0,0,3,1,2,9,9,10,13.7
2024-25,202410300PHI,10/30/2024,PHI vs DET,Isaiah Stewart,stewais01,51,DET,0,PHI,7,11,3,1,3,1,34.48333333,5,6,1,3,0,0,5,5,4,4,14,10,18,21,35.7
2024-25,202410300WAS,10/30/2024,WAS vs ATL,Bilal Coulibaly,coulibi01,67,WAS,1,ATL,27,9,1,3,1,2,34.53333333,4,5,11,14,3,5,2,2,4,4,10,28,36,37,49.3
2024-25,202410300MIA,10/30/2024,MIA vs NYK,Terry Rozier,roziete01,65,MIA,1,NYK,16,4,7,2,0,2,34.71666667,0,4,5,14,4,8,2,2,2,2,11,23,20,27,35.3
2024-25,202410300WAS,10/30/2024,WAS vs ATL,Zaccharie Risacher,risacza01,5,ATL,0,WAS,17,6,2,1,2,3,34.78333333,3,3,7,15,2,7,1,1,5,3,8,19,23,25,33.2
2024-25,202410300GSW,10/30/2024,GSW vs NOP,Jose Alvarado,alvarjo01,61,NOP,0,GSW,16,5,4,1,2,1,34.95,1,4,6,13,4,8,0,0,2,3,9,20,21,25,36
2024-25,202410300LAC,10/30/2024,LAC vs POR,Norman Powell,powelno01,80,LAC,1,POR,30,5,2,1,0,1,35.05,0,5,11,22,5,10,3,3,1,1,7,32,35,37,41
2024-25,202410300PHI,10/30/2024,PHI vs DET,Tobias Harris,harrito02,75,DET,0,PHI,18,14,1,0,1,1,35.08333333,0,14,8,18,0,3,2,2,5,1,15,19,32,33,38.3
2024-25,202410300CHO,10/30/2024,CHO vs TOR,Jakob Poeltl,poeltja01,55,TOR,0,CHO,20,16,2,2,0,1,35.11666667,5,11,10,14,0,0,0,0,4,2,18,22,36,38,47.2
2024-25,202410300CHI,10/30/2024,CHI vs ORL,Jalen Suggs,suggsja01,80,ORL,0,CHI,17,6,5,4,2,4,35.2,0,6,7,16,3,9,0,0,3,6,11,22,23,28,45.7
2024-25,202410300MEM,10/30/2024,MEM vs BRK,Cameron Johnson,johnsca02,63,BRK,0,MEM,14,2,4,0,1,0,35.23333333,0,2,4,12,4,8,2,2,3,1,6,18,16,20,25.4
2024-25,202410300MIA,10/30/2024,MIA vs NYK,Tyler Herro,herroty01,46,MIA,1,NYK,34,5,7,1,0,1,35.31666667,0,5,12,20,8,13,2,2,2,1,12,41,39,46,52.5
2024-25,202410300CHI,10/30/2024,CHI vs ORL,Nikola Vucevic,vucevni01,81,CHI,1,ORL,18,14,5,1,1,4,35.5,6,8,7,16,0,3,4,4,4,2,19,23,32,37,44.3
2024-25,202410300CHI,10/30/2024,CHI vs ORL,Zach LaVine,lavinza01,30,CHI,1,ORL,11,10,3,1,0,4,35.61666667,0,10,2,9,1,4,6,8,2,1,13,14,21,24,26.5
2024-25,202410300CHO,10/30/2024,CHO vs TOR,Gradey Dick,dickgr01,65,TOR,0,CHO,30,2,1,3,0,3,35.63333333,1,1,11,17,2,6,6,8,6,3,3,31,32,33,39.9
2024-25,202410300LAC,10/30/2024,LAC vs POR,Anfernee Simons,simonan01,51,POR,0,LAC,25,2,6,0,0,1,36.28333333,0,2,10,24,3,9,2,2,0,0,8,31,27,33,35.4
2024-25,202410300MIA,10/30/2024,MIA vs NYK,Jalen Brunson,brunsja01,81,NYK,0,MIA,22,2,9,0,0,1,36.36666667,0,2,6,18,3,7,7,8,0,0,11,31,24,33,36.9
2024-25,202410300PHI,10/30/2024,PHI vs DET,Cade Cunningham,cunnica01,67,DET,0,PHI,22,5,7,1,1,5,36.6,1,4,6,15,4,8,6,6,2,2,12,29,27,34,39.5
2024-25,202410300PHI,10/30/2024,PHI vs DET,Jaden Ivey,iveyja01,82,DET,0,PHI,23,3,3,2,0,4,36.7,0,3,9,17,3,7,2,2,3,2,6,26,26,29,33.1
2024-25,202410300WAS,10/30/2024,WAS vs ATL,Corey Kispert,kispeco01,84,WAS,1,ATL,16,1,2,0,0,0,36.76666667,0,1,6,14,4,11,0,0,1,0,3,18,17,19,20.2
2024-25,202410300MIA,10/30/2024,MIA vs NYK,OG Anunoby,anunoog01,54,NYK,0,MIA,11,3,0,2,0,3,36.86666667,0,3,3,6,3,6,2,2,2,2,3,11,14,14,17.6
2024-25,202410300IND,10/30/2024,IND vs BOS,Derrick White,whitede01,78,BOS,0,IND,23,3,1,1,1,2,37.08333333,1,2,8,9,5,5,2,2,4,2,4,24,26,27,32.1
2024-25,202410300CHI,10/30/2024,CHI vs ORL,Paolo Banchero,banchpa01,85,ORL,0,CHI,31,7,4,0,0,4,37.25,0,7,12,22,2,9,5,7,2,0,11,35,38,42,41.4
2024-25,202410300CHI,10/30/2024,CHI vs ORL,Coby White,whiteco01,84,CHI,1,ORL,21,2,3,1,0,2,37.36666667,0,2,8,16,4,10,1,2,2,1,5,24,23,26,28.9
2024-25,202410300MIA,10/30/2024,MIA vs NYK,Jimmy Butler,butleji01,64,MIA,1,NYK,15,4,4,2,0,4,37.4,2,2,6,9,0,2,3,4,3,2,8,19,19,23,27.8
2024-25,202410300IND,10/30/2024,IND vs BOS,Pascal Siakam,siakapa01,85,IND,1,BOS,29,11,5,0,0,2,37.68333333,5,6,11,20,6,8,1,4,2,0,16,34,40,45,47.7
2024-25,202410300GSW,10/30/2024,GSW vs NOP,Brandin Podziemski,podzibr01,79,GSW,1,NOP,13,8,7,1,0,4,38.1,2,6,5,15,2,7,1,2,2,1,15,20,21,28,32.1
2024-25,202410300IND,10/30/2024,IND vs BOS,Payton Pritchard,pritcpa01,87,BOS,0,IND,16,4,4,1,0,1,38.56666667,2,2,5,14,4,11,2,2,2,1,8,20,20,24,28.8
2024-25,202410300MIA,10/30/2024,MIA vs NYK,Karl-Anthony Towns,townska01,66,NYK,0,MIA,44,13,2,0,0,2,38.78333333,3,10,17,25,4,5,6,6,5,0,15,46,57,59,60.6
2024-25,202410300GSW,10/30/2024,GSW vs NOP,Jordan Hawkins,hawkijo01,72,NOP,0,GSW,23,4,1,0,0,2,38.81666667,1,3,9,21,4,14,1,2,3,0,5,24,27,28,27.3
2024-25,202410300IND,10/30/2024,IND vs BOS,Tyrese Haliburton,halibty01,75,IND,1,BOS,17,6,12,2,0,1,39.81666667,0,6,7,19,2,10,1,1,5,2,18,29,23,35,47.2
2024-25,202410300MIA,10/30/2024,MIA vs NYK,Mikal Bridges,bridgmi01,86,NYK,0,MIA,17,3,6,2,2,1,39.85,1,2,6,16,4,11,1,2,2,4,9,23,20,26,40.6
2024-25,202410300PHI,10/30/2024,PHI vs DET,Tyrese Maxey,maxeyty01,74,PHI,1,DET,32,3,7,2,0,1,40.06666667,0,3,12,25,2,10,6,7,3,2,10,39,35,42,51.1
2024-25,202410300LAC,10/30/2024,LAC vs POR,Toumani Camara,camarto01,75,POR,0,LAC,12,1,1,3,1,1,40.2,0,1,5,10,2,4,0,0,2,4,2,13,13,14,25.7
2024-25,202410300WAS,10/30/2024,WAS vs ATL,Jalen Johnson,johnsja05,61,ATL,0,WAS,21,17,4,3,0,3,40.35,6,11,9,21,1,5,2,5,1,3,21,25,38,42,53.4
2024-25,202410300WAS,10/30/2024,WAS vs ATL,Trae Young,youngtr01,59,ATL,0,WAS,35,4,15,2,0,3,40.36666667,2,2,12,28,4,13,7,7,2,2,19,50,39,54,65.3
2024-25,202410300MIA,10/30/2024,MIA vs NYK,Josh Hart,hartjo01,85,NYK,0,MIA,10,14,6,1,0,0,42.25,1,13,4,7,2,5,0,0,3,1,20,16,24,30,38.8
2024-25,202410300IND,10/30/2024,IND vs BOS,Bennedict Mathurin,mathube01,65,IND,1,BOS,30,11,4,0,0,4,42.63333333,3,8,9,17,2,5,10,11,2,0,15,34,41,45,45.2
2024-25,202410300IND,10/30/2024,IND vs BOS,Jaylen Brown,brownja02,75,BOS,0,IND,25,6,5,2,2,3,43.13333333,0,6,11,30,1,11,2,4,4,4,11,30,31,36,48.7
2024-25,202410300IND,10/30/2024,IND vs BOS,Jayson Tatum,tatumja01,79,BOS,0,IND,37,8,4,4,0,3,43.36666667,1,7,10,25,5,18,12,15,3,4,12,41,45,49,61.6
2024-25,202410290GSW,10/29/2024,GSW vs NOP,Jeremiah Robinson-Earl,robinje02,43,NOP,0,GSW,5,1,0,0,0,0,11.45,1,0,2,3,1,1,0,0,0,0,1,5,6,6,6.2
2024-25,202410290MIN,10/29/2024,MIN vs DAL,Quentin Grimes,grimequ01,55,DAL,0,MIN,9,1,0,1,0,2,12.15,0,1,3,5,3,5,0,0,0,1,1,9,10,10,11.2
2024-25,202410290BRK,10/29/2024,BRK vs DEN,Dario Saric,saricda01,68,DEN,0,BRK,3,2,0,0,0,0,12.48333333,1,1,1,2,0,0,1,2,0,0,2,3,5,5,5.4
2024-25,202410290BRK,10/29/2024,BRK vs DEN,Noah Clowney,clownno01,27,BRK,1,DEN,0,3,1,0,1,0,15.56666667,0,3,0,2,0,0,0,0,2,1,4,1,3,4,8.1
2024-25,202410290UTA,10/29/2024,UTA vs SAC,Brice Sensabaugh,sensabr01,36,UTA,1,SAC,11,3,1,0,0,1,15.7,1,2,4,8,3,5,0,0,1,0,4,12,14,15,15.1
2024-25,202410290MIN,10/29/2024,MIN vs DAL,Naji Marshall,marshna01,70,DAL,0,MIN,4,3,3,2,0,0,16.2,0,3,0,3,0,0,4,4,1,2,6,7,7,10,18.1
2024-25,202410290BRK,10/29/2024,BRK vs DEN,Shake Milton,miltosh01,52,BRK,1,DEN,3,1,2,1,0,0,16.55,0,1,1,5,1,5,0,0,2,1,3,5,4,6,10.2
2024-25,202410290GSW,10/29/2024,GSW vs NOP,Trayce Jackson-Davis,jackstr02,72,GSW,1,NOP,3,2,5,0,1,1,16.91666667,0,2,1,1,0,0,1,2,0,1,7,8,5,10,14.9
2024-25,202410290UTA,10/29/2024,UTA vs SAC,Keon Ellis,elliske01,60,SAC,0,UTA,5,4,2,2,3,1,17.31666667,1,3,2,4,0,2,1,2,4,5,6,7,9,11,26.8
2024-25,202410290UTA,10/29/2024,UTA vs SAC,Lauri Markkanen,markkla01,59,UTA,1,SAC,7,3,1,0,0,2,17.45,1,2,3,5,1,3,0,0,1,0,4,8,10,11,10.1
2024-25,202410290GSW,10/29/2024,GSW vs NOP,Moses Moody,moodymo01,70,GSW,1,NOP,17,2,1,0,1,1,17.5,0,2,6,8,5,6,0,0,2,1,3,18,19,20,22.9
2024-25,202410290UTA,10/29/2024,UTA vs SAC,Patty Mills,millspa02,36,UTA,1,SAC,0,1,0,1,1,0,17.55,0,1,0,1,0,1,0,0,0,2,1,0,1,1,7.2
2024-25,202410290UTA,10/29/2024,UTA vs SAC,Collin Sexton,sextoco01,82,UTA,1,SAC,4,2,1,0,0,3,17.88333333,0,2,0,7,0,5,4,4,1,0,3,5,6,7,4.9
2024-25,202410290MIN,10/29/2024,MIN vs DAL,Spencer Dinwiddie,dinwisp01,79,DAL,0,MIN,3,2,2,1,0,1,18.08333333,0,2,1,5,1,5,0,0,2,1,4,5,5,7,10.4
2024-25,202410290GSW,10/29/2024,GSW vs NOP,Javonte Green,greenja02,13,NOP,0,GSW,3,6,1,1,0,1,19.4,2,4,1,2,1,1,0,0,0,1,7,4,9,10,13.7
2024-25,202410290BRK,10/29/2024,BRK vs DEN,Peyton Watson,watsope01,84,DEN,0,BRK,7,2,0,0,0,0,19.75,0,2,3,5,1,2,0,0,5,0,2,7,9,9,9.4
2024-25,202410290GSW,10/29/2024,GSW vs NOP,Kyle Anderson,anderky01,83,GSW,1,NOP,1,2,4,5,0,0,19.81666667,0,2,0,9,0,6,1,2,1,5,6,5,3,7,24.4
2024-25,202410290GSW,10/29/2024,GSW vs NOP,Kevon Looney,looneke01,78,GSW,1,NOP,4,9,2,2,1,1,19.95,5,4,2,5,0,0,0,0,4,3,11,6,13,15,25.8
2024-25,202410290GSW,10/29/2024,GSW vs NOP,Herbert Jones,joneshe01,80,NOP,0,GSW,5,3,0,1,0,1,20.01666667,0,3,2,3,1,2,0,0,0,1,3,5,8,8,10.6
2024-25,202410290UTA,10/29/2024,UTA vs SAC,Trey Lyles,lylestr01,62,SAC,0,UTA,2,7,1,2,2,0,20.26666667,0,7,1,2,0,1,0,0,3,4,8,3,9,10,23.9
2024-25,202410290BRK,10/29/2024,BRK vs DEN,Russell Westbrook,westbru01,72,DEN,0,BRK,22,1,5,1,0,1,20.56666667,0,1,5,12,2,2,10,10,2,1,6,27,23,28,32.7
2024-25,202410290MIN,10/29/2024,MIN vs DAL,Daniel Gafford,gaffoda01,78,DAL,0,MIN,14,4,1,1,1,0,20.73333333,1,3,6,6,0,0,2,2,3,2,5,15,18,19,26.3
2024-25,202410290BRK,10/29/2024,BRK vs DEN,Jalen Wilson,wilsoja03,47,BRK,1,DEN,11,6,2,1,0,0,20.96666667,2,4,3,6,2,5,3,3,2,1,8,13,17,19,24.2
2024-25,202410290GSW,10/29/2024,GSW vs NOP,Daniel Theis,theisda01,64,NOP,0,GSW,5,7,3,0,1,1,21.28333333,1,6,2,5,0,2,1,2,2,1,10,8,12,15,19.9
2024-25,202410290MIN,10/29/2024,MIN vs DAL,Mike Conley,conlemi01,80,MIN,1,DAL,9,4,6,0,0,2,21.58333333,1,3,2,6,2,4,3,3,4,0,10,15,13,19,20.8
2024-25,202410290GSW,10/29/2024,GSW vs NOP,Jose Alvarado,alvarjo01,60,NOP,0,GSW,6,0,4,1,0,2,21.76666667,0,0,2,4,0,2,2,2,1,1,4,10,6,10,13
2024-25,202410290GSW,10/29/2024,GSW vs NOP,Yves Missi,missiyv01,4,NOP,0,GSW,9,7,3,0,2,2,21.81666667,1,6,4,6,0,0,1,5,1,2,10,12,16,19,25.9
2024-25,202410290BRK,10/29/2024,BRK vs DEN,Ziaire Williams,willizi02,55,BRK,1,DEN,18,3,4,0,1,2,22.01666667,2,1,7,8,4,5,0,0,3,1,7,22,21,25,28.6
2024-25,202410290BRK,10/29/2024,BRK vs DEN,Julian Strawther,strawju01,54,DEN,0,BRK,7,4,0,1,0,1,22.26666667,0,4,3,6,1,3,0,0,0,1,4,7,11,11,13.8
2024-25,202410290UTA,10/29/2024,UTA vs SAC,John Collins,collijo01,72,UTA,1,SAC,18,7,0,1,1,2,23,4,3,7,16,1,4,3,3,4,2,7,18,25,25,30.4
2024-25,202410290MIN,10/29/2024,MIN vs DAL,Nickeil Alexander-Walker,alexani01,86,MIN,1,DAL,11,2,3,1,0,1,24.03333333,1,1,4,7,3,5,0,0,3,1,5,14,13,16,19.9
2024-25,202410290UTA,10/29/2024,UTA vs SAC,Kyle Filipowski,filipky01,3,UTA,1,SAC,12,8,2,1,0,2,24.95,2,6,5,10,2,5,0,2,1,1,10,14,20,22,25.6
2024-25,202410290UTA,10/29/2024,UTA vs SAC,Jordan Clarkson,clarkjo01,59,UTA,1,SAC,21,5,3,0,0,1,25.61666667,1,4,8,16,2,7,3,3,3,0,8,24,26,29,30.5
2024-25,202410290MIN,10/29/2024,MIN vs DAL,Naz Reid,reidna01,85,MIN,1,DAL,14,9,2,0,1,5,25.66666667,0,9,5,8,2,5,2,2,1,1,11,16,23,25,25.8
2024-25,202410290GSW,10/29/2024,GSW vs NOP,Jordan Hawkins,hawkijo01,71,NOP,0,GSW,4,2,1,1,0,2,25.76666667,0,2,0,6,0,1,4,4,3,1,3,5,6,7,8.9
2024-25,202410290UTA,10/29/2024,UTA vs SAC,Walker Kessler,kesslwa01,68,UTA,1,SAC,4,8,2,1,2,1,25.76666667,2,6,2,3,0,0,0,0,2,3,10,6,12,14,24.6
2024-25,202410290UTA,10/29/2024,UTA vs SAC,Malik Monk,monkma01,76,SAC,0,UTA,7,4,3,0,1,1,26.03333333,0,4,2,11,2,8,1,2,1,1,7,10,11,14,18.3
2024-25,202410290BRK,10/29/2024,BRK vs DEN,Nic Claxton,claxtni01,75,BRK,1,DEN,16,12,2,0,3,0,26.13333333,2,10,8,9,0,0,0,0,6,3,14,18,28,30,42.4
2024-25,202410290MIN,10/29/2024,MIN vs DAL,Donte DiVincenzo,divindo01,85,MIN,1,DAL,3,2,6,2,0,1,26.45,0,2,1,6,1,5,0,0,1,2,8,9,5,11,19.4
2024-25,202410290UTA,10/29/2024,UTA vs SAC,Kevin Huerter,huertke01,68,SAC,0,UTA,14,5,0,2,1,0,26.95,1,4,6,9,2,5,0,0,1,3,5,14,19,19,29
2024-25,202410290MIN,10/29/2024,MIN vs DAL,Dereck Lively II,livelde01,59,DAL,0,MIN,5,9,1,3,1,1,26.95,4,5,2,3,0,0,1,2,4,4,10,6,14,15,28.3
2024-25,202410290GSW,10/29/2024,GSW vs NOP,Jonathan Kuminga,kuminjo01,78,GSW,1,NOP,17,3,3,2,1,2,28.2,0,3,6,13,1,3,4,4,0,3,6,20,20,23,32.1
2024-25,202410290GSW,10/29/2024,GSW vs NOP,Draymond Green,greendr01,59,GSW,1,NOP,3,3,7,1,2,0,28.5,1,2,1,4,1,3,0,0,4,3,10,10,6,13,26.1
2024-25,202410290GSW,10/29/2024,GSW vs NOP,Buddy Hield,hieldbu01,89,GSW,1,NOP,28,1,1,2,0,0,28.8,0,1,9,18,7,11,3,3,3,2,2,29,29,30,36.7
2024-25,202410290MIN,10/29/2024,MIN vs DAL,Klay Thompson,thompkl01,81,DAL,0,MIN,7,0,1,1,0,0,29.7,0,0,2,7,2,7,1,1,1,1,1,8,7,8,11.5
2024-25,202410290UTA,10/29/2024,UTA vs SAC,Cody Williams,willico04,4,UTA,1,SAC,9,0,2,2,0,1,29.83333333,0,0,3,7,3,6,0,0,1,2,2,11,9,11,17
2024-25,202410290GSW,10/29/2024,GSW vs NOP,Zion Williamson,willizi01,73,NOP,0,GSW,31,8,3,0,1,7,30.4,2,6,12,19,1,2,6,8,3,1,11,34,39,42,41.1
2024-25,202410290UTA,10/29/2024,UTA vs SAC,Keyonte George,georgke01,79,UTA,1,SAC,10,4,11,0,0,4,30.45,1,3,3,13,2,10,2,2,1,0,15,21,14,25,27.3
2024-25,202410290GSW,10/29/2024,GSW vs NOP,Lindy Waters III,waterli01,42,GSW,1,NOP,21,8,4,1,0,0,30.56666667,3,5,8,13,3,7,2,2,3,1,12,25,29,33,39.6
2024-25,202410290UTA,10/29/2024,UTA vs SAC,De'Aaron Fox,foxde01,78,SAC,0,UTA,19,5,6,1,0,3,30.91666667,2,3,8,15,1,2,2,2,3,1,11,25,24,30,34
2024-25,202410290MIN,10/29/2024,MIN vs DAL,Rudy Gobert,goberru01,80,MIN,1,DAL,7,8,1,0,0,2,31.18333333,4,4,2,5,0,0,3,5,3,0,9,8,15,16,16.1
2024-25,202410290GSW,10/29/2024,GSW vs NOP,CJ McCollum,mccolcj01,70,NOP,0,GSW,5,6,5,0,2,4,31.2,1,5,2,8,1,4,0,0,1,2,11,10,11,16,21.7
2024-25,202410290GSW,10/29/2024,GSW vs NOP,Brandon Ingram,ingrabr01,68,NOP,0,GSW,30,4,2,0,0,3,31.45,1,3,12,17,3,6,3,3,2,0,6,32,34,36,34.8
2024-25,202410290MIN,10/29/2024,MIN vs DAL,P.J. Washington,washipj01,77,DAL,0,MIN,17,8,3,1,0,0,32.16666667,4,4,7,13,3,6,0,0,5,1,11,20,25,28,34.1
2024-25,202410290UTA,10/29/2024,UTA vs SAC,Keegan Murray,murrake02,81,SAC,0,UTA,14,5,1,1,0,1,32.35,1,4,6,14,2,7,0,0,1,1,6,15,19,20,23.5
2024-25,202410290BRK,10/29/2024,BRK vs DEN,Aaron Gordon,gordoaa01,77,DEN,0,BRK,24,5,2,0,1,1,33.25,1,4,8,11,1,3,7,7,3,1,7,26,29,31,35
2024-25,202410290GSW,10/29/2024,GSW vs NOP,Brandin Podziemski,podzibr01,78,GSW,1,NOP,19,3,5,1,2,0,33.53333333,1,2,8,18,3,8,0,0,2,3,8,24,22,27,39.1
2024-25,202410290UTA,10/29/2024,UTA vs SAC,Domantas Sabonis,sabondo01,86,SAC,0,UTA,28,11,4,0,0,3,34,3,8,13,18,1,2,1,2,3,0,15,32,39,43,44.2
2024-25,202410290UTA,10/29/2024,UTA vs SAC,DeMar DeRozan,derozde01,83,SAC,0,UTA,20,4,8,1,1,1,34.05,1,3,9,14,0,1,2,3,1,2,12,28,24,32,41.8
2024-25,202410290MIN,10/29/2024,MIN vs DAL,Jaden McDaniels,mcdanja02,76,MIN,1,DAL,13,4,4,0,0,1,34.63333333,3,1,6,11,1,3,0,0,3,0,8,17,17,21,22.8
2024-25,202410290MIN,10/29/2024,MIN vs DAL,Julius Randle,randlju01,50,MIN,1,DAL,20,7,7,2,0,3,35.05,2,5,7,13,3,3,3,4,4,2,14,27,27,34,41.9
2024-25,202410290BRK,10/29/2024,BRK vs DEN,Jamal Murray,murraja01,63,DEN,0,BRK,24,3,3,0,0,1,36.73333333,0,3,8,19,2,7,6,8,3,0,6,27,27,30,31.1
2024-25,202410290BRK,10/29/2024,BRK vs DEN,Dorian Finney-Smith,finnedo01,72,BRK,1,DEN,17,5,4,1,1,1,36.75,0,5,5,11,1,7,6,11,4,2,9,21,22,26,34
2024-25,202410290MIN,10/29/2024,MIN vs DAL,Anthony Edwards,edwaran01,83,MIN,1,DAL,37,6,3,0,1,5,37.33333333,0,6,12,20,7,13,6,12,1,1,9,40,43,46,46.7
2024-25,202410290BRK,10/29/2024,BRK vs DEN,Cam Thomas,thomaca02,70,BRK,1,DEN,26,3,3,0,0,2,38.48333333,0,3,8,22,1,8,9,9,5,0,6,29,29,32,32.1
2024-25,202410290BRK,10/29/2024,BRK vs DEN,Christian Braun,braunch01,86,DEN,0,BRK,12,3,3,0,2,0,38.7,0,3,3,7,2,3,4,6,4,2,6,15,15,18,26.1
2024-25,202410290MIN,10/29/2024,MIN vs DAL,Kyrie Irving,irvinky01,62,DAL,0,MIN,35,4,5,1,0,1,39.45,2,2,13,23,6,8,3,5,3,1,9,40,39,44,49.3
2024-25,202410290BRK,10/29/2024,BRK vs DEN,Cameron Johnson,johnsca02,62,BRK,1,DEN,20,7,5,1,0,0,39.81666667,1,6,7,14,6,10,0,0,2,1,12,25,27,32,38.9
2024-25,202410290MIN,10/29/2024,MIN vs DAL,Luka Doncic,doncilu01,74,DAL,0,MIN,24,8,8,1,0,3,40.15,1,7,10,27,1,8,3,4,2,1,16,32,32,40,45.6
2024-25,202410290BRK,10/29/2024,BRK vs DEN,Nikola Jokic,jokicni01,83,DEN,0,BRK,29,18,16,0,1,1,40.51666667,6,12,9,16,0,0,11,13,3,1,34,45,47,63,76.6
2024-25,202410290BRK,10/29/2024,BRK vs DEN,Michael Porter Jr.,portemi01,85,DEN,0,BRK,16,5,2,1,0,0,40.7,1,4,6,11,4,7,0,1,2,1,7,18,21,23,28
2024-25,202410290BRK,10/29/2024,BRK vs DEN,Dennis Schroder,schrode01,84,BRK,1,DEN,28,0,14,0,0,3,41.63333333,0,0,10,18,5,11,3,4,5,0,14,42,28,42,46
2024-25,202410280DAL,10/28/2024,DAL vs UTA,Patty Mills,millspa02,35,UTA,0,DAL,0,0,2,1,0,0,10.11666667,0,0,0,2,0,1,0,0,1,1,2,2,0,2,6
2024-25,202410280NYK,10/28/2024,NYK vs CLE,Cameron Payne,payneca01,81,NYK,1,CLE,6,3,1,0,0,1,10.4,1,2,2,7,2,3,0,0,1,0,4,7,9,10,10.1
2024-25,202410280ORL,10/28/2024,ORL vs IND,Franz Wagner,wagnefr01,76,ORL,1,IND,7,1,1,1,0,0,10.88333333,0,1,3,5,1,3,0,0,1,1,2,8,8,9,12.7
2024-25,202410280SAC,10/28/2024,SAC vs POR,Rayan Rupert,ruperra01,42,POR,0,SAC,4,1,1,1,0,1,11.06666667,0,1,1,2,0,0,2,2,1,1,2,5,5,6,8.7
2024-25,202410280ORL,10/28/2024,ORL vs IND,Cole Anthony,anthoco01,85,ORL,1,IND,0,5,1,0,1,3,11.2,2,3,0,3,0,2,0,0,2,1,6,1,5,6,7.5
2024-25,202410280PHO,10/28/2024,PHO vs LAL,Dalton Knecht,knechda01,4,LAL,0,PHO,0,1,0,0,0,0,11.23333333,0,1,0,3,0,1,0,0,0,0,1,0,1,1,1.2
2024-25,202410280MEM,10/28/2024,MEM vs CHI,Jalen Smith,smithja04,65,CHI,0,MEM,16,7,1,1,0,0,11.51666667,0,7,4,5,3,4,5,9,2,1,8,17,23,24,28.9
2024-25,202410280NYK,10/28/2024,NYK vs CLE,Ariel Hukporti,hukpoar01,3,NYK,1,CLE,0,2,0,0,1,1,11.9,0,2,0,1,0,0,0,0,1,1,2,0,2,2,4.4
2024-25,202410280SAC,10/28/2024,SAC vs POR,Donovan Clingan,clingdo01,4,POR,0,SAC,2,6,0,0,1,0,11.98333333,1,5,1,2,0,0,0,0,2,1,6,2,8,8,12.2
2024-25,202410280SAS,10/28/2024,SAS vs HOU,Cam Whitmore,whitmca01,51,HOU,0,SAS,4,1,0,0,0,0,12,0,1,1,5,0,4,2,2,0,0,1,4,5,5,5.2
2024-25,202410280TOR,10/28/2024,TOR vs DEN,Jamison Battle,battlja01,4,TOR,1,DEN,4,1,0,0,1,0,12.13333333,1,0,1,3,0,2,2,2,3,1,1,4,5,5,8.2
2024-25,202410280SAS,10/28/2024,SAS vs HOU,Blake Wesley,weslebl01,64,SAS,1,HOU,6,2,2,0,0,1,12.2,2,0,2,6,1,3,1,2,0,0,4,8,8,10,10.4
2024-25,202410280PHO,10/28/2024,PHO vs LAL,Grayson Allen,allengr01,77,PHO,1,LAL,3,2,0,0,0,0,12.3,1,1,1,2,1,2,0,0,3,0,2,3,5,5,5.4
2024-25,202410280MEM,10/28/2024,MEM vs CHI,Dalen Terry,terryda01,63,CHI,0,MEM,0,0,1,1,0,1,12.41666667,0,0,0,0,0,0,0,0,4,1,1,1,0,1,3.5
2024-25,202410280PHO,10/28/2024,PHO vs LAL,Jaxson Hayes,hayesja02,75,LAL,0,PHO,0,4,0,0,0,3,12.5,0,4,0,0,0,0,0,0,2,0,4,0,4,4,1.8
2024-25,202410280DAL,10/28/2024,DAL vs UTA,Brice Sensabaugh,sensabr01,35,UTA,0,DAL,0,2,1,0,0,0,12.65,0,2,0,0,0,0,0,0,0,0,3,1,2,3,3.9
2024-25,202410280BOS,10/28/2024,BOS vs MIL,Jordan Walsh,walshjo01,12,BOS,1,MIL,2,3,0,0,0,0,12.73333333,1,2,1,3,0,2,0,0,1,0,3,2,5,5,5.6
2024-25,202410280SAS,10/28/2024,SAS vs HOU,Zach Collins,colliza01,72,SAS,1,HOU,11,3,1,2,0,0,12.78333333,1,2,3,4,1,2,4,4,2,2,4,12,14,15,22.1
2024-25,202410280DAL,10/28/2024,DAL vs UTA,Quentin Grimes,grimequ01,54,DAL,1,UTA,4,3,1,0,1,0,12.8,1,2,1,4,0,2,2,2,3,1,4,5,7,8,12.1
2024-25,202410280MIA,10/28/2024,MIA vs DET,Thomas Bryant,bryanth01,41,MIA,1,DET,4,2,0,0,0,0,13.23333333,0,2,1,4,1,4,1,1,2,0,2,4,6,6,6.4
2024-25,202410280MEM,10/28/2024,MEM vs CHI,Brandon Clarke,clarkbr01,10,MEM,1,CHI,4,4,0,0,0,1,13.48333333,2,2,2,4,0,0,0,0,1,0,4,4,8,8,7.8
2024-25,202410280MIA,10/28/2024,MIA vs DET,Nikola Jovic,jovicni01,49,MIA,1,DET,6,4,1,0,0,2,13.5,2,2,2,5,2,4,0,0,2,0,5,7,10,11,10.3
2024-25,202410280TOR,10/28/2024,TOR vs DEN,Chris Boucher,bouchch01,54,TOR,1,DEN,4,3,0,0,1,0,13.51666667,1,2,2,6,0,2,0,0,2,1,3,4,7,7,10.6
2024-25,202410280MEM,10/28/2024,MEM vs CHI,Zach Edey,edeyza01,4,MEM,1,CHI,6,5,0,0,0,0,13.53333333,1,4,3,7,0,2,0,0,1,0,5,6,11,11,12
2024-25,202410280TOR,10/28/2024,TOR vs DEN,Jonathan Mogbo,mogbojo01,4,TOR,1,DEN,6,3,1,0,0,1,13.6,0,3,1,2,0,1,4,4,2,0,4,7,9,10,10.1
2024-25,202410280ORL,10/28/2024,ORL vs IND,Bennedict Mathurin,mathube01,64,IND,0,ORL,5,2,0,0,0,1,13.7,0,2,1,1,1,1,2,2,3,0,2,5,7,7,6.4
2024-25,202410280MEM,10/28/2024,MEM vs CHI,Julian Phillips,phillju01,44,CHI,0,MEM,5,3,1,1,0,2,13.7,1,2,2,6,1,1,0,0,1,1,4,6,8,9,11.1
2024-25,202410280SAS,10/28/2024,SAS vs HOU,Steven Adams,adamsst01,1,HOU,0,SAS,6,3,0,0,0,1,13.86666667,1,2,3,3,0,0,0,1,3,0,3,6,9,9,8.6
2024-25,202410280MIA,10/28/2024,MIA vs DET,Ron Holland,hollaro01,4,DET,0,MIA,6,2,0,0,0,0,14.2,0,2,3,6,0,1,0,0,4,0,2,6,8,8,8.4
2024-25,202410280ORL,10/28/2024,ORL vs IND,Obi Toppin,toppiob01,87,IND,0,ORL,14,2,0,0,0,1,14.2,1,1,5,6,3,4,1,2,1,0,2,14,16,16,15.4
2024-25,202410280SAC,10/28/2024,SAC vs POR,Keon Ellis,elliske01,59,SAC,1,POR,3,3,1,1,1,2,14.43333333,1,2,1,3,1,2,0,0,2,2,4,4,6,7,12.1
2024-25,202410280NYK,10/28/2024,NYK vs CLE,Georges Niang,niangge01,86,CLE,0,NYK,5,4,1,1,0,0,14.53333333,1,3,2,6,1,4,0,0,2,1,5,6,9,10,14.3
2024-25,202410280DAL,10/28/2024,DAL vs UTA,Naji Marshall,marshna01,69,DAL,1,UTA,4,6,2,1,0,1,14.6,1,5,2,4,0,2,0,0,0,1,8,6,10,12,16.2
2024-25,202410280BOS,10/28/2024,BOS vs MIL,Xavier Tillman Sr.,tillmxa01,58,BOS,1,MIL,0,3,0,0,0,1,14.96666667,0,3,0,3,0,1,0,0,2,0,3,0,3,3,2.6
2024-25,202410280PHO,10/28/2024,PHO vs LAL,Jusuf Nurkic,nurkiju01,80,PHO,1,LAL,2,4,0,0,2,3,15.13333333,1,3,1,6,0,2,0,1,2,2,4,2,6,6,9.8
2024-25,202410280SAC,10/28/2024,SAC vs POR,Trey Lyles,lylestr01,61,SAC,1,POR,3,0,0,0,1,1,15.16666667,0,0,1,4,1,3,0,0,0,1,0,3,3,3,5
2024-25,202410280PHO,10/28/2024,PHO vs LAL,Ryan Dunn,dunnry01,4,PHO,1,LAL,7,1,0,1,1,0,15.36666667,0,1,3,5,1,3,0,0,1,2,1,7,8,8,14.2
2024-25,202410280BOS,10/28/2024,BOS vs MIL,Pat Connaughton,connapa01,80,MIL,0,BOS,5,2,0,0,0,0,15.4,0,2,1,1,1,1,2,2,1,0,2,5,7,7,7.4
2024-25,202410280TOR,10/28/2024,TOR vs DEN,Peyton Watson,watsope01,83,DEN,0,TOR,6,2,2,0,1,1,15.45,1,1,1,5,0,0,4,4,1,1,4,8,8,10,13.4
2024-25,202410280DAL,10/28/2024,DAL vs UTA,Cody Williams,willico04,3,UTA,0,DAL,2,4,0,0,1,1,15.8,2,2,1,5,0,3,0,0,0,1,4,2,6,6,8.8
2024-25,202410280ORL,10/28/2024,ORL vs IND,Moritz Wagner,wagnemo01,84,ORL,1,IND,14,4,1,0,0,2,16.03333333,2,2,5,10,1,2,3,4,3,0,5,15,18,19,18.3
2024-25,202410280MIA,10/28/2024,MIA vs DET,Duncan Robinson,robindu01,71,MIA,1,DET,6,1,0,0,0,1,16.1,0,1,2,8,2,7,0,0,2,0,1,6,7,7,6.2
2024-25,202410280SAS,10/28/2024,SAS vs HOU,Malaki Branham,branhma01,78,SAS,1,HOU,15,0,1,1,0,3,16.75,0,0,5,8,3,5,2,2,2,1,1,16,15,16,16.5
2024-25,202410280MEM,10/28/2024,MEM vs CHI,Jaylen Wells,wellsja01,4,MEM,1,CHI,11,6,2,1,0,1,17.41666667,2,4,5,12,1,4,0,0,3,1,8,13,17,19,23.2
2024-25,202410280SAS,10/28/2024,SAS vs HOU,Stephon Castle,castlst01,3,SAS,1,HOU,4,1,5,1,0,3,17.85,0,1,2,5,0,1,0,0,2,1,6,9,5,10,12.7
2024-25,202410280TOR,10/28/2024,TOR vs DEN,Russell Westbrook,westbru01,71,DEN,0,TOR,9,4,3,1,0,2,17.96666667,1,3,3,7,0,1,3,4,4,1,7,12,13,16,19.3
2024-25,202410280MEM,10/28/2024,MEM vs CHI,Lonzo Ball,balllo01,3,CHI,0,MEM,6,1,6,0,1,0,17.98333333,0,1,2,4,2,4,0,0,0,1,7,12,7,13,19.2
2024-25,202410280TOR,10/28/2024,TOR vs DEN,Jamal Shead,sheadja01,4,TOR,1,DEN,8,1,5,1,0,1,18.1,0,1,4,8,0,2,0,0,3,1,6,13,9,14,18.7
2024-25,202410280MEM,10/28/2024,MEM vs CHI,Jay Huff,huffja01,24,MEM,1,CHI,10,2,1,0,2,1,18.2,0,2,3,5,2,3,2,2,2,2,3,11,12,13,18.9
2024-25,202410280SAC,10/28/2024,SAC vs POR,Malik Monk,monkma01,75,SAC,1,POR,12,4,0,1,1,1,18.51666667,0,4,3,6,3,5,3,3,2,2,4,12,16,16,21.8
2024-25,202410280MIA,10/28/2024,MIA vs DET,Malik Beasley,beaslma01,83,DET,0,MIA,3,0,1,1,0,1,18.65,0,0,1,12,1,7,0,0,1,1,1,4,3,4,6.5
2024-25,202410280SAS,10/28/2024,SAS vs HOU,Amen Thompson,thompam01,66,HOU,0,SAS,7,3,0,1,1,3,18.71666667,0,3,2,5,1,1,2,2,2,2,3,7,10,10,13.6
2024-25,202410280DAL,10/28/2024,DAL vs UTA,John Collins,collijo01,71,UTA,0,DAL,16,6,3,1,1,2,19.16666667,2,4,5,13,3,6,3,3,5,2,9,19,22,25,31.7
2024-25,202410280MIA,10/28/2024,MIA vs DET,Isaiah Stewart,stewais01,50,DET,0,MIA,2,15,2,0,0,3,19.21666667,7,8,0,3,0,0,2,2,3,0,17,4,17,19,20
2024-25,202410280BOS,10/28/2024,BOS vs MIL,Bobby Portis,portibo01,86,MIL,0,BOS,4,6,0,0,1,4,19.28333333,1,5,2,6,0,1,0,0,1,1,6,4,10,10,10.2
2024-25,202410280PHO,10/28/2024,PHO vs LAL,Gabe Vincent,vincega01,15,LAL,0,PHO,3,0,0,0,0,0,19.28333333,0,0,1,3,1,2,0,0,0,0,0,3,3,3,3
2024-25,202410280ATL,10/28/2024,ATL vs WAS,David Roddy,roddyda01,67,ATL,1,WAS,9,6,2,1,1,0,19.36666667,0,6,3,4,1,2,2,2,0,2,8,11,15,17,25.2
2024-25,202410280SAC,10/28/2024,SAC vs POR,Jabari Walker,walkeja01,76,POR,0,SAC,15,6,0,0,0,0,19.41666667,3,3,5,9,0,2,5,5,2,0,6,15,21,21,22.2
2024-25,202410280DAL,10/28/2024,DAL vs UTA,Daniel Gafford,gaffoda01,77,DAL,1,UTA,9,7,0,0,3,0,20.43333333,4,3,4,8,0,0,1,1,2,3,7,9,16,16,26.4
2024-25,202410280SAC,10/28/2024,SAC vs POR,Toumani Camara,camarto01,74,POR,0,SAC,2,2,3,1,1,1,20.81666667,2,0,1,3,0,1,0,0,4,2,5,5,4,7,13.9
2024-25,202410280MIA,10/28/2024,MIA vs DET,Haywood Highsmith,highsha01,68,MIA,1,DET,4,4,1,2,0,0,20.88333333,1,3,2,4,0,2,0,1,1,2,5,5,8,9,16.3
2024-25,202410280ATL,10/28/2024,ATL vs WAS,Carlton Carrington,carrica01,3,WAS,0,ATL,13,3,2,1,0,1,21.03333333,0,3,4,5,3,4,2,2,3,1,5,15,16,18,21.6
2024-25,202410280DAL,10/28/2024,DAL vs UTA,Taylor Hendricks,hendrita0,43,UTA,0,DAL,2,3,2,1,1,1,21.26666667,2,1,0,5,0,3,2,2,2,2,5,4,5,7,13.6
2024-25,202410280ATL,10/28/2024,ATL vs WAS,Kyshawn George,georgky01,3,WAS,0,ATL,3,2,1,0,1,1,21.53333333,0,2,1,3,1,3,0,0,5,1,3,4,5,6,8.9
2024-25,202410280SAS,10/28/2024,SAS vs HOU,Tari Eason,easonta01,26,HOU,0,SAS,6,5,2,2,0,0,21.73333333,2,3,2,5,0,2,2,2,4,2,7,8,11,13,21
2024-25,202410280MIA,10/28/2024,MIA vs DET,Simone Fontecchio,fontesi01,70,DET,0,MIA,6,4,0,0,1,0,21.75,3,1,2,9,1,5,1,2,0,1,4,6,10,10,13.8
2024-25,202410280NYK,10/28/2024,NYK vs CLE,Sam Merrill,merrisa01,65,CLE,0,NYK,6,2,2,1,0,0,21.83333333,0,2,2,5,2,5,0,0,3,1,4,8,8,10,14.4
2024-25,202410280ORL,10/28/2024,ORL vs IND,Isaiah Jackson,jacksis01,63,IND,0,ORL,7,9,2,0,4,1,22.15,7,2,2,8,0,0,3,6,3,4,11,9,16,18,31.8
2024-25,202410280ATL,10/28/2024,ATL vs WAS,Jonas Valanciunas,valanjo01,85,WAS,0,ATL,7,9,4,0,0,4,22.25,2,7,3,7,0,1,1,1,0,0,13,11,16,20,19.8
2024-25,202410280TOR,10/28/2024,TOR vs DEN,Julian Strawther,strawju01,53,DEN,0,TOR,9,2,0,0,0,1,22.48333333,0,2,3,3,2,2,1,2,3,0,2,9,11,11,10.4
2024-25,202410280ORL,10/28/2024,ORL vs IND,Ben Sheppard,sheppbe01,62,IND,0,ORL,8,1,0,0,0,0,22.63333333,1,0,3,6,2,5,0,0,2,0,1,8,9,9,9.2
2024-25,202410280ATL,10/28/2024,ATL vs WAS,Larry Nance Jr.,nancela02,62,ATL,1,WAS,15,3,4,2,1,1,23.11666667,3,0,6,9,3,5,0,0,4,3,7,19,18,22,32.6
2024-25,202410280PHO,10/28/2024,PHO vs LAL,Max Christie,chrisma02,72,LAL,0,PHO,5,2,1,0,2,0,23.16666667,1,1,2,4,1,1,0,0,4,2,3,6,7,8,14.9
2024-25,202410280DAL,10/28/2024,DAL vs UTA,Spencer Dinwiddie,dinwisp01,78,DAL,1,UTA,11,0,1,0,1,1,23.18333333,0,0,3,5,3,4,2,4,3,1,1,12,11,12,14.5
2024-25,202410280ATL,10/28/2024,ATL vs WAS,Garrison Mathews,mathega01,69,ATL,1,WAS,14,0,2,0,0,2,24,0,0,4,10,4,9,2,3,2,0,2,16,14,16,15
2024-25,202410280MEM,10/28/2024,MEM vs CHI,Jaren Jackson Jr.,jacksja02,68,MEM,1,CHI,19,6,1,1,3,2,24.46666667,2,4,9,16,1,4,0,2,3,4,7,20,25,26,37.7
2024-25,202410280MEM,10/28/2024,MEM vs CHI,Patrick Williams,willipa01,47,CHI,0,MEM,5,6,1,0,2,2,24.6,1,5,2,10,1,5,0,0,0,2,7,6,11,12,17.7
2024-25,202410280PHO,10/28/2024,PHO vs LAL,Royce O'Neale,onealro01,83,PHO,1,LAL,12,9,4,0,2,1,24.73333333,2,7,4,9,2,4,2,2,4,2,13,16,21,25,33.8
2024-25,202410280ATL,10/28/2024,ATL vs WAS,Clint Capela,capelca01,77,ATL,1,WAS,16,4,2,1,1,2,24.88333333,1,3,6,6,0,0,4,6,4,2,6,18,20,22,27.8
2024-25,202410280SAC,10/28/2024,SAC vs POR,Kris Murray,murrakr01,66,POR,0,SAC,7,2,0,0,0,1,24.93333333,2,0,2,6,1,3,2,2,0,0,2,7,9,9,8.4
2024-25,202410280SAC,10/28/2024,SAC vs POR,Deni Avdija,avdijde01,79,POR,0,SAC,9,4,1,2,0,2,24.98333333,0,4,2,7,0,4,5,6,2,2,5,10,13,14,19.3
2024-25,202410280MEM,10/28/2024,MEM vs CHI,Marcus Smart,smartma01,24,MEM,1,CHI,1,4,7,2,2,1,25.01666667,2,2,0,11,0,8,1,2,3,4,11,8,5,12,27.3
2024-25,202410280ATL,10/28/2024,ATL vs WAS,Zaccharie Risacher,risacza01,4,ATL,1,WAS,4,3,1,2,2,1,25.56666667,0,3,1,8,1,4,1,3,5,4,4,5,7,8,20.1
2024-25,202410280ORL,10/28/2024,ORL vs IND,Myles Turner,turnemy01,82,IND,0,ORL,13,5,0,0,0,1,25.86666667,1,4,5,10,1,3,2,3,5,0,5,13,18,18,18
2024-25,202410280SAS,10/28/2024,SAS vs HOU,Keldon Johnson,johnske04,72,SAS,1,HOU,6,5,0,0,0,0,25.9,1,4,3,11,0,5,0,1,2,0,5,6,11,11,12
2024-25,202410280ORL,10/28/2024,ORL vs IND,Gary Harris,harriga01,58,ORL,1,IND,0,3,1,0,1,0,26.03333333,0,3,0,5,0,3,0,0,1,1,4,1,3,4,8.1
2024-25,202410280SAS,10/28/2024,SAS vs HOU,Alperen Sengun,sengual01,67,HOU,0,SAS,12,12,5,1,1,2,26.13333333,5,7,5,14,1,1,1,2,5,2,17,17,24,29,37.9
2024-25,202410280PHO,10/28/2024,PHO vs LAL,Mason Plumlee,plumlma01,50,PHO,1,LAL,0,10,2,0,1,0,26.26666667,2,8,0,0,0,0,0,0,3,1,12,2,10,12,18
2024-25,202410280NYK,10/28/2024,NYK vs CLE,Caris LeVert,leverca01,72,CLE,0,NYK,5,4,3,2,0,2,26.28333333,1,3,1,4,0,2,3,4,1,2,7,8,9,12,18.3
2024-25,202410280DAL,10/28/2024,DAL vs UTA,Dereck Lively II,livelde01,58,DAL,1,UTA,14,4,2,1,3,0,26.46666667,3,1,7,10,0,0,0,0,3,4,6,16,18,20,33.8
2024-25,202410280DAL,10/28/2024,DAL vs UTA,Jordan Clarkson,clarkjo01,58,UTA,0,DAL,13,5,4,0,0,3,26.91666667,0,5,3,11,1,6,6,8,1,0,9,17,18,22,22
2024-25,202410280ATL,10/28/2024,ATL vs WAS,Alex Sarr,sarral01,3,WAS,0,ATL,7,9,1,1,2,1,27,4,5,3,11,1,5,0,0,4,3,10,8,16,17,27.3
2024-25,202410280BOS,10/28/2024,BOS vs MIL,Al Horford,horfoal01,69,BOS,1,MIL,10,5,1,0,2,0,27.08333333,0,5,4,5,2,2,0,0,2,2,6,11,15,16,23.5
2024-25,202410280MEM,10/28/2024,MEM vs CHI,Ayo Dosunmu,dosunay01,80,CHI,0,MEM,10,8,4,0,1,0,27.28333333,2,6,4,8,2,4,0,0,1,1,12,14,18,22,28.6
2024-25,202410280BOS,10/28/2024,BOS vs MIL,Payton Pritchard,pritcpa01,86,BOS,1,MIL,28,5,3,2,0,2,27.68333333,2,3,10,14,8,12,0,0,2,2,8,31,33,36,42.5
2024-25,202410280DAL,10/28/2024,DAL vs UTA,Collin Sexton,sextoco01,81,UTA,0,DAL,23,4,2,1,0,2,27.68333333,0,4,9,11,2,3,3,4,3,1,6,25,27,29,31.8
2024-25,202410280DAL,10/28/2024,DAL vs UTA,Klay Thompson,thompkl01,80,DAL,1,UTA,18,4,2,0,0,1,27.81666667,1,3,7,15,4,11,0,0,0,0,6,20,22,24,24.8
2024-25,202410280MEM,10/28/2024,MEM vs CHI,Josh Giddey,giddejo01,84,CHI,0,MEM,12,13,8,1,1,2,27.93333333,4,9,4,10,2,4,2,4,1,2,21,20,25,33,43.6
2024-25,202410280SAC,10/28/2024,SAC vs POR,Scoot Henderson,hendesc01,66,POR,0,SAC,18,4,5,0,0,4,28.16666667,1,3,5,12,1,2,7,8,5,0,9,23,22,27,26.3
2024-25,202410280SAS,10/28/2024,SAS vs HOU,Julian Champagnie,champju02,77,SAS,1,HOU,5,5,1,1,1,0,28.18333333,1,4,2,7,1,6,0,0,2,2,6,6,10,11,18.5
2024-25,202410280NYK,10/28/2024,NYK vs CLE,Dean Wade,wadede01,58,CLE,0,NYK,1,3,4,0,0,0,28.21666667,1,2,0,5,0,5,1,2,1,0,7,5,4,8,10.6
2024-25,202410280SAS,10/28/2024,SAS vs HOU,Chris Paul,paulch01,61,SAS,1,HOU,16,1,3,1,0,2,28.61666667,1,0,5,10,3,4,3,3,4,1,4,19,17,20,22.7
2024-25,202410280TOR,10/28/2024,TOR vs DEN,Ochai Agbaji,agbajoc01,82,TOR,1,DEN,15,7,0,1,1,0,28.63333333,3,4,6,12,2,5,1,2,4,2,7,15,22,22,29.4
2024-25,202410280TOR,10/28/2024,TOR vs DEN,RJ Barrett,barrerj01,59,TOR,1,DEN,20,5,3,0,0,2,28.66666667,1,4,9,21,2,6,0,0,5,0,8,23,25,28,28.5
2024-25,202410280MIA,10/28/2024,MIA vs DET,Jalen Duren,durenja01,65,DET,0,MIA,10,11,2,0,3,0,28.78333333,4,7,5,6,0,0,0,0,2,3,13,12,21,23,35.2
2024-25,202410280SAS,10/28/2024,SAS vs HOU,Harrison Barnes,barneha02,85,SAS,1,HOU,2,3,0,0,0,2,28.83333333,1,2,0,3,0,1,2,2,1,0,3,2,5,5,3.6
2024-25,202410280SAS,10/28/2024,SAS vs HOU,Jabari Smith Jr.,smithja05,80,HOU,0,SAS,17,8,1,0,0,2,28.91666667,2,6,5,8,2,4,5,6,4,0,9,18,25,26,26.1
2024-25,202410280NYK,10/28/2024,NYK vs CLE,Miles McBride,mcbrimi01,71,NYK,1,CLE,14,3,4,0,0,1,29.13333333,1,2,6,12,2,6,0,0,2,0,7,18,17,21,22.6
2024-25,202410280SAC,10/28/2024,SAC vs POR,Jerami Grant,grantje01,58,POR,0,SAC,7,8,2,1,1,2,29.43333333,0,8,3,12,1,3,0,0,2,2,10,9,15,17,23.6
2024-25,202410280DAL,10/28/2024,DAL vs UTA,Walker Kessler,kesslwa01,67,UTA,0,DAL,12,11,1,2,2,0,29.96666667,4,7,6,11,0,0,0,2,1,4,12,13,23,24,38.7
2024-25,202410280PHO,10/28/2024,PHO vs LAL,Tyus Jones,jonesty01,70,PHO,1,LAL,7,6,5,3,0,1,30.68333333,2,4,3,8,1,4,0,0,1,3,11,12,13,18,29.7
2024-25,202410280MEM,10/28/2024,MEM vs CHI,Scotty Pippen Jr.,pippesc02,25,MEM,1,CHI,14,4,10,1,1,1,30.68333333,1,3,6,13,2,4,0,0,4,2,14,24,18,28,38.8
2024-25,202410280ORL,10/28/2024,ORL vs IND,Anthony Black,blackan01,73,ORL,1,IND,8,3,3,2,1,3,30.7,0,3,2,6,2,3,2,2,4,3,6,11,11,14,22.1
2024-25,202410280ORL,10/28/2024,ORL vs IND,Kentavious Caldwell-Pope,caldwke01,80,ORL,1,IND,4,0,1,1,0,1,30.7,0,0,2,5,0,3,0,0,4,1,1,5,4,5,7.5
2024-25,202410280MEM,10/28/2024,MEM vs CHI,Jake LaRavia,laravja01,39,MEM,1,CHI,17,9,5,0,0,1,30.75,2,7,7,11,1,3,2,5,1,0,14,22,26,31,34.3
2024-25,202410280ORL,10/28/2024,ORL vs IND,Aaron Nesmith,nesmiaa01,77,IND,0,ORL,10,4,1,1,0,0,30.9,0,4,3,9,0,1,4,6,6,1,5,11,14,15,19.3
2024-25,202410280PHO,10/28/2024,PHO vs LAL,Rui Hachimura,hachiru01,73,LAL,0,PHO,20,10,1,1,1,0,31.35,5,5,8,18,3,3,1,1,5,2,11,21,30,31,39.5
2024-25,202410280NYK,10/28/2024,NYK vs CLE,Jarrett Allen,allenja01,81,CLE,0,NYK,15,15,1,1,0,2,31.4,5,10,5,7,0,0,5,7,2,1,16,16,30,31,35.5
2024-25,202410280MEM,10/28/2024,MEM vs CHI,Desmond Bane,banede01,46,MEM,1,CHI,30,7,4,0,0,1,31.43333333,2,5,11,19,6,10,2,2,3,0,11,34,37,41,43.4
2024-25,202410280SAC,10/28/2024,SAC vs POR,Anfernee Simons,simonan01,50,POR,0,SAC,12,1,3,0,0,4,31.63333333,0,1,4,12,1,7,3,4,2,0,4,15,13,16,13.7
2024-25,202410280BOS,10/28/2024,BOS vs MIL,Taurean Prince,princta02,83,MIL,0,BOS,3,4,1,1,0,2,31.9,0,4,1,4,1,3,0,0,5,1,5,4,7,8,10.3
2024-25,202410280ORL,10/28/2024,ORL vs IND,Wendell Carter Jr.,cartewe01,59,ORL,1,IND,11,10,1,1,0,0,31.96666667,1,9,3,5,0,2,5,6,3,1,11,12,21,22,27.5
2024-25,202410280MEM,10/28/2024,MEM vs CHI,Coby White,whiteco01,83,CHI,0,MEM,20,2,5,0,0,0,32,1,1,6,15,5,10,3,3,2,0,7,25,22,27,29.9
2024-25,202410280BOS,10/28/2024,BOS vs MIL,Brook Lopez,lopezbr01,83,MIL,0,BOS,13,6,0,2,4,0,32.16666667,4,2,5,14,0,4,3,3,3,6,6,13,19,19,38.2
2024-25,202410280NYK,10/28/2024,NYK vs CLE,Karl-Anthony Towns,townska01,65,NYK,1,CLE,13,10,3,1,0,3,32.28333333,1,9,4,8,1,2,4,4,6,1,13,16,23,26,29.5
2024-25,202410280MIA,10/28/2024,MIA vs DET,Jaden Ivey,iveyja01,81,DET,0,MIA,18,4,1,2,0,4,32.31666667,2,2,6,16,5,9,1,2,2,2,5,19,22,23,26.3
2024-25,202410280MIA,10/28/2024,MIA vs DET,Jaime Jaquez Jr.,jaqueja01,78,MIA,1,DET,12,9,0,3,0,1,32.53333333,3,6,5,10,2,3,0,0,1,3,9,12,21,21,30.8
2024-25,202410280BOS,10/28/2024,BOS vs MIL,Jrue Holiday,holidjr01,73,BOS,1,MIL,21,4,3,0,0,1,32.71666667,0,4,7,12,4,7,3,3,2,0,7,24,25,28,29.3
2024-25,202410280NYK,10/28/2024,NYK vs CLE,Darius Garland,garlada01,61,CLE,0,NYK,34,3,3,2,2,3,32.75,1,2,12,19,5,8,5,5,3,4,6,37,37,40,51.1
2024-25,202410280SAC,10/28/2024,SAC vs POR,Kevin Huerter,huertke01,67,SAC,1,POR,18,1,4,0,3,0,32.9,0,1,7,12,4,9,0,0,4,3,5,22,19,23,34.2
2024-25,202410280ATL,10/28/2024,ATL vs WAS,Jordan Poole,poolejo01,81,WAS,0,ATL,26,1,5,2,0,3,32.93333333,1,0,9,17,6,8,2,2,3,2,6,31,27,32,37.7
2024-25,202410280DAL,10/28/2024,DAL vs UTA,Luka Doncic,doncilu01,73,DAL,1,UTA,15,9,8,2,1,2,33.2,0,9,5,22,1,9,4,6,5,3,17,23,24,32,44.8
2024-25,202410280SAC,10/28/2024,SAC vs POR,Keegan Murray,murrake02,80,SAC,1,POR,6,8,2,0,0,1,33.2,4,4,2,9,0,3,2,2,5,0,10,8,14,16,17.6
2024-25,202410280DAL,10/28/2024,DAL vs UTA,P.J. Washington,washipj01,76,DAL,1,UTA,12,11,2,4,2,3,33.21666667,1,10,6,11,0,4,0,0,2,6,13,14,23,25,43.2
2024-25,202410280MIA,10/28/2024,MIA vs DET,Tyler Herro,herroty01,45,MIA,1,DET,19,4,6,1,0,2,33.25,0,4,7,20,3,12,2,2,0,1,10,25,23,29,33.8
2024-25,202410280NYK,10/28/2024,NYK vs CLE,Donovan Mitchell,mitchdo01,59,CLE,0,NYK,25,2,5,0,0,4,33.25,0,2,9,17,3,8,4,4,3,0,7,30,27,32,30.9
2024-25,202410280MIA,10/28/2024,MIA vs DET,Terry Rozier,roziete01,64,MIA,1,DET,20,5,3,1,0,2,33.25,0,5,7,16,5,12,1,1,3,1,8,23,25,28,31.5
2024-25,202410280PHO,10/28/2024,PHO vs LAL,D'Angelo Russell,russeda01,81,LAL,0,PHO,14,1,9,0,0,2,33.31666667,0,1,5,13,2,9,2,2,3,0,10,23,15,24,26.7
2024-25,202410280MIA,10/28/2024,MIA vs DET,Tim Hardaway Jr.,hardati02,83,DET,0,MIA,20,0,1,0,0,1,33.48333333,0,0,5,10,3,6,7,7,1,0,1,21,20,21,20.5
2024-25,202410280BOS,10/28/2024,BOS vs MIL,Derrick White,whitede01,77,BOS,1,MIL,13,3,8,1,1,0,33.56666667,0,3,5,13,3,10,0,0,2,2,11,21,16,24,34.6
2024-25,202410280SAS,10/28/2024,SAS vs HOU,Jeremy Sochan,sochaje01,77,SAS,1,HOU,22,9,4,0,1,2,33.65,5,4,9,19,0,1,4,5,3,1,13,26,31,35,39.8
2024-25,202410280ORL,10/28/2024,ORL vs IND,Andrew Nembhard,nembhan01,72,IND,0,ORL,13,3,7,1,0,2,33.71666667,0,3,6,12,0,1,1,2,0,1,10,20,16,23,28.1
2024-25,202410280MIA,10/28/2024,MIA vs DET,Jimmy Butler,butleji01,63,MIA,1,DET,23,4,7,4,0,0,33.73333333,3,1,7,11,0,1,9,11,2,4,11,30,27,34,50.3
2024-25,202410280ORL,10/28/2024,ORL vs IND,Pascal Siakam,siakapa01,84,IND,0,ORL,26,9,4,2,0,2,33.81666667,2,7,10,18,2,5,4,5,5,2,13,30,35,39,46.8
2024-25,202410280SAC,10/28/2024,SAC vs POR,DeMar DeRozan,derozde01,82,SAC,1,POR,23,4,3,3,0,1,33.9,1,3,7,14,0,1,9,10,1,3,7,26,27,30,40.3
2024-25,202410280SAC,10/28/2024,SAC vs POR,Deandre Ayton,aytonde01,59,POR,0,SAC,20,11,1,0,0,1,34.01666667,3,8,10,17,0,0,0,0,2,0,12,21,31,32,33.7
2024-25,202410280ATL,10/28/2024,ATL vs WAS,Corey Kispert,kispeco01,83,WAS,0,ATL,21,4,1,1,0,1,34.5,0,4,7,15,4,9,3,4,4,1,5,22,25,26,29.3
2024-25,202410280MEM,10/28/2024,MEM vs CHI,Zach LaVine,lavinza01,29,CHI,0,MEM,30,3,4,1,0,1,34.6,0,3,12,22,5,12,1,1,0,1,7,34,33,37,41.6
2024-25,202410280ORL,10/28/2024,ORL vs IND,Jalen Suggs,suggsja01,79,ORL,1,IND,25,5,7,1,1,2,34.75,1,4,8,17,6,13,3,4,1,2,12,32,30,37,45.5
2024-25,202410280MIA,10/28/2024,MIA vs DET,Bam Adebayo,adebaba01,74,MIA,1,DET,12,10,4,3,3,1,34.76666667,1,9,5,9,0,2,2,4,1,6,14,16,22,26,47
2024-25,202410280MIA,10/28/2024,MIA vs DET,Cade Cunningham,cunnica01,66,DET,0,MIA,24,8,6,2,1,5,34.86666667,1,7,9,18,4,7,2,3,4,3,14,30,32,38,46.6
2024-25,202410280DAL,10/28/2024,DAL vs UTA,Lauri Markkanen,markkla01,58,UTA,0,DAL,17,9,2,0,0,1,34.9,4,5,4,15,3,5,6,6,1,0,11,19,26,28,29.8
2024-25,202410280MEM,10/28/2024,MEM vs CHI,Nikola Vucevic,vucevni01,80,CHI,0,MEM,22,7,5,0,1,1,35,2,5,9,19,4,8,0,0,3,1,12,27,29,34,39.9
2024-25,202410280MEM,10/28/2024,MEM vs CHI,Santi Aldama,aldamsa01,65,MEM,1,CHI,11,13,7,0,1,1,35.01666667,4,9,5,13,1,5,0,0,0,1,20,18,24,31,39.1
2024-25,202410280ORL,10/28/2024,ORL vs IND,Tyrese Haliburton,halibty01,74,IND,0,ORL,19,9,10,1,0,1,35.06666667,3,6,6,15,4,9,3,4,1,1,19,29,28,38,46.8
2024-25,202410280SAS,10/28/2024,SAS vs HOU,Victor Wembanyama,wembavi01,74,SAS,1,HOU,14,20,5,0,4,4,35.21666667,5,15,6,14,1,5,1,2,3,4,25,19,34,39,53.5
2024-25,202410280TOR,10/28/2024,TOR vs DEN,Davion Mitchell,mitchda01,76,TOR,1,DEN,16,2,6,0,1,4,35.28333333,1,1,5,10,3,6,3,4,3,1,8,22,18,24,26.4
2024-25,202410280TOR,10/28/2024,TOR vs DEN,Scottie Barnes,barnesc01,64,TOR,1,DEN,21,12,9,5,1,4,35.3,2,10,9,19,1,3,2,4,1,6,21,30,33,42,62.9
2024-25,202410280PHO,10/28/2024,PHO vs LAL,Bradley Beal,bealbr01,56,PHO,1,LAL,15,3,4,2,1,1,35.31666667,0,3,6,14,1,7,2,2,4,3,7,19,18,22,32.6
2024-25,202410280SAC,10/28/2024,SAC vs POR,De'Aaron Fox,foxde01,77,SAC,1,POR,24,6,3,2,0,3,35.33333333,1,5,9,20,2,8,4,4,4,2,9,27,30,33,38.7
2024-25,202410280PHO,10/28/2024,PHO vs LAL,Anthony Davis,davisan02,81,LAL,0,PHO,29,15,3,1,3,3,35.5,5,10,12,24,0,2,5,6,1,4,18,32,44,47,60.5
2024-25,202410280BOS,10/28/2024,BOS vs MIL,Damian Lillard,lillada01,77,MIL,0,BOS,33,7,7,2,1,1,35.53333333,1,6,7,15,2,8,17,18,2,3,14,40,40,47,59.9
2024-25,202410280DAL,10/28/2024,DAL vs UTA,Kyrie Irving,irvinky01,61,DAL,1,UTA,23,6,9,1,1,4,35.68333333,2,4,8,14,3,6,4,4,2,2,15,32,29,38,45.7
2024-25,202410280ATL,10/28/2024,ATL vs WAS,Trae Young,youngtr01,58,ATL,1,WAS,14,8,13,1,1,6,35.73333333,0,8,2,15,2,10,8,9,3,2,21,27,22,35,43.1
2024-25,202410280PHO,10/28/2024,PHO vs LAL,LeBron James,jamesle01,76,LAL,0,PHO,11,5,8,1,0,2,35.8,0,5,3,14,2,5,3,6,1,1,13,19,16,24,30
2024-25,202410280NYK,10/28/2024,NYK vs CLE,Evan Mobley,mobleev01,54,CLE,0,NYK,17,8,1,0,3,1,35.8,0,8,7,12,1,1,2,2,4,3,9,18,25,26,36.1
2024-25,202410280SAC,10/28/2024,SAC vs POR,Domantas Sabonis,sabondo01,85,SAC,1,POR,16,13,7,0,0,3,35.86666667,2,11,5,8,1,2,5,6,4,0,20,23,29,36,39.1
2024-25,202410280DAL,10/28/2024,DAL vs UTA,Keyonte George,georgke01,78,UTA,0,DAL,17,5,5,1,0,3,36.13333333,1,4,6,18,1,7,4,4,1,1,10,22,22,27,30.5
2024-25,202410280ATL,10/28/2024,ATL vs WAS,Dyson Daniels,daniedy01,65,ATL,1,WAS,11,3,1,3,0,0,36.41666667,0,3,4,9,2,5,1,2,1,3,4,12,14,15,25.1
2024-25,202410280BOS,10/28/2024,BOS vs MIL,Jayson Tatum,tatumja01,78,BOS,1,MIL,15,8,4,2,1,3,36.41666667,0,8,6,16,1,8,2,2,5,3,12,19,23,27,36.6
2024-25,202410280TOR,10/28/2024,TOR vs DEN,Gradey Dick,dickgr01,64,TOR,1,DEN,15,1,4,0,1,0,36.65,1,0,5,13,2,7,3,3,2,1,5,19,16,20,25.2
2024-25,202410280MIA,10/28/2024,MIA vs DET,Tobias Harris,harrito02,74,DET,0,MIA,9,10,1,1,1,2,36.73333333,2,8,4,11,0,3,1,1,2,2,11,10,19,20,26.5
2024-25,202410280ATL,10/28/2024,ATL vs WAS,Bilal Coulibaly,coulibi01,66,WAS,0,ATL,17,2,3,2,0,2,36.81666667,0,2,5,12,1,5,6,7,4,2,5,20,19,22,27.9
2024-25,202410280NYK,10/28/2024,NYK vs CLE,OG Anunoby,anunoog01,53,NYK,1,CLE,15,2,2,2,1,2,36.86666667,1,1,7,13,1,4,0,1,3,3,4,17,17,19,27.4
2024-25,202410280SAS,10/28/2024,SAS vs HOU,Dillon Brooks,brookdi01,76,HOU,0,SAS,7,7,0,0,0,0,36.88333333,2,5,2,9,1,4,2,2,2,0,7,7,14,14,15.4
2024-25,202410280BOS,10/28/2024,BOS vs MIL,Gary Trent Jr.,trentga02,75,MIL,0,BOS,10,3,1,2,0,0,37.43333333,0,3,3,8,2,6,2,2,2,2,4,11,13,14,21.1
2024-25,202410280SAS,10/28/2024,SAS vs HOU,Jalen Green,greenja05,86,HOU,0,SAS,36,1,2,0,0,4,37.53333333,0,1,11,22,7,13,7,7,0,0,3,38,37,39,36.2
2024-25,202410280NYK,10/28/2024,NYK vs CLE,Jalen Brunson,brunsja01,80,NYK,1,CLE,21,3,7,0,0,1,37.6,0,3,8,24,0,4,5,7,2,0,10,28,24,31,34.1
2024-25,202410280NYK,10/28/2024,NYK vs CLE,Josh Hart,hartjo01,84,NYK,1,CLE,16,13,2,3,0,5,37.83333333,4,9,4,10,2,5,6,6,1,3,15,18,29,31,38.6
2024-25,202410280PHO,10/28/2024,PHO vs LAL,Austin Reaves,reaveau01,87,LAL,0,PHO,23,8,3,2,0,1,37.85,0,8,8,15,5,9,2,3,3,2,11,26,31,34,42.1
2024-25,202410280BOS,10/28/2024,BOS vs MIL,Jaylen Brown,brownja02,74,BOS,1,MIL,30,6,4,0,0,4,38,1,5,10,19,0,4,10,14,2,0,10,34,36,40,39.2
2024-25,202410280PHO,10/28/2024,PHO vs LAL,Kevin Durant,duranke01,79,PHO,1,LAL,30,8,4,0,4,2,38.15,0,8,11,20,2,6,6,7,2,4,12,34,38,42,55.6
2024-25,202410280ATL,10/28/2024,ATL vs WAS,Jalen Johnson,johnsja05,60,ATL,1,WAS,29,12,7,1,1,3,38.8,2,10,11,17,1,3,6,7,3,2,19,36,41,48,56.9
2024-25,202410280BOS,10/28/2024,BOS vs MIL,Giannis Antetokounmpo,antetgi01,77,MIL,0,BOS,30,10,6,0,0,7,39.08333333,1,9,14,26,0,2,2,6,4,0,16,36,40,46,44
2024-25,202410280TOR,10/28/2024,TOR vs DEN,Michael Porter Jr.,portemi01,84,DEN,0,TOR,13,9,2,0,1,1,39.36666667,2,7,6,12,1,4,0,1,3,1,11,15,22,24,28.8
2024-25,202410280PHO,10/28/2024,PHO vs LAL,Devin Booker,bookede01,72,PHO,1,LAL,33,3,2,1,0,2,39.41666667,1,2,11,23,3,8,8,8,1,1,5,35,36,38,40.6
2024-25,202410280ORL,10/28/2024,ORL vs IND,Paolo Banchero,banchpa01,84,ORL,1,IND,50,13,9,1,2,4,39.61666667,4,9,16,26,3,9,15,22,4,3,22,59,63,72,84.1
2024-25,202410280TOR,10/28/2024,TOR vs DEN,Christian Braun,braunch01,85,DEN,0,TOR,17,4,2,1,1,1,39.65,2,2,6,11,1,4,4,4,3,2,6,19,21,23,29.8
2024-25,202410280TOR,10/28/2024,TOR vs DEN,Jamal Murray,murraja01,62,DEN,0,TOR,17,9,7,1,0,0,39.71666667,1,8,6,20,0,2,5,5,2,1,16,24,26,33,41.3
2024-25,202410280NYK,10/28/2024,NYK vs CLE,Mikal Bridges,bridgmi01,85,NYK,1,CLE,19,6,3,2,1,2,40.16666667,4,2,9,15,1,4,0,0,4,3,9,22,25,28,37.7
2024-25,202410280TOR,10/28/2024,TOR vs DEN,Jakob Poeltl,poeltja01,54,TOR,1,DEN,16,19,2,0,1,3,40.18333333,8,11,7,13,0,0,2,2,2,1,21,18,35,37,41.8
2024-25,202410280ATL,10/28/2024,ATL vs WAS,Kyle Kuzma,kuzmaky01,73,WAS,0,ATL,25,11,7,0,0,5,40.41666667,2,9,8,20,5,9,4,6,2,0,18,32,36,43,43.7
2024-25,202410280SAS,10/28/2024,SAS vs HOU,Fred VanVleet,vanvlfr01,77,HOU,0,SAS,11,3,9,2,0,0,40.95,1,2,4,14,3,8,0,0,3,2,12,20,14,23,34.1
2024-25,202410280TOR,10/28/2024,TOR vs DEN,Aaron Gordon,gordoaa01,76,DEN,0,TOR,16,11,8,2,1,5,42.11666667,5,6,4,8,2,2,6,8,2,3,19,24,27,35,45.2
2024-25,202410280TOR,10/28/2024,TOR vs DEN,Nikola Jokic,jokicni01,82,DEN,0,TOR,40,10,4,1,2,3,43.68333333,3,7,18,27,3,5,1,2,2,3,14,44,50,54,64
2024-25,202410270GSW,10/27/2024,GSW vs LAC,Moses Moody,moodymo01,69,GSW,1,LAC,3,2,0,0,0,2,11.75,1,1,1,3,1,2,0,2,1,0,2,3,5,5,3.4
2024-25,202410270BRK,10/27/2024,BRK vs MIL,A.J. Green,greenaj01,59,MIL,0,BRK,5,0,1,0,0,1,12.86666667,0,0,1,4,1,4,2,2,0,0,1,6,5,6,5.5
2024-25,202410270POR,10/27/2024,POR vs NOP,Donovan Clingan,clingdo01,3,POR,1,NOP,9,9,0,0,2,0,13.15,6,3,4,6,0,0,1,1,3,2,9,9,18,18,25.8
2024-25,202410270BRK,10/27/2024,BRK vs MIL,Delon Wright,wrighde01,50,MIL,0,BRK,0,2,0,0,1,1,13.28333333,0,2,0,2,0,1,0,0,1,1,2,0,2,2,4.4
2024-25,202410270GSW,10/27/2024,GSW vs LAC,Gary Payton II,paytoga02,47,GSW,1,LAC,6,3,0,0,0,0,13.55,2,1,2,5,0,1,2,2,1,0,3,6,9,9,9.6
2024-25,202410270BRK,10/27/2024,BRK vs MIL,Jalen Wilson,wilsoja03,46,BRK,1,MIL,2,1,2,0,0,0,14.31666667,0,1,1,1,0,0,0,0,2,0,3,4,3,5,6.2
2024-25,202410270OKC,10/27/2024,OKC vs ATL,Ajay Mitchell,mitchaj01,3,OKC,1,ATL,0,3,3,0,1,0,14.45,0,3,0,1,0,0,0,0,1,1,6,3,3,6,11.1
2024-25,202410270POR,10/27/2024,POR vs NOP,Jabari Walker,walkeja01,75,POR,1,NOP,7,5,0,0,1,1,14.53333333,2,3,2,7,1,2,2,2,3,1,5,7,12,12,15
2024-25,202410270IND,10/27/2024,IND vs PHI,Ben Sheppard,sheppbe01,61,IND,1,PHI,6,2,2,0,0,0,15.01666667,0,2,2,3,2,2,0,0,0,0,4,8,8,10,11.4
2024-25,202410270POR,10/27/2024,POR vs NOP,Kris Murray,murrakr01,65,POR,1,NOP,5,1,1,0,0,2,15.16666667,0,1,2,3,1,2,0,2,0,0,2,6,6,7,5.7
2024-25,202410270GSW,10/27/2024,GSW vs LAC,Nicolas Batum,batumni01,63,LAC,0,GSW,5,4,2,0,0,1,15.46666667,2,2,2,4,1,3,0,0,3,0,6,7,9,11,11.8
2024-25,202410270POR,10/27/2024,POR vs NOP,Javonte Green,greenja02,12,NOP,0,POR,7,3,0,0,2,0,15.48333333,2,1,2,3,1,2,2,2,3,2,3,7,10,10,16.6
2024-25,202410270POR,10/27/2024,POR vs NOP,Jose Alvarado,alvarjo01,59,NOP,0,POR,3,1,4,1,1,0,15.7,1,0,1,5,1,4,0,0,2,2,5,7,4,8,16.2
2024-25,202410270OKC,10/27/2024,OKC vs ATL,Isaiah Joe,joeis01,81,OKC,1,ATL,6,1,1,0,0,1,15.85,1,0,2,7,2,5,0,0,3,0,2,7,7,8,7.7
2024-25,202410270GSW,10/27/2024,GSW vs LAC,Trayce Jackson-Davis,jackstr02,71,GSW,1,LAC,4,1,1,0,1,1,15.95,0,1,2,6,0,0,0,0,0,1,2,5,5,6,8.7
2024-25,202410270POR,10/27/2024,POR vs NOP,Daniel Theis,theisda01,63,NOP,0,POR,2,4,1,0,2,0,16.55,1,3,1,2,0,1,0,0,1,2,5,3,6,7,14.3
2024-25,202410270GSW,10/27/2024,GSW vs LAC,Kevin Porter Jr.,porteke02,3,LAC,0,GSW,7,0,3,2,0,2,16.8,0,0,2,7,1,2,2,2,3,2,3,10,7,10,15.5
2024-25,202410270BRK,10/27/2024,BRK vs MIL,Pat Connaughton,connapa01,79,MIL,0,BRK,3,3,2,0,0,1,17.06666667,1,2,1,4,1,3,0,0,2,0,5,5,6,8,8.6
2024-25,202410270GSW,10/27/2024,GSW vs LAC,De'Anthony Melton,meltode01,41,GSW,1,LAC,8,1,0,0,1,0,17.1,0,1,3,5,2,4,0,0,2,1,1,8,9,9,12.2
2024-25,202410270IND,10/27/2024,IND vs PHI,Kyle Lowry,lowryky01,63,PHI,0,IND,6,1,2,1,0,0,17.13333333,0,1,2,4,2,3,0,0,2,1,3,8,7,9,13.2
2024-25,202410270IND,10/27/2024,IND vs PHI,Guerschon Yabusele,yabusgu01,3,PHI,0,IND,0,6,4,1,0,1,17.28333333,5,1,0,4,0,2,0,0,2,1,10,4,6,10,15.2
2024-25,202410270IND,10/27/2024,IND vs PHI,Jared McCain,mccaija01,3,PHI,0,IND,4,2,1,0,0,1,17.4,1,1,2,5,0,2,0,0,1,0,3,5,6,7,6.9
2024-25,202410270OKC,10/27/2024,OKC vs ATL,Aaron Wiggins,wiggiaa01,81,OKC,1,ATL,9,1,1,1,0,1,18.1,1,0,3,4,1,2,2,2,1,1,2,10,10,11,13.7
2024-25,202410270GSW,10/27/2024,GSW vs LAC,Terance Mann,mannte01,78,LAC,0,GSW,2,1,0,1,0,1,18.31666667,0,1,1,5,0,1,0,0,3,1,1,2,3,3,5.2
2024-25,202410270BRK,10/27/2024,BRK vs MIL,Ziaire Williams,willizi02,54,BRK,1,MIL,7,4,0,1,1,0,18.43333333,2,2,3,8,1,2,0,0,3,2,4,7,11,11,17.8
2024-25,202410270OKC,10/27/2024,OKC vs ATL,David Roddy,roddyda01,66,ATL,0,OKC,10,5,3,0,0,0,19.63333333,2,3,4,5,1,1,1,3,0,0,8,13,15,18,20.5
2024-25,202410270GSW,10/27/2024,GSW vs LAC,Amir Coffey,coffeam01,73,LAC,0,GSW,8,3,0,0,0,0,19.71666667,1,2,3,5,1,1,1,2,1,0,3,8,11,11,11.6
2024-25,202410270GSW,10/27/2024,GSW vs LAC,Kevon Looney,looneke01,77,GSW,1,LAC,10,11,3,3,0,1,20.06666667,5,6,4,9,0,0,2,4,4,3,14,13,21,24,35.7
2024-25,202410270POR,10/27/2024,POR vs NOP,Yves Missi,missiyv01,3,NOP,0,POR,5,3,2,2,2,1,20.23333333,3,0,2,4,0,0,1,1,3,4,5,7,8,10,22.6
2024-25,202410270OKC,10/27/2024,OKC vs ATL,Vit Krejci,krejcvi01,25,ATL,0,OKC,5,4,2,1,0,2,20.25,1,3,2,7,1,3,0,0,3,1,6,7,9,11,13.8
2024-25,202410270IND,10/27/2024,IND vs PHI,Bennedict Mathurin,mathube01,63,IND,1,PHI,5,2,2,0,0,1,21.15,1,1,2,6,0,4,1,2,2,0,4,7,7,9,9.4
2024-25,202410270BRK,10/27/2024,BRK vs MIL,Noah Clowney,clownno01,26,BRK,1,MIL,13,4,0,0,0,1,21.2,1,3,4,13,3,8,2,2,2,0,4,13,17,17,16.8
2024-25,202410270OKC,10/27/2024,OKC vs ATL,Alex Caruso,carusal01,74,OKC,1,ATL,2,2,1,3,2,2,21.35,1,1,1,3,0,2,0,1,1,5,3,3,4,5,18.9
2024-25,202410270IND,10/27/2024,IND vs PHI,T.J. McConnell,mccontj01,75,IND,1,PHI,10,5,4,1,0,2,21.43333333,2,3,5,10,0,0,0,0,1,1,9,14,15,19,23
2024-25,202410270OKC,10/27/2024,OKC vs ATL,Clint Capela,capelca01,76,ATL,0,OKC,6,10,2,1,1,0,21.58333333,5,5,3,8,0,0,0,1,1,2,12,8,16,18,27
2024-25,202410270IND,10/27/2024,IND vs PHI,KJ Martin,martike04,63,PHI,0,IND,8,3,1,1,0,0,21.58333333,2,1,3,3,1,1,1,2,4,1,4,9,11,12,16.1
2024-25,202410270OKC,10/27/2024,OKC vs ATL,Garrison Mathews,mathega01,68,ATL,0,OKC,14,2,2,2,0,1,21.61666667,1,1,4,9,4,8,2,2,5,2,4,16,16,18,24.4
2024-25,202410270BRK,10/27/2024,BRK vs MIL,Nic Claxton,claxtni01,74,BRK,1,MIL,10,11,1,0,2,1,21.78333333,5,6,5,6,0,0,0,0,4,2,12,11,21,22,29.7
2024-25,202410270GSW,10/27/2024,GSW vs LAC,Jonathan Kuminga,kuminjo01,77,GSW,1,LAC,12,5,1,3,0,1,22.05,3,2,4,10,1,6,3,6,2,3,6,13,17,18,27.5
2024-25,202410270IND,10/27/2024,IND vs PHI,Obi Toppin,toppiob01,86,IND,1,PHI,15,4,1,2,0,2,22.85,2,2,4,8,1,3,6,7,1,2,5,16,19,20,25.3
2024-25,202410270OKC,10/27/2024,OKC vs ATL,Cason Wallace,wallaca01,85,OKC,1,ATL,5,4,1,3,0,2,23.3,0,4,2,6,1,4,0,0,2,3,5,6,9,10,18.3
2024-25,202410270OKC,10/27/2024,OKC vs ATL,Onyeka Okongwu,okongon01,58,ATL,0,OKC,14,3,1,1,0,0,23.36666667,2,1,3,9,1,2,7,9,2,1,4,15,17,18,22.1
2024-25,202410270BRK,10/27/2024,BRK vs MIL,Ben Simmons,simmobe01,18,BRK,1,MIL,2,6,6,1,0,2,23.78333333,2,4,1,3,0,0,0,0,4,1,12,8,8,14,19.2
2024-25,202410270GSW,10/27/2024,GSW vs LAC,Brandin Podziemski,podzibr01,77,GSW,1,LAC,4,5,4,0,0,2,24.7,1,4,2,8,0,5,0,0,2,0,9,8,9,13,14
2024-25,202410270BRK,10/27/2024,BRK vs MIL,Dorian Finney-Smith,finnedo01,71,BRK,1,MIL,3,3,2,2,0,0,24.83333333,1,2,1,8,1,7,0,0,3,2,5,5,6,8,15.6
2024-25,202410270GSW,10/27/2024,GSW vs LAC,Stephen Curry,curryst01,77,GSW,1,LAC,18,4,6,2,1,6,26.7,0,4,6,11,4,7,2,2,1,3,10,24,22,28,34.8
2024-25,202410270GSW,10/27/2024,GSW vs LAC,Draymond Green,greendr01,58,GSW,1,LAC,2,5,2,0,0,2,26.81666667,0,5,0,2,0,1,2,2,4,0,7,4,7,9,9
2024-25,202410270BRK,10/27/2024,BRK vs MIL,Bobby Portis,portibo01,85,MIL,0,BRK,16,10,2,0,1,0,26.85,2,8,7,14,1,4,1,1,0,1,12,18,26,28,34
2024-25,202410270OKC,10/27/2024,OKC vs ATL,Zaccharie Risacher,risacza01,3,ATL,0,OKC,13,6,2,1,1,1,26.91666667,3,3,6,12,0,2,1,2,1,2,8,15,19,21,28.2
2024-25,202410270GSW,10/27/2024,GSW vs LAC,Buddy Hield,hieldbu01,88,GSW,1,LAC,8,6,2,1,1,4,27.88333333,1,5,3,14,1,9,1,1,3,2,8,10,14,16,20.2
2024-25,202410270BRK,10/27/2024,BRK vs MIL,Gary Trent Jr.,trentga02,74,MIL,0,BRK,9,0,2,0,0,2,27.9,0,0,2,8,2,6,3,4,4,0,2,11,9,11,10
2024-25,202410270POR,10/27/2024,POR vs NOP,Zion Williamson,willizi01,72,NOP,0,POR,14,3,4,0,1,3,28.03333333,2,1,3,12,0,0,8,10,3,1,7,18,17,21,23.6
2024-25,202410270GSW,10/27/2024,GSW vs LAC,Norman Powell,powelno01,79,LAC,0,GSW,20,1,0,0,1,1,28.08333333,0,1,8,15,2,7,2,3,4,1,1,20,21,21,23.2
2024-25,202410270IND,10/27/2024,IND vs PHI,Aaron Nesmith,nesmiaa01,76,IND,1,PHI,10,7,1,1,0,2,28.41666667,1,6,2,4,1,1,5,5,5,1,8,11,17,18,20.9
2024-25,202410270GSW,10/27/2024,GSW vs LAC,Kris Dunn,dunnkr01,69,LAC,0,GSW,6,9,4,4,0,2,28.45,0,9,3,5,0,2,0,1,2,4,13,10,15,19,32.8
2024-25,202410270BRK,10/27/2024,BRK vs MIL,Cameron Johnson,johnsca02,61,BRK,1,MIL,13,6,3,2,0,1,28.51666667,0,6,5,12,3,9,0,0,3,2,9,16,19,22,29.7
2024-25,202410270POR,10/27/2024,POR vs NOP,Jerami Grant,grantje01,57,POR,1,NOP,28,5,2,2,4,3,28.61666667,1,4,9,17,2,7,8,12,3,6,7,30,33,35,52
2024-25,202410270OKC,10/27/2024,OKC vs ATL,Luguentz Dort,dortlu01,82,OKC,1,ATL,16,2,1,0,0,0,28.83333333,1,1,5,7,4,6,2,2,5,0,3,17,18,19,19.9
2024-25,202410270BRK,10/27/2024,BRK vs MIL,Brook Lopez,lopezbr01,82,MIL,0,BRK,15,4,0,2,0,1,28.96666667,0,4,6,9,3,5,0,0,1,2,4,15,19,19,24.8
2024-25,202410270GSW,10/27/2024,GSW vs LAC,Andrew Wiggins,wiggian01,74,GSW,1,LAC,29,3,0,1,1,1,29.13333333,0,3,11,15,5,8,2,3,2,2,3,29,32,32,37.6
2024-25,202410270OKC,10/27/2024,OKC vs ATL,Jalen Johnson,johnsja05,59,ATL,0,OKC,7,9,2,0,1,4,29.2,1,8,3,13,1,3,0,0,5,1,11,9,16,18,19.8
2024-25,202410270POR,10/27/2024,POR vs NOP,Deni Avdija,avdijde01,78,POR,1,NOP,11,6,3,1,0,1,29.93333333,3,3,4,12,1,5,2,2,3,1,9,14,17,20,24.7
2024-25,202410270POR,10/27/2024,POR vs NOP,Scoot Henderson,hendesc01,65,POR,1,NOP,9,5,7,0,0,4,30.31666667,1,4,2,12,1,4,4,4,4,0,12,16,14,21,21.5
2024-25,202410270POR,10/27/2024,POR vs NOP,Deandre Ayton,aytonde01,58,POR,1,NOP,17,12,0,0,1,2,30.9,6,6,7,9,1,1,2,2,2,1,12,17,29,29,32.4
2024-25,202410270POR,10/27/2024,POR vs NOP,Herbert Jones,joneshe01,79,NOP,0,POR,12,2,1,2,0,2,31.16666667,2,0,5,7,1,3,1,2,5,2,3,13,14,15,19.9
2024-25,202410270IND,10/27/2024,IND vs PHI,Andrew Nembhard,nembhan01,71,IND,1,PHI,10,2,8,0,0,1,31.41666667,0,2,3,11,1,4,3,4,6,0,10,18,12,20,23.4
2024-25,202410270POR,10/27/2024,POR vs NOP,Brandon Ingram,ingrabr01,67,NOP,0,POR,14,8,6,0,0,2,31.61666667,1,7,7,17,0,3,0,0,2,0,14,20,22,28,30.6
2024-25,202410270IND,10/27/2024,IND vs PHI,Eric Gordon,gordoer01,71,PHI,0,IND,15,1,1,0,1,1,31.85,0,1,5,10,2,7,3,4,1,1,2,16,16,17,19.7
2024-25,202410270BRK,10/27/2024,BRK vs MIL,Damian Lillard,lillada01,76,MIL,0,BRK,21,4,4,0,0,4,32.06666667,1,3,5,13,1,7,10,11,2,0,8,25,25,29,27.8
2024-25,202410270POR,10/27/2024,POR vs NOP,Anfernee Simons,simonan01,49,POR,1,NOP,27,2,6,2,0,2,32.83333333,0,2,8,17,5,10,6,6,0,2,8,33,29,35,42.4
2024-25,202410270OKC,10/27/2024,OKC vs ATL,Jalen Williams,willija06,74,OKC,1,ATL,20,9,5,2,0,0,32.88333333,2,7,8,17,0,3,4,8,4,2,14,25,29,34,44.3
2024-25,202410270OKC,10/27/2024,OKC vs ATL,Chet Holmgren,holmgch01,85,OKC,1,ATL,25,9,4,1,6,3,33.28333333,2,7,8,12,3,5,6,8,2,7,13,29,34,38,59.8
2024-25,202410270BRK,10/27/2024,BRK vs MIL,Giannis Antetokounmpo,antetgi01,76,MIL,0,BRK,22,12,7,1,1,4,33.31666667,1,11,7,11,0,0,8,11,3,2,19,29,34,41,48.9
2024-25,202410270POR,10/27/2024,POR vs NOP,Toumani Camara,camarto01,73,POR,1,NOP,12,3,4,2,0,0,33.65,2,1,5,8,2,3,0,1,3,2,7,16,15,19,27.6
2024-25,202410270BRK,10/27/2024,BRK vs MIL,Taurean Prince,princta02,82,MIL,0,BRK,3,7,1,1,0,2,33.95,2,5,1,4,1,2,0,0,1,1,8,4,10,11,13.9
2024-25,202410270POR,10/27/2024,POR vs NOP,Jordan Hawkins,hawkijo01,70,NOP,0,POR,17,7,3,0,0,2,34.21666667,1,6,6,13,2,4,3,3,0,0,10,20,24,27,27.9
2024-25,202410270OKC,10/27/2024,OKC vs ATL,Dyson Daniels,daniedy01,64,ATL,0,OKC,7,8,2,1,1,1,34.28333333,2,6,3,11,0,4,1,2,3,2,10,9,15,17,24.6
2024-25,202410270BRK,10/27/2024,BRK vs MIL,Dennis Schroder,schrode01,83,BRK,1,MIL,29,4,6,1,0,2,34.51666667,0,4,8,15,5,8,8,8,3,1,10,35,33,39,43.8
2024-25,202410270BRK,10/27/2024,BRK vs MIL,Cam Thomas,thomaca02,69,BRK,1,MIL,32,5,2,2,0,2,34.98333333,1,4,10,21,2,8,10,11,0,2,7,34,37,39,45
2024-25,202410270GSW,10/27/2024,GSW vs LAC,Derrick Jones Jr.,jonesde02,79,LAC,0,GSW,18,4,0,2,0,2,35.41666667,4,0,7,10,3,4,1,2,2,2,4,18,22,22,26.8
2024-25,202410270GSW,10/27/2024,GSW vs LAC,James Harden,hardeja01,75,LAC,0,GSW,23,7,11,0,0,5,35.65,1,6,6,19,2,12,9,9,1,0,18,34,30,41,42.9
2024-25,202410270POR,10/27/2024,POR vs NOP,CJ McCollum,mccolcj01,69,NOP,0,POR,27,4,3,4,0,3,35.85,0,4,10,21,3,10,4,6,2,4,7,30,31,34,45.3
2024-25,202410270OKC,10/27/2024,OKC vs ATL,Shai Gilgeous-Alexander,gilgesh01,78,OKC,1,ATL,35,11,9,3,3,1,36.01666667,2,9,11,24,3,8,10,11,3,6,20,44,46,55,78.7
2024-25,202410270IND,10/27/2024,IND vs PHI,Caleb Martin,martica02,67,PHI,0,IND,17,12,1,1,0,5,36.83333333,4,8,6,16,1,5,4,6,4,1,13,18,29,30,30.9
2024-25,202410270OKC,10/27/2024,OKC vs ATL,Trae Young,youngtr01,57,ATL,0,OKC,24,1,8,0,0,10,37.05,0,1,7,14,2,7,8,8,3,0,9,32,25,33,27.2
2024-25,202410270IND,10/27/2024,IND vs PHI,Andre Drummond,drumman01,82,PHI,0,IND,9,17,1,2,1,4,37.23333333,5,12,4,6,0,1,1,1,5,3,18,10,26,27,35.9
2024-25,202410270IND,10/27/2024,IND vs PHI,Myles Turner,turnemy01,81,IND,1,PHI,14,4,2,4,1,6,37.26666667,0,4,4,11,2,5,4,8,5,5,6,16,18,20,30.8
2024-25,202410270IND,10/27/2024,IND vs PHI,Tyrese Haliburton,halibty01,73,IND,1,PHI,22,4,2,0,1,3,37.3,1,3,8,18,4,9,2,5,2,1,6,24,26,28,29.8
2024-25,202410270GSW,10/27/2024,GSW vs LAC,Ivica Zubac,zubaciv01,71,LAC,0,GSW,23,18,6,2,1,4,37.51666667,6,12,10,19,0,0,3,4,1,3,24,29,41,47,58.6
2024-25,202410270IND,10/27/2024,IND vs PHI,Kelly Oubre Jr.,oubreke01,71,PHI,0,IND,14,8,0,2,0,2,37.9,3,5,6,18,0,4,2,3,4,2,8,14,22,22,27.6
2024-25,202410270IND,10/27/2024,IND vs PHI,Pascal Siakam,siakapa01,83,IND,1,PHI,17,5,6,0,1,1,40.11666667,0,5,7,11,2,4,1,2,2,1,11,23,22,28,34
2024-25,202410270IND,10/27/2024,IND vs PHI,Tyrese Maxey,maxeyty01,73,PHI,0,IND,45,4,4,1,2,5,47.78333333,0,4,14,32,5,17,12,15,3,3,8,49,49,53,59.8
2024-25,202410260CHI,10/26/2024,CHI vs OKC,Jalen Smith,smithja04,64,CHI,1,OKC,4,6,0,0,0,0,11.05,2,4,1,4,1,2,1,2,2,0,6,4,10,10,11.2
2024-25,202410260WAS,10/26/2024,WAS vs CLE,Jared Butler,butleja02,42,WAS,1,CLE,8,1,3,1,1,0,11.18333333,0,1,3,4,1,1,1,2,2,2,4,11,9,12,19.7
2024-25,202410260DEN,10/26/2024,DEN vs LAC,Dario Saric,saricda01,66,DEN,1,LAC,0,2,0,0,0,0,11.23333333,1,1,0,2,0,0,0,0,2,0,2,0,2,2,2.4
2024-25,202410260MEM,10/26/2024,MEM vs ORL,Jett Howard,howarje01,21,ORL,0,MEM,11,2,0,0,0,0,11.55,0,2,4,6,3,5,0,0,1,0,2,11,13,13,13.4
2024-25,202410260CHO,10/26/2024,CHO vs MIA,Thomas Bryant,bryanth01,40,MIA,0,CHO,6,1,2,1,1,0,11.63333333,1,0,3,4,0,0,0,0,2,2,3,8,7,9,16.2
2024-25,202410260DEN,10/26/2024,DEN vs LAC,Peyton Watson,watsope01,82,DEN,1,LAC,1,0,0,1,0,0,11.76666667,0,0,0,3,0,1,1,2,1,1,0,1,1,1,4
2024-25,202410260CHI,10/26/2024,CHI vs OKC,Isaiah Joe,joeis01,80,OKC,0,CHI,6,1,1,0,0,0,11.8,0,1,2,4,2,4,0,0,2,0,2,7,7,8,8.7
2024-25,202410260MIN,10/26/2024,MIN vs TOR,Bruno Fernando,fernabr01,48,TOR,0,MIN,6,3,1,1,2,2,12.31666667,2,1,2,4,0,0,2,2,3,3,4,7,9,10,18.1
2024-25,202410260MEM,10/26/2024,MEM vs ORL,Moritz Wagner,wagnemo01,83,ORL,0,MEM,9,3,0,0,1,0,12.38333333,2,1,4,8,1,3,0,0,4,1,3,9,12,12,15.6
2024-25,202410260LAL,10/26/2024,LAL vs SAC,Gabe Vincent,vincega01,14,LAL,1,SAC,2,0,0,1,0,0,12.61666667,0,0,1,6,0,4,0,0,1,1,0,2,2,2,5
2024-25,202410260PHO,10/26/2024,PHO vs DAL,Jaden Hardy,hardyja02,75,DAL,0,PHO,0,1,0,0,0,0,13.26666667,0,1,0,4,0,3,0,0,1,0,1,0,1,1,1.2
2024-25,202410260MEM,10/26/2024,MEM vs ORL,Zach Edey,edeyza01,3,MEM,1,ORL,7,1,0,0,0,0,13.36666667,0,1,3,4,1,1,0,0,4,0,1,7,8,8,8.2
2024-25,202410260SAS,10/26/2024,SAS vs HOU,Jock Landale,landajo01,59,HOU,0,SAS,13,2,0,0,0,0,13.61666667,0,2,5,7,0,0,3,4,0,0,2,13,15,15,15.4
2024-25,202410260SAS,10/26/2024,SAS vs HOU,Malaki Branham,branhma01,77,SAS,1,HOU,7,3,2,0,2,2,13.68333333,0,3,3,5,0,0,1,1,0,2,5,9,10,12,17.6
2024-25,202410260LAL,10/26/2024,LAL vs SAC,Jaxson Hayes,hayesja02,74,LAL,1,SAC,4,2,1,0,0,0,14.46666667,1,1,2,2,0,0,0,0,2,0,3,5,6,7,7.9
2024-25,202410260DEN,10/26/2024,DEN vs LAC,Kevin Porter Jr.,porteke02,2,LAC,0,DEN,4,2,1,0,0,2,14.8,1,1,2,10,0,3,0,0,1,0,3,5,6,7,5.9
2024-25,202410260CHI,10/26/2024,CHI vs OKC,Julian Phillips,phillju01,43,CHI,1,OKC,9,1,0,1,0,0,14.93333333,0,1,3,6,2,5,1,1,1,1,1,9,10,10,13.2
2024-25,202410260WAS,10/26/2024,WAS vs CLE,Ty Jerome,jeromty01,5,CLE,0,WAS,14,2,3,1,0,1,15.16666667,1,1,4,6,1,1,5,6,1,1,5,17,16,19,22.9
2024-25,202410260CHO,10/26/2024,CHO vs MIA,Duncan Robinson,robindu01,70,MIA,0,CHO,4,0,1,0,2,0,15.38333333,0,0,2,8,0,5,0,0,0,2,1,5,4,5,11.5
2024-25,202410260CHI,10/26/2024,CHI vs OKC,Lonzo Ball,balllo01,2,CHI,1,OKC,3,5,1,0,0,2,15.56666667,0,5,1,6,1,5,0,0,2,0,6,4,8,9,8.5
2024-25,202410260CHI,10/26/2024,CHI vs OKC,Ajay Mitchell,mitchaj01,2,OKC,0,CHI,4,1,3,2,0,1,15.71666667,0,1,2,5,0,0,0,0,2,2,4,7,5,8,14.7
2024-25,202410260CHI,10/26/2024,CHI vs OKC,Aaron Wiggins,wiggiaa01,80,OKC,0,CHI,8,3,1,1,0,2,15.71666667,1,2,4,7,0,2,0,0,5,1,4,9,11,12,14.1
2024-25,202410260PHO,10/26/2024,PHO vs DAL,Maxi Kleber,klebima01,45,DAL,0,PHO,2,1,2,0,0,0,15.78333333,0,1,1,2,0,1,0,0,2,0,3,4,3,5,6.2
2024-25,202410260PHO,10/26/2024,PHO vs DAL,Naji Marshall,marshna01,68,DAL,0,PHO,2,2,3,1,0,0,15.96666667,1,1,1,5,0,2,0,0,2,1,5,5,4,7,11.9
2024-25,202410260MIN,10/26/2024,MIN vs TOR,Chris Boucher,bouchch01,53,TOR,0,MIN,4,9,0,0,0,0,15.98333333,1,8,2,8,0,4,0,2,2,0,9,4,13,13,14.8
2024-25,202410260DEN,10/26/2024,DEN vs LAC,Julian Strawther,strawju01,52,DEN,1,LAC,8,2,3,2,0,1,16.2,1,1,3,5,2,2,0,0,5,2,5,11,10,13,19.9
2024-25,202410260MIN,10/26/2024,MIN vs TOR,Nickeil Alexander-Walker,alexani01,85,MIN,1,TOR,4,1,4,0,0,0,16.46666667,0,1,1,2,1,1,1,2,1,0,5,8,5,9,11.2
2024-25,202410260PHO,10/26/2024,PHO vs DAL,Monte Morris,morrimo01,36,PHO,1,DAL,8,3,3,0,0,1,16.46666667,1,2,2,7,1,4,3,4,0,0,6,11,11,14,15.1
2024-25,202410260MEM,10/26/2024,MEM vs ORL,Brandon Clarke,clarkbr01,9,MEM,1,ORL,5,5,1,2,0,0,17.56666667,0,5,2,5,0,1,1,1,3,2,6,6,10,11,18.5
2024-25,202410260MEM,10/26/2024,MEM vs ORL,Jaylen Wells,wellsja01,3,MEM,1,ORL,7,2,2,0,0,0,17.56666667,1,1,2,6,1,1,2,2,0,0,4,9,9,11,12.4
2024-25,202410260PHO,10/26/2024,PHO vs DAL,Damion Lee,leeda03,1,PHO,1,DAL,2,3,2,0,0,1,17.66666667,0,3,1,3,0,2,0,0,1,0,5,4,5,7,7.6
2024-25,202410260SAS,10/26/2024,SAS vs HOU,Zach Collins,colliza01,71,SAS,1,HOU,4,8,2,0,0,0,17.8,2,6,1,4,0,0,2,2,3,0,10,6,12,14,16.6
2024-25,202410260LAL,10/26/2024,LAL vs SAC,Max Christie,chrisma02,71,LAL,1,SAC,2,0,4,2,0,2,17.9,0,0,1,4,0,2,0,0,2,2,4,6,2,6,12
2024-25,202410260DET,10/26/2024,DET vs BOS,Xavier Tillman Sr.,tillmxa01,57,BOS,0,DET,3,3,1,2,0,1,18.11666667,1,2,1,2,1,2,0,0,2,2,4,4,6,7,13.1
2024-25,202410260PHO,10/26/2024,PHO vs DAL,Daniel Gafford,gaffoda01,76,DAL,0,PHO,7,8,4,0,0,1,18.15,4,4,3,7,0,0,1,2,2,0,12,11,15,19,21.6
2024-25,202410260DET,10/26/2024,DET vs BOS,Simone Fontecchio,fontesi01,69,DET,1,BOS,11,2,0,0,0,0,18.18333333,0,2,3,6,3,5,2,2,2,0,2,11,13,13,13.4
2024-25,202410260SAS,10/26/2024,SAS vs HOU,Tari Eason,easonta01,25,HOU,0,SAS,6,2,2,3,1,1,18.31666667,0,2,3,6,0,2,0,0,3,4,4,8,8,10,22.4
2024-25,202410260LAL,10/26/2024,LAL vs SAC,Trey Lyles,lylestr01,60,SAC,0,LAL,5,4,1,1,1,0,18.61666667,1,3,1,6,1,6,2,2,3,2,5,6,9,10,17.3
2024-25,202410260DEN,10/26/2024,DEN vs LAC,Kris Dunn,dunnkr01,68,LAC,0,DEN,11,6,1,0,0,1,18.63333333,1,5,4,6,3,5,0,0,5,0,7,12,17,18,18.7
2024-25,202410260WAS,10/26/2024,WAS vs CLE,Dean Wade,wadede01,57,CLE,0,WAS,2,5,1,1,0,0,18.75,0,5,1,4,0,3,0,0,3,1,6,3,7,8,12.5
2024-25,202410260MIN,10/26/2024,MIN vs TOR,Jamison Battle,battlja01,3,TOR,0,MIN,9,6,1,0,0,0,18.8,2,4,3,8,1,4,2,2,0,0,7,10,15,16,17.7
2024-25,202410260DET,10/26/2024,DET vs BOS,Isaiah Stewart,stewais01,49,DET,1,BOS,6,5,3,1,0,1,18.86666667,2,3,3,3,0,0,0,0,4,1,8,9,11,14,18.5
2024-25,202410260MIN,10/26/2024,MIN vs TOR,Jamal Shead,sheadja01,3,TOR,0,MIN,5,0,5,0,0,1,18.88333333,0,0,2,4,1,2,0,0,2,0,5,10,5,10,11.5
2024-25,202410260WAS,10/26/2024,WAS vs CLE,Isaac Okoro,okorois01,72,CLE,0,WAS,3,5,1,2,2,1,18.9,3,2,0,4,0,1,3,5,2,4,6,4,8,9,21.5
2024-25,202410260DEN,10/26/2024,DEN vs LAC,Russell Westbrook,westbru01,70,DEN,1,LAC,2,1,2,2,1,0,19.1,0,1,0,8,0,3,2,2,4,3,3,4,3,5,15.2
2024-25,202410260MEM,10/26/2024,MEM vs ORL,Jay Huff,huffja01,23,MEM,1,ORL,18,2,0,0,1,0,19.13333333,0,2,7,9,3,5,1,1,1,1,2,18,20,20,23.4
2024-25,202410260WAS,10/26/2024,WAS vs CLE,Caris LeVert,leverca01,71,CLE,0,WAS,10,0,4,0,2,0,19.18333333,0,0,3,4,2,2,2,2,1,2,4,14,10,14,22
2024-25,202410260DET,10/26/2024,DET vs BOS,Payton Pritchard,pritcpa01,85,BOS,0,DET,19,2,0,1,0,0,19.28333333,0,2,5,8,5,7,4,4,1,1,2,19,21,21,24.4
2024-25,202410260CHO,10/26/2024,CHO vs MIA,Grant Williams,willigr01,79,CHO,1,MIA,7,2,1,1,0,2,19.3,1,1,2,7,2,5,1,2,0,1,3,8,9,10,11.9
2024-25,202410260DET,10/26/2024,DET vs BOS,Luke Kornet,kornelu01,66,BOS,0,DET,0,4,3,1,1,2,19.31666667,3,1,0,1,0,0,0,0,2,2,7,3,4,7,13.3
2024-25,202410260WAS,10/26/2024,WAS vs CLE,Sam Merrill,merrisa01,64,CLE,0,WAS,11,2,1,1,0,1,19.58333333,1,1,3,8,3,7,2,2,2,1,3,12,13,14,16.9
2024-25,202410260SAS,10/26/2024,SAS vs HOU,Amen Thompson,thompam01,65,HOU,0,SAS,1,4,2,0,0,1,19.9,2,2,0,3,0,2,1,2,2,0,6,3,5,7,7.8
2024-25,202410260LAL,10/26/2024,LAL vs SAC,Dalton Knecht,knechda01,3,LAL,1,SAC,10,0,1,0,0,1,20.16666667,0,0,4,7,2,5,0,0,3,0,1,11,10,11,10.5
2024-25,202410260DET,10/26/2024,DET vs BOS,Malik Beasley,beaslma01,82,DET,1,BOS,17,3,0,0,0,1,20.31666667,0,3,5,10,5,8,2,2,0,0,3,17,20,20,19.6
2024-25,202410260MEM,10/26/2024,MEM vs ORL,Anthony Black,blackan01,72,ORL,0,MEM,10,1,3,0,1,2,20.38333333,0,1,4,8,0,1,2,2,2,1,4,13,11,14,16.7
2024-25,202410260CHI,10/26/2024,CHI vs OKC,Ousmane Dieng,diengou01,35,OKC,0,CHI,6,6,1,0,1,0,20.43333333,0,6,2,7,0,4,2,3,0,1,7,7,12,13,17.7
2024-25,202410260SAS,10/26/2024,SAS vs HOU,Cam Whitmore,whitmca01,50,HOU,0,SAS,10,3,0,0,1,0,20.78333333,1,2,4,10,0,3,2,3,0,1,3,10,13,13,16.6
2024-25,202410260DEN,10/26/2024,DEN vs LAC,Terance Mann,mannte01,77,LAC,0,DEN,0,3,1,0,0,0,20.88333333,1,2,0,4,0,2,0,0,2,0,4,1,3,4,5.1
2024-25,202410260WAS,10/26/2024,WAS vs CLE,Jonas Valanciunas,valanjo01,84,WAS,1,CLE,10,8,0,1,0,3,21.11666667,4,4,4,7,0,0,2,2,1,1,8,10,18,18,19.6
2024-25,202410260PHO,10/26/2024,PHO vs DAL,Ryan Dunn,dunnry01,3,PHO,1,DAL,13,1,1,0,0,1,21.16666667,1,0,5,8,3,6,0,0,5,0,2,14,14,15,14.7
2024-25,202410260MIN,10/26/2024,MIN vs TOR,Naz Reid,reidna01,84,MIN,1,TOR,10,4,1,1,0,0,21.18333333,1,3,3,7,0,2,4,4,0,1,5,11,14,15,19.3
2024-25,202410260WAS,10/26/2024,WAS vs CLE,Georges Niang,niangge01,85,CLE,0,WAS,3,6,1,1,0,0,21.23333333,3,3,1,7,1,6,0,0,2,1,7,4,9,10,14.7
2024-25,202410260PHO,10/26/2024,PHO vs DAL,Dereck Lively II,livelde01,57,DAL,0,PHO,5,11,3,0,0,1,21.3,4,7,2,2,0,0,1,2,3,0,14,8,16,19,21.7
2024-25,202410260MEM,10/26/2024,MEM vs ORL,Marcus Smart,smartma01,23,MEM,1,ORL,9,0,3,2,1,2,21.35,0,0,4,8,1,3,0,0,1,3,3,12,9,12,20.5
2024-25,202410260DEN,10/26/2024,DEN vs LAC,Nicolas Batum,batumni01,62,LAC,0,DEN,1,4,3,0,1,0,21.5,1,3,0,0,0,0,1,2,3,1,7,4,5,8,13.3
2024-25,202410260CHI,10/26/2024,CHI vs OKC,Alex Caruso,carusal01,73,OKC,0,CHI,3,2,2,2,2,0,21.66666667,0,2,1,5,1,3,0,0,3,4,4,5,5,7,20.4
2024-25,202410260CHO,10/26/2024,CHO vs MIA,Jaime Jaquez Jr.,jaqueja01,77,MIA,0,CHO,6,6,4,1,0,4,21.66666667,2,4,2,4,2,2,0,0,2,1,10,10,12,16,18.2
2024-25,202410260SAS,10/26/2024,SAS vs HOU,Alperen Sengun,sengual01,66,HOU,0,SAS,6,5,2,2,0,1,22.03333333,1,4,2,8,1,2,1,2,3,2,7,8,11,13,20
2024-25,202410260MEM,10/26/2024,MEM vs ORL,Jaren Jackson Jr.,jacksja02,67,MEM,1,ORL,13,4,1,1,0,1,22.55,1,3,4,10,0,2,5,9,3,1,5,14,17,18,21.3
2024-25,202410260MEM,10/26/2024,MEM vs ORL,Scotty Pippen Jr.,pippesc02,24,MEM,1,ORL,11,5,12,2,1,5,22.91666667,2,3,5,7,1,1,0,0,5,3,17,23,16,28,39
2024-25,202410260MEM,10/26/2024,MEM vs ORL,Jake LaRavia,laravja01,38,MEM,1,ORL,3,7,2,1,0,1,23.03333333,1,6,1,1,0,0,1,2,0,1,9,5,10,12,16.4
2024-25,202410260MIN,10/26/2024,MIN vs TOR,Donte DiVincenzo,divindo01,84,MIN,1,TOR,16,2,2,1,0,2,23.35,0,2,5,15,4,11,2,2,1,1,4,18,18,20,22.4
2024-25,202410260DEN,10/26/2024,DEN vs LAC,Amir Coffey,coffeam01,72,LAC,0,DEN,0,2,3,1,0,0,23.68333333,1,1,0,5,0,3,0,0,1,1,5,3,2,5,9.9
2024-25,202410260WAS,10/26/2024,WAS vs CLE,Jordan Poole,poolejo01,80,WAS,1,CLE,14,1,6,3,0,1,23.75,0,1,4,9,4,7,2,2,2,3,7,20,15,21,32.2
2024-25,202410260WAS,10/26/2024,WAS vs CLE,Darius Garland,garlada01,60,CLE,0,WAS,23,2,5,2,0,4,23.95,0,2,9,11,4,5,1,1,4,2,7,28,25,30,34.9
2024-25,202410260CHI,10/26/2024,CHI vs OKC,Ayo Dosunmu,dosunay01,79,CHI,1,OKC,3,5,6,0,0,2,24.2,0,5,1,11,1,9,0,0,4,0,11,9,8,14,16
2024-25,202410260WAS,10/26/2024,WAS vs CLE,Kyle Kuzma,kuzmaky01,72,WAS,1,CLE,14,8,3,0,0,1,24.28333333,3,5,3,16,0,4,8,10,0,0,11,17,22,25,27.1
2024-25,202410260CHI,10/26/2024,CHI vs OKC,Luguentz Dort,dortlu01,81,OKC,0,CHI,7,2,1,0,0,1,24.73333333,0,2,2,5,1,3,2,2,0,0,3,8,9,10,9.9
2024-25,202410260MEM,10/26/2024,MEM vs ORL,Ja Morant,moranja01,12,MEM,1,ORL,16,2,10,0,1,3,24.75,0,2,4,12,0,6,8,8,3,1,12,26,18,28,33.4
2024-25,202410260CHO,10/26/2024,CHO vs MIA,Alec Burks,burksal01,67,MIA,0,CHO,9,2,0,0,1,0,24.88333333,0,2,3,4,3,4,0,0,0,1,2,9,11,11,14.4
2024-25,202410260WAS,10/26/2024,WAS vs CLE,Alex Sarr,sarral01,2,WAS,1,CLE,12,6,1,1,2,0,24.98333333,2,4,4,10,2,6,2,2,3,3,7,13,18,19,29.7
2024-25,202410260WAS,10/26/2024,WAS vs CLE,Jarrett Allen,allenja01,80,CLE,0,WAS,23,5,1,1,2,0,25.06666667,1,4,10,10,0,0,3,4,1,3,6,24,28,29,39.5
2024-25,202410260SAS,10/26/2024,SAS vs HOU,Julian Champagnie,champju02,76,SAS,1,HOU,12,6,0,0,0,2,25.21666667,3,3,4,8,2,4,2,2,1,0,6,12,18,18,17.2
2024-25,202410260WAS,10/26/2024,WAS vs CLE,Carlton Carrington,carrica01,2,WAS,1,CLE,10,2,4,0,0,2,25.28333333,0,2,2,8,2,4,4,4,5,0,6,14,12,16,16.4
2024-25,202410260MIN,10/26/2024,MIN vs TOR,Mike Conley,conlemi01,79,MIN,1,TOR,10,3,6,4,1,1,25.95,1,2,2,9,2,6,4,4,1,5,9,16,13,19,36.6
2024-25,202410260LAL,10/26/2024,LAL vs SAC,Kevin Huerter,huertke01,66,SAC,0,LAL,14,2,1,2,0,1,26.36666667,0,2,5,9,4,7,0,0,2,2,3,15,16,17,22.9
2024-25,202410260WAS,10/26/2024,WAS vs CLE,Corey Kispert,kispeco01,82,WAS,1,CLE,10,1,2,0,0,1,26.38333333,0,1,4,9,2,6,0,0,2,0,3,12,11,13,13.2
2024-25,202410260CHI,10/26/2024,CHI vs OKC,Patrick Williams,willipa01,46,CHI,1,OKC,3,8,2,1,0,1,26.38333333,2,6,1,8,1,4,0,0,1,1,10,5,11,13,17.6
2024-25,202410260CHI,10/26/2024,CHI vs OKC,Josh Giddey,giddejo01,83,CHI,1,OKC,14,7,4,0,0,4,26.43333333,2,5,6,14,2,6,0,0,2,0,11,18,21,25,24.4
2024-25,202410260SAS,10/26/2024,SAS vs HOU,Stephon Castle,castlst01,2,SAS,1,HOU,8,1,3,2,1,3,26.51666667,0,1,2,8,0,2,4,6,3,3,4,11,9,12,19.7
2024-25,202410260PHO,10/26/2024,PHO vs DAL,Royce O'Neale,onealro01,82,PHO,1,DAL,7,9,4,0,1,0,26.51666667,2,7,2,6,1,5,2,2,2,1,13,11,16,20,26.8
2024-25,202410260SAS,10/26/2024,SAS vs HOU,Chris Paul,paulch01,60,SAS,1,HOU,3,0,9,1,0,4,26.53333333,0,0,1,3,1,2,0,0,2,1,9,12,3,12,15.5
2024-25,202410260WAS,10/26/2024,WAS vs CLE,Kyshawn George,georgky01,2,WAS,1,CLE,2,4,4,0,4,2,26.55,2,2,0,7,0,4,2,4,5,4,8,6,6,10,22.8
2024-25,202410260DEN,10/26/2024,DEN vs LAC,Derrick Jones Jr.,jonesde02,78,LAC,0,DEN,9,1,1,1,1,3,26.76666667,0,1,4,8,1,4,0,0,2,2,2,10,10,11,14.7
2024-25,202410260CHO,10/26/2024,CHO vs MIA,Cody Martin,martico01,31,CHO,1,MIA,10,3,2,1,1,2,27.48333333,2,1,4,9,2,6,0,0,4,2,5,12,13,15,20.6
2024-25,202410260MEM,10/26/2024,MEM vs ORL,Santi Aldama,aldamsa01,64,MEM,1,ORL,22,7,5,0,1,2,27.65,0,7,9,12,4,6,0,0,0,1,12,27,29,34,38.9
2024-25,202410260SAS,10/26/2024,SAS vs HOU,Harrison Barnes,barneha02,84,SAS,1,HOU,11,3,1,0,1,0,27.7,0,3,4,6,2,3,1,1,0,1,4,12,14,15,19.1
2024-25,202410260LAL,10/26/2024,LAL vs SAC,Malik Monk,monkma01,74,SAC,0,LAL,14,3,5,1,0,0,27.83333333,0,3,6,14,2,7,0,0,3,1,8,19,17,22,28.1
2024-25,202410260MEM,10/26/2024,MEM vs ORL,Desmond Bane,banede01,45,MEM,1,ORL,13,7,2,2,0,3,28.05,1,6,5,10,2,6,1,1,4,2,9,15,20,22,27.4
2024-25,202410260MEM,10/26/2024,MEM vs ORL,Kentavious Caldwell-Pope,caldwke01,79,ORL,0,MEM,3,2,1,2,1,1,28.25,0,2,1,6,0,4,1,1,2,3,3,4,5,6,14.9
2024-25,202410260DET,10/26/2024,DET vs BOS,Jalen Duren,durenja01,64,DET,1,BOS,15,9,2,0,2,2,28.73333333,3,6,7,7,0,0,1,2,1,2,11,17,24,26,32.8
2024-25,202410260CHI,10/26/2024,CHI vs OKC,Chet Holmgren,holmgch01,84,OKC,0,CHI,21,16,0,1,2,2,28.76666667,3,13,8,18,0,5,5,8,2,3,16,21,37,37,47.2
2024-25,202410260MIN,10/26/2024,MIN vs TOR,Davion Mitchell,mitchda01,75,TOR,0,MIN,0,2,8,1,1,0,28.8,0,2,0,5,0,1,0,0,2,2,10,8,2,10,20.4
2024-25,202410260WAS,10/26/2024,WAS vs CLE,Donovan Mitchell,mitchdo01,58,CLE,0,WAS,30,4,5,4,0,5,29.3,1,3,11,18,6,11,2,3,1,4,9,35,34,39,49.3
2024-25,202410260CHI,10/26/2024,CHI vs OKC,Cason Wallace,wallaca01,84,OKC,0,CHI,9,6,2,3,0,0,29.3,1,5,4,11,0,4,1,1,1,3,8,11,15,17,28.2
2024-25,202410260CHO,10/26/2024,CHO vs MIA,Seth Curry,curryse01,47,CHO,1,MIA,15,4,2,0,0,0,29.33333333,2,2,6,12,3,6,0,0,3,0,6,17,19,21,22.8
2024-25,202410260SAS,10/26/2024,SAS vs HOU,Keldon Johnson,johnske04,71,SAS,1,HOU,16,8,0,1,0,0,29.43333333,1,7,5,11,1,3,5,6,2,1,8,16,24,24,28.6
2024-25,202410260CHI,10/26/2024,CHI vs OKC,Shai Gilgeous-Alexander,gilgesh01,77,OKC,0,CHI,23,8,2,4,0,1,29.5,2,6,9,21,2,9,3,3,1,4,10,25,31,33,46.6
2024-25,202410260MIN,10/26/2024,MIN vs TOR,Gradey Dick,dickgr01,63,TOR,0,MIN,25,1,2,1,0,1,29.51666667,0,1,9,16,4,9,3,3,2,1,3,27,26,28,31.2
2024-25,202410260CHI,10/26/2024,CHI vs OKC,Coby White,whiteco01,82,CHI,1,OKC,9,4,3,1,0,3,29.8,0,4,3,12,0,9,3,6,3,1,7,12,13,16,18.3
2024-25,202410260CHO,10/26/2024,CHO vs MIA,Nikola Jovic,jovicni01,48,MIA,0,CHO,10,4,6,2,0,1,29.85,0,4,3,7,2,5,2,2,3,2,10,16,14,20,28.8
2024-25,202410260MIN,10/26/2024,MIN vs TOR,Jakob Poeltl,poeltja01,53,TOR,0,MIN,8,10,3,1,1,2,29.96666667,3,7,4,9,0,0,0,0,4,2,13,11,18,21,28.5
2024-25,202410260SAS,10/26/2024,SAS vs HOU,Victor Wembanyama,wembavi01,73,SAS,1,HOU,29,7,1,0,3,3,30.2,1,6,10,17,2,5,7,8,3,3,8,30,36,37,44.9
2024-25,202410260PHO,10/26/2024,PHO vs DAL,Jusuf Nurkic,nurkiju01,79,PHO,1,DAL,18,14,1,0,1,5,30.46666667,3,11,7,12,0,2,4,8,2,1,15,19,32,33,34.3
2024-25,202410260MIN,10/26/2024,MIN vs TOR,Ochai Agbaji,agbajoc01,81,TOR,0,MIN,19,2,2,2,0,4,30.58333333,0,2,8,12,3,5,0,1,2,2,4,21,21,23,26.4
2024-25,202410260MEM,10/26/2024,MEM vs ORL,Jalen Suggs,suggsja01,78,ORL,0,MEM,21,7,3,4,1,2,30.65,0,7,6,17,5,13,4,4,1,5,10,24,28,31,46.9
2024-25,202410260MEM,10/26/2024,MEM vs ORL,Wendell Carter Jr.,cartewe01,58,ORL,0,MEM,3,10,2,0,1,2,30.73333333,5,5,1,6,0,3,1,2,3,1,12,5,13,15,19
2024-25,202410260PHO,10/26/2024,PHO vs DAL,Tyus Jones,jonesty01,69,PHO,1,DAL,8,5,7,1,1,0,30.78333333,0,5,3,7,2,3,0,0,0,2,12,15,13,20,30.5
2024-25,202410260DET,10/26/2024,DET vs BOS,Tobias Harris,harrito02,73,DET,1,BOS,8,11,3,1,1,2,31.48333333,2,9,2,11,0,5,4,4,6,2,14,11,19,22,29.7
2024-25,202410260CHO,10/26/2024,CHO vs MIA,Terry Rozier,roziete01,63,MIA,0,CHO,19,5,3,0,0,2,31.6,0,5,7,12,3,6,2,2,3,0,8,22,24,27,27.5
2024-25,202410260CHO,10/26/2024,CHO vs MIA,Tre Mann,manntr01,44,CHO,1,MIA,14,5,4,1,0,1,31.75,0,5,5,11,2,5,2,2,2,1,9,18,19,23,28
2024-25,202410260SAS,10/26/2024,SAS vs HOU,Jabari Smith Jr.,smithja05,79,HOU,0,SAS,7,7,1,1,0,1,31.96666667,2,5,3,10,1,4,0,0,5,1,8,8,14,15,18.9
2024-25,202410260DET,10/26/2024,DET vs BOS,Al Horford,horfoal01,68,BOS,0,DET,17,5,1,3,0,0,31.98333333,2,3,6,10,5,8,0,0,0,3,6,18,22,23,33.5
2024-25,202410260CHI,10/26/2024,CHI vs OKC,Jalen Williams,willija06,73,OKC,0,CHI,24,9,8,0,0,2,32.06666667,2,7,10,22,1,4,3,3,1,0,17,32,33,41,44.8
2024-25,202410260WAS,10/26/2024,WAS vs CLE,Evan Mobley,mobleev01,53,CLE,0,WAS,13,13,4,0,2,2,32.3,1,12,4,13,0,2,5,7,4,2,17,17,26,30,38.6
2024-25,202410260LAL,10/26/2024,LAL vs SAC,D'Angelo Russell,russeda01,80,LAL,1,SAC,16,4,5,2,0,2,32.46666667,1,3,6,11,3,6,1,1,3,2,9,21,20,25,32.3
2024-25,202410260CHI,10/26/2024,CHI vs OKC,Nikola Vucevic,vucevni01,79,CHI,1,OKC,18,13,2,0,1,3,32.51666667,3,10,7,12,2,2,2,2,2,1,15,20,31,33,36.6
2024-25,202410260CHO,10/26/2024,CHO vs MIA,Bam Adebayo,adebaba01,73,MIA,0,CHO,12,11,3,1,1,1,32.61666667,4,7,6,17,0,2,0,1,1,2,14,15,23,26,34.7
2024-25,202410260CHO,10/26/2024,CHO vs MIA,Tyler Herro,herroty01,44,MIA,0,CHO,22,5,5,1,0,3,32.61666667,1,4,7,15,3,7,5,6,3,1,10,27,27,32,35.5
2024-25,202410260SAS,10/26/2024,SAS vs HOU,Jalen Green,greenja05,85,HOU,0,SAS,29,6,5,0,0,2,33.05,1,5,10,22,3,10,6,6,3,0,11,34,35,40,41.7
2024-25,202410260DEN,10/26/2024,DEN vs LAC,Norman Powell,powelno01,78,LAC,0,DEN,37,3,0,1,0,0,33.18333333,1,2,14,21,7,11,2,3,1,1,3,37,40,40,43.6
2024-25,202410260PHO,10/26/2024,PHO vs DAL,Klay Thompson,thompkl01,79,DAL,0,PHO,19,3,1,1,0,1,33.33333333,0,3,7,16,5,12,0,0,4,1,4,20,22,23,26.1
2024-25,202410260MIN,10/26/2024,MIN vs TOR,Jaden McDaniels,mcdanja02,75,MIN,1,TOR,9,3,2,1,2,1,33.45,1,2,4,5,1,1,0,0,2,3,5,11,12,14,23.6
2024-25,202410260LAL,10/26/2024,LAL vs SAC,Austin Reaves,reaveau01,86,LAL,1,SAC,16,7,6,0,0,6,33.53333333,4,3,7,12,2,4,0,0,3,0,13,22,23,29,27.4
2024-25,202410260LAL,10/26/2024,LAL vs SAC,LeBron James,jamesle01,75,LAL,1,SAC,32,14,10,0,1,5,33.76666667,0,14,12,22,4,9,4,4,3,1,24,42,46,56,61.8
2024-25,202410260DEN,10/26/2024,DEN vs LAC,Christian Braun,braunch01,84,DEN,1,LAC,11,7,1,1,2,1,34.26666667,1,6,4,6,1,1,2,2,3,3,8,12,18,19,28.9
2024-25,202410260CHI,10/26/2024,CHI vs OKC,Zach LaVine,lavinza01,28,CHI,1,OKC,22,9,3,2,1,7,34.26666667,0,9,6,13,4,9,6,7,1,3,12,25,31,34,39.3
2024-25,202410260MEM,10/26/2024,MEM vs ORL,Franz Wagner,wagnefr01,75,ORL,0,MEM,23,7,3,2,0,6,34.33333333,1,6,7,16,4,10,5,6,2,2,10,26,30,33,35.9
2024-25,202410260CHO,10/26/2024,CHO vs MIA,Nick Richards,richani01,70,CHO,1,MIA,12,12,1,1,3,3,34.6,4,8,5,8,0,1,2,3,4,4,13,13,24,25,36.9
2024-25,202410260CHO,10/26/2024,CHO vs MIA,Miles Bridges,bridgmi02,72,CHO,1,MIA,16,9,2,0,1,2,34.78333333,2,7,6,14,2,6,2,4,2,1,11,18,25,27,30.8
2024-25,202410260WAS,10/26/2024,WAS vs CLE,Bilal Coulibaly,coulibi01,65,WAS,1,CLE,23,6,1,0,0,3,35.16666667,3,3,9,16,4,9,1,1,2,0,7,24,29,30,28.7
2024-25,202410260PHO,10/26/2024,PHO vs DAL,P.J. Washington,washipj01,75,DAL,0,PHO,5,6,0,1,1,1,35.28333333,2,4,2,10,1,5,0,0,4,2,6,5,11,11,17.2
2024-25,202410260SAS,10/26/2024,SAS vs HOU,Dillon Brooks,brookdi01,75,HOU,0,SAS,16,2,1,1,1,1,35.31666667,1,1,6,12,4,7,0,0,5,2,3,17,18,19,24.9
2024-25,202410260DET,10/26/2024,DET vs BOS,Jrue Holiday,holidjr01,72,BOS,0,DET,7,3,4,0,1,3,35.65,1,2,2,5,2,3,1,2,2,1,7,11,10,14,16.6
2024-25,202410260MIN,10/26/2024,MIN vs TOR,Julius Randle,randlju01,49,MIN,1,TOR,24,9,5,0,0,4,35.83333333,3,6,9,16,1,4,5,7,2,0,14,29,33,38,38.3
2024-25,202410260DEN,10/26/2024,DEN vs LAC,Aaron Gordon,gordoaa01,75,DEN,1,LAC,10,5,2,1,0,0,35.85,2,3,3,10,1,4,3,4,2,1,7,12,15,17,22
2024-25,202410260CHO,10/26/2024,CHO vs MIA,LaMelo Ball,ballla01,25,CHO,1,MIA,27,8,7,1,0,5,36.51666667,2,6,9,22,2,10,7,8,5,1,15,34,35,42,45.1
2024-25,202410260LAL,10/26/2024,LAL vs SAC,Domantas Sabonis,sabondo01,84,SAC,0,LAL,29,12,10,1,1,2,36.75,3,9,10,14,1,3,8,9,3,2,22,39,41,51,62.4
2024-25,202410260DEN,10/26/2024,DEN vs LAC,Nikola Jokic,jokicni01,81,DEN,1,LAC,41,9,4,2,1,5,36.76666667,3,6,14,26,7,12,6,8,2,3,13,45,50,54,61.8
2024-25,202410260DET,10/26/2024,DET vs BOS,Tim Hardaway Jr.,hardati02,82,DET,1,BOS,9,2,2,0,0,0,36.8,0,2,2,7,1,5,4,4,3,0,4,11,11,13,14.4
2024-25,202410260MIN,10/26/2024,MIN vs TOR,Scottie Barnes,barnesc01,63,TOR,0,MIN,20,8,6,1,0,6,36.81666667,3,5,9,19,1,4,1,2,4,1,14,26,28,34,35.6
2024-25,202410260DEN,10/26/2024,DEN vs LAC,Jamal Murray,murraja01,61,DEN,1,LAC,22,2,5,2,0,2,36.85,0,2,7,14,3,6,5,5,1,2,7,27,24,29,35.9
2024-25,202410260SAS,10/26/2024,SAS vs HOU,Jeremy Sochan,sochaje01,76,SAS,1,HOU,17,12,3,2,0,3,36.86666667,3,9,8,14,0,1,1,2,3,2,15,20,29,32,38.9
2024-25,202410260CHO,10/26/2024,CHO vs MIA,Jimmy Butler,butleji01,62,MIA,0,CHO,26,8,8,2,1,1,36.9,4,4,7,15,1,3,11,17,2,3,16,34,34,42,55.6
2024-25,202410260MEM,10/26/2024,MEM vs ORL,Paolo Banchero,banchpa01,83,ORL,0,MEM,16,7,3,1,0,3,36.91666667,3,4,4,12,1,4,7,13,3,1,10,19,23,26,28.9
2024-25,202410260PHO,10/26/2024,PHO vs DAL,Devin Booker,bookede01,71,PHO,1,DAL,21,1,5,1,0,1,37.1,0,1,4,12,2,8,11,12,3,1,6,26,22,27,31.7
2024-25,202410260LAL,10/26/2024,LAL vs SAC,DeMar DeRozan,derozde01,81,SAC,0,LAL,23,0,3,3,0,2,37.21666667,0,0,9,12,2,3,3,4,2,3,3,26,23,26,34.5
2024-25,202410260LAL,10/26/2024,LAL vs SAC,Rui Hachimura,hachiru01,72,LAL,1,SAC,18,9,3,0,0,1,37.33333333,4,5,5,13,2,2,6,6,1,0,12,21,27,30,32.3
2024-25,202410260LAL,10/26/2024,LAL vs SAC,Anthony Davis,davisan02,80,LAL,1,SAC,31,9,2,3,2,2,37.75,3,6,10,15,1,2,10,13,1,5,11,33,40,42,57.8
2024-25,202410260DEN,10/26/2024,DEN vs LAC,James Harden,hardeja01,74,LAC,0,DEN,23,6,16,1,1,7,37.75,0,6,5,11,1,5,12,13,5,2,22,39,29,45,53.2
2024-25,202410260DEN,10/26/2024,DEN vs LAC,Michael Porter Jr.,portemi01,83,DEN,1,LAC,9,9,3,2,0,1,37.96666667,2,7,4,13,0,6,1,1,2,2,12,12,18,21,29.3
2024-25,202410260DET,10/26/2024,DET vs BOS,Jayson Tatum,tatumja01,77,BOS,0,DET,37,4,2,2,1,1,38.13333333,1,3,12,26,6,13,7,9,5,3,6,39,41,43,52.8
2024-25,202410260DET,10/26/2024,DET vs BOS,Jaylen Brown,brownja02,73,BOS,0,DET,24,10,5,1,0,2,38.15,3,7,6,24,3,9,9,10,2,1,15,29,34,39,44.5
2024-25,202410260SAS,10/26/2024,SAS vs HOU,Fred VanVleet,vanvlfr01,76,HOU,0,SAS,18,2,7,3,0,2,38.61666667,0,2,5,12,4,10,4,4,3,3,9,25,20,27,37.9
2024-25,202410260PHO,10/26/2024,PHO vs DAL,Kyrie Irving,irvinky01,60,DAL,0,PHO,22,2,5,3,0,1,38.7,0,2,9,22,2,5,2,2,4,3,7,27,24,29,39.9
2024-25,202410260DET,10/26/2024,DET vs BOS,Jaden Ivey,iveyja01,80,DET,1,BOS,26,5,6,1,0,1,38.88333333,2,3,10,18,2,5,4,5,2,1,11,32,31,37,43
2024-25,202410260MIN,10/26/2024,MIN vs TOR,Rudy Gobert,goberru01,79,MIN,1,TOR,15,12,1,1,4,1,38.98333333,2,10,6,8,0,0,3,4,3,5,13,16,27,28,44.9
2024-25,202410260DEN,10/26/2024,DEN vs LAC,Ivica Zubac,zubaciv01,70,LAC,0,DEN,24,15,4,0,1,3,39.06666667,4,11,11,17,0,0,2,3,4,1,19,28,39,43,48
2024-25,202410260MIN,10/26/2024,MIN vs TOR,Anthony Edwards,edwaran01,82,MIN,1,TOR,24,6,4,1,1,4,39.18333333,0,6,9,21,5,12,1,3,3,2,10,28,30,34,39.2
2024-25,202410260PHO,10/26/2024,PHO vs DAL,Kevin Durant,duranke01,78,PHO,1,DAL,31,9,2,1,1,1,39.36666667,0,9,10,21,4,8,7,9,0,2,11,33,40,42,49.8
2024-25,202410260DET,10/26/2024,DET vs BOS,Derrick White,whitede01,76,BOS,0,DET,17,6,3,0,3,1,39.36666667,2,4,6,14,0,6,5,5,2,3,9,20,23,26,36.7
2024-25,202410260PHO,10/26/2024,PHO vs DAL,Luka Doncic,doncilu01,72,DAL,0,PHO,40,10,4,0,1,2,39.4,1,9,12,25,5,13,11,12,4,1,14,44,50,54,59
2024-25,202410260LAL,10/26/2024,LAL vs SAC,Keegan Murray,murrake02,79,SAC,0,LAL,14,4,1,2,2,1,39.75,1,3,5,11,2,7,2,2,2,4,5,15,18,19,31.3
2024-25,202410260DET,10/26/2024,DET vs BOS,Cade Cunningham,cunnica01,65,DET,1,BOS,21,6,10,1,4,7,40.51666667,0,6,9,22,2,8,1,3,2,5,16,31,27,37,51.2
2024-25,202410260LAL,10/26/2024,LAL vs SAC,De'Aaron Fox,foxde01,76,SAC,0,LAL,28,5,10,2,0,6,41,0,5,9,20,3,10,7,8,3,2,15,38,33,43,49
2024-25,202410250MIL,10/25/2024,MIL vs CHI,A.J. Green,greenaj01,58,MIL,1,CHI,9,1,1,0,0,0,11.25,0,1,3,4,3,4,0,0,1,0,2,10,10,11,11.7
2024-25,202410250LAL,10/25/2024,LAL vs PHO,Max Christie,chrisma02,70,LAL,1,PHO,3,3,0,0,0,1,11.41666667,0,3,1,1,1,1,0,0,0,0,3,3,6,6,5.6
2024-25,202410250CLE,10/25/2024,CLE vs DET,Isaiah Stewart,stewais01,48,DET,0,CLE,0,3,1,1,1,3,11.46666667,1,2,0,0,0,0,0,0,5,2,4,1,3,4,8.1
2024-25,202410250NYK,10/25/2024,NYK vs IND,Ben Sheppard,sheppbe01,60,IND,0,NYK,4,0,0,0,0,0,11.55,0,0,2,4,0,1,0,0,6,0,0,4,4,4,4
2024-25,202410250HOU,10/25/2024,HOU vs MEM,Brandon Clarke,clarkbr01,8,MEM,0,HOU,3,3,0,0,0,1,11.9,1,2,1,5,0,1,1,2,1,0,3,3,6,6,5.6
2024-25,202410250MIL,10/25/2024,MIL vs CHI,Dalen Terry,terryda01,61,CHI,0,MIL,3,2,1,1,1,0,12.35,1,1,0,1,0,0,3,4,2,2,3,4,5,6,12.9
2024-25,202410250HOU,10/25/2024,HOU vs MEM,Reed Sheppard,sheppre01,2,HOU,1,MEM,6,0,2,1,0,0,12.63333333,0,0,2,5,2,4,0,0,1,1,2,8,6,8,12
2024-25,202410250UTA,10/25/2024,UTA vs GSW,Gary Payton II,paytoga02,46,GSW,0,UTA,4,1,2,3,0,0,12.75,0,1,2,3,0,1,0,0,1,3,3,6,5,7,17.2
2024-25,202410250MIL,10/25/2024,MIL vs CHI,Delon Wright,wrighde01,49,MIL,1,CHI,5,0,3,1,0,0,13.13333333,0,0,2,3,1,2,0,0,1,1,3,8,5,8,12.5
2024-25,202410250ORL,10/25/2024,ORL vs BRK,Jalen Wilson,wilsoja03,45,BRK,0,ORL,0,1,2,1,0,2,13.16666667,0,1,0,3,0,2,0,0,4,1,3,2,1,3,5.2
2024-25,202410250LAL,10/25/2024,LAL vs PHO,Monte Morris,morrimo01,35,PHO,0,LAL,8,2,3,2,0,0,13.18333333,1,1,2,3,2,3,2,2,0,2,5,11,10,13,20.9
2024-25,202410250POR,10/25/2024,POR vs NOP,Jose Alvarado,alvarjo01,58,NOP,0,POR,0,1,4,3,0,4,13.2,0,1,0,1,0,0,0,0,3,3,5,4,1,5,12.2
2024-25,202410250LAL,10/25/2024,LAL vs PHO,Dalton Knecht,knechda01,2,LAL,1,PHO,8,1,2,1,0,0,13.31666667,0,1,2,5,2,4,2,2,0,1,3,10,9,11,15.2
2024-25,202410250UTA,10/25/2024,UTA vs GSW,Kevon Looney,looneke01,76,GSW,0,UTA,9,10,1,0,1,1,13.41666667,7,3,4,6,0,0,1,2,2,1,11,10,19,20,24.5
2024-25,202410250LAL,10/25/2024,LAL vs PHO,Ryan Dunn,dunnry01,2,PHO,0,LAL,9,3,1,0,0,0,13.51666667,0,3,3,5,3,5,0,0,2,0,4,10,12,13,14.1
2024-25,202410250HOU,10/25/2024,HOU vs MEM,Cam Whitmore,whitmca01,49,HOU,1,MEM,11,3,0,0,0,1,13.51666667,1,2,5,12,0,4,1,3,5,0,3,11,14,14,13.6
2024-25,202410250UTA,10/25/2024,UTA vs GSW,De'Anthony Melton,meltode01,40,GSW,0,UTA,0,1,4,0,1,2,13.76666667,1,0,0,4,0,3,0,0,5,1,5,4,1,5,8.2
2024-25,202410250POR,10/25/2024,POR vs NOP,Donovan Clingan,clingdo01,2,POR,1,NOP,4,6,0,0,4,2,14.43333333,2,4,1,1,0,0,2,3,3,4,6,4,10,10,21.2
2024-25,202410250TOR,10/25/2024,TOR vs PHI,Jamison Battle,battlja01,2,TOR,1,PHI,12,6,0,0,0,0,14.73333333,3,3,4,5,2,3,2,4,6,0,6,12,18,18,19.2
2024-25,202410250ATL,10/25/2024,ATL vs CHO,Vit Krejci,krejcvi01,24,ATL,1,CHO,3,0,0,1,1,1,14.75,0,0,1,2,0,1,1,2,5,2,0,3,3,3,8
2024-25,202410250MIL,10/25/2024,MIL vs CHI,Jalen Smith,smithja04,63,CHI,0,MIL,11,5,1,0,0,1,14.83333333,3,2,4,9,3,5,0,0,4,0,6,12,16,17,17.5
2024-25,202410250MIL,10/25/2024,MIL vs CHI,Julian Phillips,phillju01,42,CHI,0,MIL,3,2,0,1,0,0,14.86666667,1,1,1,2,1,2,0,0,1,1,2,3,5,5,8.4
2024-25,202410250NYK,10/25/2024,NYK vs IND,Jericho Sims,simsje01,47,NYK,1,IND,2,2,0,0,0,0,14.98333333,0,2,1,1,0,0,0,0,1,0,2,2,4,4,4.4
2024-25,202410250POR,10/25/2024,POR vs NOP,Kris Murray,murrakr01,64,POR,1,NOP,7,3,2,0,0,0,15,1,2,3,5,1,1,0,0,1,0,5,9,10,12,13.6
2024-25,202410250ORL,10/25/2024,ORL vs BRK,Moritz Wagner,wagnemo01,82,ORL,1,BRK,18,3,0,1,1,3,15.1,0,3,7,8,1,2,3,4,5,2,3,18,21,21,24.6
2024-25,202410250NYK,10/25/2024,NYK vs IND,Isaiah Jackson,jacksis01,61,IND,0,NYK,10,5,2,1,0,2,15.28333333,2,3,5,6,0,0,0,2,3,1,7,12,15,17,20
2024-25,202410250CLE,10/25/2024,CLE vs DET,Georges Niang,niangge01,84,CLE,1,DET,3,5,0,0,0,1,15.33333333,0,5,1,3,1,2,0,0,2,0,5,3,8,8,8
2024-25,202410250HOU,10/25/2024,HOU vs MEM,Jay Huff,huffja01,22,MEM,0,HOU,8,3,1,2,2,0,15.55,1,2,3,7,2,4,0,0,2,4,4,9,11,12,25.1
2024-25,202410250TOR,10/25/2024,TOR vs PHI,D.J. Carton,cartodj01,5,TOR,1,PHI,0,2,3,2,0,1,15.71666667,0,2,0,3,0,2,0,0,1,2,5,3,2,5,11.9
2024-25,202410250ORL,10/25/2024,ORL vs BRK,Noah Clowney,clownno01,25,BRK,0,ORL,7,2,0,1,0,1,15.8,1,1,3,8,1,4,0,0,3,1,2,7,9,9,11.4
2024-25,202410250CLE,10/25/2024,CLE vs DET,Sam Merrill,merrisa01,63,CLE,1,DET,0,1,2,1,0,0,15.8,0,1,0,4,0,4,0,0,1,1,3,2,1,3,7.2
2024-25,202410250CLE,10/25/2024,CLE vs DET,Ty Jerome,jeromty01,4,CLE,1,DET,13,2,4,1,0,1,15.83333333,1,1,4,6,0,1,5,6,0,1,6,17,15,19,23.4
2024-25,202410250HOU,10/25/2024,HOU vs MEM,Tari Eason,easonta01,24,HOU,1,MEM,13,5,0,2,1,0,16.03333333,2,3,5,7,3,4,0,0,2,3,5,13,18,18,28
2024-25,202410250NYK,10/25/2024,NYK vs IND,T.J. McConnell,mccontj01,74,IND,0,NYK,7,2,5,0,0,2,16.2,0,2,3,4,0,0,1,2,0,0,7,12,9,14,14.9
2024-25,202410250ORL,10/25/2024,ORL vs BRK,Gary Harris,harriga01,56,ORL,1,BRK,6,1,0,0,1,0,16.36666667,0,1,2,5,2,5,0,0,0,1,1,6,7,7,10.2
2024-25,202410250MIL,10/25/2024,MIL vs CHI,Pat Connaughton,connapa01,78,MIL,1,CHI,3,5,1,0,0,2,16.55,2,3,1,6,1,5,0,0,1,0,6,4,8,9,8.5
2024-25,202410250ORL,10/25/2024,ORL vs BRK,Shake Milton,miltosh01,50,BRK,0,ORL,3,1,2,0,0,0,16.58333333,0,1,1,2,1,2,0,0,3,0,3,5,4,6,7.2
2024-25,202410250UTA,10/25/2024,UTA vs GSW,Trayce Jackson-Davis,jackstr02,70,GSW,0,UTA,12,9,2,0,0,1,16.9,3,6,6,6,0,0,0,0,3,0,11,14,21,23,24.8
2024-25,202410250POR,10/25/2024,POR vs NOP,Jabari Walker,walkeja01,74,POR,1,NOP,2,4,0,0,0,1,16.91666667,0,4,1,3,0,2,0,0,2,0,4,2,6,6,5.8
2024-25,202410250CLE,10/25/2024,CLE vs DET,Ron Holland,hollaro01,2,DET,0,CLE,4,7,1,0,1,1,17.18333333,0,7,2,6,0,2,0,0,1,1,8,5,11,12,15.9
2024-25,202410250TOR,10/25/2024,TOR vs PHI,Guerschon Yabusele,yabusgu01,2,PHI,0,TOR,9,4,1,0,1,3,17.46666667,0,4,3,6,0,2,3,3,4,1,5,10,13,14,15.3
2024-25,202410250LAL,10/25/2024,LAL vs PHO,Jaxson Hayes,hayesja02,73,LAL,1,PHO,6,6,4,1,1,1,17.53333333,1,5,3,3,0,0,0,0,3,2,10,10,12,16,24.2
2024-25,202410250ATL,10/25/2024,ATL vs CHO,Josh Green,greenjo02,58,CHO,0,ATL,5,3,2,1,1,0,17.65,1,2,2,5,1,3,0,0,4,2,5,7,8,10,17.6
2024-25,202410250UTA,10/25/2024,UTA vs GSW,Jonathan Kuminga,kuminjo01,76,GSW,0,UTA,2,1,1,0,1,0,17.66666667,0,1,1,5,0,1,0,0,0,1,2,3,3,4,7.7
2024-25,202410250NYK,10/25/2024,NYK vs IND,Aaron Nesmith,nesmiaa01,75,IND,0,NYK,4,2,0,0,0,1,17.71666667,1,1,2,5,0,1,0,0,3,0,2,4,6,6,5.4
2024-25,202410250UTA,10/25/2024,UTA vs GSW,Brice Sensabaugh,sensabr01,34,UTA,1,GSW,9,3,0,0,0,1,17.8,2,1,3,9,2,7,1,1,0,0,3,9,12,12,11.6
2024-25,202410250CLE,10/25/2024,CLE vs DET,Isaac Okoro,okorois01,71,CLE,1,DET,4,2,3,0,0,0,17.98333333,1,1,2,2,0,0,0,0,3,0,5,7,6,9,10.9
2024-25,202410250UTA,10/25/2024,UTA vs GSW,Patty Mills,millspa02,34,UTA,1,GSW,7,1,0,1,1,1,18.18333333,0,1,3,7,1,5,0,0,1,2,1,7,8,8,13.2
2024-25,202410250LAL,10/25/2024,LAL vs PHO,Jusuf Nurkic,nurkiju01,78,PHO,0,LAL,4,7,4,0,1,4,18.41666667,1,6,1,5,0,3,2,2,4,1,11,8,11,15,17.4
2024-25,202410250POR,10/25/2024,POR vs NOP,Daniel Theis,theisda01,62,NOP,0,POR,5,6,4,0,0,1,18.45,1,5,1,4,0,2,3,4,4,0,10,9,11,15,17.2
2024-25,202410250ATL,10/25/2024,ATL vs CHO,Garrison Mathews,mathega01,67,ATL,1,CHO,8,1,0,0,0,0,18.53333333,0,1,2,3,2,3,2,2,2,0,1,8,9,9,9.2
2024-25,202410250ATL,10/25/2024,ATL vs CHO,Zaccharie Risacher,risacza01,2,ATL,1,CHO,5,0,1,0,1,0,18.53333333,0,0,1,5,1,4,2,2,0,1,1,6,5,6,9.5
2024-25,202410250ATL,10/25/2024,ATL vs CHO,Vasilije Micic,micicva01,62,CHO,0,ATL,2,6,1,0,0,1,18.6,3,3,1,6,0,3,0,0,0,0,7,3,8,9,9.7
2024-25,202410250ORL,10/25/2024,ORL vs BRK,Ziaire Williams,willizi02,53,BRK,0,ORL,7,7,1,1,0,1,18.7,1,6,3,7,1,2,0,0,4,1,8,8,14,15,18.9
2024-25,202410250UTA,10/25/2024,UTA vs GSW,Kyle Anderson,anderky01,81,GSW,0,UTA,7,6,3,2,0,0,18.78333333,2,4,3,7,1,4,0,0,0,2,9,10,13,16,24.7
2024-25,202410250UTA,10/25/2024,UTA vs GSW,Moses Moody,moodymo01,68,GSW,0,UTA,12,1,1,2,0,2,18.78333333,0,1,5,10,2,5,0,0,0,2,2,13,13,14,18.7
2024-25,202410250LAL,10/25/2024,LAL vs PHO,Mason Plumlee,plumlma01,48,PHO,0,LAL,6,7,0,1,0,0,18.98333333,1,6,3,4,0,0,0,0,4,1,7,6,13,13,17.4
2024-25,202410250TOR,10/25/2024,TOR vs PHI,Chris Boucher,bouchch01,52,TOR,1,PHI,4,3,1,2,4,1,19.26666667,0,3,0,5,0,4,4,4,0,6,4,5,7,8,26.1
2024-25,202410250TOR,10/25/2024,TOR vs PHI,Davion Mitchell,mitchda01,74,TOR,1,PHI,8,3,3,0,0,3,19.3,0,3,3,5,2,4,0,0,6,0,6,11,11,14,13.1
2024-25,202410250POR,10/25/2024,POR vs NOP,Javonte Green,greenja02,11,NOP,0,POR,3,2,0,0,0,1,19.35,1,1,1,3,0,1,1,1,2,0,2,3,5,5,4.4
2024-25,202410250NYK,10/25/2024,NYK vs IND,Jarace Walker,walkeja02,36,IND,0,NYK,12,4,3,2,0,0,19.51666667,1,3,4,8,1,4,3,3,1,2,7,15,16,19,27.3
2024-25,202410250ORL,10/25/2024,ORL vs BRK,Cole Anthony,anthoco01,83,ORL,1,BRK,4,1,2,3,0,1,19.58333333,0,1,1,3,1,2,1,2,2,3,3,6,5,7,16.2
2024-25,202410250CLE,10/25/2024,CLE vs DET,Caris LeVert,leverca01,70,CLE,1,DET,9,3,2,3,1,0,19.6,1,2,4,7,1,2,0,2,1,4,5,11,12,14,27.6
2024-25,202410250NYK,10/25/2024,NYK vs IND,Obi Toppin,toppiob01,85,IND,0,NYK,8,1,4,0,1,0,19.8,0,1,4,6,0,1,0,0,0,1,5,12,9,13,18.2
2024-25,202410250CLE,10/25/2024,CLE vs DET,Simone Fontecchio,fontesi01,68,DET,0,CLE,5,2,0,0,0,1,19.85,0,2,1,4,1,4,2,2,0,0,2,5,7,7,6.4
2024-25,202410250UTA,10/25/2024,UTA vs GSW,Draymond Green,greendr01,57,GSW,0,UTA,3,2,4,3,0,2,19.85,0,2,1,4,1,2,0,0,3,3,6,7,5,9,18.4
2024-25,202410250UTA,10/25/2024,UTA vs GSW,Buddy Hield,hieldbu01,87,GSW,0,UTA,27,4,6,1,0,0,19.91666667,0,4,10,14,7,9,0,0,0,1,10,33,31,37,43.8
2024-25,202410250HOU,10/25/2024,HOU vs MEM,Marcus Smart,smartma01,22,MEM,0,HOU,7,1,2,1,0,2,20.18333333,0,1,1,4,1,1,4,5,3,1,3,9,8,10,12.2
2024-25,202410250UTA,10/25/2024,UTA vs GSW,Walker Kessler,kesslwa01,66,UTA,1,GSW,2,9,2,0,1,2,20.25,3,6,1,1,0,0,0,0,1,1,11,4,11,13,16.8
2024-25,202410250TOR,10/25/2024,TOR vs PHI,Eric Gordon,gordoer01,70,PHI,0,TOR,8,1,2,0,0,0,20.38333333,0,1,1,4,1,2,5,7,1,0,3,10,9,11,12.2
2024-25,202410250ORL,10/25/2024,ORL vs BRK,Nic Claxton,claxtni01,73,BRK,0,ORL,4,5,3,1,1,1,20.43333333,1,4,1,4,0,0,2,2,1,2,8,7,9,12,19.5
2024-25,202410250UTA,10/25/2024,UTA vs GSW,Collin Sexton,sextoco01,80,UTA,1,GSW,12,2,1,0,0,4,20.56666667,1,1,4,13,0,2,4,5,1,0,3,13,14,15,11.9
2024-25,202410250LAL,10/25/2024,LAL vs PHO,Gabe Vincent,vincega01,13,LAL,1,PHO,5,2,0,3,0,0,20.58333333,1,1,2,5,1,3,0,0,4,3,2,5,7,7,16.4
2024-25,202410250NYK,10/25/2024,NYK vs IND,Miles McBride,mcbrimi01,70,NYK,1,IND,8,2,2,0,0,2,20.61666667,0,2,3,4,2,2,0,0,3,0,4,10,10,12,11.4
2024-25,202410250HOU,10/25/2024,HOU vs MEM,Jaylen Wells,wellsja01,2,MEM,0,HOU,8,4,0,0,0,0,21.11666667,2,2,3,14,1,5,1,2,1,0,4,8,12,12,12.8
2024-25,202410250NYK,10/25/2024,NYK vs IND,Andrew Nembhard,nembhan01,70,IND,0,NYK,2,2,2,2,0,3,21.41666667,0,2,1,3,0,2,0,0,0,2,4,4,4,6,10.4
2024-25,202410250ATL,10/25/2024,ATL vs CHO,Clint Capela,capelca01,75,ATL,1,CHO,6,7,1,1,2,2,21.55,1,6,2,2,0,0,2,2,3,3,8,7,13,14,22.9
2024-25,202410250ORL,10/25/2024,ORL vs BRK,Jalen Suggs,suggsja01,77,ORL,1,BRK,10,5,1,1,0,3,21.63333333,0,5,3,6,2,3,2,2,2,1,6,11,15,16,17.5
2024-25,202410250NYK,10/25/2024,NYK vs IND,Cameron Payne,payneca01,80,NYK,1,IND,7,2,3,1,0,0,22.03333333,1,1,3,9,1,5,0,1,1,1,5,10,9,12,16.9
2024-25,202410250HOU,10/25/2024,HOU vs MEM,John Konchar,konchjo01,57,MEM,0,HOU,7,6,2,2,1,1,22.11666667,2,4,2,3,2,3,1,2,2,3,8,9,13,15,25.2
2024-25,202410250POR,10/25/2024,POR vs NOP,Yves Missi,missiyv01,2,NOP,0,POR,8,6,2,0,2,0,22.28333333,2,4,2,5,0,0,4,6,2,2,8,10,14,16,24.2
2024-25,202410250HOU,10/25/2024,HOU vs MEM,Santi Aldama,aldamsa01,63,MEM,0,HOU,2,5,3,0,2,2,22.36666667,0,5,0,2,0,1,2,2,2,2,8,5,7,10,16.5
2024-25,202410250TOR,10/25/2024,TOR vs PHI,Andre Drummond,drumman01,81,PHI,0,TOR,11,9,0,4,2,2,22.36666667,6,3,4,11,0,0,3,8,5,6,9,11,20,20,37.8
2024-25,202410250HOU,10/25/2024,HOU vs MEM,Zach Edey,edeyza01,2,MEM,0,HOU,13,9,1,1,1,0,22.58333333,4,5,6,10,0,0,1,3,4,2,10,14,22,23,31.3
2024-25,202410250CLE,10/25/2024,CLE vs DET,Tim Hardaway Jr.,hardati02,81,DET,0,CLE,9,3,1,0,0,1,23.16666667,0,3,3,6,3,5,0,0,1,0,4,10,12,13,13.1
2024-25,202410250ATL,10/25/2024,ATL vs CHO,Cody Martin,martico01,30,CHO,0,ATL,3,5,1,0,0,0,23.2,1,4,1,5,1,3,0,0,2,0,6,4,8,9,10.5
2024-25,202410250NYK,10/25/2024,NYK vs IND,Pascal Siakam,siakapa01,82,IND,0,NYK,12,5,2,0,0,2,23.21666667,2,3,5,11,0,4,2,2,1,0,7,14,17,19,19
2024-25,202410250NYK,10/25/2024,NYK vs IND,Myles Turner,turnemy01,80,IND,0,NYK,13,7,1,0,3,2,23.21666667,1,6,5,9,0,3,3,5,4,3,8,14,20,21,29.9
2024-25,202410250UTA,10/25/2024,UTA vs GSW,Andrew Wiggins,wiggian01,73,GSW,0,UTA,10,13,5,0,2,1,23.36666667,5,8,3,10,2,4,2,2,4,2,18,15,23,28,38.1
2024-25,202410250HOU,10/25/2024,HOU vs MEM,Jake LaRavia,laravja01,37,MEM,0,HOU,6,6,4,0,0,2,23.45,3,3,2,4,0,2,2,5,4,0,10,10,12,16,17.2
2024-25,202410250NYK,10/25/2024,NYK vs IND,Bennedict Mathurin,mathube01,62,IND,0,NYK,20,2,1,1,0,1,23.6,0,2,8,13,2,5,2,4,1,1,3,21,22,23,25.9
2024-25,202410250UTA,10/25/2024,UTA vs GSW,Jordan Clarkson,clarkjo01,57,UTA,1,GSW,11,1,2,0,0,2,23.7,0,1,4,10,0,4,3,5,2,0,3,13,12,14,13.2
2024-25,202410250UTA,10/25/2024,UTA vs GSW,John Collins,collijo01,70,UTA,1,GSW,14,7,4,1,1,3,23.7,2,5,4,10,1,3,5,5,2,2,11,18,21,25,31.4
2024-25,202410250TOR,10/25/2024,TOR vs PHI,Jonathan Mogbo,mogbojo01,2,TOR,1,PHI,12,9,5,2,3,2,23.76666667,5,4,3,8,0,1,6,7,2,5,14,17,21,26,43.3
2024-25,202410250HOU,10/25/2024,HOU vs MEM,Ja Morant,moranja01,11,MEM,0,HOU,24,0,2,0,0,6,23.8,0,0,8,17,2,4,6,9,1,0,2,26,24,26,21
2024-25,202410250ORL,10/25/2024,ORL vs BRK,Ben Simmons,simmobe01,17,BRK,0,ORL,7,6,3,1,1,4,23.9,0,6,2,5,0,0,3,4,5,2,9,10,13,16,20.7
2024-25,202410250TOR,10/25/2024,TOR vs PHI,Gradey Dick,dickgr01,62,TOR,1,PHI,8,1,0,1,0,2,23.96666667,0,1,3,9,1,4,1,1,6,1,1,8,9,9,10.2
2024-25,202410250HOU,10/25/2024,HOU vs MEM,Amen Thompson,thompam01,64,HOU,1,MEM,9,6,3,0,0,8,24.1,3,3,2,4,0,1,5,5,3,0,9,12,15,18,12.7
2024-25,202410250HOU,10/25/2024,HOU vs MEM,Scotty Pippen Jr.,pippesc02,23,MEM,0,HOU,13,3,4,0,0,1,24.18333333,0,3,4,9,2,3,3,4,2,0,7,17,16,20,21.6
2024-25,202410250TOR,10/25/2024,TOR vs PHI,KJ Martin,martike04,62,PHI,0,TOR,2,3,3,1,1,0,24.31666667,0,3,1,1,0,0,0,0,4,2,6,5,5,8,16.1
2024-25,202410250ATL,10/25/2024,ATL vs CHO,Dyson Daniels,daniedy01,63,ATL,1,CHO,18,1,4,2,2,1,24.4,0,1,8,10,2,4,0,0,5,4,5,22,19,23,36.2
2024-25,202410250MIL,10/25/2024,MIL vs CHI,Josh Giddey,giddejo01,82,CHI,0,MIL,17,6,9,0,0,1,24.46666667,0,6,6,10,2,2,3,4,0,0,15,26,23,32,36.7
2024-25,202410250UTA,10/25/2024,UTA vs GSW,Brandin Podziemski,podzibr01,76,GSW,0,UTA,15,5,1,1,1,0,24.63333333,1,4,7,14,1,5,0,0,2,2,6,16,20,21,28.5
2024-25,202410250UTA,10/25/2024,UTA vs GSW,Taylor Hendricks,hendrita0,42,UTA,1,GSW,0,7,0,2,2,1,24.71666667,1,6,0,6,0,4,0,0,3,4,7,0,7,7,19.4
2024-25,202410250POR,10/25/2024,POR vs NOP,Toumani Camara,camarto01,72,POR,1,NOP,5,6,2,1,0,1,24.93333333,4,2,2,6,1,2,0,0,4,1,8,7,11,13,17.2
2024-25,202410250ATL,10/25/2024,ATL vs CHO,Tre Mann,manntr01,43,CHO,0,ATL,17,3,4,1,0,3,24.95,3,0,6,19,2,7,3,3,3,1,7,21,20,24,26.6
2024-25,202410250UTA,10/25/2024,UTA vs GSW,Cody Williams,willico04,2,UTA,1,GSW,2,3,2,1,0,1,25.2,0,3,1,6,0,3,0,0,1,1,5,4,5,7,10.6
2024-25,202410250TOR,10/25/2024,TOR vs PHI,Jamal Shead,sheadja01,2,TOR,1,PHI,11,2,5,0,0,7,25.48333333,0,2,4,11,1,2,2,2,2,0,7,16,13,18,13.9
2024-25,202410250ORL,10/25/2024,ORL vs BRK,Kentavious Caldwell-Pope,caldwke01,78,ORL,1,BRK,10,1,2,2,2,0,25.76666667,0,1,3,7,2,5,2,2,1,4,3,12,11,13,26.2
2024-25,202410250NYK,10/25/2024,NYK vs IND,Tyrese Haliburton,halibty01,72,IND,0,NYK,0,1,5,1,0,1,25.85,0,1,0,8,0,7,0,0,2,1,6,5,1,6,10.7
2024-25,202410250ORL,10/25/2024,ORL vs BRK,Anthony Black,blackan01,71,ORL,1,BRK,10,3,5,0,2,2,26.03333333,0,3,4,6,1,1,1,2,4,2,8,15,13,18,25.1
2024-25,202410250TOR,10/25/2024,TOR vs PHI,Ochai Agbaji,agbajoc01,80,TOR,1,PHI,12,8,1,2,0,1,26.21666667,3,5,5,9,0,1,2,2,3,2,9,13,20,21,28.1
2024-25,202410250ORL,10/25/2024,ORL vs BRK,Dorian Finney-Smith,finnedo01,70,BRK,0,ORL,15,6,0,1,0,1,26.45,3,3,6,10,3,6,0,0,1,1,6,15,21,21,24.2
2024-25,202410250ATL,10/25/2024,ATL vs CHO,Onyeka Okongwu,okongon01,57,ATL,1,CHO,7,8,3,1,0,0,26.45,0,8,3,6,1,2,0,0,3,1,11,10,15,18,24.1
2024-25,202410250CLE,10/25/2024,CLE vs DET,Dean Wade,wadede01,56,CLE,1,DET,19,5,1,2,0,0,26.78333333,0,5,7,9,5,7,0,1,2,2,6,20,24,25,32.5
2024-25,202410250UTA,10/25/2024,UTA vs GSW,Lauri Markkanen,markkla01,57,UTA,1,GSW,13,8,2,1,0,2,26.83333333,2,6,4,17,1,5,4,7,0,1,10,15,21,23,26.6
2024-25,202410250ATL,10/25/2024,ATL vs CHO,Seth Curry,curryse01,46,CHO,0,ATL,9,5,2,3,0,1,27.3,3,2,3,9,3,7,0,0,4,3,7,11,14,16,26
2024-25,202410250TOR,10/25/2024,TOR vs PHI,Jakob Poeltl,poeltja01,52,TOR,1,PHI,19,9,3,0,4,2,27.4,1,8,5,8,0,0,9,11,4,4,12,22,28,31,44.3
2024-25,202410250UTA,10/25/2024,UTA vs GSW,Stephen Curry,curryst01,76,GSW,0,UTA,20,3,4,2,0,3,27.41666667,0,3,7,20,4,13,2,2,3,2,7,24,23,27,32.6
2024-25,202410250MIL,10/25/2024,MIL vs CHI,Ayo Dosunmu,dosunay01,78,CHI,0,MIL,2,5,5,0,1,1,27.6,0,5,1,8,0,5,0,0,1,1,10,7,7,12,17.5
2024-25,202410250MIL,10/25/2024,MIL vs CHI,Bobby Portis,portibo01,84,MIL,1,CHI,9,12,1,1,0,1,27.83333333,2,10,4,9,1,3,0,0,0,1,13,10,21,22,26.9
2024-25,202410250LAL,10/25/2024,LAL vs PHO,Royce O'Neale,onealro01,81,PHO,0,LAL,7,4,4,1,0,2,27.93333333,0,4,2,5,1,3,2,2,3,1,8,11,11,15,18.8
2024-25,202410250POR,10/25/2024,POR vs NOP,Scoot Henderson,hendesc01,64,POR,1,NOP,15,1,6,3,0,3,28.51666667,0,1,7,9,1,3,0,1,2,3,7,21,16,22,31.2
2024-25,202410250ATL,10/25/2024,ATL vs CHO,LaMelo Ball,ballla01,24,CHO,0,ATL,34,5,4,1,1,10,28.71666667,1,4,10,20,9,14,5,6,6,2,9,38,39,43,42
2024-25,202410250POR,10/25/2024,POR vs NOP,Jordan Hawkins,hawkijo01,69,NOP,0,POR,24,5,0,0,0,0,29.01666667,1,4,8,12,4,7,4,4,1,0,5,24,29,29,30
2024-25,202410250POR,10/25/2024,POR vs NOP,Zion Williamson,willizi01,71,NOP,0,POR,16,11,7,1,3,1,29.1,3,8,4,15,0,1,8,14,3,4,18,23,27,34,50.7
2024-25,202410250HOU,10/25/2024,HOU vs MEM,Desmond Bane,banede01,44,MEM,0,HOU,17,3,4,2,2,2,29.18333333,1,2,8,16,0,4,1,2,3,4,7,21,20,24,36.6
2024-25,202410250POR,10/25/2024,POR vs NOP,Herbert Jones,joneshe01,78,NOP,0,POR,8,1,1,2,1,2,29.18333333,1,0,4,9,0,3,0,0,1,3,2,9,9,10,17.7
2024-25,202410250CLE,10/25/2024,CLE vs DET,Jalen Duren,durenja01,63,DET,0,CLE,5,7,5,1,1,1,29.2,3,4,2,4,0,0,1,4,5,2,12,10,12,17,25.9
2024-25,202410250ATL,10/25/2024,ATL vs CHO,Grant Williams,willigr01,78,CHO,0,ATL,9,4,6,1,0,1,29.2,2,2,2,7,2,6,3,4,4,1,10,15,13,19,24.8
2024-25,202410250TOR,10/25/2024,TOR vs PHI,Kyle Lowry,lowryky01,62,PHI,0,TOR,14,1,2,3,0,2,29.21666667,0,1,3,5,3,5,5,5,5,3,3,16,15,17,25.2
2024-25,202410250CLE,10/25/2024,CLE vs DET,Jaden Ivey,iveyja01,79,DET,0,CLE,22,5,4,0,0,2,29.26666667,0,5,8,16,2,5,4,6,4,0,9,26,27,31,32
2024-25,202410250LAL,10/25/2024,LAL vs PHO,D'Angelo Russell,russeda01,79,LAL,1,PHO,5,2,5,1,1,2,29.28333333,1,1,1,6,1,3,2,2,3,2,7,10,7,12,18.9
2024-25,202410250CLE,10/25/2024,CLE vs DET,Malik Beasley,beaslma01,81,DET,0,CLE,13,4,1,0,1,1,29.3,0,4,5,11,3,6,0,0,1,1,5,14,17,18,21.3
2024-25,202410250MIL,10/25/2024,MIL vs CHI,Brook Lopez,lopezbr01,81,MIL,1,CHI,7,4,1,0,3,2,29.4,0,4,2,10,1,6,2,2,3,3,5,8,11,12,20.3
2024-25,202410250MIL,10/25/2024,MIL vs CHI,Taurean Prince,princta02,81,MIL,1,CHI,11,8,2,1,0,0,29.63333333,3,5,5,7,1,1,0,0,4,1,10,13,19,21,26.6
2024-25,202410250UTA,10/25/2024,UTA vs GSW,Keyonte George,georgke01,77,UTA,1,GSW,12,2,3,2,0,5,29.81666667,1,1,4,12,3,8,1,1,0,2,5,15,14,17,19.9
2024-25,202410250NYK,10/25/2024,NYK vs IND,Jalen Brunson,brunsja01,79,NYK,1,IND,26,5,5,0,0,1,29.91666667,2,3,10,19,3,5,3,4,1,0,10,31,31,36,38.5
2024-25,202410250ATL,10/25/2024,ATL vs CHO,Nick Richards,richani01,69,CHO,0,ATL,12,13,2,0,1,1,30.05,6,7,3,6,0,0,6,8,1,1,15,14,25,27,32.6
2024-25,202410250CLE,10/25/2024,CLE vs DET,Donovan Mitchell,mitchdo01,57,CLE,1,DET,19,2,5,0,0,2,30.11666667,1,1,8,21,1,8,2,4,3,0,7,24,21,26,26.9
2024-25,202410250ATL,10/25/2024,ATL vs CHO,Miles Bridges,bridgmi02,71,CHO,0,ATL,27,5,0,0,1,0,30.5,1,4,8,17,3,8,8,8,3,1,5,27,32,32,36
2024-25,202410250POR,10/25/2024,POR vs NOP,Deni Avdija,avdijde01,77,POR,1,NOP,2,6,6,1,2,2,30.9,1,5,1,9,0,3,0,0,1,3,12,8,8,14,25.2
2024-25,202410250HOU,10/25/2024,HOU vs MEM,Fred VanVleet,vanvlfr01,75,HOU,1,MEM,16,3,3,1,0,0,30.91666667,0,3,5,9,5,9,1,4,4,1,6,19,19,22,27.1
2024-25,202410250HOU,10/25/2024,HOU vs MEM,Dillon Brooks,brookdi01,74,HOU,1,MEM,18,4,0,2,0,0,31.2,3,1,5,12,2,6,6,6,3,2,4,18,22,22,28.8
2024-25,202410250CLE,10/25/2024,CLE vs DET,Jarrett Allen,allenja01,79,CLE,1,DET,17,11,2,1,1,1,31.21666667,0,11,5,7,0,0,7,8,0,2,13,19,28,30,38.2
2024-25,202410250ORL,10/25/2024,ORL vs BRK,Wendell Carter Jr.,cartewe01,57,ORL,1,BRK,8,11,4,2,0,0,31.45,1,10,3,5,1,3,1,2,1,2,15,12,19,23,33.2
2024-25,202410250HOU,10/25/2024,HOU vs MEM,Alperen Sengun,sengual01,65,HOU,1,MEM,16,15,2,1,0,3,31.7,5,10,5,13,0,2,6,8,5,1,17,18,31,33,37
2024-25,202410250CLE,10/25/2024,CLE vs DET,Evan Mobley,mobleev01,52,CLE,1,DET,16,6,3,4,2,4,31.73333333,1,5,6,12,2,3,2,2,1,6,9,19,22,25,41.7
2024-25,202410250HOU,10/25/2024,HOU vs MEM,Jalen Green,greenja05,84,HOU,1,MEM,22,6,4,3,1,2,31.75,2,4,8,21,4,8,2,6,3,4,10,26,28,32,45.2
2024-25,202410250MIL,10/25/2024,MIL vs CHI,Nikola Vucevic,vucevni01,78,CHI,0,MIL,22,10,4,0,0,1,32,2,8,7,17,4,9,4,4,4,0,14,26,32,36,39
2024-25,202410250NYK,10/25/2024,NYK vs IND,Karl-Anthony Towns,townska01,64,NYK,1,IND,21,15,0,1,2,0,32.28333333,4,11,5,11,2,2,9,10,2,3,15,21,36,36,48
2024-25,202410250LAL,10/25/2024,LAL vs PHO,Tyus Jones,jonesty01,68,PHO,0,LAL,14,2,4,1,0,2,32.4,0,2,5,8,2,4,2,2,0,1,6,18,16,20,23.4
2024-25,202410250ORL,10/25/2024,ORL vs BRK,Dennis Schroder,schrode01,82,BRK,0,ORL,20,1,6,1,0,2,32.45,0,1,7,12,3,4,3,4,3,1,7,26,21,27,31.2
2024-25,202410250POR,10/25/2024,POR vs NOP,Deandre Ayton,aytonde01,57,POR,1,NOP,10,15,2,0,2,1,32.93333333,2,13,5,14,0,0,0,1,4,2,17,12,25,27,36
2024-25,202410250CLE,10/25/2024,CLE vs DET,Darius Garland,garlada01,59,CLE,1,DET,13,2,6,1,0,3,33.03333333,0,2,5,11,3,7,0,0,2,1,8,19,15,21,24.4
2024-25,202410250ATL,10/25/2024,ATL vs CHO,De'Andre Hunter,huntede01,59,ATL,1,CHO,24,7,3,0,1,0,33.15,1,6,7,14,2,6,8,8,4,1,10,27,31,34,39.9
2024-25,202410250MIL,10/25/2024,MIL vs CHI,Zach LaVine,lavinza01,27,CHI,0,MIL,25,5,1,0,2,1,33.28333333,1,4,9,15,2,6,5,6,0,2,6,26,30,31,37.5
2024-25,202410250NYK,10/25/2024,NYK vs IND,Mikal Bridges,bridgmi01,84,NYK,1,IND,21,1,5,1,0,1,33.48333333,1,0,8,12,2,3,3,4,4,1,6,26,22,27,31.7
2024-25,202410250TOR,10/25/2024,TOR vs PHI,Caleb Martin,martica02,66,PHI,0,TOR,11,5,4,0,1,3,33.78333333,4,1,2,6,0,1,7,10,4,1,9,15,16,20,23
2024-25,202410250NYK,10/25/2024,NYK vs IND,OG Anunoby,anunoog01,52,NYK,1,IND,14,4,1,1,0,1,34.01666667,0,4,6,12,1,4,1,2,3,1,5,15,18,19,22.3
2024-25,202410250MIL,10/25/2024,MIL vs CHI,Gary Trent Jr.,trentga02,73,MIL,1,CHI,10,1,2,2,0,0,34.01666667,0,1,3,8,2,5,2,2,2,2,3,12,11,13,20.2
2024-25,202410250MIL,10/25/2024,MIL vs CHI,Coby White,whiteco01,81,CHI,0,MIL,35,6,5,4,0,3,34.36666667,0,6,12,20,7,13,4,4,1,4,11,40,41,46,58.7
2024-25,202410250CLE,10/25/2024,CLE vs DET,Tobias Harris,harrito02,72,DET,0,CLE,10,5,4,1,1,1,34.66666667,0,5,3,9,2,3,2,2,1,2,9,14,15,19,27
2024-25,202410250LAL,10/25/2024,LAL vs PHO,LeBron James,jamesle01,74,LAL,1,PHO,21,4,8,0,0,2,34.7,0,4,7,13,2,5,5,8,1,0,12,29,25,33,35.8
2024-25,202410250CLE,10/25/2024,CLE vs DET,Cade Cunningham,cunnica01,64,DET,0,CLE,33,4,6,0,0,9,34.91666667,2,2,14,24,2,6,3,3,4,0,10,39,37,43,37.8
2024-25,202410250HOU,10/25/2024,HOU vs MEM,Jabari Smith Jr.,smithja05,78,HOU,1,MEM,14,16,4,0,2,3,35.03333333,6,10,5,13,0,3,4,4,5,2,20,18,30,34,42.2
2024-25,202410250ORL,10/25/2024,ORL vs BRK,Cam Thomas,thomaca02,68,BRK,0,ORL,24,6,3,0,0,3,35.05,1,5,7,17,3,5,7,8,2,0,9,27,30,33,32.7
2024-25,202410250MIL,10/25/2024,MIL vs CHI,Giannis Antetokounmpo,antetgi01,75,MIL,1,CHI,38,11,5,0,0,3,35.13333333,1,10,15,23,0,1,8,16,1,0,16,43,49,54,55.7
2024-25,202410250POR,10/25/2024,POR vs NOP,Brandon Ingram,ingrabr01,66,NOP,0,POR,21,8,4,2,1,2,35.31666667,2,6,8,20,4,9,1,2,3,3,12,25,29,33,43.6
2024-25,202410250LAL,10/25/2024,LAL vs PHO,Devin Booker,bookede01,70,PHO,0,LAL,23,3,4,1,1,2,35.33333333,2,1,9,21,4,10,1,2,3,2,7,27,26,30,36.6
2024-25,202410250ORL,10/25/2024,ORL vs BRK,Cameron Johnson,johnsca02,60,BRK,0,ORL,12,2,2,0,1,2,35.4,1,1,4,12,2,10,2,3,4,1,4,14,14,16,18.4
2024-25,202410250LAL,10/25/2024,LAL vs PHO,Bradley Beal,bealbr01,55,PHO,0,LAL,15,1,9,2,1,2,35.43333333,0,1,6,14,3,6,0,0,4,3,10,24,16,25,36.7
2024-25,202410250MIL,10/25/2024,MIL vs CHI,Damian Lillard,lillada01,75,MIL,1,CHI,28,4,8,0,0,5,35.78333333,0,4,11,21,3,12,3,3,1,0,12,36,32,40,39.8
2024-25,202410250MIL,10/25/2024,MIL vs CHI,Patrick Williams,willipa01,45,CHI,0,MIL,13,5,2,3,0,1,36.08333333,1,4,5,11,2,4,1,1,2,3,7,15,18,20,30
2024-25,202410250POR,10/25/2024,POR vs NOP,Anfernee Simons,simonan01,48,POR,1,NOP,24,1,7,1,0,4,36.15,0,1,6,20,2,9,10,11,2,1,8,31,25,32,34.7
2024-25,202410250TOR,10/25/2024,TOR vs PHI,Scottie Barnes,barnesc01,62,TOR,1,PHI,27,5,4,2,1,4,36.31666667,2,3,8,11,0,2,11,13,2,3,9,31,32,36,44
2024-25,202410250LAL,10/25/2024,LAL vs PHO,Austin Reaves,reaveau01,85,LAL,1,PHO,26,4,8,3,1,4,36.65,0,4,8,12,5,7,5,6,4,4,12,34,30,38,50.8
2024-25,202410250NYK,10/25/2024,NYK vs IND,Josh Hart,hartjo01,83,NYK,1,IND,20,10,3,1,0,3,36.66666667,3,7,8,15,1,6,3,4,1,1,13,23,30,33,36.5
2024-25,202410250ORL,10/25/2024,ORL vs BRK,Paolo Banchero,banchpa01,82,ORL,1,BRK,15,6,9,0,1,0,37.21666667,1,5,4,13,1,2,6,11,2,1,15,24,21,30,38.7
2024-25,202410250LAL,10/25/2024,LAL vs PHO,Anthony Davis,davisan02,79,LAL,1,PHO,35,8,4,1,2,1,37.5,1,7,11,18,0,0,13,17,2,3,12,39,43,47,58.6
2024-25,202410250LAL,10/25/2024,LAL vs PHO,Kevin Durant,duranke01,77,PHO,0,LAL,30,4,6,0,1,3,38.56666667,0,4,11,17,2,3,6,7,3,1,10,36,34,40,43.8
2024-25,202410250ORL,10/25/2024,ORL vs BRK,Franz Wagner,wagnefr01,74,ORL,1,BRK,29,6,5,1,0,3,38.9,2,4,10,19,3,6,6,6,2,1,11,34,35,40,43.7
2024-25,202410250LAL,10/25/2024,LAL vs PHO,Rui Hachimura,hachiru01,71,LAL,1,PHO,14,7,2,0,0,1,39.01666667,2,5,5,12,2,4,2,4,1,0,9,16,21,23,24.4
2024-25,202410250TOR,10/25/2024,TOR vs PHI,Kelly Oubre Jr.,oubreke01,70,PHI,0,TOR,28,2,2,2,0,4,39.13333333,0,2,9,17,3,6,7,8,3,2,4,30,30,32,35.4
2024-25,202410250POR,10/25/2024,POR vs NOP,CJ McCollum,mccolcj01,68,NOP,0,POR,20,2,3,4,1,1,39.86666667,0,2,8,17,4,9,0,0,2,5,5,23,22,25,40.9
2024-25,202410250POR,10/25/2024,POR vs NOP,Jerami Grant,grantje01,56,POR,1,NOP,34,6,1,1,3,5,40.21666667,0,6,11,23,8,17,4,4,3,4,7,35,40,41,49.7
2024-25,202410250TOR,10/25/2024,TOR vs PHI,Tyrese Maxey,maxeyty01,72,PHI,0,TOR,24,2,4,1,0,1,40.9,0,2,6,23,2,12,10,12,5,1,6,28,26,30,34.4
2024-25,202410250ATL,10/25/2024,ATL vs CHO,Jalen Johnson,johnsja05,58,ATL,1,CHO,16,7,3,2,2,2,41.16666667,2,5,4,15,1,4,7,9,5,4,10,19,23,26,38.9
2024-25,202410250ATL,10/25/2024,ATL vs CHO,Trae Young,youngtr01,56,ATL,1,CHO,38,8,10,4,0,7,41.46666667,3,5,11,24,5,14,11,13,1,4,18,48,46,56,67.6
2024-25,202410240WAS,10/24/2024,WAS vs BOS,Jordan Walsh,walshjo01,11,BOS,0,WAS,0,0,0,0,1,0,10.13333333,0,0,0,3,0,2,0,0,1,1,0,0,0,0,3
2024-25,202410240SAC,10/24/2024,SAC vs MIN,Trey Lyles,lylestr01,59,SAC,1,MIN,3,1,1,1,0,0,10.75,0,1,1,4,1,3,0,0,1,1,2,4,4,5,8.7
2024-25,202410240DEN,10/24/2024,DEN vs OKC,Dario Saric,saricda01,65,DEN,1,OKC,2,1,0,1,0,0,11.03333333,0,1,1,2,0,1,0,0,1,1,1,2,3,3,6.2
2024-25,202410240SAC,10/24/2024,SAC vs MIN,Keon Ellis,elliske01,58,SAC,1,MIN,2,1,0,2,0,0,11.18333333,0,1,0,1,0,0,2,2,1,2,1,2,3,3,9.2
2024-25,202410240DEN,10/24/2024,DEN vs OKC,Ousmane Dieng,diengou01,34,OKC,0,DEN,6,3,0,0,1,0,13.25,0,3,2,4,2,3,0,0,1,1,3,6,9,9,12.6
2024-25,202410240DAL,10/24/2024,DAL vs SAS,Zach Collins,colliza01,70,SAS,0,DAL,5,5,1,1,0,1,13.55,2,3,2,3,1,1,0,0,3,1,6,6,10,11,14.5
2024-25,202410240WAS,10/24/2024,WAS vs BOS,Neemias Queta,quetane01,30,BOS,0,WAS,12,7,0,0,0,1,13.63333333,4,3,5,7,0,1,2,2,4,0,7,12,19,19,19.4
2024-25,202410240DEN,10/24/2024,DEN vs OKC,Peyton Watson,watsope01,81,DEN,1,OKC,2,6,1,0,2,0,14.78333333,2,4,1,7,0,4,0,0,0,2,7,3,8,9,16.7
2024-25,202410240DAL,10/24/2024,DAL vs SAS,Quentin Grimes,grimequ01,52,DAL,1,SAS,2,0,0,0,0,0,14.98333333,0,0,1,6,0,1,0,0,1,0,0,2,2,2,2
2024-25,202410240DAL,10/24/2024,DAL vs SAS,Maxi Kleber,klebima01,44,DAL,1,SAS,3,4,1,0,1,0,15.4,0,4,1,3,1,1,0,0,1,1,5,4,7,8,12.3
2024-25,202410240WAS,10/24/2024,WAS vs BOS,Xavier Tillman Sr.,tillmxa01,56,BOS,0,WAS,8,1,1,0,0,1,15.43333333,0,1,3,4,2,3,0,0,1,0,2,9,9,10,9.7
2024-25,202410240DAL,10/24/2024,DAL vs SAS,Tre Jones,jonestr01,78,SAS,0,DAL,3,1,3,1,0,0,15.63333333,1,0,0,2,0,0,3,4,0,1,4,6,4,7,11.7
2024-25,202410240WAS,10/24/2024,WAS vs BOS,Luke Kornet,kornelu01,65,BOS,0,WAS,4,4,1,0,0,0,16.21666667,1,3,2,3,0,0,0,0,4,0,5,5,8,9,10.3
2024-25,202410240DEN,10/24/2024,DEN vs OKC,Julian Strawther,strawju01,51,DEN,1,OKC,6,0,1,1,0,1,17.25,0,0,3,6,0,2,0,0,2,1,1,7,6,7,9.5
2024-25,202410240SAC,10/24/2024,SAC vs MIN,Nickeil Alexander-Walker,alexani01,84,MIN,0,SAC,9,1,2,0,0,1,18.31666667,0,1,3,5,3,5,0,0,0,0,3,11,10,12,12.2
2024-25,202410240DAL,10/24/2024,DAL vs SAS,Stephon Castle,castlst01,1,SAS,0,DAL,8,3,5,0,0,2,18.45,2,1,3,7,0,2,2,3,3,0,8,13,11,16,17.1
2024-25,202410240DAL,10/24/2024,DAL vs SAS,Daniel Gafford,gaffoda01,75,DAL,1,SAS,9,6,2,1,1,1,18.51666667,4,2,3,6,0,0,3,4,5,2,8,11,15,17,24.2
2024-25,202410240DEN,10/24/2024,DEN vs OKC,Alex Caruso,carusal01,72,OKC,0,DEN,0,6,4,0,0,1,19.08333333,2,4,0,2,0,1,0,0,2,0,10,4,6,10,12.2
2024-25,202410240DEN,10/24/2024,DEN vs OKC,Aaron Wiggins,wiggiaa01,79,OKC,0,DEN,15,6,1,0,2,1,19.51666667,0,6,7,9,1,2,0,0,1,2,7,16,21,22,28.7
2024-25,202410240SAC,10/24/2024,SAC vs MIN,Kevin Huerter,huertke01,65,SAC,1,MIN,2,4,0,0,0,0,19.6,0,4,1,4,0,3,0,0,2,0,4,2,6,6,6.8
2024-25,202410240DAL,10/24/2024,DAL vs SAS,Jaden Hardy,hardyja02,74,DAL,1,SAS,11,1,2,0,1,2,19.66666667,1,0,3,6,3,5,2,2,3,1,3,13,12,14,16.2
2024-25,202410240WAS,10/24/2024,WAS vs BOS,Al Horford,horfoal01,67,BOS,0,WAS,0,5,1,0,0,2,20.08333333,1,4,0,2,0,1,0,0,0,0,6,1,5,6,5.5
2024-25,202410240WAS,10/24/2024,WAS vs BOS,Jonas Valanciunas,valanjo01,83,WAS,1,BOS,18,5,2,0,0,0,20.21666667,2,3,8,13,0,0,2,2,0,0,7,20,23,25,27
2024-25,202410240WAS,10/24/2024,WAS vs BOS,Kyshawn George,georgky01,1,WAS,1,BOS,4,3,2,1,0,0,20.28333333,0,3,2,6,0,4,0,0,3,1,5,6,7,9,13.6
2024-25,202410240DEN,10/24/2024,DEN vs OKC,Isaiah Joe,joeis01,79,OKC,0,DEN,7,2,1,0,0,0,20.4,1,1,3,10,1,6,0,0,0,0,3,8,9,10,10.9
2024-25,202410240DAL,10/24/2024,DAL vs SAS,Naji Marshall,marshna01,67,DAL,1,SAS,2,1,3,0,0,0,21.23333333,0,1,1,6,0,2,0,0,1,0,4,5,3,6,7.7
2024-25,202410240DEN,10/24/2024,DEN vs OKC,Russell Westbrook,westbru01,69,DEN,1,OKC,6,5,5,1,2,2,21.25,1,4,2,10,1,6,1,4,0,3,10,11,11,16,26.5
2024-25,202410240WAS,10/24/2024,WAS vs BOS,Alex Sarr,sarral01,1,WAS,1,BOS,2,5,1,0,2,0,21.86666667,1,4,1,7,0,5,0,0,2,2,6,3,7,8,15.5
2024-25,202410240WAS,10/24/2024,WAS vs BOS,Jrue Holiday,holidjr01,71,BOS,0,WAS,7,2,1,0,0,2,22.75,0,2,1,4,0,1,5,5,3,0,3,8,9,10,8.9
2024-25,202410240DEN,10/24/2024,DEN vs OKC,Cason Wallace,wallaca01,83,OKC,0,DEN,4,4,0,2,0,0,23.03333333,2,2,2,7,0,1,0,0,1,2,4,4,8,8,14.8
2024-25,202410240WAS,10/24/2024,WAS vs BOS,Corey Kispert,kispeco01,81,WAS,1,BOS,6,5,3,0,0,1,24.08333333,0,5,3,6,0,3,0,0,2,0,8,9,11,14,15.5
2024-25,202410240DAL,10/24/2024,DAL vs SAS,Keldon Johnson,johnske04,70,SAS,0,DAL,7,4,2,0,0,2,24.78333333,0,4,3,9,1,3,0,0,0,0,6,9,11,13,12.8
2024-25,202410240WAS,10/24/2024,WAS vs BOS,Carlton Carrington,carrica01,1,WAS,1,BOS,3,3,2,0,2,2,25.91666667,0,3,1,6,0,2,1,2,3,2,5,5,6,8,13.6
2024-25,202410240DAL,10/24/2024,DAL vs SAS,Klay Thompson,thompkl01,78,DAL,1,SAS,22,7,1,3,0,0,26.08333333,3,4,7,13,6,10,2,2,1,3,8,23,29,30,40.9
2024-25,202410240DAL,10/24/2024,DAL vs SAS,P.J. Washington,washipj01,74,DAL,1,SAS,11,5,2,1,0,0,26.31666667,2,3,4,11,2,7,1,2,1,1,7,13,16,18,23
2024-25,202410240SAC,10/24/2024,SAC vs MIN,Malik Monk,monkma01,73,SAC,1,MIN,17,1,4,0,0,0,26.4,0,1,6,9,1,2,4,5,1,0,5,21,18,22,24.2
2024-25,202410240SAC,10/24/2024,SAC vs MIN,Naz Reid,reidna01,83,MIN,0,SAC,19,13,3,0,0,2,26.51666667,0,13,6,10,4,7,3,3,4,0,16,22,32,35,37.1
2024-25,202410240SAC,10/24/2024,SAC vs MIN,Donte DiVincenzo,divindo01,83,MIN,0,SAC,9,1,2,0,0,2,26.65,1,0,4,10,1,6,0,0,3,0,3,11,10,12,11.2
2024-25,202410240DAL,10/24/2024,DAL vs SAS,Jeremy Sochan,sochaje01,75,SAS,0,DAL,18,6,2,0,0,4,27.03333333,2,4,6,11,1,2,5,7,4,0,8,20,24,26,24.2
2024-25,202410240DAL,10/24/2024,DAL vs SAS,Julian Champagnie,champju02,75,SAS,0,DAL,18,7,3,1,2,3,27.31666667,2,5,7,12,4,8,0,0,1,3,10,21,25,28,36.9
2024-25,202410240SAC,10/24/2024,SAC vs MIN,Mike Conley,conlemi01,78,MIN,0,SAC,6,2,4,0,1,0,27.33333333,1,1,2,9,2,7,0,0,2,1,6,10,8,12,17.4
2024-25,202410240DAL,10/24/2024,DAL vs SAS,Kyrie Irving,irvinky01,59,DAL,1,SAS,15,3,2,2,1,0,27.4,1,2,6,17,3,7,0,0,1,3,5,17,18,20,30.6
2024-25,202410240SAC,10/24/2024,SAC vs MIN,Jaden McDaniels,mcdanja02,74,MIN,0,SAC,6,2,3,0,1,2,27.48333333,2,0,2,9,0,4,2,2,3,1,5,9,8,11,13.9
2024-25,202410240WAS,10/24/2024,WAS vs BOS,Kyle Kuzma,kuzmaky01,71,WAS,1,BOS,12,2,1,1,1,1,27.65,0,2,6,16,0,5,0,0,1,2,3,13,14,15,20.9
2024-25,202410240DAL,10/24/2024,DAL vs SAS,Dereck Lively II,livelde01,56,DAL,1,SAS,15,11,6,1,0,2,27.78333333,4,7,6,8,0,0,3,5,4,1,17,21,26,32,38.2
2024-25,202410240WAS,10/24/2024,WAS vs BOS,Payton Pritchard,pritcpa01,84,BOS,0,WAS,15,1,2,0,0,0,27.95,0,1,5,11,5,10,0,0,1,0,3,17,16,18,19.2
2024-25,202410240DAL,10/24/2024,DAL vs SAS,Victor Wembanyama,wembavi01,72,SAS,0,DAL,17,9,1,0,1,4,28.46666667,2,7,5,18,1,8,6,6,1,1,10,18,26,27,28.3
2024-25,202410240DEN,10/24/2024,DEN vs OKC,Luguentz Dort,dortlu01,80,OKC,0,DEN,5,2,0,3,1,0,28.58333333,1,1,2,7,0,2,1,1,3,4,2,5,7,7,19.4
2024-25,202410240WAS,10/24/2024,WAS vs BOS,Jayson Tatum,tatumja01,76,BOS,0,WAS,25,11,6,1,0,1,28.65,2,9,9,20,3,11,4,7,1,1,17,31,36,42,49.2
2024-25,202410240DAL,10/24/2024,DAL vs SAS,Chris Paul,paulch01,59,SAS,0,DAL,3,7,8,1,0,2,28.76666667,0,7,1,6,1,4,0,0,3,1,15,11,10,18,24.4
2024-25,202410240DEN,10/24/2024,DEN vs OKC,Christian Braun,braunch01,83,DEN,1,OKC,16,7,1,2,2,3,29.1,2,5,8,15,0,3,0,0,1,4,8,17,23,24,34.9
2024-25,202410240DAL,10/24/2024,DAL vs SAS,Harrison Barnes,barneha02,83,SAS,0,DAL,17,4,2,1,0,0,29.18333333,1,3,7,10,2,5,1,2,2,1,6,19,21,23,27.8
2024-25,202410240WAS,10/24/2024,WAS vs BOS,Derrick White,whitede01,75,BOS,0,WAS,19,4,4,1,0,1,29.26666667,1,3,6,11,4,7,3,4,1,1,8,23,23,27,31.8
2024-25,202410240WAS,10/24/2024,WAS vs BOS,Bilal Coulibaly,coulibi01,64,WAS,1,BOS,8,6,6,1,0,3,29.83333333,1,5,1,2,0,0,6,8,0,1,12,14,14,20,24.2
2024-25,202410240WAS,10/24/2024,WAS vs BOS,Jaylen Brown,brownja02,72,BOS,0,WAS,27,8,3,4,0,2,30.3,1,7,10,20,3,6,4,5,1,4,11,30,35,38,51.1
2024-25,202410240DEN,10/24/2024,DEN vs OKC,Michael Porter Jr.,portemi01,82,DEN,1,OKC,15,8,2,1,0,1,32.16666667,1,7,5,17,3,10,2,2,2,1,10,17,23,25,29.6
2024-25,202410240WAS,10/24/2024,WAS vs BOS,Jordan Poole,poolejo01,79,WAS,1,BOS,26,1,4,4,1,4,32.48333333,0,1,9,17,6,11,2,2,3,5,5,30,27,31,44.2
2024-25,202410240DEN,10/24/2024,DEN vs OKC,Aaron Gordon,gordoaa01,74,DEN,1,OKC,12,9,2,1,0,2,32.55,5,4,5,12,0,1,2,2,1,1,11,14,21,23,26.8
2024-25,202410240DEN,10/24/2024,DEN vs OKC,Jalen Williams,willija06,72,OKC,0,DEN,12,3,3,0,2,5,33.71666667,1,2,5,16,2,8,0,1,3,2,6,15,15,18,21.1
2024-25,202410240SAC,10/24/2024,SAC vs MIN,Rudy Gobert,goberru01,78,MIN,0,SAC,3,11,1,2,0,3,34.63333333,1,10,1,2,0,0,1,2,4,2,12,4,14,15,20.7
2024-25,202410240SAC,10/24/2024,SAC vs MIN,Julius Randle,randlju01,48,MIN,0,SAC,33,5,4,0,0,3,34.81666667,0,5,13,17,5,6,2,3,3,0,9,37,38,42,42
2024-25,202410240DEN,10/24/2024,DEN vs OKC,Nikola Jokic,jokicni01,80,DEN,1,OKC,16,12,13,2,1,3,35.2,4,8,6,13,1,3,3,4,3,3,25,29,28,41,55.9
2024-25,202410240DEN,10/24/2024,DEN vs OKC,Chet Holmgren,holmgch01,83,OKC,0,DEN,25,14,5,2,4,2,35.78333333,4,10,11,18,0,5,3,5,2,6,19,30,39,44,65.3
2024-25,202410240DEN,10/24/2024,DEN vs OKC,Shai Gilgeous-Alexander,gilgesh01,76,OKC,0,DEN,28,7,8,2,3,2,36.2,2,5,11,24,2,6,4,5,2,5,15,36,35,43,61.4
2024-25,202410240DAL,10/24/2024,DAL vs SAS,Luka Doncic,doncilu01,71,DAL,1,SAS,28,10,8,1,1,4,36.26666667,1,9,9,25,4,11,6,8,3,2,18,36,38,46,54
2024-25,202410240SAC,10/24/2024,SAC vs MIN,De'Aaron Fox,foxde01,75,SAC,1,MIN,15,2,11,1,0,2,37.15,0,2,6,14,1,4,2,2,3,1,13,26,17,28,34.9
2024-25,202410240SAC,10/24/2024,SAC vs MIN,Domantas Sabonis,sabondo01,83,SAC,1,MIN,24,8,1,2,1,4,38.18333333,1,7,8,13,3,4,5,8,4,3,9,25,32,33,40.1
2024-25,202410240DEN,10/24/2024,DEN vs OKC,Jamal Murray,murraja01,60,DEN,1,OKC,12,6,4,2,0,3,38.45,2,4,4,13,2,5,2,2,2,2,10,16,18,22,28.2
2024-25,202410240SAC,10/24/2024,SAC vs MIN,Anthony Edwards,edwaran01,81,MIN,0,SAC,32,7,4,1,0,3,39.2,1,6,10,24,5,15,7,7,4,1,11,36,39,43,46.4
2024-25,202410240SAC,10/24/2024,SAC vs MIN,DeMar DeRozan,derozde01,80,SAC,1,MIN,26,8,2,1,0,2,42.53333333,1,7,7,18,0,2,12,14,0,1,10,28,34,36,39.6
2024-25,202410240SAC,10/24/2024,SAC vs MIN,Keegan Murray,murrake02,78,SAC,1,MIN,23,11,2,0,0,0,43,2,9,8,17,5,10,2,2,3,0,13,25,34,36,39.2
2024-25,202410230HOU,10/23/2024,HOU vs CHO,Jock Landale,landajo01,57,HOU,1,CHO,5,3,2,0,0,0,10.46666667,3,0,2,4,1,1,0,0,1,0,5,7,8,10,11.6
2024-25,202410230HOU,10/23/2024,HOU vs CHO,Brandon Miller,millebr02,75,CHO,0,HOU,6,1,1,1,0,1,10.73333333,1,0,2,4,1,2,1,1,0,1,2,7,7,8,10.7
2024-25,202410230TOR,10/23/2024,TOR vs CLE,Jonathan Mogbo,mogbojo01,1,TOR,1,CLE,7,0,0,1,0,0,11.21666667,0,0,2,4,1,2,2,2,1,1,0,7,7,7,10
2024-25,202410230ATL,10/23/2024,ATL vs BRK,Vit Krejci,krejcvi01,23,ATL,1,BRK,3,1,2,0,0,0,11.31666667,0,1,1,2,0,1,1,1,1,0,3,5,4,6,7.2
2024-25,202410230MIA,10/23/2024,MIA vs ORL,Jonathan Isaac,isaacjo01,59,ORL,0,MIA,3,3,0,1,2,0,11.45,2,1,1,4,1,2,0,2,1,3,3,3,6,6,15.6
2024-25,202410230NOP,10/23/2024,NOP vs CHI,Julian Phillips,phillju01,41,CHI,0,NOP,2,0,1,1,0,0,11.53333333,0,0,1,3,0,2,0,0,0,1,1,3,2,3,6.5
2024-25,202410230LAC,10/23/2024,LAC vs PHO,Oso Ighodaro,ighodos01,1,PHO,0,LAC,2,6,0,0,1,0,12.23333333,2,4,1,1,0,0,0,0,1,1,6,2,8,8,12.2
2024-25,202410230UTA,10/23/2024,UTA vs MEM,Brice Sensabaugh,sensabr01,33,UTA,1,MEM,3,2,0,2,0,0,12.31666667,2,0,1,2,0,0,1,2,1,2,2,3,5,5,11.4
2024-25,202410230MIA,10/23/2024,MIA vs ORL,Jalen Suggs,suggsja01,76,ORL,0,MIA,11,2,4,1,0,1,12.53333333,0,2,3,4,1,2,4,4,3,1,6,15,13,17,21.4
2024-25,202410230LAC,10/23/2024,LAC vs PHO,Monte Morris,morrimo01,34,PHO,0,LAC,5,1,2,1,0,0,12.55,0,1,2,5,0,2,1,2,0,1,3,7,6,8,12.2
2024-25,202410230POR,10/23/2024,POR vs GSW,Donovan Clingan,clingdo01,1,POR,1,GSW,2,2,0,1,1,1,12.58333333,0,2,1,2,0,0,0,0,1,2,2,2,4,4,9.4
2024-25,202410230NOP,10/23/2024,NOP vs CHI,Jose Alvarado,alvarjo01,57,NOP,1,CHI,3,0,3,1,0,0,12.8,0,0,1,3,1,3,0,0,3,1,3,6,3,6,10.5
2024-25,202410230HOU,10/23/2024,HOU vs CHO,Tari Eason,easonta01,23,HOU,1,CHO,2,2,2,2,0,0,12.88333333,1,1,1,3,0,1,0,0,1,2,4,4,4,6,13.4
2024-25,202410230LAC,10/23/2024,LAC vs PHO,Kevin Porter Jr.,porteke02,1,LAC,1,PHO,2,4,2,1,0,2,12.93333333,1,3,1,8,0,4,0,0,2,1,6,4,6,8,10.8
2024-25,202410230LAC,10/23/2024,LAC vs PHO,Kai Jones,joneska01,1,LAC,1,PHO,6,4,0,0,0,0,13,2,2,3,5,0,0,0,0,2,0,4,6,10,10,10.8
2024-25,202410230PHI,10/23/2024,PHI vs MIL,Delon Wright,wrighde01,48,MIL,0,PHI,2,0,0,1,0,0,13.15,0,0,1,3,0,1,0,0,0,1,0,2,2,2,5
2024-25,202410230NOP,10/23/2024,NOP vs CHI,Lonzo Ball,balllo01,1,CHI,0,NOP,5,2,4,0,0,1,13.65,0,2,2,4,1,3,0,0,2,0,6,9,7,11,12.4
2024-25,202410230UTA,10/23/2024,UTA vs MEM,Brandon Clarke,clarkbr01,7,MEM,0,UTA,2,3,1,0,0,1,13.68333333,1,2,1,5,0,2,0,0,1,0,4,3,5,6,6.1
2024-25,202410230POR,10/23/2024,POR vs GSW,Kevon Looney,looneke01,75,GSW,0,POR,2,6,2,1,1,1,14.08333333,3,3,0,2,0,0,2,2,3,2,8,4,8,10,17.2
2024-25,202410230LAC,10/23/2024,LAC vs PHO,Mason Plumlee,plumlma01,47,PHO,0,LAC,8,2,1,0,1,1,14.21666667,1,1,2,2,0,0,4,6,1,1,3,9,10,11,13.9
2024-25,202410230TOR,10/23/2024,TOR vs CLE,Immanuel Quickley,quickim01,69,TOR,1,CLE,13,2,4,1,0,2,14.23333333,0,2,4,9,2,4,3,4,2,1,6,17,15,19,22.4
2024-25,202410230POR,10/23/2024,POR vs GSW,Gary Payton II,paytoga02,45,GSW,0,POR,8,1,3,2,0,0,14.48333333,0,1,3,4,0,1,2,2,0,2,4,11,9,12,19.7
2024-25,202410230ATL,10/23/2024,ATL vs BRK,Noah Clowney,clownno01,24,BRK,0,ATL,7,6,0,1,1,1,14.6,3,3,2,6,1,3,2,2,1,2,6,7,13,13,19.2
2024-25,202410230UTA,10/23/2024,UTA vs MEM,Zach Edey,edeyza01,1,MEM,0,UTA,5,5,0,0,0,1,14.73333333,4,1,2,4,0,0,1,5,6,0,5,5,10,10,10
2024-25,202410230POR,10/23/2024,POR vs GSW,Buddy Hield,hieldbu01,86,GSW,0,POR,22,5,1,0,0,1,14.73333333,1,4,8,12,5,7,1,1,2,0,6,23,27,28,28.5
2024-25,202410230POR,10/23/2024,POR vs GSW,Kyle Anderson,anderky01,80,GSW,0,POR,2,5,3,2,1,1,14.85,3,2,1,2,0,1,0,0,1,3,8,5,7,10,20.5
2024-25,202410230DET,10/23/2024,DET vs IND,Simone Fontecchio,fontesi01,67,DET,1,IND,0,1,0,0,0,1,14.85,1,0,0,4,0,2,0,0,3,0,1,0,1,1,0.2
2024-25,202410230POR,10/23/2024,POR vs GSW,Moses Moody,moodymo01,67,GSW,0,POR,15,2,2,0,0,0,14.88333333,0,2,5,11,3,8,2,2,3,0,4,17,17,19,20.4
2024-25,202410230HOU,10/23/2024,HOU vs CHO,Moussa Diabate,diabamo01,12,CHO,0,HOU,2,5,0,1,2,0,14.98333333,2,3,1,4,0,0,0,0,0,3,5,2,7,7,17
2024-25,202410230PHI,10/23/2024,PHI vs MIL,KJ Martin,martike04,61,PHI,1,MIL,3,5,0,0,0,0,15.06666667,2,3,1,3,0,0,1,2,3,0,5,3,8,8,9
2024-25,202410230UTA,10/23/2024,UTA vs MEM,John Konchar,konchjo01,56,MEM,0,UTA,5,5,1,0,0,0,15.23333333,1,4,1,1,1,1,2,2,2,0,6,6,10,11,12.5
2024-25,202410230DET,10/23/2024,DET vs IND,Ron Holland,hollaro01,1,DET,1,IND,6,3,0,2,0,1,15.3,1,2,2,6,0,3,2,2,1,2,3,6,9,9,14.6
2024-25,202410230ATL,10/23/2024,ATL vs BRK,Nic Claxton,claxtni01,72,BRK,0,ATL,7,5,0,1,1,0,15.41666667,0,5,3,4,0,0,1,4,3,2,5,7,12,12,19
2024-25,202410230TOR,10/23/2024,TOR vs CLE,Bruno Fernando,fernabr01,46,TOR,1,CLE,6,7,1,0,0,1,15.41666667,2,5,3,6,0,0,0,0,4,0,8,7,13,14,14.9
2024-25,202410230HOU,10/23/2024,HOU vs CHO,Reed Sheppard,sheppre01,1,HOU,1,CHO,4,2,3,0,1,3,15.55,1,1,2,5,0,1,0,0,3,1,5,7,6,9,10.9
2024-25,202410230DET,10/23/2024,DET vs IND,T.J. McConnell,mccontj01,73,IND,0,DET,14,2,4,1,0,1,15.8,0,2,7,8,0,0,0,0,0,1,6,18,16,20,24.4
2024-25,202410230ATL,10/23/2024,ATL vs BRK,Ziaire Williams,willizi02,52,BRK,0,ATL,9,3,1,0,0,1,15.85,1,2,3,6,2,3,1,2,2,0,4,10,12,13,13.1
2024-25,202410230MIA,10/23/2024,MIA vs ORL,Thomas Bryant,bryanth01,39,MIA,1,ORL,7,3,2,0,1,1,16.01666667,0,3,2,2,1,1,2,2,0,1,5,9,10,12,15.6
2024-25,202410230DET,10/23/2024,DET vs IND,Obi Toppin,toppiob01,84,IND,0,DET,2,1,2,1,0,0,16.03333333,0,1,1,2,0,1,0,0,3,1,3,4,3,5,9.2
2024-25,202410230MIA,10/23/2024,MIA vs ORL,Moritz Wagner,wagnemo01,81,ORL,0,MIA,7,6,2,0,0,1,16.03333333,1,5,2,4,1,3,2,2,2,0,8,9,13,15,16.2
2024-25,202410230TOR,10/23/2024,TOR vs CLE,Sam Merrill,merrisa01,62,CLE,0,TOR,7,0,1,0,0,0,16.06666667,0,0,2,4,1,3,2,2,4,0,1,8,7,8,8.5
2024-25,202410230UTA,10/23/2024,UTA vs MEM,Patty Mills,millspa02,33,UTA,1,MEM,0,1,1,0,0,0,16.06666667,0,1,0,0,0,0,0,0,2,0,2,1,1,2,2.7
2024-25,202410230UTA,10/23/2024,UTA vs MEM,Jake LaRavia,laravja01,36,MEM,0,UTA,5,1,0,0,1,0,16.15,0,1,2,4,1,2,0,0,2,1,1,5,6,6,9.2
2024-25,202410230TOR,10/23/2024,TOR vs CLE,Jamison Battle,battlja01,1,TOR,1,CLE,6,2,1,0,1,0,16.36666667,0,2,2,4,2,4,0,0,1,1,3,7,8,9,12.9
2024-25,202410230HOU,10/23/2024,HOU vs CHO,Vasilije Micic,micicva01,61,CHO,0,HOU,5,5,1,1,0,3,16.55,2,3,2,9,1,3,0,0,1,1,6,6,10,11,12.5
2024-25,202410230POR,10/23/2024,POR vs GSW,Rayan Rupert,ruperra01,40,POR,1,GSW,6,3,0,1,0,0,16.95,1,2,3,4,0,1,0,0,2,1,3,6,9,9,12.6
2024-25,202410230DET,10/23/2024,DET vs IND,Isaiah Stewart,stewais01,47,DET,1,IND,2,4,2,1,1,2,16.98333333,1,3,1,2,0,1,0,0,2,2,6,4,6,8,13.8
2024-25,202410230NOP,10/23/2024,NOP vs CHI,Jalen Smith,smithja04,62,CHI,0,NOP,15,5,0,1,0,0,17.3,3,2,5,8,1,3,4,4,2,1,5,15,20,20,24
2024-25,202410230MIA,10/23/2024,MIA vs ORL,Cole Anthony,anthoco01,82,ORL,0,MIA,0,3,6,0,0,2,17.5,0,3,0,7,0,5,0,0,2,0,9,6,3,9,10.6
2024-25,202410230UTA,10/23/2024,UTA vs MEM,John Collins,collijo01,69,UTA,1,MEM,11,5,0,1,1,2,18.31666667,1,4,5,12,0,3,1,1,5,2,5,11,16,16,21
2024-25,202410230NOP,10/23/2024,NOP vs CHI,Daniel Theis,theisda01,61,NOP,1,CHI,8,2,3,2,3,2,18.51666667,0,2,3,5,0,1,2,2,2,5,5,11,10,13,27.9
2024-25,202410230TOR,10/23/2024,TOR vs CLE,Georges Niang,niangge01,83,CLE,0,TOR,11,1,0,0,0,1,18.55,0,1,4,5,3,4,0,0,1,0,1,11,12,12,11.2
2024-25,202410230TOR,10/23/2024,TOR vs CLE,Jamal Shead,sheadja01,1,TOR,1,CLE,10,1,4,1,1,2,18.71666667,0,1,3,7,1,4,3,3,2,2,5,14,11,15,21.2
2024-25,202410230DET,10/23/2024,DET vs IND,Aaron Nesmith,nesmiaa01,74,IND,0,DET,7,2,0,2,1,0,18.75,1,1,2,4,1,2,2,2,4,3,2,7,9,9,18.4
2024-25,202410230TOR,10/23/2024,TOR vs CLE,Ty Jerome,jeromty01,3,CLE,0,TOR,14,2,6,2,0,2,18.95,1,1,6,7,2,2,0,0,1,2,8,20,16,22,29.4
2024-25,202410230ATL,10/23/2024,ATL vs BRK,Zaccharie Risacher,risacza01,1,ATL,1,BRK,7,1,0,0,0,1,19,1,0,2,8,1,4,2,4,2,0,1,7,8,8,7.2
2024-25,202410230TOR,10/23/2024,TOR vs CLE,Isaac Okoro,okorois01,70,CLE,0,TOR,3,2,2,0,1,1,19.03333333,0,2,1,2,0,0,1,2,1,1,4,5,5,7,10.4
2024-25,202410230POR,10/23/2024,POR vs GSW,De'Anthony Melton,meltode01,39,GSW,0,POR,11,2,4,3,0,1,19.1,0,2,4,11,2,8,1,2,3,3,6,15,13,17,27.4
2024-25,202410230MIA,10/23/2024,MIA vs ORL,Jaime Jaquez Jr.,jaqueja01,76,MIA,1,ORL,13,5,3,0,0,2,19.18333333,2,3,4,9,2,2,3,5,4,0,8,16,18,21,21.5
2024-25,202410230UTA,10/23/2024,UTA vs MEM,Cody Williams,willico04,1,UTA,1,MEM,2,4,0,0,0,1,19.46666667,0,4,0,0,0,0,2,2,4,0,4,2,6,6,5.8
2024-25,202410230ATL,10/23/2024,ATL vs BRK,Clint Capela,capelca01,74,ATL,1,BRK,6,7,1,1,1,1,19.51666667,1,6,3,5,0,0,0,0,0,2,8,7,13,14,20.9
2024-25,202410230POR,10/23/2024,POR vs GSW,Jonathan Kuminga,kuminjo01,75,GSW,0,POR,10,4,1,0,1,4,19.51666667,1,3,3,9,0,2,4,6,3,1,5,11,14,15,15.3
2024-25,202410230MIA,10/23/2024,MIA vs ORL,Duncan Robinson,robindu01,69,MIA,1,ORL,6,1,1,0,0,0,19.66666667,0,1,2,7,2,5,0,0,4,0,2,7,7,8,8.7
2024-25,202410230TOR,10/23/2024,TOR vs CLE,Dean Wade,wadede01,55,CLE,0,TOR,5,8,1,2,0,0,19.7,1,7,2,5,1,3,0,0,3,2,9,6,13,14,22.1
2024-25,202410230TOR,10/23/2024,TOR vs CLE,Chris Boucher,bouchch01,51,TOR,1,CLE,18,2,1,1,1,1,19.98333333,1,1,5,9,4,5,4,6,1,2,3,19,20,21,26.9
2024-25,202410230LAC,10/23/2024,LAC vs PHO,Kris Dunn,dunnkr01,67,LAC,1,PHO,5,4,2,2,0,1,20.25,2,2,2,4,1,2,0,0,1,2,6,7,9,11,17.8
2024-25,202410230POR,10/23/2024,POR vs GSW,Draymond Green,greendr01,56,GSW,0,POR,8,6,3,1,2,3,20.43333333,0,6,3,3,1,1,1,2,3,3,9,11,14,17,25.7
2024-25,202410230TOR,10/23/2024,TOR vs CLE,Caris LeVert,leverca01,69,CLE,0,TOR,19,1,4,0,0,0,20.63333333,0,1,8,9,2,2,1,2,1,0,5,23,20,24,26.2
2024-25,202410230PHI,10/23/2024,PHI vs MIL,Pat Connaughton,connapa01,77,MIL,0,PHI,9,4,1,0,1,0,20.9,1,3,4,9,1,5,0,0,1,1,5,10,13,14,18.3
2024-25,202410230LAC,10/23/2024,LAC vs PHO,Grayson Allen,allengr01,76,PHO,0,LAC,8,1,3,1,1,1,21.38333333,0,1,2,7,2,6,2,2,2,2,4,11,9,12,18.7
2024-25,202410230MIA,10/23/2024,MIA vs ORL,Gary Harris,harriga01,55,ORL,0,MIA,18,3,1,0,2,1,21.76666667,1,2,6,9,6,9,0,0,1,2,4,19,21,22,28.1
2024-25,202410230UTA,10/23/2024,UTA vs MEM,Scotty Pippen Jr.,pippesc02,22,MEM,0,UTA,6,3,7,3,1,2,21.81666667,1,2,3,6,0,2,0,2,3,4,10,13,9,16,30.1
2024-25,202410230HOU,10/23/2024,HOU vs CHO,Amen Thompson,thompam01,63,HOU,1,CHO,13,4,0,0,1,0,21.83333333,1,3,5,11,1,2,2,4,3,1,4,13,17,17,20.8
2024-25,202410230LAC,10/23/2024,LAC vs PHO,Jusuf Nurkic,nurkiju01,77,PHO,0,LAC,11,9,2,2,0,4,22.31666667,0,9,2,5,1,4,6,8,4,2,11,13,20,22,26.8
2024-25,202410230UTA,10/23/2024,UTA vs MEM,Jay Huff,huffja01,21,MEM,0,UTA,13,5,1,0,2,0,22.45,1,4,4,6,3,5,2,2,2,2,6,14,18,19,26.5
2024-25,202410230PHI,10/23/2024,PHI vs MIL,Eric Gordon,gordoer01,69,PHI,1,MIL,2,1,1,0,0,0,22.46666667,0,1,1,6,0,2,0,0,1,0,2,3,3,4,4.7
2024-25,202410230TOR,10/23/2024,TOR vs CLE,Darius Garland,garlada01,58,CLE,0,TOR,7,1,6,0,0,2,22.7,0,1,3,12,1,6,0,0,4,0,7,13,8,14,15.2
2024-25,202410230NOP,10/23/2024,NOP vs CHI,Yves Missi,missiyv01,1,NOP,1,CHI,12,7,1,1,3,1,22.76666667,3,4,5,8,0,0,2,2,2,4,8,13,19,20,32.9
2024-25,202410230POR,10/23/2024,POR vs GSW,Andrew Wiggins,wiggian01,72,GSW,0,POR,20,4,2,0,0,1,23.06666667,2,2,8,15,4,7,0,0,2,0,6,22,24,26,26.8
2024-25,202410230MIA,10/23/2024,MIA vs ORL,Franz Wagner,wagnefr01,73,ORL,0,MIA,23,4,4,2,1,0,23.1,1,3,10,16,3,6,0,0,3,3,8,27,27,31,42.8
2024-25,202410230UTA,10/23/2024,UTA vs MEM,Jaylen Wells,wellsja01,1,MEM,0,UTA,6,0,1,1,0,0,23.45,0,0,2,6,2,5,0,2,5,1,1,7,6,7,10.5
2024-25,202410230HOU,10/23/2024,HOU vs CHO,Cody Martin,martico01,29,CHO,0,HOU,8,8,1,0,1,0,23.51666667,3,5,2,6,1,4,3,4,3,1,9,9,16,17,22.1
2024-25,202410230LAC,10/23/2024,LAC vs PHO,Nicolas Batum,batumni01,61,LAC,1,PHO,2,2,2,1,0,1,23.61666667,0,2,0,2,0,2,2,2,3,1,4,4,4,6,9.4
2024-25,202410230HOU,10/23/2024,HOU vs CHO,Nick Richards,richani01,68,CHO,0,HOU,6,8,1,0,2,1,23.91666667,2,6,3,4,0,0,0,2,5,2,9,7,14,15,22.1
2024-25,202410230MIA,10/23/2024,MIA vs ORL,Nikola Jovic,jovicni01,47,MIA,1,ORL,15,5,1,1,1,1,24.01666667,1,4,7,14,1,7,0,1,4,2,6,16,20,21,27.5
2024-25,202410230NOP,10/23/2024,NOP vs CHI,Patrick Williams,willipa01,44,CHI,0,NOP,6,3,3,0,1,2,24.06666667,2,1,2,7,1,4,1,2,0,1,6,9,9,12,15.1
2024-25,202410230PHI,10/23/2024,PHI vs MIL,Kyle Lowry,lowryky01,61,PHI,1,MIL,13,4,6,0,0,0,24.2,0,4,4,7,3,5,2,4,1,0,10,19,17,23,26.8
2024-25,202410230ATL,10/23/2024,ATL vs BRK,Ben Simmons,simmobe01,16,BRK,0,ATL,6,5,8,0,1,6,24.2,2,3,3,4,0,0,0,0,5,1,13,14,11,19,21
2024-25,202410230LAC,10/23/2024,LAC vs PHO,Royce O'Neale,onealro01,80,PHO,0,LAC,5,5,1,1,1,3,24.21666667,1,4,2,5,1,3,0,0,1,2,6,6,10,11,15.5
2024-25,202410230TOR,10/23/2024,TOR vs CLE,Davion Mitchell,mitchda01,73,TOR,1,CLE,8,0,3,2,0,5,24.55,0,0,4,10,0,3,0,0,0,2,3,11,8,11,13.5
2024-25,202410230POR,10/23/2024,POR vs GSW,Trayce Jackson-Davis,jackstr02,69,GSW,0,POR,14,4,2,1,0,0,24.61666667,1,3,5,5,0,0,4,5,1,1,6,16,18,20,24.8
2024-25,202410230HOU,10/23/2024,HOU vs CHO,Grant Williams,willigr01,77,CHO,0,HOU,8,4,1,1,1,2,24.81666667,1,3,3,6,2,4,0,0,4,2,5,9,12,13,18.3
2024-25,202410230POR,10/23/2024,POR vs GSW,Brandin Podziemski,podzibr01,75,GSW,0,POR,0,7,4,1,0,3,24.93333333,4,3,0,5,0,4,0,0,3,1,11,4,7,11,14.4
2024-25,202410230NOP,10/23/2024,NOP vs CHI,Ayo Dosunmu,dosunay01,77,CHI,0,NOP,8,4,3,0,0,2,24.96666667,0,4,4,6,0,2,0,0,2,0,7,11,12,15,15.3
2024-25,202410230UTA,10/23/2024,UTA vs MEM,Collin Sexton,sextoco01,79,UTA,1,MEM,16,2,3,1,1,4,24.98333333,0,2,5,8,0,0,6,8,2,2,5,19,18,21,24.9
2024-25,202410230PHI,10/23/2024,PHI vs MIL,Andre Drummond,drumman01,80,PHI,1,MIL,10,13,0,0,0,1,25.05,5,8,4,8,0,1,2,2,5,0,13,10,23,23,24.6
2024-25,202410230POR,10/23/2024,POR vs GSW,Stephen Curry,curryst01,75,GSW,0,POR,17,9,10,2,0,2,25.06666667,0,9,4,10,3,7,6,6,0,2,19,27,26,36,46.8
2024-25,202410230UTA,10/23/2024,UTA vs MEM,Jordan Clarkson,clarkjo01,56,UTA,1,MEM,17,5,7,0,1,2,25.1,2,3,7,16,2,5,1,2,1,1,12,24,22,29,34.5
2024-25,202410230MIA,10/23/2024,MIA vs ORL,Kentavious Caldwell-Pope,caldwke01,77,ORL,0,MIA,3,1,2,1,2,2,25.15,1,0,0,5,0,5,3,3,1,3,3,5,4,6,14.2
2024-25,202410230NOP,10/23/2024,NOP vs CHI,Javonte Green,greenja02,10,NOP,1,CHI,9,3,1,4,0,1,25.21666667,0,3,3,3,0,0,3,4,0,4,4,10,12,13,25.1
2024-25,202410230TOR,10/23/2024,TOR vs CLE,Ochai Agbaji,agbajoc01,79,TOR,1,CLE,3,6,1,1,1,0,25.25,4,2,1,1,0,0,1,2,2,2,7,4,9,10,17.7
2024-25,202410230MIA,10/23/2024,MIA vs ORL,Bam Adebayo,adebaba01,72,MIA,1,ORL,9,5,1,0,0,0,25.51666667,3,2,1,5,0,2,7,10,1,0,6,10,14,15,16.5
2024-25,202410230PHI,10/23/2024,PHI vs MIL,Guerschon Yabusele,yabusgu01,1,PHI,1,MIL,10,4,3,3,0,3,25.51666667,2,2,4,8,1,4,1,3,6,3,7,13,14,17,25.3
2024-25,202410230ATL,10/23/2024,ATL vs BRK,De'Andre Hunter,huntede01,58,ATL,1,BRK,12,6,1,2,0,0,25.78333333,1,5,3,10,2,4,4,5,5,2,7,13,18,19,26.7
2024-25,202410230MIA,10/23/2024,MIA vs ORL,Jimmy Butler,butleji01,61,MIA,1,ORL,3,4,5,1,1,1,25.81666667,1,3,1,8,0,2,1,2,1,2,9,8,7,12,20.3
2024-25,202410230LAC,10/23/2024,LAC vs PHO,Amir Coffey,coffeam01,71,LAC,1,PHO,11,3,1,1,0,0,25.81666667,0,3,4,4,2,2,1,2,2,1,4,12,14,15,19.1
2024-25,202410230TOR,10/23/2024,TOR vs CLE,Scottie Barnes,barnesc01,61,TOR,1,CLE,9,6,5,0,0,2,25.85,3,3,3,14,0,2,3,4,5,0,11,14,15,20,21.7
2024-25,202410230PHI,10/23/2024,PHI vs MIL,Bobby Portis,portibo01,83,MIL,0,PHI,16,3,3,2,1,4,25.85,1,2,7,10,1,1,1,1,4,3,6,19,19,22,29.1
2024-25,202410230UTA,10/23/2024,UTA vs MEM,Marcus Smart,smartma01,21,MEM,0,UTA,11,5,1,1,0,2,26.03333333,3,2,3,11,1,6,4,4,4,1,6,12,16,17,19.5
2024-25,202410230TOR,10/23/2024,TOR vs CLE,Jarrett Allen,allenja01,78,CLE,0,TOR,14,7,1,1,4,1,26.08333333,2,5,5,7,0,0,4,5,1,5,8,15,21,22,37.9
2024-25,202410230TOR,10/23/2024,TOR vs CLE,Jakob Poeltl,poeltja01,51,TOR,1,CLE,6,9,2,0,0,5,26.15,3,6,2,6,0,0,2,4,4,0,11,8,15,17,14.8
2024-25,202410230HOU,10/23/2024,HOU vs CHO,Seth Curry,curryse01,45,CHO,0,HOU,7,2,1,0,1,0,26.33333333,0,2,2,5,2,3,1,3,2,1,3,8,9,10,13.9
2024-25,202410230MIA,10/23/2024,MIA vs ORL,Wendell Carter Jr.,cartewe01,56,ORL,0,MIA,8,14,2,2,0,1,26.61666667,4,10,3,7,1,2,1,2,2,2,16,10,22,24,32.8
2024-25,202410230TOR,10/23/2024,TOR vs CLE,Evan Mobley,mobleev01,51,CLE,0,TOR,25,9,3,2,3,1,26.95,4,5,9,14,1,2,6,6,2,5,12,28,34,37,54.3
2024-25,202410230UTA,10/23/2024,UTA vs MEM,Desmond Bane,banede01,43,MEM,0,UTA,24,4,4,1,1,1,27.08333333,0,4,8,20,4,10,4,4,4,2,8,28,28,32,39.8
2024-25,202410230LAC,10/23/2024,LAC vs PHO,Terance Mann,mannte01,76,LAC,1,PHO,8,5,4,1,0,1,27.1,1,4,4,6,0,1,0,3,6,1,9,12,13,17,22
2024-25,202410230POR,10/23/2024,POR vs GSW,Deni Avdija,avdijde01,76,POR,1,GSW,15,7,2,2,2,4,27.48333333,2,5,4,10,0,3,7,8,2,4,9,17,22,24,34.4
2024-25,202410230TOR,10/23/2024,TOR vs CLE,Donovan Mitchell,mitchdo01,56,CLE,0,TOR,21,2,3,3,1,2,27.66666667,0,2,7,14,2,5,5,7,2,4,5,24,23,26,37.9
2024-25,202410230DET,10/23/2024,DET vs IND,Bennedict Mathurin,mathube01,61,IND,0,DET,19,6,1,0,0,3,27.68333333,1,5,5,8,2,3,7,9,3,0,7,20,25,26,24.7
2024-25,202410230DET,10/23/2024,DET vs IND,Malik Beasley,beaslma01,80,DET,1,IND,14,3,1,0,0,1,27.83333333,0,3,5,13,2,6,2,3,2,0,4,15,17,18,18.1
2024-25,202410230ATL,10/23/2024,ATL vs BRK,Bogdan Bogdanovic,bogdabo01,80,ATL,1,BRK,8,2,2,0,2,2,27.83333333,0,2,2,6,2,6,2,2,3,2,4,10,10,12,17.4
2024-25,202410230MIA,10/23/2024,MIA vs ORL,Anthony Black,blackan01,70,ORL,0,MIA,10,6,4,0,0,0,27.9,4,2,4,9,1,2,1,3,2,0,10,14,16,20,23.2
2024-25,202410230NOP,10/23/2024,NOP vs CHI,Jordan Hawkins,hawkijo01,68,NOP,1,CHI,13,7,1,0,1,2,27.9,0,7,4,9,3,6,2,2,1,1,8,14,20,21,23.9
2024-25,202410230POR,10/23/2024,POR vs GSW,Scoot Henderson,hendesc01,63,POR,1,GSW,22,4,4,0,0,2,27.9,1,3,7,18,0,5,8,9,3,0,8,26,26,30,30.8
2024-25,202410230UTA,10/23/2024,UTA vs MEM,Ja Morant,moranja01,10,MEM,0,UTA,22,5,10,1,0,3,27.93333333,0,5,7,12,0,2,8,9,4,1,15,32,27,37,43
2024-25,202410230ATL,10/23/2024,ATL vs BRK,Onyeka Okongwu,okongon01,56,ATL,1,BRK,28,8,1,0,3,2,28.48333333,4,4,11,12,0,0,6,6,1,3,9,29,36,37,46.1
2024-25,202410230UTA,10/23/2024,UTA vs MEM,Taylor Hendricks,hendrita0,41,UTA,1,MEM,12,5,0,2,1,0,28.53333333,2,3,4,7,3,5,1,2,3,3,5,12,17,17,27
2024-25,202410230MIA,10/23/2024,MIA vs ORL,Tyler Herro,herroty01,43,MIA,1,ORL,14,5,3,0,1,1,28.75,0,5,5,11,2,5,2,2,1,1,8,17,19,22,26.5
2024-25,202410230DET,10/23/2024,DET vs IND,Tim Hardaway Jr.,hardati02,80,DET,1,IND,14,1,1,1,0,0,28.93333333,0,1,4,9,4,7,2,2,2,1,2,15,15,16,19.7
2024-25,202410230HOU,10/23/2024,HOU vs CHO,Tre Mann,manntr01,42,CHO,0,HOU,24,6,1,0,1,3,28.95,3,3,8,16,4,8,4,4,2,1,7,25,30,31,32.7
2024-25,202410230LAC,10/23/2024,LAC vs PHO,Derrick Jones Jr.,jonesde02,77,LAC,1,PHO,12,4,1,2,0,2,29,2,2,5,6,2,2,0,0,4,2,5,13,16,17,22.3
2024-25,202410230TOR,10/23/2024,TOR vs CLE,Gradey Dick,dickgr01,61,TOR,1,CLE,16,2,1,0,2,0,29.26666667,1,1,5,13,2,6,4,4,0,2,3,17,18,19,25.9
2024-25,202410230ATL,10/23/2024,ATL vs BRK,Dorian Finney-Smith,finnedo01,69,BRK,0,ATL,8,8,1,1,2,1,29.55,3,5,3,10,2,7,0,0,5,3,9,9,16,17,27.1
2024-25,202410230UTA,10/23/2024,UTA vs MEM,Walker Kessler,kesslwa01,65,UTA,1,MEM,16,14,1,1,5,2,29.58333333,6,8,6,7,0,0,4,5,2,6,15,17,30,31,50.3
2024-25,202410230POR,10/23/2024,POR vs GSW,Toumani Camara,camarto01,71,POR,1,GSW,11,6,4,2,0,2,29.88333333,4,2,3,8,2,4,3,4,4,2,10,15,17,21,28.2
2024-25,202410230NOP,10/23/2024,NOP vs CHI,CJ McCollum,mccolcj01,67,NOP,1,CHI,23,2,5,1,1,0,29.95,0,2,9,19,5,11,0,0,1,2,7,28,25,30,38.9
2024-25,202410230NOP,10/23/2024,NOP vs CHI,Dejounte Murray,murrade01,79,NOP,1,CHI,14,8,10,1,0,1,29.98333333,0,8,4,15,0,3,6,7,0,1,18,24,22,32,40.6
2024-25,202410230DET,10/23/2024,DET vs IND,Jalen Duren,durenja01,62,DET,1,IND,13,13,4,0,0,2,30.06666667,4,9,4,4,0,0,5,6,3,0,17,17,26,30,32.6
2024-25,202410230MIA,10/23/2024,MIA vs ORL,Haywood Highsmith,highsha01,67,MIA,1,ORL,9,5,2,2,1,1,30.23333333,1,4,4,8,1,2,0,0,3,3,7,11,14,16,26
2024-25,202410230PHI,10/23/2024,PHI vs MIL,Taurean Prince,princta02,80,MIL,0,PHI,16,5,3,0,0,0,30.38333333,0,5,6,7,4,5,0,0,2,0,8,19,21,24,26.5
2024-25,202410230PHI,10/23/2024,PHI vs MIL,Kelly Oubre Jr.,oubreke01,69,PHI,1,MIL,21,2,1,0,0,1,30.41666667,1,1,8,18,1,6,4,6,5,0,3,22,23,24,23.9
2024-25,202410230NOP,10/23/2024,NOP vs CHI,Josh Giddey,giddejo01,81,CHI,0,NOP,14,5,3,0,0,3,30.48333333,1,4,5,11,0,1,4,7,1,0,8,17,19,22,21.5
2024-25,202410230DET,10/23/2024,DET vs IND,Jaden Ivey,iveyja01,78,DET,1,IND,17,5,4,1,0,1,30.6,4,1,5,13,0,2,7,9,3,1,9,21,22,26,31
2024-25,202410230NOP,10/23/2024,NOP vs CHI,Nikola Vucevic,vucevni01,77,CHI,0,NOP,21,11,1,0,0,1,30.7,2,9,8,12,1,2,4,5,3,0,12,22,32,33,34.7
2024-25,202410230POR,10/23/2024,POR vs GSW,Deandre Ayton,aytonde01,56,POR,1,GSW,10,11,2,2,0,1,30.95,2,9,5,12,0,2,0,0,2,2,13,12,21,23,31.2
2024-25,202410230UTA,10/23/2024,UTA vs MEM,Keyonte George,georgke01,76,UTA,1,MEM,12,2,7,0,0,1,31.06666667,0,2,3,18,1,6,5,9,2,0,9,19,14,21,23.9
2024-25,202410230PHI,10/23/2024,PHI vs MIL,Giannis Antetokounmpo,antetgi01,74,MIL,0,PHI,25,14,7,0,1,3,31.2,1,13,8,11,0,0,9,16,4,1,21,32,39,46,52.3
2024-25,202410230MIA,10/23/2024,MIA vs ORL,Paolo Banchero,banchpa01,81,ORL,0,MIA,33,11,3,1,1,0,31.2,4,7,12,24,4,8,5,6,2,2,14,36,44,47,56.7
2024-25,202410230HOU,10/23/2024,HOU vs CHO,Dillon Brooks,brookdi01,73,HOU,1,CHO,2,3,0,0,0,0,31.41666667,1,2,1,6,0,3,0,0,4,0,3,2,5,5,5.6
2024-25,202410230UTA,10/23/2024,UTA vs MEM,Santi Aldama,aldamsa01,62,MEM,0,UTA,27,5,2,0,0,2,31.43333333,2,3,10,16,5,10,2,2,2,0,7,29,32,34,34
2024-25,202410230NOP,10/23/2024,NOP vs CHI,Brandon Ingram,ingrabr01,65,NOP,1,CHI,33,7,2,2,1,3,31.46666667,2,5,13,23,3,5,4,4,4,3,9,35,40,42,50.4
2024-25,202410230DET,10/23/2024,DET vs IND,Pascal Siakam,siakapa01,81,IND,0,DET,19,8,9,2,0,0,31.96666667,3,5,8,15,1,3,2,3,0,2,17,28,27,36,48.1
2024-25,202410230ATL,10/23/2024,ATL vs BRK,Cameron Johnson,johnsca02,59,BRK,0,ATL,14,4,0,1,1,0,32.01666667,0,4,4,10,1,6,5,6,3,2,4,14,18,18,24.8
2024-25,202410230MIA,10/23/2024,MIA vs ORL,Terry Rozier,roziete01,62,MIA,1,ORL,19,6,5,0,2,3,32.05,0,6,5,15,2,7,7,7,0,2,11,24,25,30,36.7
2024-25,202410230LAC,10/23/2024,LAC vs PHO,Devin Booker,bookede01,69,PHO,0,LAC,15,4,6,1,1,4,32.13333333,0,4,5,9,4,5,1,2,6,2,10,21,19,25,30.8
2024-25,202410230HOU,10/23/2024,HOU vs CHO,Miles Bridges,bridgmi02,70,CHO,0,HOU,10,9,2,1,1,4,32.28333333,0,9,5,11,0,3,0,0,1,2,11,12,19,21,25.8
2024-25,202410230POR,10/23/2024,POR vs GSW,Anfernee Simons,simonan01,47,POR,1,GSW,15,2,3,1,0,5,32.61666667,0,2,5,12,2,7,3,3,3,1,5,18,17,20,19.9
2024-25,202410230NOP,10/23/2024,NOP vs CHI,Herbert Jones,joneshe01,77,NOP,1,CHI,2,4,2,2,0,0,32.68333333,1,3,1,6,0,3,0,0,3,2,6,4,6,8,15.8
2024-25,202410230HOU,10/23/2024,HOU vs CHO,Jabari Smith Jr.,smithja05,77,HOU,1,CHO,8,5,1,0,1,0,33.13333333,1,4,2,7,2,5,2,3,2,1,6,9,13,14,18.5
2024-25,202410230POR,10/23/2024,POR vs GSW,Jerami Grant,grantje01,55,POR,1,GSW,16,2,3,1,1,0,33.16666667,0,2,6,18,2,8,2,2,2,2,5,19,18,21,28.9
2024-25,202410230ATL,10/23/2024,ATL vs BRK,Cam Thomas,thomaca02,67,BRK,0,ATL,36,5,3,3,0,2,33.71666667,2,3,14,27,7,13,1,1,4,3,8,39,41,44,53.5
2024-25,202410230LAC,10/23/2024,LAC vs PHO,Ivica Zubac,zubaciv01,69,LAC,1,PHO,21,9,3,0,0,3,33.81666667,1,8,8,13,0,0,5,8,6,0,12,24,30,33,33.3
2024-25,202410230HOU,10/23/2024,HOU vs CHO,Alperen Sengun,sengual01,64,HOU,1,CHO,25,18,5,4,1,3,33.86666667,6,12,10,22,2,3,3,4,2,5,23,30,43,48,66.1
2024-25,202410230ATL,10/23/2024,ATL vs BRK,Jalen Wilson,wilsoja03,44,BRK,0,ATL,16,4,1,0,0,1,33.96666667,1,3,3,7,2,5,8,8,5,0,5,17,20,21,21.3
2024-25,202410230ATL,10/23/2024,ATL vs BRK,Dennis Schroder,schrode01,81,BRK,0,ATL,13,3,7,1,0,5,34.33333333,0,3,5,16,2,6,1,2,4,1,10,20,16,23,25.1
2024-25,202410230PHI,10/23/2024,PHI vs MIL,Gary Trent Jr.,trentga02,72,MIL,0,PHI,11,2,0,0,0,0,34.45,0,2,3,6,2,5,3,3,5,0,2,11,13,13,13.4
2024-25,202410230ATL,10/23/2024,ATL vs BRK,Dyson Daniels,daniedy01,62,ATL,1,BRK,15,5,2,5,1,1,34.53333333,3,2,6,12,2,4,1,4,4,6,7,17,20,22,41
2024-25,202410230UTA,10/23/2024,UTA vs MEM,Lauri Markkanen,markkla01,56,UTA,1,MEM,35,9,2,0,0,2,34.56666667,1,8,9,15,4,7,13,14,2,0,11,37,44,46,46.8
2024-25,202410230NOP,10/23/2024,NOP vs CHI,Coby White,whiteco01,80,CHI,0,NOP,10,8,6,1,1,4,34.78333333,0,8,4,13,0,5,2,2,1,2,14,16,18,24,30.6
2024-25,202410230DET,10/23/2024,DET vs IND,Andrew Nembhard,nembhan01,69,IND,0,DET,8,2,7,1,0,2,34.81666667,0,2,3,8,0,2,2,2,3,1,9,15,10,17,21.9
2024-25,202410230DET,10/23/2024,DET vs IND,Tyrese Haliburton,halibty01,71,IND,0,DET,15,5,4,3,2,3,34.96666667,1,4,6,18,1,9,2,2,2,5,9,19,20,24,39
2024-25,202410230LAC,10/23/2024,LAC vs PHO,Tyus Jones,jonesty01,67,PHO,0,LAC,11,2,8,2,1,0,35.08333333,0,2,5,10,1,5,0,0,0,3,10,19,13,21,34.4
2024-25,202410230HOU,10/23/2024,HOU vs CHO,Jalen Green,greenja05,83,HOU,1,CHO,28,2,0,0,0,0,35.45,0,2,9,23,5,15,5,5,0,0,2,28,30,30,30.4
2024-25,202410230PHI,10/23/2024,PHI vs MIL,Brook Lopez,lopezbr01,80,MIL,0,PHI,10,8,6,0,6,4,35.53333333,1,7,3,11,1,6,3,4,4,6,14,16,18,24,42.6
2024-25,202410230DET,10/23/2024,DET vs IND,Tobias Harris,harrito02,71,DET,1,IND,13,2,1,0,1,2,35.78333333,1,1,6,13,1,6,0,0,3,1,3,14,15,16,17.9
2024-25,202410230DET,10/23/2024,DET vs IND,Myles Turner,turnemy01,79,IND,0,DET,20,9,4,0,4,4,36.05,0,9,7,14,3,8,3,3,4,4,13,24,29,33,44.8
2024-25,202410230DET,10/23/2024,DET vs IND,Cade Cunningham,cunnica01,63,DET,1,IND,28,5,8,1,0,2,36.53333333,0,5,10,23,2,6,6,6,2,1,13,36,33,41,47
2024-25,202410230ATL,10/23/2024,ATL vs BRK,Trae Young,youngtr01,55,ATL,1,BRK,30,5,12,1,1,3,36.66666667,1,4,7,16,2,6,14,16,1,2,17,42,35,47,57
2024-25,202410230NOP,10/23/2024,NOP vs CHI,Zach LaVine,lavinza01,26,CHI,0,NOP,27,5,3,0,0,7,36.76666667,1,4,10,17,5,8,2,3,4,0,8,30,32,35,30.5
2024-25,202410230ATL,10/23/2024,ATL vs BRK,Jalen Johnson,johnsja05,57,ATL,1,BRK,11,10,4,3,1,6,36.85,1,9,4,9,0,3,3,8,3,4,14,15,21,25,35
2024-25,202410230HOU,10/23/2024,HOU vs CHO,Fred VanVleet,vanvlfr01,74,HOU,1,CHO,14,4,6,2,0,2,37.38333333,2,2,4,18,2,11,4,4,1,2,10,20,18,24,31.8
2024-25,202410230PHI,10/23/2024,PHI vs MIL,Caleb Martin,martica02,65,PHI,1,MIL,12,9,3,0,1,3,37.45,4,5,5,10,0,1,2,2,4,1,12,15,21,24,27.3
2024-25,202410230HOU,10/23/2024,HOU vs CHO,LaMelo Ball,ballla01,23,CHO,0,HOU,34,8,11,1,1,2,37.91666667,1,7,10,20,4,12,10,10,3,2,19,45,42,53,64.1
2024-25,202410230PHI,10/23/2024,PHI vs MIL,Damian Lillard,lillada01,74,MIL,0,PHI,30,9,6,0,0,3,38.3,3,6,9,19,6,12,6,7,1,0,15,36,39,45,46.8
2024-25,202410230LAC,10/23/2024,LAC vs PHO,Bradley Beal,bealbr01,54,PHO,0,LAC,24,3,1,1,1,2,38.46666667,0,3,8,12,4,6,4,5,1,2,4,25,27,28,33.1
2024-25,202410230PHI,10/23/2024,PHI vs MIL,Tyrese Maxey,maxeyty01,71,PHI,1,MIL,25,6,3,1,1,1,38.98333333,0,6,10,31,2,9,3,4,1,2,9,28,31,34,41.7
2024-25,202410230LAC,10/23/2024,LAC vs PHO,Norman Powell,powelno01,77,LAC,1,PHO,17,4,4,0,1,3,39.6,1,3,5,16,1,7,6,6,0,1,8,21,21,25,27.8
2024-25,202410230LAC,10/23/2024,LAC vs PHO,James Harden,hardeja01,73,LAC,1,PHO,29,12,8,1,0,8,39.86666667,3,9,10,28,2,9,7,9,3,1,20,37,41,49,50.4
2024-25,202410230LAC,10/23/2024,LAC vs PHO,Kevin Durant,duranke01,76,PHO,0,LAC,25,7,0,3,1,7,43.66666667,0,7,8,17,2,5,7,9,4,4,7,25,32,32,38.4
2024-25,202410220LAL,10/22/2024,LAL vs MIN,Max Christie,chrisma02,69,LAL,1,MIN,2,2,0,0,0,0,11.41666667,1,1,0,3,0,3,2,2,5,0,2,2,4,4,4.4
2024-25,202410220BOS,10/22/2024,BOS vs NYK,Pacome Dadiet,dadiepa01,1,NYK,0,BOS,3,1,0,0,0,0,13.38333333,0,1,1,3,1,2,0,0,1,0,1,3,4,4,4.2
2024-25,202410220LAL,10/22/2024,LAL vs MIN,Jaxson Hayes,hayesja02,72,LAL,1,MIN,10,4,0,0,1,0,15.33333333,3,1,4,5,0,0,2,2,3,1,4,10,14,14,17.8
2024-25,202410220LAL,10/22/2024,LAL vs MIN,Dalton Knecht,knechda01,1,LAL,1,MIN,5,1,2,1,0,1,15.78333333,0,1,2,4,1,3,0,0,1,1,3,7,6,8,11.2
2024-25,202410220LAL,10/22/2024,LAL vs MIN,Jaden McDaniels,mcdanja02,73,MIN,0,LAL,6,2,1,1,0,1,16,0,2,3,8,0,3,0,0,5,1,3,7,8,9,11.9
2024-25,202410220LAL,10/22/2024,LAL vs MIN,Gabe Vincent,vincega01,12,LAL,1,MIN,2,2,2,0,0,2,17.21666667,0,2,1,2,0,0,0,0,1,0,4,4,4,6,5.4
2024-25,202410220BOS,10/22/2024,BOS vs NYK,Xavier Tillman Sr.,tillmxa01,55,BOS,1,NYK,2,7,2,0,0,0,17.7,3,4,1,6,0,3,0,0,1,0,9,4,9,11,13.4
2024-25,202410220BOS,10/22/2024,BOS vs NYK,Luke Kornet,kornelu01,64,BOS,1,NYK,4,3,1,1,1,0,19.31666667,2,1,2,3,0,0,0,0,0,2,4,5,7,8,15.1
2024-25,202410220LAL,10/22/2024,LAL vs MIN,Mike Conley,conlemi01,77,MIN,0,LAL,5,4,2,1,0,3,20.21666667,2,2,1,7,0,5,3,3,1,1,6,7,9,11,12.8
2024-25,202410220BOS,10/22/2024,BOS vs NYK,Cameron Payne,payneca01,79,NYK,0,BOS,11,3,4,1,0,1,20.71666667,1,2,5,10,1,4,0,0,3,1,7,15,14,18,22.6
2024-25,202410220BOS,10/22/2024,BOS vs NYK,Karl-Anthony Towns,townska01,63,NYK,0,BOS,12,7,3,0,0,0,23.61666667,0,7,5,9,1,2,1,1,1,0,10,15,19,22,24.9
2024-25,202410220BOS,10/22/2024,BOS vs NYK,Sam Hauser,hausesa01,80,BOS,1,NYK,10,5,1,0,0,0,24.16666667,1,4,4,10,2,7,0,0,2,0,6,11,15,16,17.5
2024-25,202410220BOS,10/22/2024,BOS vs NYK,Jericho Sims,simsje01,46,NYK,0,BOS,4,9,1,0,2,1,24.38333333,3,6,2,3,0,0,0,0,0,2,10,5,13,14,21.3
2024-25,202410220BOS,10/22/2024,BOS vs NYK,Jalen Brunson,brunsja01,78,NYK,0,BOS,22,1,2,0,0,4,24.5,0,1,9,14,1,2,3,3,3,0,3,24,23,25,22.2
2024-25,202410220BOS,10/22/2024,BOS vs NYK,Josh Hart,hartjo01,82,NYK,0,BOS,12,4,3,0,0,1,24.5,1,3,4,6,0,2,4,6,0,0,7,15,16,19,20.3
2024-25,202410220BOS,10/22/2024,BOS vs NYK,Payton Pritchard,pritcpa01,83,BOS,1,NYK,3,4,4,0,0,1,24.96666667,1,3,1,10,1,9,0,0,2,0,8,7,7,11,12.8
2024-25,202410220BOS,10/22/2024,BOS vs NYK,Miles McBride,mcbrimi01,69,NYK,0,BOS,22,0,2,0,0,1,25.85,0,0,8,10,4,5,2,3,1,0,2,24,22,24,24
2024-25,202410220BOS,10/22/2024,BOS vs NYK,Al Horford,horfoal01,66,BOS,1,NYK,11,3,5,1,1,0,26.08333333,0,3,4,7,3,5,0,0,2,2,8,16,14,19,28.1
2024-25,202410220LAL,10/22/2024,LAL vs MIN,Naz Reid,reidna01,82,MIN,0,LAL,12,4,1,0,0,1,26.35,1,3,3,8,2,4,4,4,3,0,5,13,16,17,17.3
2024-25,202410220BOS,10/22/2024,BOS vs NYK,Derrick White,whitede01,74,BOS,1,NYK,24,3,4,1,0,0,26.63333333,0,3,8,13,6,10,2,2,1,1,7,28,27,31,36.6
2024-25,202410220LAL,10/22/2024,LAL vs MIN,Nickeil Alexander-Walker,alexani01,83,MIN,0,LAL,14,5,0,0,0,2,28.36666667,2,3,5,7,3,4,1,2,0,0,5,14,19,19,18
2024-25,202410220BOS,10/22/2024,BOS vs NYK,Jaylen Brown,brownja02,71,BOS,1,NYK,23,7,1,1,0,1,29.9,2,5,7,18,5,9,4,4,3,1,8,24,30,31,34.9
2024-25,202410220BOS,10/22/2024,BOS vs NYK,Jayson Tatum,tatumja01,75,BOS,1,NYK,37,4,10,1,1,1,30.3,0,4,14,18,8,11,1,2,1,2,14,47,41,51,61.8
2024-25,202410220BOS,10/22/2024,BOS vs NYK,Jrue Holiday,holidjr01,70,BOS,1,NYK,18,4,4,1,0,0,30.51666667,2,2,7,9,4,6,0,0,2,1,8,22,22,26,31.8
2024-25,202410220LAL,10/22/2024,LAL vs MIN,Donte DiVincenzo,divindo01,82,MIN,0,LAL,10,3,3,2,0,1,31.55,1,2,3,11,2,8,2,4,2,2,6,13,13,16,23.1
2024-25,202410220BOS,10/22/2024,BOS vs NYK,OG Anunoby,anunoog01,51,NYK,0,BOS,4,5,3,1,0,0,34.16666667,0,5,1,7,0,4,2,2,3,1,8,7,9,12,17.5
2024-25,202410220LAL,10/22/2024,LAL vs MIN,D'Angelo Russell,russeda01,78,LAL,1,MIN,9,1,5,2,0,1,34.21666667,0,1,4,12,1,7,0,0,2,2,6,14,10,15,22.7
2024-25,202410220LAL,10/22/2024,LAL vs MIN,Julius Randle,randlju01,47,MIN,0,LAL,16,9,4,0,0,2,34.31666667,3,6,5,10,1,3,5,7,3,0,13,20,25,29,30.8
2024-25,202410220BOS,10/22/2024,BOS vs NYK,Mikal Bridges,bridgmi01,83,NYK,0,BOS,16,0,2,0,0,1,34.61666667,0,0,7,13,2,7,0,1,0,0,2,18,16,18,18
2024-25,202410220LAL,10/22/2024,LAL vs MIN,LeBron James,jamesle01,73,LAL,1,MIN,16,5,4,0,2,2,34.65,0,5,7,16,1,4,1,1,3,2,9,20,21,25,32
2024-25,202410220LAL,10/22/2024,LAL vs MIN,Rui Hachimura,hachiru01,70,LAL,1,MIN,18,5,1,2,1,0,35.08333333,3,2,7,14,1,4,3,4,2,3,6,19,23,24,34.5
2024-25,202410220LAL,10/22/2024,LAL vs MIN,Rudy Gobert,goberru01,77,MIN,0,LAL,13,14,2,0,1,1,35.33333333,3,11,5,8,0,0,3,4,4,1,16,15,27,29,34.8
2024-25,202410220LAL,10/22/2024,LAL vs MIN,Austin Reaves,reaveau01,84,LAL,1,MIN,12,9,4,1,1,0,36.03333333,4,5,6,14,0,5,0,1,4,2,13,16,21,25,34.8
2024-25,202410220LAL,10/22/2024,LAL vs MIN,Anthony Davis,davisan02,78,LAL,1,MIN,36,16,4,1,3,1,37.58333333,3,13,11,23,1,3,13,15,1,4,20,40,52,56,72.2
2024-25,202410220LAL,10/22/2024,LAL vs MIN,Anthony Edwards,edwaran01,80,MIN,0,LAL,27,6,3,0,0,4,41.06666667,0,6,10,25,5,13,2,3,3,0,9,30,33,36,34.7
2023-24,202404140IND,4/14/2024,IND vs ATL,Kendall Brown,brownke03,16,IND,1,ATL,4,1,1,0,0,1,10.13333333,0,1,2,4,0,1,0,0,1,0,2,5,5,6,5.7
2023-24,202404140IND,4/14/2024,IND vs ATL,Jarace Walker,walkeja02,34,IND,1,ATL,8,5,1,1,0,1,10.13333333,0,5,3,5,2,3,0,0,0,1,6,9,13,14,17.5
2023-24,202404140OKC,4/14/2024,OKC vs DAL,Isaiah Joe,joeis01,78,OKC,1,DAL,2,2,1,1,0,1,10.18333333,1,1,1,3,0,2,0,0,0,1,3,3,4,5,7.9
2023-24,202404140SAC,4/14/2024,SAC vs POR,Ibou Badji,badjiib01,22,POR,0,SAC,2,0,0,1,0,1,10.21666667,0,0,1,2,0,0,0,0,2,1,0,2,2,2,4
2023-24,202404140PHI,4/14/2024,PHI vs BRK,Keon Johnson,johnske07,5,BRK,0,PHI,3,2,0,0,0,1,10.35,0,2,1,2,0,1,1,2,1,0,2,3,5,5,4.4
2023-24,202404140BOS,4/14/2024,BOS vs WAS,JD Davison,davisjd01,8,BOS,1,WAS,1,3,2,1,0,1,10.43333333,0,3,0,2,0,1,1,2,2,1,5,3,4,6,9.6
2023-24,202404140SAC,4/14/2024,SAC vs POR,Sasha Vezenkov,vezenal01,42,SAC,1,POR,0,1,0,1,0,0,10.6,0,1,0,2,0,1,0,0,1,1,1,0,1,1,4.2
2023-24,202404140MIA,4/14/2024,MIA vs TOR,Malik Williams,willima11,7,TOR,0,MIA,6,4,0,0,0,0,11.1,2,2,3,7,0,1,0,0,2,0,4,6,10,10,10.8
2023-24,202404140SAS,4/14/2024,SAS vs DET,Troy Brown Jr.,browntr01,59,DET,0,SAS,0,3,1,1,1,0,11.16666667,0,3,0,3,0,0,0,0,0,2,4,1,3,4,11.1
2023-24,202404140SAC,4/14/2024,SAC vs POR,Kessler Edwards,edwarke02,54,SAC,1,POR,0,1,1,1,0,1,11.35,0,1,0,1,0,0,0,0,1,1,2,1,1,2,4.7
2023-24,202404140OKC,4/14/2024,OKC vs DAL,Chet Holmgren,holmgch01,82,OKC,1,DAL,13,9,0,0,1,2,11.53333333,2,7,6,8,0,1,1,1,1,1,9,13,22,22,24.8
2023-24,202404140CLE,4/14/2024,CLE vs CHO,Tristan Thompson,thomptr01,49,CLE,1,CHO,6,3,0,0,0,0,11.88333333,2,1,3,7,0,0,0,2,0,0,3,6,9,9,9.6
2023-24,202404140CLE,4/14/2024,CLE vs CHO,Damian Jones,jonesda03,39,CLE,1,CHO,5,0,0,0,0,0,12,0,0,2,4,1,2,0,0,1,0,0,5,5,5,5
2023-24,202404140LAC,4/14/2024,LAC vs HOU,Boban Marjanovic,marjabo01,14,HOU,0,LAC,13,8,1,1,1,2,12,0,8,6,8,0,0,1,3,0,2,9,14,21,22,28.1
2023-24,202404140CLE,4/14/2024,CLE vs CHO,Pete Nance,nancepe01,8,CLE,1,CHO,3,1,0,0,0,0,12,0,1,1,3,1,1,0,0,1,0,1,3,4,4,4.2
2023-24,202404140OKC,4/14/2024,OKC vs DAL,Jaylin Williams,willija07,69,OKC,1,DAL,5,7,1,1,0,0,12.05,0,7,2,2,1,1,0,0,1,1,8,6,12,13,17.9
2023-24,202404140SAS,4/14/2024,SAS vs DET,Buddy Boeheim,boehebu01,10,DET,0,SAS,3,2,0,0,0,0,12.11666667,2,0,0,2,0,2,3,5,1,0,2,3,5,5,5.4
2023-24,202404140OKC,4/14/2024,OKC vs DAL,Luguentz Dort,dortlu01,79,OKC,1,DAL,5,2,2,0,0,0,12.11666667,0,2,2,6,1,4,0,0,1,0,4,7,7,9,10.4
2023-24,202404140NOP,4/14/2024,NOP vs LAL,Jaxson Hayes,hayesja02,71,LAL,0,NOP,0,3,0,0,0,0,12.13333333,0,3,0,0,0,0,0,0,1,0,3,0,3,3,3.6
2023-24,202404140IND,4/14/2024,IND vs ATL,Obi Toppin,toppiob01,83,IND,1,ATL,7,2,3,1,0,2,12.45,1,1,2,6,1,4,2,2,1,1,5,10,9,12,14.9
2023-24,202404140LAC,4/14/2024,LAC vs HOU,Jeff Green,greenje02,78,HOU,0,LAC,7,2,0,0,1,1,12.46666667,1,1,3,6,1,2,0,0,1,1,2,7,9,9,11.4
2023-24,202404140GSW,4/14/2024,GSW vs UTA,Dario Saric,saricda01,64,GSW,1,UTA,12,5,1,0,1,3,12.65,2,3,4,6,1,2,3,4,0,1,6,13,17,18,19.5
2023-24,202404140ORL,4/14/2024,ORL vs MIL,Moritz Wagner,wagnemo01,80,ORL,1,MIL,10,1,1,0,0,1,12.73333333,0,1,5,6,0,0,0,0,1,0,2,11,11,12,11.7
2023-24,202404140SAC,4/14/2024,SAC vs POR,Alex Len,lenal01,48,SAC,1,POR,2,2,1,0,1,0,13,1,1,0,1,0,0,2,4,2,1,3,3,4,5,8.9
2023-24,202404140OKC,4/14/2024,OKC vs DAL,Jalen Williams,willija06,71,OKC,1,DAL,9,0,3,0,0,0,13.25,0,0,4,6,1,2,0,0,1,0,3,12,9,12,13.5
2023-24,202404140NOP,4/14/2024,NOP vs LAL,Gabe Vincent,vincega01,11,LAL,0,NOP,0,0,1,0,0,0,13.36666667,0,0,0,2,0,1,0,0,2,0,1,1,0,1,1.5
2023-24,202404140NOP,4/14/2024,NOP vs LAL,Spencer Dinwiddie,dinwisp01,76,LAL,0,NOP,7,1,1,0,0,1,13.76666667,0,1,2,4,1,2,2,2,0,0,2,8,8,9,8.7
2023-24,202404140ORL,4/14/2024,ORL vs MIL,Pat Connaughton,connapa01,76,MIL,0,ORL,0,1,0,0,0,1,13.93333333,0,1,0,1,0,1,0,0,1,0,1,0,1,1,0.2
2023-24,202404140LAC,4/14/2024,LAC vs HOU,Nate Hinton,hintona01,15,HOU,0,LAC,2,5,4,0,0,0,13.98333333,1,4,1,3,0,2,0,0,1,0,9,6,7,11,14
2023-24,202404140NYK,4/14/2024,NYK vs CHI,Miles McBride,mcbrimi01,68,NYK,1,CHI,7,2,3,0,0,0,14.26666667,1,1,3,4,1,2,0,0,1,0,5,10,9,12,13.9
2023-24,202404140ORL,4/14/2024,ORL vs MIL,Wendell Carter Jr.,cartewe01,55,ORL,1,MIL,7,2,0,0,0,0,14.28333333,2,0,3,3,1,1,0,0,1,0,2,7,9,9,9.4
2023-24,202404140MIN,4/14/2024,MIN vs PHO,Drew Eubanks,eubandr01,75,PHO,0,MIN,0,0,1,0,0,0,14.56666667,0,0,0,2,0,0,0,0,3,0,1,1,0,1,1.5
2023-24,202404140SAC,4/14/2024,SAC vs POR,Moses Brown,brownmo01,22,POR,0,SAC,9,7,0,2,0,2,15.11666667,2,5,4,7,0,0,1,2,2,2,7,9,16,16,21.4
2023-24,202404140IND,4/14/2024,IND vs ATL,T.J. McConnell,mccontj01,72,IND,1,ATL,17,4,8,0,0,1,15.15,0,4,7,11,3,4,0,0,2,0,12,25,21,29,32.8
2023-24,202404140GSW,4/14/2024,GSW vs UTA,Pat Spencer,spencpa01,6,GSW,1,UTA,2,4,3,0,0,1,15.15,2,2,1,3,0,2,0,0,0,0,7,5,6,9,10.3
2023-24,202404140GSW,4/14/2024,GSW vs UTA,Kevon Looney,looneke01,74,GSW,1,UTA,4,2,2,0,1,0,15.16666667,1,1,2,4,0,0,0,0,1,1,4,6,6,8,12.4
2023-24,202404140OKC,4/14/2024,OKC vs DAL,Cason Wallace,wallaca01,82,OKC,1,DAL,12,2,1,0,1,0,15.43333333,1,1,5,6,2,2,0,0,1,1,3,13,14,15,18.9
2023-24,202404140OKC,4/14/2024,OKC vs DAL,Lindy Waters III,waterli01,38,OKC,1,DAL,12,0,2,0,1,0,15.5,0,0,4,6,4,5,0,0,1,1,2,14,12,14,18
2023-24,202404140NYK,4/14/2024,NYK vs CHI,Jevon Carter,carteje01,72,CHI,0,NYK,0,1,2,0,0,1,15.51666667,0,1,0,8,0,6,0,0,3,0,3,2,1,3,3.2
2023-24,202404140BOS,4/14/2024,BOS vs WAS,Oshae Brissett,brissos01,55,BOS,1,WAS,4,2,1,1,3,3,15.6,0,2,2,6,0,1,0,3,0,4,3,5,6,7,16.9
2023-24,202404140GSW,4/14/2024,GSW vs UTA,Kenneth Lofton Jr.,loftoke01,21,UTA,0,GSW,7,1,6,0,1,1,15.9,0,1,3,5,1,2,0,0,1,1,7,13,8,14,19.2
2023-24,202404140OKC,4/14/2024,OKC vs DAL,Shai Gilgeous-Alexander,gilgesh01,75,OKC,1,DAL,15,1,6,0,0,0,15.91666667,1,0,5,11,0,4,5,5,1,0,7,21,16,22,25.2
2023-24,202404140MIA,4/14/2024,MIA vs TOR,Nikola Jovic,jovicni01,46,MIA,1,TOR,3,3,1,2,0,0,15.95,0,3,1,4,1,4,0,0,2,2,4,4,6,7,14.1
2023-24,202404140CLE,4/14/2024,CLE vs CHO,Isaiah Mobley,mobleis01,10,CLE,1,CHO,11,3,0,1,0,1,16.23333333,2,1,5,9,1,3,0,1,0,1,3,11,14,14,16.6
2023-24,202404140SAS,4/14/2024,SAS vs DET,Zach Collins,colliza01,69,SAS,1,DET,17,9,2,1,0,0,16.38333333,4,5,6,11,1,2,4,4,3,1,11,19,26,28,33.8
2023-24,202404140SAS,4/14/2024,SAS vs DET,Evan Fournier,fournev01,32,DET,0,SAS,6,1,1,1,0,0,16.7,0,1,3,8,0,3,0,1,1,1,2,7,7,8,11.7
2023-24,202404140NYK,4/14/2024,NYK vs CHI,Torrey Craig,craigto01,53,CHI,0,NYK,2,5,1,1,0,0,16.73333333,1,4,1,3,0,1,0,0,5,1,6,3,7,8,12.5
2023-24,202404140LAC,4/14/2024,LAC vs HOU,Aaron Holiday,holidaa01,78,HOU,0,LAC,9,2,2,1,0,3,16.73333333,0,2,4,10,1,3,0,0,2,1,4,11,11,13,14.4
2023-24,202404140ORL,4/14/2024,ORL vs MIL,Joe Ingles,inglejo01,68,ORL,1,MIL,3,3,2,1,0,1,16.81666667,0,3,1,1,1,1,0,0,0,1,5,5,6,8,11.6
2023-24,202404140GSW,4/14/2024,GSW vs UTA,Moses Moody,moodymo01,66,GSW,1,UTA,9,1,2,2,0,1,16.95,0,1,3,8,1,4,2,2,0,2,3,11,10,12,18.2
2023-24,202404140ORL,4/14/2024,ORL vs MIL,Cole Anthony,anthoco01,81,ORL,1,MIL,13,5,4,2,0,1,17.05,2,3,5,9,1,3,2,2,3,2,9,17,18,22,30
2023-24,202404140BOS,4/14/2024,BOS vs WAS,Jordan Walsh,walshjo01,9,BOS,1,WAS,1,3,1,2,0,1,17.13333333,0,3,0,2,0,1,1,2,1,2,4,2,4,5,11.1
2023-24,202404140MEM,4/14/2024,MEM vs DEN,Zeke Nnaji,nnajize01,58,DEN,0,MEM,6,4,0,1,0,0,17.21666667,1,3,3,5,0,0,0,0,3,1,4,6,10,10,13.8
2023-24,202404140NYK,4/14/2024,NYK vs CHI,Bojan Bogdanovic,bogdabo02,57,NYK,1,CHI,13,2,1,0,0,0,17.28333333,0,2,4,9,3,6,2,2,0,0,3,14,15,16,16.9
2023-24,202404140GSW,4/14/2024,GSW vs UTA,Lester Quinones,quinole01,37,GSW,1,UTA,12,1,3,0,0,1,17.28333333,1,0,5,11,2,7,0,0,3,0,4,15,13,16,16.7
2023-24,202404140BOS,4/14/2024,BOS vs WAS,Anthony Gill,gillan01,50,WAS,0,BOS,12,5,3,0,0,0,17.43333333,3,2,5,12,1,5,1,1,2,0,8,15,17,20,22.5
2023-24,202404140NOP,4/14/2024,NOP vs LAL,Dyson Daniels,daniedy01,61,NOP,1,LAL,2,2,1,0,0,0,17.61666667,0,2,1,4,0,3,0,0,0,0,3,3,4,5,5.9
2023-24,202404140MIN,4/14/2024,MIN vs PHO,Nickeil Alexander-Walker,alexani01,82,MIN,1,PHO,3,0,2,1,0,0,17.71666667,0,0,1,4,1,3,0,0,0,1,2,5,3,5,9
2023-24,202404140MIN,4/14/2024,MIN vs PHO,Kyle Anderson,anderky01,79,MIN,1,PHO,4,1,4,1,0,1,17.71666667,0,1,2,5,0,0,0,0,2,1,5,8,5,9,13.2
2023-24,202404140OKC,4/14/2024,OKC vs DAL,Aaron Wiggins,wiggiaa01,78,OKC,1,DAL,14,6,1,1,0,0,17.76666667,1,5,5,8,2,2,2,2,1,1,7,15,20,21,25.7
2023-24,202404140PHI,4/14/2024,PHI vs BRK,Jacob Gilyard,gilyaja01,41,BRK,0,PHI,0,0,2,4,0,1,17.81666667,0,0,0,4,0,4,0,0,0,4,2,2,0,2,14
2023-24,202404140OKC,4/14/2024,OKC vs DAL,Bismack Biyombo,biyombi01,40,OKC,1,DAL,6,6,0,0,1,0,18.13333333,1,5,2,4,0,0,2,4,1,1,6,6,12,12,16.2
2023-24,202404140OKC,4/14/2024,OKC vs DAL,Ousmane Dieng,diengou01,33,OKC,1,DAL,13,1,4,3,2,1,18.13333333,0,1,6,12,1,3,0,0,2,5,5,17,14,18,34.2
2023-24,202404140OKC,4/14/2024,OKC vs DAL,Mike Muscala,muscami01,53,OKC,1,DAL,2,5,0,0,0,1,18.23333333,2,3,1,2,0,1,0,0,2,0,5,2,7,7,7
2023-24,202404140PHI,4/14/2024,PHI vs BRK,Mo Bamba,bambamo01,57,PHI,1,BRK,4,6,0,0,2,0,18.43333333,2,4,2,3,0,1,0,0,1,2,6,4,10,10,17.2
2023-24,202404140IND,4/14/2024,IND vs ATL,Doug McDermott,mcderdo01,64,IND,1,ATL,15,1,1,0,0,0,18.45,1,0,6,9,3,5,0,0,0,0,2,16,16,17,17.7
2023-24,202404140NYK,4/14/2024,NYK vs CHI,Precious Achiuwa,achiupr01,74,NYK,1,CHI,4,5,2,0,1,2,18.5,1,4,2,3,0,0,0,0,3,1,7,6,9,11,14
2023-24,202404140SAS,4/14/2024,SAS vs DET,Devonte Graham,grahade01,23,SAS,1,DET,12,1,2,0,0,3,18.71666667,0,1,4,8,4,7,0,0,0,0,3,14,13,15,13.2
2023-24,202404140SAC,4/14/2024,SAC vs POR,Trey Lyles,lylestr01,58,SAC,1,POR,5,8,3,0,0,0,18.76666667,3,5,1,4,1,2,2,2,0,0,11,8,13,16,19.1
2023-24,202404140CLE,4/14/2024,CLE vs CHO,Marcus Morris,morrima03,49,CLE,1,CHO,7,3,0,0,0,1,18.8,1,2,3,9,1,4,0,0,2,0,3,7,10,10,9.6
2023-24,202404140OKC,4/14/2024,OKC vs DAL,Alex Fudge,fudgeal01,6,DAL,0,OKC,11,2,0,3,0,0,18.91666667,2,0,5,9,1,3,0,0,1,3,2,11,13,13,22.4
2023-24,202404140GSW,4/14/2024,GSW vs UTA,Johnny Juzang,juzanjo01,20,UTA,0,GSW,8,1,2,0,0,0,19.15,0,1,2,5,2,4,2,4,0,0,3,10,9,11,12.2
2023-24,202404140MEM,4/14/2024,MEM vs DEN,Justin Holiday,holidju01,58,DEN,0,MEM,3,1,3,1,0,1,19.18333333,0,1,1,5,1,5,0,0,1,1,4,6,4,7,10.7
2023-24,202404140IND,4/14/2024,IND vs ATL,Jalen Smith,smithja04,61,IND,1,ATL,10,5,2,0,1,2,19.28333333,3,2,4,4,2,2,0,0,2,1,7,12,15,17,20
2023-24,202404140CLE,4/14/2024,CLE vs CHO,Aleksej Pokusevski,pokusal01,28,CHO,0,CLE,8,5,3,1,0,3,19.35,0,5,3,7,1,3,1,2,2,1,8,11,13,16,18.5
2023-24,202404140MIA,4/14/2024,MIA vs TOR,Bam Adebayo,adebaba01,71,MIA,1,TOR,17,6,2,3,1,4,19.48333333,3,3,8,10,0,1,1,1,1,4,8,19,23,25,35.2
2023-24,202404140OKC,4/14/2024,OKC vs DAL,Josh Giddey,giddejo01,80,OKC,1,DAL,8,6,8,0,0,3,19.5,2,4,3,8,1,4,1,1,2,0,14,16,14,22,24.2
2023-24,202404140BOS,4/14/2024,BOS vs WAS,Neemias Queta,quetane01,28,BOS,1,WAS,19,9,1,0,6,3,19.5,3,6,8,11,0,0,3,4,2,6,10,20,28,29,46.3
2023-24,202404140GSW,4/14/2024,GSW vs UTA,Klay Thompson,thompkl01,77,GSW,1,UTA,25,3,3,0,1,0,19.51666667,0,3,7,13,6,12,5,5,0,1,6,28,28,31,36.1
2023-24,202404140OKC,4/14/2024,OKC vs DAL,Tim Hardaway Jr.,hardati02,79,DAL,0,OKC,3,1,3,2,0,0,19.66666667,0,1,1,9,1,6,0,0,2,2,4,6,4,7,14.7
2023-24,202404140IND,4/14/2024,IND vs ATL,Aaron Nesmith,nesmiaa01,73,IND,1,ATL,8,3,1,1,0,0,19.81666667,0,3,3,3,1,1,1,1,3,1,4,9,11,12,16.1
2023-24,202404140IND,4/14/2024,IND vs ATL,AJ Griffin,griffaj01,20,ATL,0,IND,8,0,0,0,1,1,19.91666667,0,0,4,14,0,5,0,0,0,1,0,8,8,8,10
2023-24,202404140BOS,4/14/2024,BOS vs WAS,Jaden Springer,sprinja01,49,BOS,1,WAS,7,2,0,3,1,1,20.03333333,0,2,2,4,1,2,2,2,2,4,2,7,9,9,20.4
2023-24,202404140GSW,4/14/2024,GSW vs UTA,Keyonte George,georgke01,75,UTA,0,GSW,21,1,4,0,0,1,20.13333333,0,1,8,11,5,6,0,1,1,0,5,25,22,26,27.2
2023-24,202404140MIN,4/14/2024,MIN vs PHO,Jusuf Nurkic,nurkiju01,76,PHO,0,MIN,6,5,8,5,1,1,20.16666667,2,3,3,4,0,1,0,0,4,6,13,14,11,19,41
2023-24,202404140NOP,4/14/2024,NOP vs LAL,Taurean Prince,princta02,79,LAL,0,NOP,9,1,0,1,0,2,20.2,0,1,3,6,1,1,2,2,0,1,1,9,10,10,11.2
2023-24,202404140GSW,4/14/2024,GSW vs UTA,Andrew Wiggins,wiggian01,71,GSW,1,UTA,19,4,3,2,0,1,20.21666667,1,3,6,11,2,5,5,6,2,2,7,22,23,26,33.3
2023-24,202404140MIN,4/14/2024,MIN vs PHO,Naz Reid,reidna01,81,MIN,1,PHO,10,4,1,1,0,4,20.23333333,0,4,4,8,2,5,0,0,4,1,5,11,14,15,15.3
2023-24,202404140PHI,4/14/2024,PHI vs BRK,Nicolas Batum,batumni01,60,PHI,1,BRK,0,5,5,0,0,0,20.26666667,1,4,0,3,0,2,0,0,2,0,10,5,5,10,13.5
2023-24,202404140PHI,4/14/2024,PHI vs BRK,Nic Claxton,claxtni01,71,BRK,0,PHI,6,8,1,0,0,3,20.28333333,1,7,3,6,0,0,0,0,3,0,9,7,14,15,14.1
2023-24,202404140SAS,4/14/2024,SAS vs DET,Malachi Flynn,flynnma01,69,DET,0,SAS,4,1,3,1,0,1,20.35,0,1,2,8,0,4,0,0,0,1,4,7,5,8,11.7
2023-24,202404140ORL,4/14/2024,ORL vs MIL,Malik Beasley,beaslma01,79,MIL,0,ORL,4,2,0,1,0,0,20.38333333,0,2,2,6,0,4,0,0,0,1,2,4,6,6,9.4
2023-24,202404140MIA,4/14/2024,MIA vs TOR,Bruce Brown,brownbr01,68,TOR,0,MIA,6,0,0,0,0,1,20.41666667,0,0,3,5,0,1,0,1,2,0,0,6,6,6,5
2023-24,202404140MIA,4/14/2024,MIA vs TOR,Jordan Nwora,nworajo01,52,TOR,0,MIA,14,11,1,0,0,2,20.5,2,9,6,10,2,4,0,0,1,0,12,15,25,26,26.7
2023-24,202404140OKC,4/14/2024,OKC vs DAL,Kenrich Williams,willike04,69,OKC,1,DAL,9,7,7,0,0,4,20.5,0,7,4,9,1,2,0,0,0,0,14,16,16,23,23.9
2023-24,202404140MEM,4/14/2024,MEM vs DEN,Peyton Watson,watsope01,80,DEN,0,MEM,11,2,1,1,0,1,20.53333333,1,1,5,7,1,1,0,0,3,1,3,12,13,14,16.9
2023-24,202404140BOS,4/14/2024,BOS vs WAS,Justin Champagnie,champju01,15,WAS,0,BOS,9,7,3,2,1,0,20.78333333,1,6,4,9,0,2,1,1,1,3,10,12,16,19,30.9
2023-24,202404140GSW,4/14/2024,GSW vs UTA,Trayce Jackson-Davis,jackstr02,68,GSW,1,UTA,8,0,1,0,0,1,20.83333333,0,0,4,4,0,0,0,1,1,0,1,9,8,9,8.5
2023-24,202404140NOP,4/14/2024,NOP vs LAL,Jose Alvarado,alvarjo01,56,NOP,1,LAL,10,1,1,1,0,2,20.91666667,0,1,4,7,2,5,0,0,0,1,2,11,11,12,13.7
2023-24,202404140IND,4/14/2024,IND vs ATL,Garrison Mathews,mathega01,66,ATL,0,IND,6,0,0,1,1,0,21,0,0,2,5,2,5,0,0,0,2,0,6,6,6,12
2023-24,202404140LAC,4/14/2024,LAC vs HOU,Jock Landale,landajo01,56,HOU,0,LAC,5,4,2,1,0,4,21.16666667,3,1,2,7,1,3,0,0,0,1,6,7,9,11,11.8
2023-24,202404140IND,4/14/2024,IND vs ATL,Bruno Fernando,fernabr01,45,ATL,0,IND,12,2,1,0,0,1,21.2,0,2,3,5,0,0,6,6,2,0,3,13,14,15,14.9
2023-24,202404140GSW,4/14/2024,GSW vs UTA,Micah Potter,pottemi01,16,UTA,0,GSW,10,8,1,0,2,1,21.35,2,6,4,7,2,3,0,2,5,2,9,11,18,19,26.1
2023-24,202404140GSW,4/14/2024,GSW vs UTA,Brandin Podziemski,podzibr01,74,GSW,1,UTA,7,9,2,2,0,0,21.45,3,6,3,7,1,3,0,0,0,2,11,9,16,18,26.8
2023-24,202404140LAC,4/14/2024,LAC vs HOU,Jeenathan Williams,willije02,22,HOU,0,LAC,13,3,0,1,1,2,21.48333333,1,2,6,9,1,1,0,3,0,2,3,13,16,16,20.6
2023-24,202404140CLE,4/14/2024,CLE vs CHO,Amari Bailey,baileam01,10,CHO,0,CLE,11,5,5,2,0,1,21.63333333,4,1,4,10,1,2,2,2,1,2,10,16,16,21,29.5
2023-24,202404140SAC,4/14/2024,SAC vs POR,Davion Mitchell,mitchda01,72,SAC,1,POR,11,4,3,0,0,1,21.68333333,1,3,4,11,3,5,0,0,0,0,7,14,15,18,19.3
2023-24,202404140OKC,4/14/2024,OKC vs DAL,Gordon Hayward,haywago01,51,OKC,1,DAL,10,4,2,0,0,2,21.7,0,4,4,6,0,1,2,3,2,0,6,12,14,16,15.8
2023-24,202404140SAS,4/14/2024,SAS vs DET,David Duke Jr.,dukeda01,4,SAS,1,DET,15,3,0,1,0,2,21.73333333,1,2,6,8,2,3,1,1,2,1,3,15,18,18,19.6
2023-24,202404140PHI,4/14/2024,PHI vs BRK,Buddy Hield,hieldbu01,85,PHI,1,BRK,19,7,5,1,0,1,21.73333333,2,5,6,15,4,10,3,3,2,1,12,24,26,31,36.9
2023-24,202404140IND,4/14/2024,IND vs ATL,Vit Krejci,krejcvi01,22,ATL,0,IND,0,5,5,0,0,1,21.73333333,2,3,0,2,0,2,0,0,1,0,10,5,5,10,12.5
2023-24,202404140IND,4/14/2024,IND vs ATL,Myles Turner,turnemy01,78,IND,1,ATL,31,12,0,0,4,1,21.9,3,9,13,17,3,4,2,2,2,4,12,31,43,43,56.4
2023-24,202404140ORL,4/14/2024,ORL vs MIL,Jae Crowder,crowdja01,50,MIL,0,ORL,6,2,0,1,0,2,22.06666667,1,1,2,6,2,5,0,0,2,1,2,6,8,8,9.4
2023-24,202404140MIA,4/14/2024,MIA vs TOR,Kelly Olynyk,olynyke01,78,TOR,0,MIA,11,8,2,1,0,4,22.25,1,7,5,9,1,3,0,0,4,1,10,13,19,21,22.6
2023-24,202404140SAS,4/14/2024,SAS vs DET,Jamaree Bouyea,bouyeja01,9,SAS,1,DET,5,8,2,0,0,1,22.46666667,1,7,2,4,1,1,0,0,5,0,10,7,13,15,16.6
2023-24,202404140CLE,4/14/2024,CLE vs CHO,Jarrett Allen,allenja01,77,CLE,1,CHO,14,7,2,2,0,3,22.56666667,1,6,7,7,0,0,0,0,1,2,9,16,21,23,28.4
2023-24,202404140CLE,4/14/2024,CLE vs CHO,Georges Niang,niangge01,82,CLE,1,CHO,16,1,1,0,0,0,22.56666667,0,1,6,9,4,7,0,0,2,0,2,17,17,18,18.7
2023-24,202404140SAS,4/14/2024,SAS vs DET,RaiQuan Gray,grayra01,3,SAS,1,DET,10,5,4,0,1,0,22.58333333,2,3,5,9,0,2,0,0,0,1,9,14,15,19,25
2023-24,202404140MEM,4/14/2024,MEM vs DEN,Zavier Simpson,simpsza01,7,MEM,1,DEN,8,1,3,0,0,0,22.65,0,1,4,8,0,1,0,0,1,0,4,11,9,12,13.7
2023-24,202404140LAC,4/14/2024,LAC vs HOU,Jalen Green,greenja05,82,HOU,0,LAC,13,6,3,0,0,1,22.66666667,1,5,5,14,3,10,0,0,0,0,9,16,19,22,23.7
2023-24,202404140GSW,4/14/2024,GSW vs UTA,Chris Paul,paulch01,58,GSW,1,UTA,6,4,6,0,0,1,22.68333333,0,4,3,10,0,3,0,0,3,0,10,12,10,16,18.8
2023-24,202404140IND,4/14/2024,IND vs ATL,Andrew Nembhard,nembhan01,68,IND,1,ATL,10,2,5,1,0,1,22.71666667,0,2,4,5,2,3,0,0,3,1,7,15,12,17,21.9
2023-24,202404140BOS,4/14/2024,BOS vs WAS,Eugene Omoruyi,omorueu01,43,WAS,0,BOS,26,2,5,0,0,0,23.01666667,1,1,11,17,4,6,0,0,1,0,7,31,28,33,35.9
2023-24,202404140PHI,4/14/2024,PHI vs BRK,Cameron Payne,payneca01,78,PHI,1,BRK,10,2,3,1,0,1,23.16666667,1,1,4,9,2,7,0,0,0,1,5,13,12,15,18.9
2023-24,202404140PHI,4/14/2024,PHI vs BRK,Kyle Lowry,lowryky01,60,PHI,1,BRK,0,4,8,1,0,2,23.2,0,4,0,2,0,2,0,0,1,1,12,8,4,12,17.8
2023-24,202404140MIA,4/14/2024,MIA vs TOR,Jalen McDaniels,mcdanja01,50,TOR,0,MIA,7,2,2,1,0,2,23.2,0,2,2,7,1,2,2,2,3,1,4,9,9,11,13.4
2023-24,202404140GSW,4/14/2024,GSW vs UTA,Jonathan Kuminga,kuminjo01,74,GSW,1,UTA,0,0,7,2,1,0,23.23333333,0,0,0,4,0,0,0,0,1,3,7,7,0,7,19.5
2023-24,202404140MIA,4/14/2024,MIA vs TOR,Gary Trent Jr.,trentga02,71,TOR,0,MIA,18,4,1,0,0,0,23.25,1,3,6,14,3,8,3,3,1,0,5,19,22,23,24.3
2023-24,202404140MIN,4/14/2024,MIN vs PHO,Royce O'Neale,onealro01,79,PHO,0,MIN,4,2,3,0,0,1,23.28333333,0,2,1,4,1,3,1,2,3,0,5,7,6,9,9.9
2023-24,202404140MIA,4/14/2024,MIA vs TOR,Thomas Bryant,bryanth01,38,MIA,1,TOR,18,10,1,0,1,2,23.38333333,3,7,8,10,0,1,2,2,1,1,11,19,28,29,32.5
2023-24,202404140NOP,4/14/2024,NOP vs LAL,Brandon Ingram,ingrabr01,64,NOP,1,LAL,13,5,0,0,0,2,23.38333333,0,5,6,9,1,3,0,0,0,0,5,13,18,18,17
2023-24,202404140OKC,4/14/2024,OKC vs DAL,A.J. Lawson,lawsoaj01,42,DAL,0,OKC,12,5,2,0,0,1,23.53333333,1,4,5,13,0,5,2,2,1,0,7,14,17,19,20
2023-24,202404140MIA,4/14/2024,MIA vs TOR,Caleb Martin,martica02,64,MIA,1,TOR,12,5,2,1,1,1,23.66666667,2,3,5,12,2,6,0,0,1,2,7,14,17,19,26
2023-24,202404140OKC,4/14/2024,OKC vs DAL,Markieff Morris,morrima02,26,DAL,0,OKC,8,5,3,0,1,2,23.68333333,0,5,2,7,2,4,2,2,0,1,8,11,13,16,19.5
2023-24,202404140MEM,4/14/2024,MEM vs DEN,Reggie Jackson,jacksre01,82,DEN,0,MEM,11,0,2,0,0,2,23.73333333,0,0,3,9,2,6,3,3,3,0,2,13,11,13,12
2023-24,202404140LAC,4/14/2024,LAC vs HOU,Mason Plumlee,plumlma01,46,LAC,1,HOU,9,13,4,1,2,3,23.9,4,9,3,13,0,3,3,4,3,3,17,13,22,26,36.6
2023-24,202404140PHI,4/14/2024,PHI vs BRK,Kelly Oubre Jr.,oubreke01,68,PHI,1,BRK,8,5,0,0,1,1,23.96666667,0,5,3,10,1,4,1,2,1,1,5,8,13,13,16
2023-24,202404140GSW,4/14/2024,GSW vs UTA,Gui Santos,santogu01,23,GSW,1,UTA,13,5,2,1,0,0,24.01666667,2,3,5,10,1,5,2,2,3,1,7,15,18,20,25
2023-24,202404140SAC,4/14/2024,SAC vs POR,Duop Reath,reathdu01,68,POR,0,SAC,14,6,0,3,1,1,24.15,1,5,5,12,2,5,2,2,2,4,6,14,20,20,32.2
2023-24,202404140SAC,4/14/2024,SAC vs POR,Keon Ellis,elliske01,57,SAC,1,POR,13,3,2,3,2,1,24.18333333,1,2,4,9,3,6,2,2,3,5,5,15,16,18,33.6
2023-24,202404140CLE,4/14/2024,CLE vs CHO,Tre Mann,manntr01,41,CHO,0,CLE,11,4,6,1,0,2,24.23333333,0,4,4,11,3,6,0,0,2,1,10,17,15,21,25.8
2023-24,202404140MEM,4/14/2024,MEM vs DEN,Jamal Murray,murraja01,59,DEN,0,MEM,21,6,4,0,1,2,24.26666667,2,4,7,14,3,7,4,4,1,1,10,25,27,31,35.2
2023-24,202404140MEM,4/14/2024,MEM vs DEN,Michael Porter Jr.,portemi01,81,DEN,0,MEM,12,5,4,0,2,2,24.26666667,0,5,5,12,2,8,0,0,0,2,9,16,17,21,28
2023-24,202404140BOS,4/14/2024,BOS vs WAS,Jules Bernard,bernaju01,19,WAS,0,BOS,13,6,3,1,0,2,24.3,2,4,5,10,2,4,1,1,0,1,9,16,19,22,25.7
2023-24,202404140MIA,4/14/2024,MIA vs TOR,Haywood Highsmith,highsha01,66,MIA,1,TOR,5,3,1,1,0,2,24.33333333,1,2,2,5,1,4,0,0,3,1,4,6,8,9,11.1
2023-24,202404140MIA,4/14/2024,MIA vs TOR,Jimmy Butler,butleji01,60,MIA,1,TOR,15,5,4,0,0,1,24.4,3,2,6,9,0,0,3,4,1,0,9,19,20,24,26
2023-24,202404140MEM,4/14/2024,MEM vs DEN,Timmy Allen,allenti01,5,MEM,1,DEN,1,1,1,2,0,0,24.43333333,0,1,0,2,0,0,1,2,3,2,2,2,2,3,9.7
2023-24,202404140NYK,4/14/2024,NYK vs CHI,Dalen Terry,terryda01,59,CHI,0,NYK,6,7,1,1,2,1,24.45,3,4,3,7,0,2,0,1,3,3,8,7,13,14,23.9
2023-24,202404140SAS,4/14/2024,SAS vs DET,Tre Jones,jonestr01,77,SAS,1,DET,11,6,6,1,0,0,24.53333333,0,6,5,12,1,6,0,0,1,1,12,17,17,23,30.2
2023-24,202404140MIA,4/14/2024,MIA vs TOR,Garrett Temple,templga01,27,TOR,0,MIA,9,3,7,0,0,1,24.75,2,1,1,8,1,5,6,6,3,0,10,16,12,19,22.1
2023-24,202404140PHI,4/14/2024,PHI vs BRK,Mikal Bridges,bridgmi01,82,BRK,0,PHI,8,2,1,0,0,0,24.83333333,0,2,3,8,2,5,0,0,1,0,3,9,10,11,11.9
2023-24,202404140MEM,4/14/2024,MEM vs DEN,Kentavious Caldwell-Pope,caldwke01,76,DEN,0,MEM,11,4,3,0,1,2,24.83333333,0,4,5,6,1,2,0,1,1,1,7,14,15,18,21.3
2023-24,202404140MEM,4/14/2024,MEM vs DEN,Christian Braun,braunch01,82,DEN,0,MEM,19,10,5,2,0,1,24.95,5,5,6,14,2,6,5,6,2,2,15,24,29,34,43.5
2023-24,202404140MEM,4/14/2024,MEM vs DEN,Scotty Pippen Jr.,pippesc02,21,MEM,1,DEN,15,3,7,0,0,3,25.11666667,2,1,7,11,0,3,1,1,5,0,10,22,18,25,26.1
2023-24,202404140CLE,4/14/2024,CLE vs CHO,Evan Mobley,mobleev01,50,CLE,1,CHO,14,6,5,0,0,0,25.4,3,3,5,13,0,1,4,4,0,0,11,19,20,25,28.7
2023-24,202404140IND,4/14/2024,IND vs ATL,Tyrese Haliburton,halibty01,70,IND,1,ATL,12,2,13,3,1,2,25.41666667,0,2,5,10,0,4,2,3,3,4,15,25,14,27,43.9
2023-24,202404140IND,4/14/2024,IND vs ATL,Pascal Siakam,siakapa01,80,IND,1,ATL,28,6,1,1,0,2,25.41666667,2,4,13,18,1,2,1,2,3,1,7,29,34,35,37.7
2023-24,202404140IND,4/14/2024,IND vs ATL,Ben Sheppard,sheppbe01,58,IND,1,ATL,7,4,2,1,0,0,25.5,2,2,3,6,1,3,0,0,1,1,6,9,11,13,17.8
2023-24,202404140SAC,4/14/2024,SAC vs POR,De'Aaron Fox,foxde01,74,SAC,1,POR,24,2,3,3,1,1,25.51666667,0,2,10,14,2,3,2,2,1,4,5,27,26,29,41.9
2023-24,202404140SAS,4/14/2024,SAS vs DET,Julian Champagnie,champju02,74,SAS,1,DET,11,3,6,0,0,2,25.6,0,3,4,9,2,4,1,2,0,0,9,17,14,20,21.6
2023-24,202404140SAS,4/14/2024,SAS vs DET,Sandro Mamukelashvili,mamuksa01,46,SAS,1,DET,18,8,1,0,0,3,25.98333333,2,6,7,13,3,6,1,2,0,0,9,19,26,27,26.1
2023-24,202404140MEM,4/14/2024,MEM vs DEN,Aaron Gordon,gordoaa01,73,DEN,0,MEM,15,5,5,0,1,1,26.08333333,3,2,4,6,0,1,7,8,2,1,10,20,20,25,30.5
2023-24,202404140ORL,4/14/2024,ORL vs MIL,Jonathan Isaac,isaacjo01,58,ORL,1,MIL,10,8,2,1,3,0,26.15,2,6,4,11,2,7,0,0,2,4,10,12,18,20,34.6
2023-24,202404140ORL,4/14/2024,ORL vs MIL,Patrick Beverley,beverpa01,73,MIL,0,ORL,2,5,2,1,0,2,26.26666667,2,3,1,3,0,1,0,0,1,1,7,4,7,9,12
2023-24,202404140IND,4/14/2024,IND vs ATL,De'Andre Hunter,huntede01,57,ATL,0,IND,6,2,1,0,0,1,26.56666667,0,2,0,6,0,2,6,6,1,0,3,7,8,9,8.9
2023-24,202404140BOS,4/14/2024,BOS vs WAS,Johnny Davis,davisjo06,50,WAS,0,BOS,6,1,2,2,0,3,26.58333333,0,1,3,5,0,0,0,0,4,2,3,8,7,9,13.2
2023-24,202404140PHI,4/14/2024,PHI vs BRK,Cam Thomas,thomaca02,66,BRK,0,PHI,18,3,2,0,0,1,26.58333333,0,3,5,12,3,7,5,6,0,0,5,20,21,23,23.6
2023-24,202404140IND,4/14/2024,IND vs ATL,Mouhamed Gueye,gueyemo02,6,ATL,0,IND,19,9,0,2,3,0,26.8,4,5,6,11,2,3,5,6,4,5,9,19,28,28,44.8
2023-24,202404140OKC,4/14/2024,OKC vs DAL,Dwight Powell,poweldw01,63,DAL,0,OKC,2,8,1,1,1,1,26.98333333,4,4,1,2,0,1,0,0,3,2,9,3,10,11,18.1
2023-24,202404140SAS,4/14/2024,SAS vs DET,Jaden Ivey,iveyja01,77,DET,0,SAS,13,1,2,0,0,2,27.06666667,0,1,5,13,1,6,2,2,0,0,3,15,14,16,15.2
2023-24,202404140BOS,4/14/2024,BOS vs WAS,Luke Kornet,kornelu01,63,BOS,1,WAS,11,8,5,0,3,0,27.11666667,3,5,4,5,0,0,3,3,0,3,13,16,19,24,37.1
2023-24,202404140SAC,4/14/2024,SAC vs POR,Domantas Sabonis,sabondo01,82,SAC,1,POR,18,11,9,0,0,4,27.13333333,2,9,7,10,0,2,4,4,1,0,20,27,29,38,40.7
2023-24,202404140SAC,4/14/2024,SAC vs POR,Keegan Murray,murrake02,77,SAC,1,POR,12,5,1,1,1,1,27.28333333,1,4,4,12,2,7,2,2,3,2,6,13,17,18,24.5
2023-24,202404140MIN,4/14/2024,MIN vs PHO,Mike Conley,conlemi01,76,MIN,1,PHO,17,4,2,1,2,3,27.43333333,1,3,5,7,4,5,3,3,1,3,6,19,21,23,30.8
2023-24,202404140IND,4/14/2024,IND vs ATL,Bogdan Bogdanovic,bogdabo01,79,ATL,0,IND,18,4,1,2,0,0,27.45,1,3,6,15,3,8,3,3,2,2,5,19,22,23,30.3
2023-24,202404140MIN,4/14/2024,MIN vs PHO,Jaden McDaniels,mcdanja02,72,MIN,1,PHO,6,0,1,0,0,3,27.51666667,0,0,2,7,1,4,1,2,1,0,1,7,6,7,4.5
2023-24,202404140LAC,4/14/2024,LAC vs HOU,Terance Mann,mannte01,75,LAC,1,HOU,24,6,2,1,0,1,27.66666667,2,4,10,14,1,3,3,3,1,1,8,26,30,32,36.2
2023-24,202404140ORL,4/14/2024,ORL vs MIL,Gary Harris,harriga01,54,ORL,1,MIL,3,0,2,1,0,1,27.78333333,0,0,1,4,1,4,0,0,3,1,2,5,3,5,8
2023-24,202404140GSW,4/14/2024,GSW vs UTA,Kira Lewis Jr.,lewiski01,28,UTA,0,GSW,13,3,3,1,0,1,27.86666667,1,2,6,12,0,2,1,1,1,1,6,16,16,19,23.1
2023-24,202404140ORL,4/14/2024,ORL vs MIL,Jalen Suggs,suggsja01,75,ORL,1,MIL,4,2,4,1,1,1,27.93333333,0,2,1,3,0,2,2,2,3,2,6,8,6,10,17.4
2023-24,202404140MIA,4/14/2024,MIA vs TOR,Delon Wright,wrighde01,47,MIA,1,TOR,11,3,4,4,1,1,28.28333333,1,2,4,7,3,5,0,0,1,5,7,15,14,18,34.6
2023-24,202404140ORL,4/14/2024,ORL vs MIL,Brook Lopez,lopezbr01,79,MIL,0,ORL,11,3,0,0,2,1,28.45,2,1,4,9,1,3,2,2,4,2,3,11,14,14,19.6
2023-24,202404140NOP,4/14/2024,NOP vs LAL,Austin Reaves,reaveau01,83,LAL,0,NOP,20,1,2,1,1,2,28.56666667,0,1,8,12,3,7,1,2,2,2,3,22,21,23,28.2
2023-24,202404140OKC,4/14/2024,OKC vs DAL,Jaden Hardy,hardyja02,73,DAL,0,OKC,9,4,3,2,0,4,28.83333333,0,4,4,14,1,4,0,0,5,2,7,12,13,16,20.3
2023-24,202404140LAC,4/14/2024,LAC vs HOU,Daniel Theis,theisda01,60,LAC,1,HOU,16,11,2,2,2,1,28.83333333,3,8,6,12,2,6,2,2,2,4,13,18,27,29,43.2
2023-24,202404140GSW,4/14/2024,GSW vs UTA,Brice Sensabaugh,sensabr01,32,UTA,0,GSW,14,3,0,1,0,5,28.85,1,2,6,15,2,7,0,0,3,1,3,14,17,17,15.6
2023-24,202404140GSW,4/14/2024,GSW vs UTA,Luka Samanic,samanlu01,43,UTA,0,GSW,14,5,2,1,0,7,28.95,1,4,5,11,0,5,4,4,4,1,7,16,19,21,19
2023-24,202404140PHI,4/14/2024,PHI vs BRK,Lonnie Walker IV,walkelo01,58,BRK,0,PHI,12,6,5,1,2,2,28.98333333,0,6,6,15,0,6,0,0,0,3,11,17,18,23,33.7
2023-24,202404140MIA,4/14/2024,MIA vs TOR,Gradey Dick,dickgr01,60,TOR,0,MIA,14,2,1,2,0,2,29.01666667,0,2,5,13,1,5,3,4,1,2,3,15,16,17,21.9
2023-24,202404140PHI,4/14/2024,PHI vs BRK,Paul Reed,reedpa01,82,PHI,1,BRK,13,12,3,2,2,2,29.01666667,5,7,6,12,0,1,1,2,3,4,15,16,25,28,41.9
2023-24,202404140CLE,4/14/2024,CLE vs CHO,Isaac Okoro,okorois01,69,CLE,1,CHO,11,3,6,0,0,0,29.05,0,3,3,6,3,4,2,2,0,0,9,17,14,20,23.6
2023-24,202404140MIN,4/14/2024,MIN vs PHO,Karl-Anthony Towns,townska01,62,MIN,1,PHO,10,6,2,0,0,5,29.2,2,4,3,8,1,4,3,4,4,0,8,12,16,18,15.2
2023-24,202404140PHI,4/14/2024,PHI vs BRK,Tyrese Maxey,maxeyty01,70,PHI,1,BRK,26,3,3,1,0,2,29.26666667,0,3,10,20,3,7,3,4,3,1,6,29,29,32,35.1
2023-24,202404140CLE,4/14/2024,CLE vs CHO,Emoni Bates,batesem01,15,CLE,1,CHO,7,3,3,0,0,6,29.41666667,0,3,3,12,1,5,0,0,0,0,6,10,10,13,9.1
2023-24,202404140MIA,4/14/2024,MIA vs TOR,Tyler Herro,herroty01,42,MIA,1,TOR,17,6,8,1,0,6,29.45,0,6,5,11,2,5,5,5,1,1,14,25,23,31,33.2
2023-24,202404140CLE,4/14/2024,CLE vs CHO,Bryce McGowens,mcgowbr01,59,CHO,0,CLE,18,3,4,0,1,0,29.71666667,1,2,6,14,2,6,4,4,0,1,7,22,21,25,30.6
2023-24,202404140OKC,4/14/2024,OKC vs DAL,Brandon Williams,willibr03,17,DAL,0,OKC,22,5,3,0,0,3,29.78333333,1,4,8,21,1,6,5,6,1,0,8,25,27,30,29.5
2023-24,202404140GSW,4/14/2024,GSW vs UTA,Omer Yurtseven,yurtsom01,48,UTA,0,GSW,11,18,2,0,0,2,29.8,6,12,5,12,0,1,1,2,2,0,20,13,29,31,33.6
2023-24,202404140CLE,4/14/2024,CLE vs CHO,Marques Bolden,boldema01,11,CHO,0,CLE,14,8,2,1,4,1,29.86666667,4,4,7,10,0,1,0,0,1,5,10,16,22,24,40.6
2023-24,202404140PHI,4/14/2024,PHI vs BRK,Tobias Harris,harrito02,70,PHI,1,BRK,21,8,2,1,1,1,30,2,6,8,15,3,6,2,2,1,2,10,23,29,31,38.6
2023-24,202404140SAC,4/14/2024,SAC vs POR,Taze Moore,mooreta02,4,POR,0,SAC,12,8,4,1,0,2,30.15,4,4,5,14,1,5,1,2,2,1,12,16,20,24,28.6
2023-24,202404140SAS,4/14/2024,SAS vs DET,Blake Wesley,weslebl01,61,SAS,1,DET,17,7,5,3,0,1,30.28333333,1,6,7,9,1,1,2,3,2,3,12,22,24,29,40.9
2023-24,202404140ORL,4/14/2024,ORL vs MIL,Damian Lillard,lillada01,73,MIL,0,ORL,16,4,2,1,0,2,30.38333333,1,3,2,14,0,4,12,13,0,1,6,18,20,22,24.8
2023-24,202404140NOP,4/14/2024,NOP vs LAL,Larry Nance Jr.,nancela02,61,NOP,1,LAL,13,6,4,1,0,1,30.51666667,2,4,5,8,1,2,2,2,3,1,10,17,19,23,28.2
2023-24,202404140IND,4/14/2024,IND vs ATL,Dejounte Murray,murrade01,78,ATL,0,IND,32,3,3,1,0,3,30.56666667,1,2,13,19,4,6,2,3,1,1,6,35,35,38,40.1
2023-24,202404140CLE,4/14/2024,CLE vs CHO,Max Strus,strusma01,70,CLE,1,CHO,14,10,11,0,0,3,30.58333333,3,7,5,12,4,6,0,0,0,0,21,25,24,35,39.5
2023-24,202404140SAC,4/14/2024,SAC vs POR,Harrison Barnes,barneha02,82,SAC,1,POR,17,5,3,2,0,1,30.68333333,1,4,5,8,2,4,5,7,1,2,8,20,22,25,32.5
2023-24,202404140BOS,4/14/2024,BOS vs WAS,Deni Avdija,avdijde01,75,WAS,0,BOS,9,3,2,0,1,1,30.71666667,0,3,3,11,1,5,2,2,1,1,5,11,12,14,17.6
2023-24,202404140MEM,4/14/2024,MEM vs DEN,Nikola Jokic,jokicni01,79,DEN,0,MEM,15,15,5,4,0,4,30.78333333,4,11,7,11,0,0,1,2,1,4,20,20,30,35,48.5
2023-24,202404140BOS,4/14/2024,BOS vs WAS,Jared Butler,butleja02,40,WAS,0,BOS,22,2,7,1,1,4,30.85,1,1,9,19,2,4,2,2,4,2,9,29,24,31,36.9
2023-24,202404140LAC,4/14/2024,LAC vs HOU,Brandon Boston Jr.,bostobr01,32,LAC,1,HOU,15,6,3,4,0,6,30.88333333,2,4,5,16,2,6,3,4,3,4,9,18,21,24,32.7
2023-24,202404140NYK,4/14/2024,NYK vs CHI,Isaiah Hartenstein,harteis01,75,NYK,1,CHI,8,13,4,2,2,2,30.9,5,8,3,4,0,0,2,4,2,4,17,12,21,25,39.6
2023-24,202404140ORL,4/14/2024,ORL vs MIL,Bobby Portis,portibo01,82,MIL,0,ORL,17,10,1,2,2,3,31.18333333,0,10,6,9,3,4,2,2,5,4,11,18,27,28,39.5
2023-24,202404140SAS,4/14/2024,SAS vs DET,Marcus Sasser,sassema01,71,DET,0,SAS,17,3,7,0,1,3,31.21666667,1,2,6,13,2,4,3,3,1,1,10,24,20,27,31.1
2023-24,202404140OKC,4/14/2024,OKC vs DAL,Josh Green,greenjo02,57,DAL,0,OKC,4,3,3,0,0,1,31.28333333,1,2,1,8,0,4,2,2,0,0,6,7,7,10,11.1
2023-24,202404140NOP,4/14/2024,NOP vs LAL,Trey Murphy III,murphtr02,57,NOP,1,LAL,11,3,2,2,1,1,31.53333333,1,2,4,8,3,6,0,0,2,3,5,13,14,16,25.6
2023-24,202404140ORL,4/14/2024,ORL vs MIL,Khris Middleton,middlkh01,55,MIL,0,ORL,17,3,5,1,0,4,31.58333333,1,2,6,15,0,4,5,6,3,1,8,22,20,25,27.1
2023-24,202404140SAS,4/14/2024,SAS vs DET,Sidy Cissoko,cissosi01,12,SAS,1,DET,7,4,5,3,2,1,31.71666667,1,3,3,8,0,2,1,2,4,5,9,12,11,16,33.3
2023-24,202404140SAS,4/14/2024,SAS vs DET,Jared Rhoden,rhodeja01,17,DET,0,SAS,16,4,2,0,0,0,31.85,0,4,6,12,4,8,0,0,4,0,6,18,20,22,23.8
2023-24,202404140IND,4/14/2024,IND vs ATL,Trae Young,youngtr01,54,ATL,0,IND,12,3,12,0,0,8,31.91666667,1,2,4,9,1,4,3,3,1,0,15,24,15,27,25.6
2023-24,202404140CLE,4/14/2024,CLE vs CHO,Leaky Black,blackle01,26,CHO,0,CLE,11,6,5,2,1,0,32.03333333,0,6,4,4,2,2,1,1,3,3,11,16,17,22,34.7
2023-24,202404140NOP,4/14/2024,NOP vs LAL,Herbert Jones,joneshe01,76,NOP,1,LAL,18,5,1,2,0,1,32.18333333,1,4,6,13,4,7,2,2,3,2,6,19,23,24,30.5
2023-24,202404140MIN,4/14/2024,MIN vs PHO,Rudy Gobert,goberru01,76,MIN,1,PHO,21,7,1,2,1,1,32.2,3,4,7,9,0,0,7,9,3,3,8,22,28,29,38.9
2023-24,202404140PHI,4/14/2024,PHI vs BRK,Jalen Wilson,wilsoja03,43,BRK,0,PHI,9,9,1,1,2,0,32.25,2,7,4,13,1,5,0,0,3,3,10,10,18,19,30.3
2023-24,202404140MIA,4/14/2024,MIA vs TOR,Jaime Jaquez Jr.,jaqueja01,75,MIA,1,TOR,18,4,5,1,2,1,32.31666667,0,4,6,12,0,4,6,7,1,3,9,23,22,27,38.3
2023-24,202404140CLE,4/14/2024,CLE vs CHO,Nick Smith Jr.,smithni01,51,CHO,0,CLE,24,6,3,1,0,1,32.56666667,1,5,9,20,6,11,0,0,0,1,9,27,30,33,37.7
2023-24,202404140NOP,4/14/2024,NOP vs LAL,Anthony Davis,davisan02,77,LAL,0,NOP,30,11,3,2,0,3,32.58333333,4,7,13,17,0,1,4,4,4,2,14,33,41,44,50.7
2023-24,202404140ORL,4/14/2024,ORL vs MIL,Franz Wagner,wagnefr01,72,ORL,1,MIL,25,5,3,3,0,0,32.65,1,4,10,21,1,5,4,4,1,3,8,28,30,33,44.5
2023-24,202404140MIA,4/14/2024,MIA vs TOR,Ochai Agbaji,agbajoc01,78,TOR,0,MIA,10,6,2,2,1,4,32.75,4,2,4,11,0,3,2,3,3,3,8,12,16,18,25.2
2023-24,202404140MIA,4/14/2024,MIA vs TOR,Javon Freeman-Liberty,freemja01,22,TOR,0,MIA,8,1,7,0,2,3,32.75,1,0,3,6,0,2,2,2,1,2,8,15,9,16,22.7
2023-24,202404140MIN,4/14/2024,MIN vs PHO,Grayson Allen,allengr01,75,PHO,0,MIN,20,6,1,2,0,0,32.76666667,1,5,8,11,3,3,1,1,1,2,7,21,26,27,34.7
2023-24,202404140LAC,4/14/2024,LAC vs HOU,Jabari Smith Jr.,smithja05,76,HOU,0,LAC,15,8,3,0,0,0,32.86666667,2,6,6,19,2,10,1,2,1,0,11,18,23,26,29.1
2023-24,202404140BOS,4/14/2024,BOS vs WAS,Corey Kispert,kispeco01,80,WAS,0,BOS,8,3,8,1,0,0,32.93333333,0,3,3,9,0,5,2,2,0,1,11,16,11,19,26.6
2023-24,202404140BOS,4/14/2024,BOS vs WAS,Patrick Baldwin Jr.,baldwpa01,38,WAS,0,BOS,17,7,0,2,1,1,33.38333333,0,7,6,11,4,7,1,1,3,3,7,17,24,24,33.4
2023-24,202404140SAS,4/14/2024,SAS vs DET,Chimezie Metu,metuch01,51,DET,0,SAS,9,4,0,2,0,6,33.43333333,1,3,4,9,1,4,0,0,0,2,4,9,13,13,13.8
2023-24,202404140NOP,4/14/2024,NOP vs LAL,CJ McCollum,mccolcj01,66,NOP,1,LAL,25,4,7,0,0,3,33.73333333,2,2,9,19,4,9,3,4,3,0,11,32,29,36,37.3
2023-24,202404140NOP,4/14/2024,NOP vs LAL,Rui Hachimura,hachiru01,69,LAL,0,NOP,11,7,4,2,0,1,34.26666667,1,6,5,10,1,4,0,0,1,2,11,15,18,22,30.4
2023-24,202404140NOP,4/14/2024,NOP vs LAL,Zion Williamson,willizi01,70,NOP,1,LAL,12,8,8,2,0,4,34.33333333,3,5,4,13,0,1,4,5,2,2,16,20,20,28,35.6
2023-24,202404140ORL,4/14/2024,ORL vs MIL,Paolo Banchero,banchpa01,80,ORL,1,MIL,26,11,7,0,0,3,35.05,0,11,8,19,2,6,8,9,1,0,18,33,37,44,46.7
2023-24,202404140MIN,4/14/2024,MIN vs PHO,Anthony Edwards,edwaran01,79,MIN,1,PHO,13,6,4,1,1,5,35.16666667,1,5,3,7,0,2,7,8,3,2,10,17,19,23,27.2
2023-24,202404140BOS,4/14/2024,BOS vs WAS,Sam Hauser,hausesa01,79,BOS,1,WAS,16,5,2,2,1,0,35.26666667,1,4,6,20,4,11,0,0,1,3,7,18,21,23,34
2023-24,202404140MIN,4/14/2024,MIN vs PHO,Devin Booker,bookede01,68,PHO,0,MIN,23,4,7,1,0,1,35.61666667,2,2,6,16,3,8,8,10,3,1,11,30,27,34,40.3
2023-24,202404140LAC,4/14/2024,LAC vs HOU,Cam Whitmore,whitmca01,47,HOU,0,LAC,21,6,5,0,1,1,35.98333333,3,3,9,17,2,6,1,3,1,1,11,26,27,32,37.7
2023-24,202404140LAC,4/14/2024,LAC vs HOU,Amir Coffey,coffeam01,70,LAC,1,HOU,18,3,2,1,1,1,36.03333333,0,3,7,17,0,7,4,4,0,2,5,20,21,23,29.6
2023-24,202404140MEM,4/14/2024,MEM vs DEN,Jordan Goodwin,goodwjo01,57,MEM,1,DEN,8,8,3,3,0,1,36.5,2,6,3,13,0,3,2,4,1,3,11,11,16,19,30.1
2023-24,202404140BOS,4/14/2024,BOS vs WAS,Svi Mykhailiuk,mykhasv01,41,BOS,1,WAS,26,5,5,0,1,1,37.26666667,1,4,10,13,6,8,0,0,2,1,10,31,31,36,41.5
2023-24,202404140OKC,4/14/2024,OKC vs DAL,Olivier-Maxence Prosper,prospol01,40,DAL,0,OKC,15,8,1,0,0,2,37.3,3,5,5,14,2,6,3,5,2,0,9,16,23,24,24.1
2023-24,202404140SAC,4/14/2024,SAC vs POR,Justin Minaya,minayju01,34,POR,0,SAC,8,6,2,0,0,2,37.55,6,0,3,10,1,6,1,1,5,0,8,10,14,16,16.2
2023-24,202404140MIN,4/14/2024,MIN vs PHO,Kevin Durant,duranke01,75,PHO,0,MIN,15,4,1,2,1,4,37.58333333,2,2,6,14,1,3,2,2,3,3,5,16,19,20,26.3
2023-24,202404140MIN,4/14/2024,MIN vs PHO,Bradley Beal,bealbr01,53,PHO,0,MIN,36,6,5,2,1,1,37.61666667,3,3,14,21,6,6,2,2,2,3,11,41,42,47,58.7
2023-24,202404140NOP,4/14/2024,NOP vs LAL,LeBron James,jamesle01,72,LAL,0,NOP,28,11,17,5,1,4,37.68333333,2,9,11,20,0,2,6,6,0,6,28,45,39,56,80.7
2023-24,202404140PHI,4/14/2024,PHI vs BRK,Trendon Watford,watfotr01,63,BRK,0,PHI,14,8,5,1,1,3,37.75,0,8,5,13,1,2,3,4,3,2,13,19,22,27,34.1
2023-24,202404140NYK,4/14/2024,NYK vs CHI,Javonte Green,greenja02,9,CHI,0,NYK,11,8,1,2,0,1,37.78333333,4,4,5,14,1,6,0,0,4,2,9,12,19,20,27.1
2023-24,202404140NOP,4/14/2024,NOP vs LAL,D'Angelo Russell,russeda01,77,LAL,0,NOP,19,1,4,1,1,0,37.93333333,0,1,6,13,5,10,2,2,2,2,5,23,20,24,32.2
2023-24,202404140MEM,4/14/2024,MEM vs DEN,Trey Jemison,jemistr01,25,MEM,1,DEN,6,11,3,2,1,2,38.15,3,8,3,6,0,0,0,0,4,3,14,9,17,20,30.7
2023-24,202404140LAC,4/14/2024,LAC vs HOU,Kobe Brown,brownko01,44,LAC,1,HOU,9,6,4,2,2,0,38.43333333,3,3,4,10,1,3,0,0,3,4,10,13,15,19,34.2
2023-24,202404140SAC,4/14/2024,SAC vs POR,Dalano Banton,bantoda01,54,POR,0,SAC,17,3,7,3,0,5,38.95,0,3,6,26,0,15,5,6,2,3,10,24,20,27,35.1
2023-24,202404140MEM,4/14/2024,MEM vs DEN,Jake LaRavia,laravja01,35,MEM,1,DEN,29,5,4,0,0,4,39.7,2,3,11,20,4,11,3,4,3,0,9,33,34,38,37
2023-24,202404140LAC,4/14/2024,LAC vs HOU,Amen Thompson,thompam01,62,HOU,0,LAC,18,11,10,3,3,3,39.91666667,5,6,8,9,0,0,2,3,5,6,21,28,29,39,61.2
2023-24,202404140NYK,4/14/2024,NYK vs CHI,Josh Hart,hartjo01,81,NYK,1,CHI,12,10,4,1,1,3,40.13333333,3,7,6,10,0,2,0,0,5,2,14,16,22,26,33
2023-24,202404140SAS,4/14/2024,SAS vs DET,James Wiseman,wisemja01,63,DET,0,SAS,21,17,1,2,1,1,40.13333333,6,11,8,17,0,0,5,7,2,3,18,22,38,39,50.9
2023-24,202404140SAC,4/14/2024,SAC vs POR,Rayan Rupert,ruperra01,39,POR,0,SAC,11,6,5,0,0,2,40.26666667,3,3,4,12,2,7,1,2,1,0,11,16,17,22,23.7
2023-24,202404140NYK,4/14/2024,NYK vs CHI,Alex Caruso,carusal01,71,CHI,0,NYK,15,5,8,5,0,3,40.75,0,5,5,8,3,5,2,2,2,5,13,23,20,28,45
2023-24,202404140CLE,4/14/2024,CLE vs CHO,JT Thor,thorjt01,63,CHO,0,CLE,20,9,4,2,3,0,41.1,0,9,8,11,3,6,1,2,2,5,13,24,29,33,51.8
2023-24,202404140PHI,4/14/2024,PHI vs BRK,Noah Clowney,clownno01,23,BRK,0,PHI,16,4,2,1,1,1,41.13333333,1,3,5,10,2,4,4,5,3,2,6,18,20,22,28.8
2023-24,202404140NYK,4/14/2024,NYK vs CHI,Jalen Brunson,brunsja01,77,NYK,1,CHI,40,8,7,0,0,4,41.18333333,2,6,14,30,1,4,11,12,1,0,15,47,48,55,56.1
2023-24,202404140GSW,4/14/2024,GSW vs UTA,Taylor Hendricks,hendrita0,40,UTA,0,GSW,16,8,2,3,1,1,41.18333333,3,5,6,10,2,4,2,2,2,4,10,18,24,26,39.6
2023-24,202404140NYK,4/14/2024,NYK vs CHI,Nikola Vucevic,vucevni01,76,CHI,0,NYK,29,11,3,0,0,2,42.01666667,5,6,12,19,2,4,3,3,2,0,14,32,40,43,44.7
2023-24,202404140NYK,4/14/2024,NYK vs CHI,OG Anunoby,anunoog01,50,NYK,1,CHI,11,5,4,2,1,6,42.73333333,2,3,4,10,2,4,1,3,4,3,9,15,16,20,26
2023-24,202404140NYK,4/14/2024,NYK vs CHI,Coby White,whiteco01,79,CHI,0,NYK,26,2,4,2,0,2,43.25,0,2,12,18,0,3,2,2,1,2,6,30,28,32,38.4
2023-24,202404140SAC,4/14/2024,SAC vs POR,Kris Murray,murrakr01,62,POR,0,SAC,9,18,0,1,1,2,43.58333333,7,11,3,15,1,7,2,2,3,2,18,9,27,27,34.6
2023-24,202404140BOS,4/14/2024,BOS vs WAS,Payton Pritchard,pritcpa01,82,BOS,1,WAS,38,9,12,0,0,2,43.71666667,1,8,15,21,4,6,4,4,3,0,21,50,47,59,64.8
2023-24,202404140MEM,4/14/2024,MEM vs DEN,GG Jackson II,jacksgg01,48,MEM,1,DEN,44,12,1,2,1,3,44.11666667,6,6,17,36,4,13,6,7,1,3,13,45,56,57,65.9
2023-24,202404140NYK,4/14/2024,NYK vs CHI,DeMar DeRozan,derozde01,79,CHI,0,NYK,30,5,5,4,1,2,44.48333333,2,3,11,24,2,4,6,8,1,5,10,35,35,40,56.5
2023-24,202404140LAC,4/14/2024,LAC vs HOU,Xavier Moon,moonxa01,14,LAC,1,HOU,14,6,6,2,1,0,46.35,2,4,6,22,2,9,0,0,2,3,12,20,20,26,39.2
2023-24,202404140NYK,4/14/2024,NYK vs CHI,Donte DiVincenzo,divindo01,81,NYK,1,CHI,25,7,2,2,1,4,52.5,2,5,10,21,5,14,0,0,1,3,9,27,32,34,41.4
2023-24,202404120LAC,4/12/2024,LAC vs UTA,Ivica Zubac,zubaciv01,68,LAC,1,UTA,10,2,0,0,1,0,10.31666667,2,0,5,6,0,0,0,0,0,1,2,10,12,12,15.4
2023-24,202404120DAL,4/12/2024,DAL vs DET,Dante Exum,exumda01,55,DAL,1,DET,0,2,2,0,0,1,10.66666667,0,2,0,1,0,0,0,0,0,0,4,2,2,4,4.4
2023-24,202404120DAL,4/12/2024,DAL vs DET,Maxi Kleber,klebima01,43,DAL,1,DET,6,3,2,0,2,1,11.2,0,3,2,2,2,2,0,0,0,2,5,8,9,11,17.6
2023-24,202404120PHI,4/12/2024,PHI vs ORL,Markelle Fultz,fultzma01,42,ORL,0,PHI,4,2,4,1,1,0,11.3,0,2,2,4,0,0,0,0,0,2,6,8,6,10,18.4
2023-24,202404120PHI,4/12/2024,PHI vs ORL,Cole Anthony,anthoco01,80,ORL,0,PHI,7,0,0,0,0,1,11.43333333,0,0,3,7,0,1,1,1,0,0,0,7,7,7,6
2023-24,202404120NYK,4/12/2024,NYK vs BRK,Alec Burks,burksal01,66,NYK,1,BRK,5,1,4,1,0,1,11.46666667,0,1,1,4,1,2,2,2,0,1,5,9,6,10,14.2
2023-24,202404120DAL,4/12/2024,DAL vs DET,Taj Gibson,gibsota01,19,DET,0,DAL,8,5,2,0,1,0,11.5,1,4,4,6,0,0,0,0,1,1,7,10,13,15,20
2023-24,202404120SAC,4/12/2024,SAC vs PHO,Drew Eubanks,eubandr01,74,PHO,0,SAC,2,7,0,0,0,1,11.65,1,6,1,3,0,0,0,0,0,0,7,2,9,9,9.4
2023-24,202404120OKC,4/12/2024,OKC vs MIL,Andre Jackson Jr.,jacksan01,56,MIL,0,OKC,0,2,0,0,0,3,11.91666667,0,2,0,2,0,1,0,0,2,0,2,0,2,2,-0.6
2023-24,202404120NYK,4/12/2024,NYK vs BRK,Jacob Gilyard,gilyaja01,40,BRK,0,NYK,0,3,2,1,0,0,11.93333333,1,2,0,0,0,0,0,0,2,1,5,2,3,5,9.6
2023-24,202404120DAL,4/12/2024,DAL vs DET,Daniel Gafford,gaffoda01,74,DAL,1,DET,6,2,1,0,1,3,11.95,0,2,3,4,0,0,0,0,2,1,3,7,8,9,9.9
2023-24,202404120MEM,4/12/2024,MEM vs LAL,Zavier Simpson,simpsza01,6,MEM,1,LAL,2,1,2,0,0,1,11.96666667,0,1,1,4,0,1,0,0,1,0,3,4,3,5,5.2
2023-24,202404120BOS,4/12/2024,BOS vs CHO,Amari Bailey,baileam01,9,CHO,0,BOS,5,2,0,0,0,2,12,0,2,1,2,0,1,3,3,1,0,2,5,7,7,5.4
2023-24,202404120BOS,4/12/2024,BOS vs CHO,Drew Peterson,peterdr01,2,BOS,1,CHO,8,0,0,1,0,0,12,0,0,3,4,2,3,0,0,0,1,0,8,8,8,11
2023-24,202404120WAS,4/12/2024,WAS vs CHI,Eugene Omoruyi,omorueu01,42,WAS,1,CHI,7,0,0,0,1,1,12.06666667,0,0,3,6,1,2,0,0,1,1,0,7,7,7,9
2023-24,202404120LAC,4/12/2024,LAC vs UTA,Omer Yurtseven,yurtsom01,47,UTA,0,LAC,4,10,3,0,0,1,12.61666667,1,9,1,4,0,1,2,2,1,0,13,7,14,17,19.5
2023-24,202404120BOS,4/12/2024,BOS vs CHO,Xavier Tillman Sr.,tillmxa01,53,BOS,1,CHO,2,3,1,2,0,1,13.33333333,1,2,1,3,0,0,0,0,3,2,4,3,5,6,12.1
2023-24,202404120PHI,4/12/2024,PHI vs ORL,Joe Ingles,inglejo01,67,ORL,0,PHI,2,1,6,0,0,0,13.43333333,0,1,1,1,0,0,0,0,0,0,7,8,3,9,12.2
2023-24,202404120PHI,4/12/2024,PHI vs ORL,Goga Bitadze,bitadgo01,61,ORL,0,PHI,5,2,0,2,1,2,13.5,1,1,2,4,0,0,1,1,2,3,2,5,7,7,14.4
2023-24,202404120DAL,4/12/2024,DAL vs DET,Markieff Morris,morrima02,25,DAL,1,DET,2,2,0,0,1,0,13.51666667,0,2,1,6,0,4,0,0,0,1,2,2,4,4,7.4
2023-24,202404120LAC,4/12/2024,LAC vs UTA,Mason Plumlee,plumlma01,45,LAC,1,UTA,3,4,2,0,0,2,13.61666667,2,2,1,2,0,0,1,2,0,0,6,5,7,9,8.8
2023-24,202404120BOS,4/12/2024,BOS vs CHO,Brandon Miller,millebr02,74,CHO,0,BOS,9,2,0,0,0,1,13.63333333,0,2,3,8,1,4,2,2,0,0,2,9,11,11,10.4
2023-24,202404120DAL,4/12/2024,DAL vs DET,Derrick Jones Jr.,jonesde02,76,DAL,1,DET,3,1,3,0,0,2,13.93333333,0,1,1,2,0,0,1,2,1,0,4,6,4,7,6.7
2023-24,202404120OKC,4/12/2024,OKC vs MIL,Isaiah Joe,joeis01,77,OKC,1,MIL,0,2,3,0,0,1,14.03333333,1,1,0,2,0,2,0,0,2,0,5,3,2,5,5.9
2023-24,202404120OKC,4/12/2024,OKC vs MIL,Chris Livingston,livinch01,21,MIL,0,OKC,6,5,0,0,0,1,14.06666667,1,4,3,3,0,0,0,0,3,0,5,6,11,11,11
2023-24,202404120OKC,4/12/2024,OKC vs MIL,TyTy Washington Jr.,washity02,10,MIL,0,OKC,2,1,2,1,0,0,14.06666667,0,1,1,5,0,2,0,0,0,1,3,4,3,5,9.2
2023-24,202404120MEM,4/12/2024,MEM vs LAL,Jack White,whiteja03,3,MEM,1,LAL,0,4,0,2,0,1,14.16666667,1,3,0,2,0,2,0,0,2,2,4,0,4,4,9.8
2023-24,202404120PHI,4/12/2024,PHI vs ORL,Buddy Hield,hieldbu01,84,PHI,1,ORL,6,3,0,0,0,1,14.25,1,2,2,5,2,4,0,0,1,0,3,6,9,9,8.6
2023-24,202404120OKC,4/12/2024,OKC vs MIL,Kenrich Williams,willike04,68,OKC,1,MIL,5,3,1,1,0,0,14.25,0,3,2,2,1,1,0,0,1,1,4,6,8,9,13.1
2023-24,202404120CLE,4/12/2024,CLE vs IND,Ben Sheppard,sheppbe01,57,IND,0,CLE,3,3,1,0,0,2,14.38333333,0,3,1,3,1,3,0,0,1,0,4,4,6,7,6.1
2023-24,202404120POR,4/12/2024,POR vs HOU,Jabari Walker,walkeja01,72,POR,1,HOU,9,5,0,0,0,1,14.41666667,1,4,3,4,1,1,2,4,1,0,5,9,14,14,14
2023-24,202404120SAC,4/12/2024,SAC vs PHO,Trey Lyles,lylestr01,57,SAC,1,PHO,3,2,1,0,0,1,14.66666667,0,2,1,2,1,2,0,0,2,0,3,4,5,6,5.9
2023-24,202404120POR,4/12/2024,POR vs HOU,Moses Brown,brownmo01,21,POR,1,HOU,8,9,0,0,0,1,14.78333333,5,4,3,5,0,0,2,4,2,0,9,8,17,17,17.8
2023-24,202404120MIN,4/12/2024,MIN vs ATL,Jordan McLaughlin,mclaujo01,55,MIN,1,ATL,4,1,2,1,0,1,14.83333333,1,0,2,4,0,2,0,0,1,1,3,6,5,7,10.2
2023-24,202404120PHI,4/12/2024,PHI vs ORL,Paul Reed,reedpa01,81,PHI,1,ORL,6,3,1,0,1,0,14.88333333,0,3,3,3,0,0,0,1,2,1,4,7,9,10,14.1
2023-24,202404120BOS,4/12/2024,BOS vs CHO,Miles Bridges,bridgmi02,69,CHO,0,BOS,4,3,2,0,0,1,14.9,0,3,2,4,0,1,0,0,1,0,5,6,7,9,9.6
2023-24,202404120DAL,4/12/2024,DAL vs DET,P.J. Washington,washipj01,73,DAL,1,DET,9,3,1,1,0,0,14.91666667,0,3,4,8,1,3,0,0,0,1,4,10,12,13,17.1
2023-24,202404120BOS,4/12/2024,BOS vs CHO,Leaky Black,blackle01,25,CHO,0,BOS,4,3,0,1,2,1,15.1,1,2,2,6,0,2,0,0,0,3,3,4,7,7,15.6
2023-24,202404120BOS,4/12/2024,BOS vs CHO,Oshae Brissett,brissos01,54,BOS,1,CHO,8,11,1,1,0,0,15.15,6,5,3,8,0,0,2,5,1,1,12,9,19,20,25.7
2023-24,202404120MIA,4/12/2024,MIA vs TOR,Javon Freeman-Liberty,freemja01,21,TOR,0,MIA,4,1,2,0,0,2,15.18333333,0,1,1,5,0,3,2,2,1,0,3,6,5,7,6.2
2023-24,202404120SAS,4/12/2024,SAS vs DEN,Justin Holiday,holidju01,57,DEN,0,SAS,8,1,2,1,0,0,15.3,0,1,3,7,2,6,0,0,1,1,3,10,9,11,15.2
2023-24,202404120DAL,4/12/2024,DAL vs DET,Malachi Flynn,flynnma01,68,DET,0,DAL,10,0,5,4,0,0,15.51666667,0,0,5,10,0,2,0,0,1,4,5,15,10,15,29.5
2023-24,202404120MIN,4/12/2024,MIN vs ATL,Kyle Anderson,anderky01,78,MIN,1,ATL,0,0,1,1,2,2,15.58333333,0,0,0,2,0,0,0,2,3,3,1,1,0,1,8.5
2023-24,202404120LAC,4/12/2024,LAC vs UTA,Norman Powell,powelno01,76,LAC,1,UTA,4,1,1,0,0,0,15.6,0,1,2,7,0,3,0,0,0,0,2,5,5,6,6.7
2023-24,202404120DAL,4/12/2024,DAL vs DET,Tim Hardaway Jr.,hardati02,78,DAL,1,DET,8,2,2,0,0,1,15.7,0,2,3,6,1,3,1,2,0,0,4,10,10,12,12.4
2023-24,202404120CLE,4/12/2024,CLE vs IND,Obi Toppin,toppiob01,82,IND,0,CLE,10,2,6,2,1,1,15.95,1,1,4,8,0,2,2,2,1,3,8,16,12,18,29.4
2023-24,202404120OKC,4/12/2024,OKC vs MIL,Jaylin Williams,willija07,68,OKC,1,MIL,10,2,2,1,0,1,16.13333333,0,2,4,8,2,5,0,0,1,1,4,12,12,14,17.4
2023-24,202404120OKC,4/12/2024,OKC vs MIL,Pat Connaughton,connapa01,75,MIL,0,OKC,8,1,2,0,0,1,16.16666667,0,1,3,6,1,4,1,2,2,0,3,10,9,11,11.2
2023-24,202404120GSW,4/12/2024,GSW vs NOP,Jonas Valanciunas,valanjo01,81,NOP,0,GSW,10,5,1,0,0,1,16.36666667,2,3,4,9,0,1,2,3,1,0,6,11,15,16,16.5
2023-24,202404120BOS,4/12/2024,BOS vs CHO,Vasilije Micic,micicva01,59,CHO,0,BOS,5,1,3,0,0,3,16.38333333,0,1,2,5,1,2,0,0,1,0,4,8,6,9,7.7
2023-24,202404120SAS,4/12/2024,SAS vs DEN,Sidy Cissoko,cissosi01,11,SAS,1,DEN,8,3,0,0,0,0,16.58333333,2,1,4,5,0,1,0,0,5,0,3,8,11,11,11.6
2023-24,202404120POR,4/12/2024,POR vs HOU,Jeff Green,greenje02,77,HOU,0,POR,7,3,4,0,0,0,16.66666667,0,3,2,6,1,5,2,2,1,0,7,11,10,14,16.6
2023-24,202404120LAC,4/12/2024,LAC vs UTA,Xavier Moon,moonxa01,13,LAC,1,UTA,2,3,4,0,1,1,16.91666667,2,1,1,4,0,2,0,0,2,1,7,6,5,9,13.6
2023-24,202404120WAS,4/12/2024,WAS vs CHI,Anthony Gill,gillan01,49,WAS,1,CHI,4,0,1,1,0,0,16.93333333,0,0,1,4,0,1,2,2,2,1,1,5,4,5,8.5
2023-24,202404120SAC,4/12/2024,SAC vs PHO,Eric Gordon,gordoer01,68,PHO,0,SAC,2,0,3,1,1,0,17.05,0,0,1,5,0,4,0,0,0,2,3,5,2,5,12.5
2023-24,202404120WAS,4/12/2024,WAS vs CHI,Justin Champagnie,champju01,14,WAS,1,CHI,2,4,0,0,1,0,17.11666667,1,3,1,6,0,3,0,0,0,1,4,2,6,6,9.8
2023-24,202404120BOS,4/12/2024,BOS vs CHO,JD Davison,davisjd01,7,BOS,1,CHO,7,4,7,0,1,1,17.13333333,1,3,3,7,1,3,0,0,1,1,11,14,11,18,24.3
2023-24,202404120DAL,4/12/2024,DAL vs DET,Brandon Williams,willibr03,16,DAL,1,DET,4,1,0,0,0,1,17.66666667,0,1,2,8,0,2,0,0,1,0,1,4,5,5,4.2
2023-24,202404120LAC,4/12/2024,LAC vs UTA,Jason Preston,prestja01,7,UTA,0,LAC,2,6,2,0,1,0,17.76666667,2,4,1,6,0,2,0,0,1,1,8,4,8,10,15.2
2023-24,202404120BOS,4/12/2024,BOS vs CHO,Aleksej Pokusevski,pokusal01,27,CHO,0,BOS,8,5,1,0,1,0,17.8,1,4,3,10,2,5,0,0,2,1,6,9,13,14,18.5
2023-24,202404120BOS,4/12/2024,BOS vs CHO,Neemias Queta,quetane01,27,BOS,1,CHO,16,6,5,2,0,0,17.95,4,2,8,10,0,0,0,0,2,2,11,21,22,27,36.7
2023-24,202404120BOS,4/12/2024,BOS vs CHO,JT Thor,thorjt01,62,CHO,0,BOS,6,4,0,0,0,0,18,0,4,2,3,2,2,0,0,2,0,4,6,10,10,10.8
2023-24,202404120PHI,4/12/2024,PHI vs ORL,Moritz Wagner,wagnemo01,79,ORL,0,PHI,17,6,2,1,1,2,18.06666667,1,5,7,7,1,1,2,2,4,2,8,19,23,25,31.2
2023-24,202404120MIA,4/12/2024,MIA vs TOR,Kevin Love,loveke01,54,MIA,1,TOR,14,8,2,1,0,0,18.08333333,1,7,5,13,2,8,2,2,1,1,10,16,22,24,29.6
2023-24,202404120MIN,4/12/2024,MIN vs ATL,AJ Griffin,griffaj01,19,ATL,0,MIN,3,4,1,0,0,1,18.33333333,0,4,1,3,1,1,0,0,0,0,5,4,7,8,8.3
2023-24,202404120MEM,4/12/2024,MEM vs LAL,Gabe Vincent,vincega01,10,LAL,0,MEM,5,1,1,0,0,0,18.61666667,1,0,2,5,1,4,0,0,0,0,2,6,6,7,7.7
2023-24,202404120NYK,4/12/2024,NYK vs BRK,Bojan Bogdanovic,bogdabo02,56,NYK,1,BRK,9,0,1,1,0,1,18.76666667,0,0,3,11,2,4,1,2,0,1,1,10,9,10,12.5
2023-24,202404120LAC,4/12/2024,LAC vs UTA,Kobe Brown,brownko01,43,LAC,1,UTA,7,4,2,3,0,1,18.81666667,4,0,3,8,1,3,0,0,1,3,6,9,11,13,22.8
2023-24,202404120GSW,4/12/2024,GSW vs NOP,Moses Moody,moodymo01,65,GSW,1,NOP,9,3,1,0,0,0,18.85,2,1,4,7,1,2,0,0,1,0,4,10,12,13,14.1
2023-24,202404120SAS,4/12/2024,SAS vs DEN,Reggie Jackson,jacksre01,81,DEN,0,SAS,6,1,4,2,0,0,18.96666667,0,1,3,9,0,2,0,0,2,2,5,10,7,11,19.2
2023-24,202404120MIA,4/12/2024,MIA vs TOR,Delon Wright,wrighde01,46,MIA,1,TOR,7,2,5,2,0,0,19,0,2,2,4,1,3,2,2,1,2,7,12,9,14,22.9
2023-24,202404120SAS,4/12/2024,SAS vs DEN,Blake Wesley,weslebl01,60,SAS,1,DEN,2,1,4,0,0,1,19.05,0,1,1,2,0,0,0,0,2,0,5,6,3,7,8.2
2023-24,202404120SAS,4/12/2024,SAS vs DEN,Peyton Watson,watsope01,79,DEN,0,SAS,6,7,0,1,1,1,19.08333333,2,5,3,8,0,1,0,0,2,2,7,6,13,13,19.4
2023-24,202404120POR,4/12/2024,POR vs HOU,Duop Reath,reathdu01,67,POR,1,HOU,10,4,0,0,2,0,19.1,1,3,3,7,1,2,3,4,1,2,4,10,14,14,20.8
2023-24,202404120MIA,4/12/2024,MIA vs TOR,Malik Williams,willima11,6,TOR,0,MIA,0,4,0,0,0,1,19.1,2,2,0,2,0,0,0,0,3,0,4,0,4,4,3.8
2023-24,202404120OKC,4/12/2024,OKC vs MIL,Danilo Gallinari,gallida01,49,MIL,0,OKC,11,4,0,1,0,3,19.23333333,1,3,3,8,0,2,5,5,1,1,4,11,15,15,15.8
2023-24,202404120OKC,4/12/2024,OKC vs MIL,Cason Wallace,wallaca01,81,OKC,1,MIL,6,1,2,2,0,0,19.23333333,0,1,2,5,2,4,0,0,1,2,3,8,7,9,16.2
2023-24,202404120MEM,4/12/2024,MEM vs LAL,Spencer Dinwiddie,dinwisp01,75,LAL,0,MEM,3,1,1,0,0,1,19.51666667,0,1,0,1,0,1,3,3,3,0,2,4,4,5,4.7
2023-24,202404120CLE,4/12/2024,CLE vs IND,T.J. McConnell,mccontj01,71,IND,0,CLE,16,2,7,2,0,0,19.53333333,0,2,8,14,0,1,0,0,2,2,9,23,18,25,34.9
2023-24,202404120CLE,4/12/2024,CLE vs IND,Jalen Smith,smithja04,60,IND,0,CLE,11,6,0,2,0,1,19.53333333,3,3,5,8,1,2,0,0,3,2,6,11,17,17,23.2
2023-24,202404120BOS,4/12/2024,BOS vs CHO,Bryce McGowens,mcgowbr01,58,CHO,0,BOS,8,2,1,0,1,3,19.73333333,0,2,1,4,0,1,6,8,0,1,3,9,10,11,11.9
2023-24,202404120BOS,4/12/2024,BOS vs CHO,Jordan Walsh,walshjo01,8,BOS,1,CHO,8,3,0,1,0,0,19.95,1,2,3,4,2,3,0,0,3,1,3,8,11,11,14.6
2023-24,202404120SAC,4/12/2024,SAC vs PHO,Davion Mitchell,mitchda01,71,SAC,1,PHO,2,0,3,0,0,1,20.05,0,0,1,7,0,3,0,0,2,0,3,5,2,5,5.5
2023-24,202404120LAC,4/12/2024,LAC vs UTA,P.J. Tucker,tuckepj01,30,LAC,1,UTA,0,5,0,1,0,0,20.73333333,2,3,0,1,0,1,0,0,0,1,5,0,5,5,9
2023-24,202404120MIN,4/12/2024,MIN vs ATL,Mouhamed Gueye,gueyemo02,5,ATL,0,MIN,2,5,1,1,0,0,20.75,3,2,1,5,0,2,0,0,4,1,6,3,7,8,12.5
2023-24,202404120LAC,4/12/2024,LAC vs UTA,Brice Sensabaugh,sensabr01,31,UTA,0,LAC,9,3,1,1,2,0,20.95,1,2,3,8,0,4,3,3,0,3,4,10,12,13,23.1
2023-24,202404120DAL,4/12/2024,DAL vs DET,Dwight Powell,poweldw01,62,DAL,1,DET,4,10,4,0,0,1,21,5,5,2,3,0,0,0,0,3,0,14,8,14,18,21
2023-24,202404120OKC,4/12/2024,OKC vs MIL,Bobby Portis,portibo01,81,MIL,0,OKC,4,8,3,0,1,2,21.28333333,3,5,2,7,0,0,0,0,1,1,11,7,12,15,19.1
2023-24,202404120SAS,4/12/2024,SAS vs DEN,Zach Collins,colliza01,68,SAS,1,DEN,15,6,3,1,1,2,21.45,3,3,5,9,2,3,3,3,0,2,9,18,21,24,30.7
2023-24,202404120MIA,4/12/2024,MIA vs TOR,Bruce Brown,brownbr01,67,TOR,0,MIA,14,4,4,0,0,2,21.5,0,4,5,6,2,2,2,2,3,0,8,18,18,22,22.8
2023-24,202404120GSW,4/12/2024,GSW vs NOP,Trayce Jackson-Davis,jackstr02,67,GSW,1,NOP,10,11,2,1,0,1,21.71666667,3,8,5,7,0,0,0,3,2,1,13,12,21,23,28.2
2023-24,202404120DAL,4/12/2024,DAL vs DET,A.J. Lawson,lawsoaj01,41,DAL,1,DET,2,6,2,0,0,2,21.81666667,1,5,1,6,0,2,0,0,0,0,8,4,8,10,10.2
2023-24,202404120MIN,4/12/2024,MIN vs ATL,Bruno Fernando,fernabr01,44,ATL,0,MIN,14,5,2,0,0,2,22.03333333,1,4,6,9,0,0,2,5,5,0,7,16,19,21,21
2023-24,202404120WAS,4/12/2024,WAS vs CHI,Tristan Vukcevic,vukcetr01,10,WAS,1,CHI,19,1,1,1,1,3,22.25,0,1,5,11,2,7,7,9,4,2,2,20,20,21,24.7
2023-24,202404120BOS,4/12/2024,BOS vs CHO,Davis Bertans,bertada01,43,CHO,0,BOS,9,0,1,1,1,2,22.36666667,0,0,3,7,3,7,0,0,3,2,1,10,9,10,14.5
2023-24,202404120POR,4/12/2024,POR vs HOU,Deandre Ayton,aytonde01,55,POR,1,HOU,6,2,1,1,0,2,22.66666667,0,2,3,10,0,2,0,0,1,1,3,7,8,9,10.9
2023-24,202404120LAC,4/12/2024,LAC vs UTA,Johnny Juzang,juzanjo01,19,UTA,0,LAC,12,0,2,2,0,1,22.71666667,0,0,4,6,2,3,2,2,2,2,2,14,12,14,20
2023-24,202404120LAC,4/12/2024,LAC vs UTA,Taylor Hendricks,hendrita0,39,UTA,0,LAC,7,5,1,0,0,0,22.73333333,1,4,3,5,1,3,0,0,2,0,6,8,12,13,14.5
2023-24,202404120SAS,4/12/2024,SAS vs DEN,Christian Braun,braunch01,81,DEN,0,SAS,11,3,3,0,2,1,22.76666667,0,3,4,7,2,4,1,2,2,2,6,14,14,17,24.1
2023-24,202404120OKC,4/12/2024,OKC vs MIL,Khris Middleton,middlkh01,54,MIL,0,OKC,18,7,6,1,0,2,22.96666667,0,7,7,10,2,2,2,2,1,1,13,24,25,31,36.4
2023-24,202404120NYK,4/12/2024,NYK vs BRK,Jericho Sims,simsje01,45,NYK,1,BRK,2,4,1,0,1,0,22.96666667,2,2,0,1,0,0,2,2,3,1,5,3,6,7,11.3
2023-24,202404120MIN,4/12/2024,MIN vs ATL,Garrison Mathews,mathega01,65,ATL,0,MIN,0,1,0,1,0,0,23.15,0,1,0,4,0,3,0,0,3,1,1,0,1,1,4.2
2023-24,202404120LAC,4/12/2024,LAC vs UTA,Darius Bazley,bazleda01,8,UTA,0,LAC,12,5,1,2,1,2,23.2,2,3,5,7,1,2,1,1,1,3,6,13,17,18,26.5
2023-24,202404120WAS,4/12/2024,WAS vs CHI,Henri Drell,drellhe01,4,CHI,0,WAS,9,2,1,2,1,1,23.23333333,0,2,3,7,2,4,1,2,5,3,3,10,11,12,20.9
2023-24,202404120DAL,4/12/2024,DAL vs DET,Josh Green,greenjo02,56,DAL,1,DET,4,3,0,1,0,2,23.26666667,0,3,2,6,0,3,0,0,0,1,3,4,7,7,8.6
2023-24,202404120GSW,4/12/2024,GSW vs NOP,Brandin Podziemski,podzibr01,73,GSW,1,NOP,5,7,1,0,1,1,23.45,0,7,2,4,1,3,0,0,0,1,8,6,12,13,16.9
2023-24,202404120OKC,4/12/2024,OKC vs MIL,Brook Lopez,lopezbr01,78,MIL,0,OKC,18,2,1,0,1,0,23.48333333,2,0,7,14,2,7,2,2,2,1,3,19,20,21,24.9
2023-24,202404120MIN,4/12/2024,MIN vs ATL,Nickeil Alexander-Walker,alexani01,81,MIN,1,ATL,12,1,1,1,1,0,23.83333333,0,1,4,11,2,8,2,2,3,2,2,13,13,14,20.7
2023-24,202404120LAC,4/12/2024,LAC vs UTA,Brandon Boston Jr.,bostobr01,31,LAC,1,UTA,10,5,1,1,0,4,24,2,3,4,12,0,2,2,2,4,1,6,11,15,16,16.5
2023-24,202404120MEM,4/12/2024,MEM vs LAL,Taurean Prince,princta02,78,LAL,0,MEM,9,4,1,0,0,1,24.01666667,1,3,3,8,3,6,0,0,2,0,5,10,13,14,14.3
2023-24,202404120NYK,4/12/2024,NYK vs BRK,Mikal Bridges,bridgmi01,81,BRK,0,NYK,5,0,4,0,1,0,24.13333333,0,0,2,8,1,5,0,0,1,1,4,9,5,9,14
2023-24,202404120OKC,4/12/2024,OKC vs MIL,Aaron Wiggins,wiggiaa01,77,OKC,1,MIL,19,3,3,2,0,1,24.21666667,1,2,8,12,1,2,2,3,1,2,6,22,22,25,32.1
2023-24,202404120OKC,4/12/2024,OKC vs MIL,Patrick Beverley,beverpa01,72,MIL,0,OKC,6,3,7,1,0,1,24.26666667,0,3,2,5,0,0,2,2,2,1,10,13,9,16,22.1
2023-24,202404120PHI,4/12/2024,PHI vs ORL,Kyle Lowry,lowryky01,59,PHI,1,ORL,7,3,2,0,0,2,24.26666667,1,2,2,3,1,1,2,2,3,0,5,9,10,12,11.6
2023-24,202404120SAC,4/12/2024,SAC vs PHO,Royce O'Neale,onealro01,78,PHO,0,SAC,6,3,2,0,0,0,24.45,0,3,2,6,2,6,0,0,3,0,5,8,9,11,12.6
2023-24,202404120BOS,4/12/2024,BOS vs CHO,Luke Kornet,kornelu01,62,BOS,1,CHO,16,10,3,0,0,0,24.63333333,3,7,7,10,0,0,2,2,3,0,13,19,26,29,32.5
2023-24,202404120OKC,4/12/2024,OKC vs MIL,Jae Crowder,crowdja01,49,MIL,0,OKC,3,5,1,0,0,1,24.66666667,1,4,1,8,1,4,0,0,0,0,6,4,8,9,9.5
2023-24,202404120WAS,4/12/2024,WAS vs CHI,Johnny Davis,davisjo06,49,WAS,1,CHI,15,2,2,1,0,0,24.75,0,2,5,8,4,5,1,2,3,1,4,17,17,19,23.4
2023-24,202404120WAS,4/12/2024,WAS vs CHI,Onuralp Bitim,bitimon01,23,CHI,0,WAS,6,2,0,0,0,3,24.83333333,0,2,2,10,1,6,1,1,3,0,2,6,8,8,5.4
2023-24,202404120BOS,4/12/2024,BOS vs CHO,Jaden Springer,sprinja01,48,BOS,1,CHO,11,6,4,3,0,1,24.93333333,0,6,4,6,0,0,3,4,3,3,10,15,17,21,32.2
2023-24,202404120MIA,4/12/2024,MIA vs TOR,Kelly Olynyk,olynyke01,77,TOR,0,MIA,8,11,6,0,0,4,24.98333333,3,8,3,7,0,0,2,2,3,0,17,14,19,25,26.2
2023-24,202404120OKC,4/12/2024,OKC vs MIL,Chet Holmgren,holmgch01,81,OKC,1,MIL,22,9,3,1,3,2,25,3,6,9,13,1,4,3,3,2,4,12,25,31,34,47.3
2023-24,202404120NYK,4/12/2024,NYK vs BRK,Mitchell Robinson,robinmi01,30,NYK,1,BRK,15,8,0,0,2,0,25.03333333,6,2,5,6,0,0,5,8,3,2,8,15,23,23,30.6
2023-24,202404120MIN,4/12/2024,MIN vs ATL,De'Andre Hunter,huntede01,56,ATL,0,MIN,15,2,1,0,0,1,25.15,1,1,5,14,2,6,3,3,4,0,3,16,17,18,17.9
2023-24,202404120CLE,4/12/2024,CLE vs IND,Isaac Okoro,okorois01,68,CLE,1,IND,7,1,0,1,1,0,25.15,1,0,2,4,0,1,3,3,1,2,1,7,8,8,14.2
2023-24,202404120MEM,4/12/2024,MEM vs LAL,Austin Reaves,reaveau01,82,LAL,0,MEM,13,0,1,0,2,2,25.2,0,0,5,8,3,5,0,1,5,2,1,14,13,14,18.5
2023-24,202404120POR,4/12/2024,POR vs HOU,Cam Whitmore,whitmca01,46,HOU,0,POR,11,5,4,2,0,1,25.25,0,5,4,14,3,9,0,0,5,2,9,15,16,20,28
2023-24,202404120MIA,4/12/2024,MIA vs TOR,Ochai Agbaji,agbajoc01,77,TOR,0,MIA,7,1,2,1,1,0,25.28333333,0,1,3,5,1,2,0,0,1,2,3,9,8,10,17.2
2023-24,202404120MIA,4/12/2024,MIA vs TOR,Bam Adebayo,adebaba01,70,MIA,1,TOR,19,6,3,0,0,0,25.4,1,5,8,10,1,2,2,4,1,0,9,22,25,28,30.7
2023-24,202404120DAL,4/12/2024,DAL vs DET,Troy Brown Jr.,browntr01,58,DET,0,DAL,6,5,2,2,0,1,25.51666667,0,5,3,10,0,4,0,0,0,2,7,8,11,13,20
2023-24,202404120OKC,4/12/2024,OKC vs MIL,Gordon Hayward,haywago01,50,OKC,1,MIL,6,6,2,2,0,1,25.68333333,2,4,3,4,0,0,0,1,0,2,8,8,12,14,21.2
2023-24,202404120WAS,4/12/2024,WAS vs CHI,Javonte Green,greenja02,8,CHI,0,WAS,24,7,0,2,0,0,25.76666667,2,5,10,15,3,7,1,1,2,2,7,24,31,31,38.4
2023-24,202404120POR,4/12/2024,POR vs HOU,Aaron Holiday,holidaa01,77,HOU,0,POR,18,2,2,0,0,0,25.95,0,2,7,11,0,3,4,4,5,0,4,20,20,22,23.4
2023-24,202404120MIN,4/12/2024,MIN vs ATL,Clint Capela,capelca01,73,ATL,0,MIN,13,11,3,1,1,1,25.96666667,2,9,6,8,0,0,1,2,2,2,14,16,24,27,35.7
2023-24,202404120MIA,4/12/2024,MIA vs TOR,Haywood Highsmith,highsha01,65,MIA,1,TOR,9,1,1,0,1,1,25.98333333,1,0,4,5,1,2,0,1,2,1,2,10,10,11,13.7
2023-24,202404120GSW,4/12/2024,GSW vs NOP,Dyson Daniels,daniedy01,60,NOP,0,GSW,6,8,7,2,1,0,26.06666667,3,5,2,4,1,1,1,1,1,3,15,13,14,21,35.1
2023-24,202404120POR,4/12/2024,POR vs HOU,Rayan Rupert,ruperra01,38,POR,1,HOU,4,2,5,1,0,1,26.23333333,1,1,1,6,1,4,1,2,0,1,7,9,6,11,15.9
2023-24,202404120WAS,4/12/2024,WAS vs CHI,Dalen Terry,terryda01,58,CHI,0,WAS,17,4,8,1,2,3,26.5,1,3,6,8,1,2,4,8,5,3,12,25,21,29,39.8
2023-24,202404120CLE,4/12/2024,CLE vs IND,Georges Niang,niangge01,81,CLE,1,IND,9,5,0,2,0,0,26.61666667,0,5,3,10,3,8,0,0,2,2,5,9,14,14,21
2023-24,202404120CLE,4/12/2024,CLE vs IND,Caris LeVert,leverca01,68,CLE,1,IND,16,6,5,1,0,1,26.71666667,2,4,6,12,1,2,3,4,1,1,11,21,22,27,32.7
2023-24,202404120WAS,4/12/2024,WAS vs CHI,Coby White,whiteco01,78,CHI,0,WAS,20,4,4,1,0,1,26.71666667,2,2,7,16,0,2,6,7,1,1,8,24,24,28,32.8
2023-24,202404120MIA,4/12/2024,MIA vs TOR,Nikola Jovic,jovicni01,45,MIA,1,TOR,22,5,2,1,0,1,26.78333333,1,4,9,18,4,10,0,0,1,1,7,24,27,29,33
2023-24,202404120DAL,4/12/2024,DAL vs DET,Jared Rhoden,rhodeja01,16,DET,0,DAL,11,4,0,0,3,0,26.78333333,0,4,5,5,1,1,0,0,0,3,4,11,15,15,24.8
2023-24,202404120OKC,4/12/2024,OKC vs MIL,Jalen Williams,willija06,70,OKC,1,MIL,17,2,5,1,1,1,26.78333333,0,2,7,12,1,3,2,2,0,2,7,22,19,24,31.9
2023-24,202404120PHI,4/12/2024,PHI vs ORL,Jonathan Isaac,isaacjo01,57,ORL,0,PHI,5,9,1,1,1,1,26.8,2,7,2,7,0,3,1,1,3,2,10,6,14,15,22.3
2023-24,202404120LAC,4/12/2024,LAC vs UTA,Daniel Theis,theisda01,59,LAC,1,UTA,14,7,0,0,2,1,26.81666667,3,4,6,9,0,2,2,2,1,2,7,14,21,21,27.4
2023-24,202404120OKC,4/12/2024,OKC vs MIL,Luguentz Dort,dortlu01,78,OKC,1,MIL,11,1,3,3,0,0,27.08333333,0,1,3,7,3,7,2,2,3,3,4,14,12,15,25.7
2023-24,202404120MEM,4/12/2024,MEM vs LAL,Timmy Allen,allenti01,4,MEM,1,LAL,2,6,1,0,0,1,27.21666667,3,3,1,4,0,1,0,0,3,0,7,3,8,9,9.7
2023-24,202404120MIN,4/12/2024,MIN vs ATL,Anthony Edwards,edwaran01,78,MIN,1,ATL,14,4,4,2,0,3,27.26666667,0,4,4,12,0,5,6,6,4,2,8,18,18,22,27.8
2023-24,202404120MIN,4/12/2024,MIN vs ATL,Trae Young,youngtr01,53,ATL,0,MIN,19,2,7,1,0,2,27.38333333,0,2,6,12,3,7,4,6,1,1,9,26,21,28,32.9
2023-24,202404120DAL,4/12/2024,DAL vs DET,Jaden Ivey,iveyja01,76,DET,0,DAL,7,1,5,2,0,2,27.51666667,0,1,3,9,0,4,1,3,2,2,6,12,8,13,19.7
2023-24,202404120MIN,4/12/2024,MIN vs ATL,Karl-Anthony Towns,townska01,61,MIN,1,ATL,11,5,8,0,1,3,27.53333333,1,4,4,11,1,6,2,2,2,1,13,19,16,24,29
2023-24,202404120LAC,4/12/2024,LAC vs UTA,Luka Samanic,samanlu01,42,UTA,0,LAC,11,6,2,1,0,2,27.65,3,3,4,9,0,3,3,5,0,1,8,13,17,19,22.2
2023-24,202404120NYK,4/12/2024,NYK vs BRK,Noah Clowney,clownno01,22,BRK,0,NYK,9,5,2,0,0,2,27.76666667,3,2,4,7,1,4,0,0,1,0,7,11,14,16,16
2023-24,202404120GSW,4/12/2024,GSW vs NOP,Chris Paul,paulch01,57,GSW,1,NOP,9,4,6,2,0,1,27.8,0,4,4,9,1,3,0,0,2,2,10,15,13,19,27.8
2023-24,202404120MIN,4/12/2024,MIN vs ATL,Naz Reid,reidna01,80,MIN,1,ATL,19,3,2,0,1,2,27.88333333,0,3,5,10,2,5,7,8,2,1,5,21,22,24,26.6
2023-24,202404120CLE,4/12/2024,CLE vs IND,Max Strus,strusma01,69,CLE,1,IND,7,5,9,1,0,0,27.95,2,3,2,10,1,5,2,3,1,1,14,16,12,21,29.5
2023-24,202404120POR,4/12/2024,POR vs HOU,Justin Minaya,minayju01,33,POR,1,HOU,2,4,2,0,0,0,28.23333333,2,2,1,3,0,2,0,0,4,0,6,4,6,8,9.8
2023-24,202404120LAC,4/12/2024,LAC vs UTA,Keyonte George,georgke01,74,UTA,0,LAC,14,1,2,0,0,5,28.3,0,1,5,15,2,7,2,3,1,0,3,16,15,17,13.2
2023-24,202404120CLE,4/12/2024,CLE vs IND,Myles Turner,turnemy01,77,IND,0,CLE,17,6,5,0,1,2,28.46666667,0,6,6,11,1,5,4,6,0,1,11,22,23,28,32.7
2023-24,202404120DAL,4/12/2024,DAL vs DET,Jaden Hardy,hardyja02,72,DAL,1,DET,25,7,2,1,0,4,28.51666667,1,6,9,19,2,6,5,6,1,1,9,27,32,34,35.4
2023-24,202404120CLE,4/12/2024,CLE vs IND,Darius Garland,garlada01,57,CLE,1,IND,16,2,4,0,0,4,28.63333333,0,2,6,11,4,5,0,0,0,0,6,20,18,22,20.4
2023-24,202404120WAS,4/12/2024,WAS vs CHI,Jared Butler,butleja02,39,WAS,1,CHI,15,1,10,2,0,0,28.65,0,1,6,9,1,3,2,4,3,2,11,25,16,26,37.2
2023-24,202404120MIA,4/12/2024,MIA vs TOR,Gary Trent Jr.,trentga02,70,TOR,0,MIA,7,1,1,0,0,1,28.65,0,1,3,13,1,7,0,0,2,0,2,8,8,9,8.7
2023-24,202404120OKC,4/12/2024,OKC vs MIL,Shai Gilgeous-Alexander,gilgesh01,74,OKC,1,MIL,23,7,3,0,1,0,28.66666667,1,6,7,21,0,7,9,9,1,1,10,26,30,33,38.9
2023-24,202404120LAC,4/12/2024,LAC vs UTA,Talen Horton-Tucker,hortota01,51,UTA,0,LAC,12,1,4,0,0,2,28.68333333,0,1,5,12,0,5,2,2,1,0,5,16,13,17,17.2
2023-24,202404120MIN,4/12/2024,MIN vs ATL,Bogdan Bogdanovic,bogdabo01,78,ATL,0,MIN,17,2,2,0,0,1,28.7,0,2,5,10,2,4,5,5,0,0,4,19,19,21,21.4
2023-24,202404120SAS,4/12/2024,SAS vs DEN,Kentavious Caldwell-Pope,caldwke01,75,DEN,0,SAS,5,1,1,1,0,0,28.7,0,1,2,6,1,4,0,0,0,1,2,6,6,7,10.7
2023-24,202404120SAS,4/12/2024,SAS vs DEN,Aaron Gordon,gordoaa01,72,DEN,0,SAS,13,4,4,1,0,0,28.91666667,2,2,6,6,1,1,0,0,1,1,8,17,17,21,26.8
2023-24,202404120MIA,4/12/2024,MIA vs TOR,Tyler Herro,herroty01,41,MIA,1,TOR,17,3,5,0,0,2,28.91666667,0,3,4,10,3,6,6,6,3,0,8,22,20,25,26.1
2023-24,202404120BOS,4/12/2024,BOS vs CHO,Nick Smith Jr.,smithni01,50,CHO,0,BOS,15,3,2,0,0,1,29,0,3,5,12,3,6,2,2,1,0,5,17,18,20,20.6
2023-24,202404120DAL,4/12/2024,DAL vs DET,Olivier-Maxence Prosper,prospol01,39,DAL,1,DET,16,6,1,2,1,1,29.01666667,2,4,6,12,2,4,2,2,1,3,7,17,22,23,32.7
2023-24,202404120SAS,4/12/2024,SAS vs DEN,Jamal Murray,murraja01,58,DEN,0,SAS,35,5,4,1,0,1,29.03333333,0,5,14,26,5,11,2,2,1,1,9,39,40,44,49
2023-24,202404120MEM,4/12/2024,MEM vs LAL,Rui Hachimura,hachiru01,68,LAL,0,MEM,14,5,1,1,0,1,29.16666667,2,3,5,6,2,3,2,2,1,1,6,15,19,20,23.5
2023-24,202404120SAS,4/12/2024,SAS vs DEN,Michael Porter Jr.,portemi01,80,DEN,0,SAS,14,3,0,0,0,1,29.23333333,0,3,5,14,1,5,3,3,2,0,3,14,17,17,16.6
2023-24,202404120CLE,4/12/2024,CLE vs IND,Evan Mobley,mobleev01,49,CLE,1,IND,12,5,2,0,1,1,29.25,1,4,6,7,0,1,0,0,5,1,7,14,17,19,23
2023-24,202404120MIA,4/12/2024,MIA vs TOR,Jimmy Butler,butleji01,59,MIA,1,TOR,14,3,7,0,0,0,29.28333333,1,2,5,7,2,2,2,4,0,0,10,21,17,24,28.1
2023-24,202404120DAL,4/12/2024,DAL vs DET,Evan Fournier,fournev01,31,DET,0,DAL,13,4,2,0,1,1,29.4,1,3,6,14,1,6,0,0,2,1,6,15,17,19,22.8
2023-24,202404120OKC,4/12/2024,OKC vs MIL,Malik Beasley,beaslma01,78,MIL,0,OKC,17,2,2,0,0,2,29.7,0,2,7,10,3,5,0,0,1,0,4,19,19,21,20.4
2023-24,202404120MIN,4/12/2024,MIN vs ATL,Jaden McDaniels,mcdanja02,71,MIN,1,ATL,11,3,1,0,1,0,29.73333333,0,3,4,7,3,4,0,0,2,1,4,12,14,15,19.1
2023-24,202404120PHI,4/12/2024,PHI vs ORL,Kelly Oubre Jr.,oubreke01,67,PHI,1,ORL,21,9,2,0,1,1,29.75,2,7,6,14,2,7,7,9,4,1,11,23,30,32,36.8
2023-24,202404120LAC,4/12/2024,LAC vs UTA,Bones Hyland,hylanbo01,37,LAC,1,UTA,20,5,6,3,1,1,29.78333333,0,5,7,17,3,11,3,4,2,4,11,26,25,31,46
2023-24,202404120MIA,4/12/2024,MIA vs TOR,Caleb Martin,martica02,63,MIA,1,TOR,3,4,3,1,0,0,29.98333333,1,3,1,3,1,3,0,0,1,1,7,6,7,10,15.3
2023-24,202404120MEM,4/12/2024,MEM vs LAL,Scotty Pippen Jr.,pippesc02,20,MEM,1,LAL,28,5,6,4,0,4,30.15,1,4,12,22,3,7,1,2,4,4,11,34,33,39,51
2023-24,202404120BOS,4/12/2024,BOS vs CHO,Marques Bolden,boldema01,10,CHO,0,BOS,6,5,2,1,2,1,30.2,2,3,2,5,0,0,2,2,3,3,7,8,11,13,23
2023-24,202404120BOS,4/12/2024,BOS vs CHO,Sam Hauser,hausesa01,78,BOS,1,CHO,16,4,2,0,0,0,30.2,0,4,6,17,4,13,0,0,0,0,6,18,20,22,23.8
2023-24,202404120MIA,4/12/2024,MIA vs TOR,Immanuel Quickley,quickim01,68,TOR,0,MIA,15,4,5,0,0,3,30.26666667,0,4,4,11,3,7,4,4,4,0,9,20,19,24,24.3
2023-24,202404120PHI,4/12/2024,PHI vs ORL,Nicolas Batum,batumni01,59,PHI,1,ORL,5,4,1,2,0,0,30.38333333,1,3,2,6,1,3,0,0,2,2,5,6,9,10,17.3
2023-24,202404120SAS,4/12/2024,SAS vs DEN,Sandro Mamukelashvili,mamuksa01,45,SAS,1,DEN,21,12,2,0,1,2,30.38333333,2,10,8,14,3,5,2,4,3,1,14,23,33,35,39.4
2023-24,202404120MIN,4/12/2024,MIN vs ATL,Mike Conley,conlemi01,75,MIN,1,ATL,13,6,10,2,0,2,30.68333333,1,5,5,11,2,6,1,1,3,2,16,23,19,29,39.2
2023-24,202404120MIA,4/12/2024,MIA vs TOR,Gradey Dick,dickgr01,59,TOR,0,MIA,8,1,0,0,0,0,30.75,0,1,3,7,2,5,0,0,0,0,1,8,9,9,9.2
2023-24,202404120BOS,4/12/2024,BOS vs CHO,Payton Pritchard,pritcpa01,81,BOS,1,CHO,31,3,11,1,0,2,30.86666667,0,3,14,22,3,8,0,0,2,1,14,42,34,45,52.1
2023-24,202404120BOS,4/12/2024,BOS vs CHO,Tre Mann,manntr01,40,CHO,0,BOS,19,3,8,0,0,4,30.88333333,0,3,6,10,3,4,4,5,1,0,11,27,22,30,30.6
2023-24,202404120LAC,4/12/2024,LAC vs UTA,Amir Coffey,coffeam01,69,LAC,1,UTA,16,6,1,0,1,0,30.93333333,1,5,6,15,3,9,1,2,4,1,7,17,22,23,27.7
2023-24,202404120MIN,4/12/2024,MIN vs ATL,Dejounte Murray,murrade01,77,ATL,0,MIN,12,5,4,0,0,3,31.01666667,1,4,5,14,0,3,2,4,3,0,9,16,17,21,21
2023-24,202404120POR,4/12/2024,POR vs HOU,Dillon Brooks,brookdi01,72,HOU,0,POR,9,5,0,0,1,1,31.06666667,2,3,4,10,1,5,0,0,5,1,5,9,14,14,17
2023-24,202404120SAS,4/12/2024,SAS vs DEN,Devonte Graham,grahade01,22,SAS,1,DEN,11,4,5,0,0,2,31.56666667,2,2,4,11,2,7,1,2,0,0,9,16,15,20,21.3
2023-24,202404120SAC,4/12/2024,SAC vs PHO,Jusuf Nurkic,nurkiju01,75,PHO,0,SAC,10,10,3,1,2,4,31.71666667,1,9,3,5,0,0,4,5,2,3,13,13,20,23,31.5
2023-24,202404120PHI,4/12/2024,PHI vs ORL,Joel Embiid,embiijo01,39,PHI,1,ORL,32,13,7,0,1,4,32.01666667,0,13,10,23,4,7,8,9,2,1,20,39,45,52,57.1
2023-24,202404120CLE,4/12/2024,CLE vs IND,Pascal Siakam,siakapa01,79,IND,0,CLE,19,6,1,0,0,0,32.05,1,5,7,15,2,3,3,4,4,0,7,20,25,26,27.7
2023-24,202404120POR,4/12/2024,POR vs HOU,Jock Landale,landajo01,55,HOU,0,POR,20,4,3,1,2,0,32.13333333,0,4,8,13,0,3,4,4,2,3,7,23,24,27,38.3
2023-24,202404120POR,4/12/2024,POR vs HOU,Jabari Smith Jr.,smithja05,75,HOU,0,POR,8,5,4,0,2,1,32.13333333,2,3,3,5,1,2,1,3,1,2,9,12,13,17,25
2023-24,202404120MIA,4/12/2024,MIA vs TOR,Jaime Jaquez Jr.,jaqueja01,74,MIA,1,TOR,20,4,9,2,1,0,32.28333333,0,4,7,15,2,4,4,4,5,3,13,29,24,33,47.3
2023-24,202404120PHI,4/12/2024,PHI vs ORL,Gary Harris,harriga01,53,ORL,0,PHI,3,0,0,1,1,1,32.33333333,0,0,1,8,1,5,0,0,1,2,0,3,3,3,8
2023-24,202404120GSW,4/12/2024,GSW vs NOP,Stephen Curry,curryst01,74,GSW,1,NOP,33,4,5,1,0,7,32.38333333,0,4,12,23,7,13,2,2,2,1,9,38,37,42,41.3
2023-24,202404120DAL,4/12/2024,DAL vs DET,Marcus Sasser,sassema01,70,DET,0,DAL,24,3,3,1,0,2,32.48333333,0,3,9,20,2,9,4,4,1,1,6,27,27,30,33.1
2023-24,202404120NYK,4/12/2024,NYK vs BRK,Jalen Wilson,wilsoja03,42,BRK,0,NYK,11,7,0,1,0,0,32.53333333,3,4,4,10,1,4,2,2,2,1,7,11,18,18,22.4
2023-24,202404120MIA,4/12/2024,MIA vs TOR,RJ Barrett,barrerj01,58,TOR,0,MIA,35,11,3,0,0,3,32.6,1,10,13,18,1,4,8,10,3,0,14,38,46,49,49.7
2023-24,202404120SAC,4/12/2024,SAC vs PHO,Keon Ellis,elliske01,56,SAC,1,PHO,17,3,1,2,0,0,32.75,1,2,7,11,2,6,1,1,3,2,4,18,20,21,28.1
2023-24,202404120NYK,4/12/2024,NYK vs BRK,Lonnie Walker IV,walkelo01,57,BRK,0,NYK,15,4,2,1,1,0,33.16666667,2,2,6,13,3,8,0,0,3,2,6,17,19,21,28.8
2023-24,202404120CLE,4/12/2024,CLE vs IND,Aaron Nesmith,nesmiaa01,72,IND,0,CLE,15,6,0,0,0,0,33.25,1,5,5,8,0,2,5,5,2,0,6,15,21,21,22.2
2023-24,202404120PHI,4/12/2024,PHI vs ORL,Jalen Suggs,suggsja01,74,ORL,0,PHI,20,4,2,0,0,1,33.46666667,1,3,7,12,3,6,3,6,3,0,6,22,24,26,26.8
2023-24,202404120NYK,4/12/2024,NYK vs BRK,OG Anunoby,anunoog01,49,NYK,1,BRK,15,1,0,2,0,0,33.51666667,0,1,6,13,3,5,0,0,3,2,1,15,16,16,22.2
2023-24,202404120POR,4/12/2024,POR vs HOU,Scoot Henderson,hendesc01,62,POR,1,HOU,30,5,7,1,1,1,33.6,2,3,10,23,6,7,4,5,3,2,12,37,35,42,51.5
2023-24,202404120GSW,4/12/2024,GSW vs NOP,Andrew Wiggins,wiggian01,70,GSW,1,NOP,18,4,0,0,0,2,33.76666667,1,3,5,14,0,4,8,10,2,0,4,18,22,22,20.8
2023-24,202404120BOS,4/12/2024,BOS vs CHO,Svi Mykhailiuk,mykhasv01,40,BOS,1,CHO,8,3,0,1,0,1,33.85,0,3,2,13,2,11,2,2,2,1,3,8,11,11,13.6
2023-24,202404120SAC,4/12/2024,SAC vs PHO,Bradley Beal,bealbr01,52,PHO,0,SAC,20,9,4,2,1,3,33.9,2,7,9,13,1,3,1,1,3,3,13,24,29,33,42.8
2023-24,202404120WAS,4/12/2024,WAS vs CHI,Torrey Craig,craigto01,52,CHI,0,WAS,11,15,3,1,1,2,33.96666667,0,15,4,7,3,4,0,0,3,2,18,14,26,29,37.5
2023-24,202404120MEM,4/12/2024,MEM vs LAL,D'Angelo Russell,russeda01,76,LAL,0,MEM,4,3,10,1,1,2,34.58333333,0,3,2,9,0,5,0,0,3,2,13,14,7,17,26.6
2023-24,202404120DAL,4/12/2024,DAL vs DET,Chimezie Metu,metuch01,50,DET,0,DAL,18,8,2,2,0,0,34.78333333,1,7,6,11,4,5,2,2,1,2,10,20,26,28,36.6
2023-24,202404120CLE,4/12/2024,CLE vs IND,Andrew Nembhard,nembhan01,67,IND,0,CLE,10,2,5,0,0,2,34.88333333,1,1,3,8,0,3,4,4,2,0,7,15,12,17,17.9
2023-24,202404120POR,4/12/2024,POR vs HOU,Jalen Green,greenja05,81,HOU,0,POR,26,9,1,0,0,3,34.93333333,0,9,10,20,5,10,1,1,0,0,10,27,35,36,35.3
2023-24,202404120WAS,4/12/2024,WAS vs CHI,Adama Sanogo,sanogad01,9,CHI,0,WAS,22,20,0,1,0,2,35.08333333,10,10,8,18,0,0,6,9,5,1,20,22,42,42,47
2023-24,202404120POR,4/12/2024,POR vs HOU,Amen Thompson,thompam01,61,HOU,0,POR,17,15,6,0,0,2,35.26666667,6,9,6,12,0,1,5,6,1,0,21,23,32,38,42
2023-24,202404120GSW,4/12/2024,GSW vs NOP,Jose Alvarado,alvarjo01,55,NOP,0,GSW,4,3,2,1,0,0,35.3,0,3,1,5,1,5,1,2,3,1,5,6,7,9,13.6
2023-24,202404120PHI,4/12/2024,PHI vs ORL,Franz Wagner,wagnefr01,71,ORL,0,PHI,24,6,3,1,1,1,35.31666667,1,5,9,18,1,4,5,5,4,2,9,27,30,33,40.7
2023-24,202404120LAC,4/12/2024,LAC vs UTA,Kenneth Lofton Jr.,loftoke01,20,UTA,0,LAC,27,9,8,1,0,3,35.38333333,4,5,10,16,0,5,7,7,5,1,17,35,36,44,49.8
2023-24,202404120MEM,4/12/2024,MEM vs LAL,Trey Jemison,jemistr01,24,MEM,1,LAL,6,5,0,0,1,1,35.41666667,2,3,3,4,0,0,0,0,6,1,5,6,11,11,14
2023-24,202404120CLE,4/12/2024,CLE vs IND,Tyrese Haliburton,halibty01,69,IND,0,CLE,19,6,12,1,0,5,35.48333333,0,6,7,13,4,10,1,1,1,1,18,31,25,37,42.2
2023-24,202404120NYK,4/12/2024,NYK vs BRK,Nic Claxton,claxtni01,70,BRK,0,NYK,9,12,3,0,2,1,35.7,5,7,4,8,0,0,1,4,3,2,15,12,21,24,32.9
2023-24,202404120GSW,4/12/2024,GSW vs NOP,Draymond Green,greendr01,55,GSW,1,NOP,0,12,11,1,1,2,35.95,1,11,0,0,0,0,0,0,5,2,23,11,12,23,34.9
2023-24,202404120DAL,4/12/2024,DAL vs DET,James Wiseman,wisemja01,62,DET,0,DAL,10,10,2,0,2,0,36.5,3,7,5,10,0,0,0,0,2,2,12,12,20,22,31
2023-24,202404120NYK,4/12/2024,NYK vs BRK,Jalen Brunson,brunsja01,76,NYK,1,BRK,30,1,11,1,0,0,36.53333333,0,1,10,25,3,7,7,7,2,1,12,41,31,42,50.7
2023-24,202404120GSW,4/12/2024,GSW vs NOP,Zion Williamson,willizi01,69,NOP,0,GSW,26,3,3,6,1,2,36.56666667,0,3,11,26,1,2,3,6,2,7,6,29,29,32,53.1
2023-24,202404120NYK,4/12/2024,NYK vs BRK,Cam Thomas,thomaca02,65,BRK,0,NYK,41,1,6,0,0,4,36.7,0,1,15,26,4,9,7,7,4,0,7,47,42,48,47.2
2023-24,202404120MIN,4/12/2024,MIN vs ATL,Rudy Gobert,goberru01,75,MIN,1,ATL,25,19,0,1,5,1,36.71666667,4,15,10,10,0,0,5,8,2,6,19,25,44,44,64.8
2023-24,202404120SAS,4/12/2024,SAS vs DEN,Victor Wembanyama,wembavi01,71,SAS,1,DEN,34,12,5,1,2,7,36.81666667,1,11,12,27,5,12,5,7,1,3,17,39,46,51,57.9
2023-24,202404120WAS,4/12/2024,WAS vs CHI,Jevon Carter,carteje01,71,CHI,0,WAS,20,2,12,1,1,1,36.85,2,0,8,15,4,8,0,0,1,2,14,32,22,34,45.4
2023-24,202404120SAS,4/12/2024,SAS vs DEN,Julian Champagnie,champju02,73,SAS,1,DEN,14,5,2,0,0,1,37.2,1,4,4,5,2,3,4,4,0,0,7,16,19,21,22
2023-24,202404120MEM,4/12/2024,MEM vs LAL,Jordan Goodwin,goodwjo01,56,MEM,1,LAL,23,17,3,4,0,2,37.5,8,9,7,23,4,9,5,6,4,4,20,26,40,43,57.9
2023-24,202404120CLE,4/12/2024,CLE vs IND,Donovan Mitchell,mitchdo01,55,CLE,1,IND,33,4,5,4,0,1,37.55,2,2,12,27,4,10,5,5,2,4,9,38,37,42,56.3
2023-24,202404120WAS,4/12/2024,WAS vs CHI,Deni Avdija,avdijde01,74,WAS,1,CHI,24,12,8,0,0,4,37.61666667,0,12,9,15,1,4,5,8,3,0,20,32,36,44,46.4
2023-24,202404120GSW,4/12/2024,GSW vs NOP,CJ McCollum,mccolcj01,65,NOP,0,GSW,28,5,5,0,2,3,37.83333333,0,5,10,21,8,13,0,0,3,2,10,33,33,38,44.5
2023-24,202404120PHI,4/12/2024,PHI vs ORL,Tobias Harris,harrito02,69,PHI,1,ORL,14,6,3,2,2,1,37.9,2,4,5,10,1,2,3,3,2,4,9,17,20,23,36.7
2023-24,202404120GSW,4/12/2024,GSW vs NOP,Klay Thompson,thompkl01,76,GSW,1,NOP,19,6,1,1,2,2,38,2,4,6,19,3,9,4,4,1,3,7,20,25,26,34.7
2023-24,202404120SAC,4/12/2024,SAC vs PHO,Grayson Allen,allengr01,74,PHO,0,SAC,19,3,4,0,0,3,38.03333333,0,3,6,12,4,8,3,3,1,0,7,23,22,26,25.6
2023-24,202404120NYK,4/12/2024,NYK vs BRK,Trendon Watford,watfotr01,62,BRK,0,NYK,17,13,3,0,0,5,38.06666667,2,11,6,10,1,2,4,6,3,0,16,20,30,33,32.1
2023-24,202404120CLE,4/12/2024,CLE vs IND,Jarrett Allen,allenja01,76,CLE,1,IND,29,13,3,0,0,2,38.1,3,10,13,14,0,0,3,8,2,0,16,32,42,45,47.1
2023-24,202404120GSW,4/12/2024,GSW vs NOP,Herbert Jones,joneshe01,75,NOP,0,GSW,13,5,4,1,1,1,38.36666667,0,5,5,10,2,5,1,2,3,2,9,17,18,22,30
2023-24,202404120POR,4/12/2024,POR vs HOU,Dalano Banton,bantoda01,53,POR,1,HOU,28,10,3,1,2,1,38.4,0,10,9,26,2,10,8,9,1,3,13,31,38,41,52.5
2023-24,202404120SAS,4/12/2024,SAS vs DEN,Nikola Jokic,jokicni01,78,DEN,0,SAS,22,7,12,2,1,3,38.55,2,5,9,13,1,2,3,3,5,3,19,34,29,41,54.4
2023-24,202404120SAS,4/12/2024,SAS vs DEN,Tre Jones,jonestr01,76,SAS,1,DEN,14,6,10,0,0,3,38.55,0,6,6,11,1,2,1,3,1,0,16,24,20,30,33.2
2023-24,202404120PHI,4/12/2024,PHI vs ORL,Tyrese Maxey,maxeyty01,69,PHI,1,ORL,28,2,3,0,1,1,39.78333333,1,1,10,19,5,10,3,4,2,1,5,31,30,33,36.9
2023-24,202404120WAS,4/12/2024,WAS vs CHI,Corey Kispert,kispeco01,79,WAS,1,CHI,23,7,6,0,1,3,39.96666667,2,5,8,15,6,11,1,2,4,1,13,29,30,36,40.4
2023-24,202404120MEM,4/12/2024,MEM vs LAL,GG Jackson II,jacksgg01,47,MEM,1,LAL,31,1,1,3,0,2,40.33333333,0,1,12,23,7,13,0,2,4,3,2,32,32,33,40.7
2023-24,202404120NYK,4/12/2024,NYK vs BRK,Josh Hart,hartjo01,80,NYK,1,BRK,16,7,1,3,0,2,40.43333333,0,7,6,9,2,3,2,2,4,3,8,17,23,24,32.9
2023-24,202404120PHI,4/12/2024,PHI vs ORL,Paolo Banchero,banchpa01,79,ORL,0,PHI,22,15,7,0,1,2,40.51666667,4,11,7,24,2,6,6,9,2,1,22,29,37,44,51.5
2023-24,202404120WAS,4/12/2024,WAS vs CHI,Patrick Baldwin Jr.,baldwpa01,37,WAS,1,CHI,18,12,4,1,1,1,40.65,1,11,7,12,3,7,1,2,2,2,16,22,30,34,43.4
2023-24,202404120MEM,4/12/2024,MEM vs LAL,LeBron James,jamesle01,71,LAL,0,MEM,37,9,5,2,0,8,40.9,2,7,13,20,3,7,8,11,1,2,14,42,46,51,53.3
2023-24,202404120SAC,4/12/2024,SAC vs PHO,De'Aaron Fox,foxde01,73,SAC,1,PHO,23,5,6,4,0,2,41,0,5,9,23,3,8,2,2,4,4,11,29,28,34,48
2023-24,202404120SAC,4/12/2024,SAC vs PHO,Devin Booker,bookede01,67,PHO,0,SAC,21,4,6,0,0,4,41.25,1,3,7,12,2,4,5,5,5,0,10,27,25,31,30.8
2023-24,202404120SAC,4/12/2024,SAC vs PHO,Harrison Barnes,barneha02,81,SAC,1,PHO,12,6,3,1,1,0,41.38333333,2,4,3,10,1,4,5,5,0,2,9,15,18,21,29.7
2023-24,202404120SAC,4/12/2024,SAC vs PHO,Kevin Durant,duranke01,74,PHO,0,SAC,28,5,3,0,0,3,41.88333333,1,4,11,20,3,7,3,3,2,0,8,31,33,36,35.5
2023-24,202404120GSW,4/12/2024,GSW vs NOP,Trey Murphy III,murphtr02,56,NOP,0,GSW,24,8,2,1,0,1,42.23333333,0,8,8,12,6,9,2,2,0,1,10,26,32,34,38.6
2023-24,202404120SAC,4/12/2024,SAC vs PHO,Domantas Sabonis,sabondo01,81,SAC,1,PHO,25,12,9,2,0,2,42.38333333,4,8,9,18,2,3,5,6,5,2,21,34,37,46,56.9
2023-24,202404120POR,4/12/2024,POR vs HOU,Kris Murray,murrakr01,61,POR,1,HOU,10,7,2,0,0,0,42.56666667,4,3,4,11,1,7,1,1,1,0,9,12,17,19,21.4
2023-24,202404120SAC,4/12/2024,SAC vs PHO,Keegan Murray,murrake02,76,SAC,1,PHO,23,7,0,3,0,0,42.66666667,2,5,9,19,5,12,0,0,1,3,7,23,30,30,40.4
2023-24,202404120MEM,4/12/2024,MEM vs LAL,Anthony Davis,davisan02,76,LAL,0,MEM,36,14,5,1,2,4,42.81666667,4,10,11,22,1,6,13,17,2,3,19,41,50,55,65.3
2023-24,202404120MEM,4/12/2024,MEM vs LAL,Jake LaRavia,laravja01,34,MEM,1,LAL,28,3,6,1,1,1,43.25,1,2,7,13,3,6,11,11,3,2,9,34,31,37,45.6
2023-24,202404120NYK,4/12/2024,NYK vs BRK,Donte DiVincenzo,divindo01,80,NYK,1,BRK,14,6,3,2,0,1,43.71666667,0,6,5,12,2,8,2,2,0,2,9,17,20,23,30.7
2023-24,202404110DET,4/11/2024,DET vs CHI,Torrey Craig,craigto01,51,CHI,0,DET,3,2,1,1,0,0,10,2,0,1,2,0,0,1,1,0,1,3,4,5,6,9.9
2023-24,202404110DET,4/11/2024,DET vs CHI,Adama Sanogo,sanogad01,8,CHI,0,DET,4,6,0,0,0,1,10.68333333,6,0,2,5,0,0,0,0,0,0,6,4,10,10,10.2
2023-24,202404110SAC,4/11/2024,SAC vs NOP,Sasha Vezenkov,vezenal01,41,SAC,1,NOP,5,2,0,0,0,0,10.91666667,0,2,2,5,1,4,0,0,1,0,2,5,7,7,7.4
2023-24,202404110UTA,4/11/2024,UTA vs HOU,Aaron Holiday,holidaa01,76,HOU,0,UTA,6,2,1,0,0,0,11.31666667,2,0,2,5,2,5,0,0,0,0,3,7,8,9,9.9
2023-24,202404110SAC,4/11/2024,SAC vs NOP,Alex Len,lenal01,46,SAC,1,NOP,2,1,1,0,0,1,11.38333333,0,1,1,1,0,0,0,0,3,0,2,3,3,4,3.7
2023-24,202404110BOS,4/11/2024,BOS vs NYK,Svi Mykhailiuk,mykhasv01,39,BOS,1,NYK,9,2,2,0,0,0,12.78333333,1,1,3,5,3,4,0,0,0,0,4,11,11,13,14.4
2023-24,202404110BOS,4/11/2024,BOS vs NYK,Jaden Springer,sprinja01,47,BOS,1,NYK,3,1,0,2,0,1,12.78333333,0,1,1,2,1,2,0,0,1,2,1,3,4,4,9.2
2023-24,202404110POR,4/11/2024,POR vs GSW,Ashton Hagans,haganas01,19,POR,1,GSW,5,2,4,1,0,1,13.55,1,1,2,4,1,3,0,0,1,1,6,9,7,11,15.4
2023-24,202404110POR,4/11/2024,POR vs GSW,Duop Reath,reathdu01,66,POR,1,GSW,8,5,0,0,1,0,14.21666667,3,2,2,10,1,4,3,3,0,1,5,8,13,13,17
2023-24,202404110SAC,4/11/2024,SAC vs NOP,Trey Lyles,lylestr01,56,SAC,1,NOP,6,1,2,0,0,0,14.66666667,0,1,2,4,2,4,0,0,0,0,3,8,7,9,10.2
2023-24,202404110BOS,4/11/2024,BOS vs NYK,Mitchell Robinson,robinmi01,29,NYK,0,BOS,5,4,0,1,0,0,14.78333333,4,0,2,3,0,0,1,1,1,1,4,5,9,9,12.8
2023-24,202404110DET,4/11/2024,DET vs CHI,Malachi Flynn,flynnma01,67,DET,1,CHI,12,2,1,0,0,3,15.3,1,1,4,8,1,2,3,5,0,0,3,13,14,15,12.9
2023-24,202404110BOS,4/11/2024,BOS vs NYK,Al Horford,horfoal01,65,BOS,1,NYK,6,2,1,1,2,1,15.53333333,0,2,2,3,2,3,0,0,2,3,3,7,8,9,17.9
2023-24,202404110BOS,4/11/2024,BOS vs NYK,Precious Achiuwa,achiupr01,72,NYK,0,BOS,2,5,0,0,1,1,16.03333333,2,3,1,6,0,1,0,0,0,1,5,2,7,7,10
2023-24,202404110DET,4/11/2024,DET vs CHI,Dalen Terry,terryda01,57,CHI,0,DET,12,2,0,1,0,0,17.01666667,0,2,5,9,2,4,0,0,2,1,2,12,14,14,17.4
2023-24,202404110DET,4/11/2024,DET vs CHI,James Wiseman,wisemja01,61,DET,1,CHI,2,6,2,0,0,0,17.2,2,4,1,2,0,0,0,2,0,0,8,4,8,10,12.2
2023-24,202404110DET,4/11/2024,DET vs CHI,Jared Rhoden,rhodeja01,15,DET,1,CHI,8,4,1,0,1,1,17.85,1,3,3,6,2,4,0,0,1,1,5,9,12,13,16.3
2023-24,202404110UTA,4/11/2024,UTA vs HOU,Jalen Green,greenja05,80,HOU,0,UTA,3,1,1,0,0,3,18.7,0,1,1,7,1,5,0,0,2,0,2,4,4,5,2.7
2023-24,202404110UTA,4/11/2024,UTA vs HOU,Taylor Hendricks,hendrita0,38,UTA,1,HOU,5,4,4,3,1,0,18.9,1,3,2,3,1,2,0,0,1,4,8,9,9,13,27.8
2023-24,202404110UTA,4/11/2024,UTA vs HOU,Omer Yurtseven,yurtsom01,46,UTA,1,HOU,10,5,0,0,0,0,19.1,2,3,5,9,0,1,0,0,0,0,5,10,15,15,16
2023-24,202404110BOS,4/11/2024,BOS vs NYK,Payton Pritchard,pritcpa01,80,BOS,1,NYK,16,4,6,0,0,0,20.83333333,2,2,7,13,2,4,0,0,0,0,10,22,20,26,29.8
2023-24,202404110POR,4/11/2024,POR vs GSW,Kevon Looney,looneke01,72,GSW,0,POR,9,11,0,2,4,2,20.95,4,7,4,6,0,0,1,2,2,6,11,9,20,20,38.2
2023-24,202404110DET,4/11/2024,DET vs CHI,Jevon Carter,carteje01,70,CHI,0,DET,5,1,1,3,1,0,21.36666667,0,1,2,6,1,5,0,0,0,4,2,6,6,7,19.7
2023-24,202404110POR,4/11/2024,POR vs GSW,Moses Moody,moodymo01,64,GSW,0,POR,8,2,1,0,0,2,21.36666667,0,2,2,3,1,1,3,6,3,0,3,9,10,11,9.9
2023-24,202404110BOS,4/11/2024,BOS vs NYK,Miles McBride,mcbrimi01,67,NYK,0,BOS,2,0,4,1,0,1,21.68333333,0,0,1,6,0,4,0,0,1,1,4,6,2,6,10
2023-24,202404110SAC,4/11/2024,SAC vs NOP,Jose Alvarado,alvarjo01,54,NOP,0,SAC,14,6,6,0,0,0,22.01666667,1,5,5,8,4,6,0,0,4,0,12,20,20,26,30.2
2023-24,202404110UTA,4/11/2024,UTA vs HOU,Jeff Green,greenje02,76,HOU,0,UTA,13,6,0,0,0,0,22.06666667,1,5,4,7,3,5,2,2,1,0,6,13,19,19,20.2
2023-24,202404110BOS,4/11/2024,BOS vs NYK,Sam Hauser,hausesa01,77,BOS,1,NYK,15,4,3,0,1,0,22.06666667,1,3,5,8,3,5,2,2,0,1,7,18,19,22,27.3
2023-24,202404110UTA,4/11/2024,UTA vs HOU,Darius Bazley,bazleda01,7,UTA,1,HOU,8,7,2,0,2,1,23.05,2,5,4,5,0,1,0,0,0,2,9,10,15,17,24.4
2023-24,202404110SAC,4/11/2024,SAC vs NOP,Keon Ellis,elliske01,55,SAC,1,NOP,5,1,0,0,0,0,23.31666667,0,1,2,5,1,3,0,0,1,0,1,5,6,6,6.2
2023-24,202404110UTA,4/11/2024,UTA vs HOU,Johnny Juzang,juzanjo01,18,UTA,1,HOU,10,2,1,0,1,3,23.88333333,0,2,3,5,2,3,2,2,3,1,3,11,12,13,13.9
2023-24,202404110UTA,4/11/2024,UTA vs HOU,Brice Sensabaugh,sensabr01,30,UTA,1,HOU,17,6,3,0,0,0,24.11666667,1,5,5,12,4,9,3,3,2,0,9,20,23,26,28.7
2023-24,202404110BOS,4/11/2024,BOS vs NYK,Bojan Bogdanovic,bogdabo02,55,NYK,0,BOS,14,3,0,1,0,1,25.15,1,2,6,10,2,6,0,0,0,1,3,14,17,17,19.6
2023-24,202404110BOS,4/11/2024,BOS vs NYK,Kristaps Porzingis,porzikr01,57,BOS,1,NYK,14,8,1,0,2,1,25.31666667,2,6,5,12,2,5,2,2,2,2,9,15,22,23,30.1
2023-24,202404110SAC,4/11/2024,SAC vs NOP,Dyson Daniels,daniedy01,59,NOP,0,SAC,10,4,1,1,1,1,25.45,0,4,4,8,2,5,0,0,2,2,5,11,14,15,21.3
2023-24,202404110DET,4/11/2024,DET vs CHI,Evan Fournier,fournev01,30,DET,1,CHI,5,1,3,0,0,2,25.6,0,1,2,7,0,4,1,2,3,0,4,8,6,9,8.7
2023-24,202404110UTA,4/11/2024,UTA vs HOU,Jabari Smith Jr.,smithja05,74,HOU,0,UTA,7,3,2,0,2,0,25.75,0,3,3,6,1,4,0,0,1,2,5,9,10,12,19.6
2023-24,202404110BOS,4/11/2024,BOS vs NYK,OG Anunoby,anunoog01,48,NYK,0,BOS,12,5,1,1,1,1,25.96666667,1,4,5,10,2,3,0,0,1,2,6,13,17,18,24.5
2023-24,202404110UTA,4/11/2024,UTA vs HOU,Cam Whitmore,whitmca01,45,HOU,0,UTA,18,4,4,0,2,2,26.83333333,0,4,5,11,4,8,4,4,2,2,8,22,22,26,32.8
2023-24,202404110POR,4/11/2024,POR vs GSW,Trayce Jackson-Davis,jackstr02,66,GSW,0,POR,10,8,4,1,4,1,27.05,3,5,3,4,0,0,4,4,1,5,12,14,18,22,39.6
2023-24,202404110UTA,4/11/2024,UTA vs HOU,Dillon Brooks,brookdi01,71,HOU,0,UTA,8,4,1,2,0,1,27.08333333,3,1,4,14,0,5,0,0,5,2,5,9,12,13,19.3
2023-24,202404110SAC,4/11/2024,SAC vs NOP,Davion Mitchell,mitchda01,70,SAC,1,NOP,13,2,5,0,0,1,27.13333333,0,2,5,8,2,2,1,2,1,0,7,18,15,20,21.9
2023-24,202404110UTA,4/11/2024,UTA vs HOU,Jock Landale,landajo01,54,HOU,0,UTA,9,1,2,1,1,1,27.28333333,1,0,3,3,1,1,2,2,4,2,3,11,10,12,18.2
2023-24,202404110UTA,4/11/2024,UTA vs HOU,Kenneth Lofton Jr.,loftoke01,19,UTA,1,HOU,14,9,5,2,1,2,27.38333333,5,4,5,7,2,3,2,4,3,3,14,19,23,28,39.3
2023-24,202404110POR,4/11/2024,POR vs GSW,Rayan Rupert,ruperra01,37,POR,1,GSW,2,4,0,0,0,1,28.55,1,3,1,6,0,3,0,0,3,0,4,2,6,6,5.8
2023-24,202404110BOS,4/11/2024,BOS vs NYK,Jaylen Brown,brownja02,70,BOS,1,NYK,15,2,1,0,2,3,28.63333333,1,1,6,15,1,5,2,3,3,2,3,16,17,18,21.9
2023-24,202404110BOS,4/11/2024,BOS vs NYK,Derrick White,whitede01,73,BOS,1,NYK,2,2,2,1,1,1,28.63333333,0,2,1,5,0,3,0,0,3,2,4,4,4,6,12.4
2023-24,202404110BOS,4/11/2024,BOS vs NYK,Jrue Holiday,holidjr01,69,BOS,1,NYK,7,5,1,1,2,2,28.83333333,1,4,3,7,1,4,0,0,2,3,6,8,12,13,21.5
2023-24,202404110UTA,4/11/2024,UTA vs HOU,Talen Horton-Tucker,hortota01,50,UTA,1,HOU,16,5,5,0,2,1,28.9,1,4,5,13,2,6,4,4,5,2,10,21,21,26,34.5
2023-24,202404110SAC,4/11/2024,SAC vs NOP,Herbert Jones,joneshe01,74,NOP,0,SAC,5,5,6,0,0,3,29.31666667,1,4,2,7,1,4,0,0,4,0,11,11,10,16,17
2023-24,202404110POR,4/11/2024,POR vs GSW,Justin Minaya,minayju01,32,POR,1,GSW,3,4,2,1,0,0,29.33333333,4,0,1,7,1,5,0,0,4,1,6,5,7,9,13.8
2023-24,202404110POR,4/11/2024,POR vs GSW,Andrew Wiggins,wiggian01,69,GSW,0,POR,15,5,1,1,2,3,29.91666667,0,5,5,12,3,8,2,2,3,3,6,16,20,21,28.5
2023-24,202404110BOS,4/11/2024,BOS vs NYK,Jalen Brunson,brunsja01,75,NYK,0,BOS,39,2,4,0,0,2,30.03333333,0,2,15,23,6,11,3,5,2,0,6,43,41,45,45.4
2023-24,202404110DET,4/11/2024,DET vs CHI,Javonte Green,greenja02,7,CHI,0,DET,11,8,0,1,2,1,30.38333333,0,8,5,6,0,1,1,2,3,3,8,11,19,19,28.6
2023-24,202404110DET,4/11/2024,DET vs CHI,Jaden Ivey,iveyja01,75,DET,1,CHI,16,2,6,1,0,4,30.6,0,2,6,13,3,5,1,3,1,1,8,22,18,24,26.4
2023-24,202404110DET,4/11/2024,DET vs CHI,Jalen Duren,durenja01,61,DET,1,CHI,20,11,3,0,0,4,30.8,2,9,7,9,0,0,6,7,3,0,14,23,31,34,33.7
2023-24,202404110SAC,4/11/2024,SAC vs NOP,Zion Williamson,willizi01,68,NOP,0,SAC,31,4,6,3,1,4,30.91666667,1,3,13,21,0,1,5,5,0,4,10,37,35,41,52.8
2023-24,202404110BOS,4/11/2024,BOS vs NYK,Jayson Tatum,tatumja01,74,BOS,1,NYK,18,4,7,2,1,2,31.8,1,3,5,13,1,7,7,9,3,3,11,25,22,29,40.3
2023-24,202404110BOS,4/11/2024,BOS vs NYK,Josh Hart,hartjo01,79,NYK,0,BOS,16,16,5,1,0,1,31.96666667,2,14,7,15,1,4,1,1,2,1,21,21,32,37,44.7
2023-24,202404110POR,4/11/2024,POR vs GSW,Chris Paul,paulch01,56,GSW,0,POR,8,3,4,1,1,1,31.96666667,0,3,3,9,2,6,0,0,3,2,7,12,11,15,22.6
2023-24,202404110DET,4/11/2024,DET vs CHI,Chimezie Metu,metuch01,49,DET,1,CHI,15,8,3,0,0,1,32.06666667,0,8,5,10,3,6,2,2,2,0,11,18,23,26,28.1
2023-24,202404110SAC,4/11/2024,SAC vs NOP,Harrison Barnes,barneha02,80,SAC,1,NOP,22,5,4,1,0,0,32.5,1,4,9,15,2,6,2,2,2,1,9,26,27,31,37
2023-24,202404110POR,4/11/2024,POR vs GSW,Brandin Podziemski,podzibr01,72,GSW,0,POR,9,3,4,0,0,0,32.7,1,2,4,9,0,1,1,1,1,0,7,13,12,16,18.6
2023-24,202404110DET,4/11/2024,DET vs CHI,Marcus Sasser,sassema01,69,DET,1,CHI,20,0,5,2,1,4,32.7,0,0,8,15,4,10,0,0,0,3,5,25,20,25,32.5
2023-24,202404110UTA,4/11/2024,UTA vs HOU,Keyonte George,georgke01,73,UTA,1,HOU,20,4,5,2,0,5,32.91666667,0,4,7,14,2,6,4,5,3,2,9,25,24,29,33.3
2023-24,202404110BOS,4/11/2024,BOS vs NYK,Isaiah Hartenstein,harteis01,74,NYK,0,BOS,11,13,6,1,2,4,33.08333333,7,6,5,11,0,0,1,3,4,3,19,17,24,30,40.6
2023-24,202404110SAC,4/11/2024,SAC vs NOP,Jonas Valanciunas,valanjo01,80,NOP,0,SAC,13,10,3,1,0,2,33.2,1,9,5,8,0,0,3,5,4,1,13,16,23,26,30.5
2023-24,202404110DET,4/11/2024,DET vs CHI,Alex Caruso,carusal01,70,CHI,0,DET,8,4,10,2,0,2,33.53333333,1,3,3,6,1,3,1,2,3,2,14,18,12,22,31.8
2023-24,202404110UTA,4/11/2024,UTA vs HOU,Luka Samanic,samanlu01,41,UTA,1,HOU,22,6,2,1,0,2,33.55,3,3,7,17,1,7,7,9,2,1,8,24,28,30,33.2
2023-24,202404110POR,4/11/2024,POR vs GSW,Deandre Ayton,aytonde01,54,POR,1,GSW,25,11,1,3,1,1,33.78333333,1,10,12,24,0,1,1,1,0,4,12,26,36,37,50.7
2023-24,202404110POR,4/11/2024,POR vs GSW,Jonathan Kuminga,kuminjo01,73,GSW,0,POR,19,6,1,1,0,4,34.1,2,4,7,11,1,2,4,4,4,1,7,20,25,26,26.7
2023-24,202404110SAC,4/11/2024,SAC vs NOP,Domantas Sabonis,sabondo01,80,SAC,1,NOP,18,10,4,2,0,4,34.83333333,2,8,8,12,0,0,2,4,2,2,14,22,28,32,38
2023-24,202404110UTA,4/11/2024,UTA vs HOU,Amen Thompson,thompam01,60,HOU,0,UTA,15,10,4,2,0,1,35.4,6,4,6,12,0,1,3,4,0,2,14,19,25,29,38
2023-24,202404110SAC,4/11/2024,SAC vs NOP,Keegan Murray,murrake02,75,SAC,1,NOP,19,5,1,2,0,0,35.55,2,3,6,14,5,10,2,2,3,2,6,20,24,25,32.5
2023-24,202404110DET,4/11/2024,DET vs CHI,Troy Brown Jr.,browntr01,57,DET,1,CHI,4,4,3,1,0,1,35.56666667,1,3,1,6,0,3,2,2,2,1,7,7,8,11,15.3
2023-24,202404110DET,4/11/2024,DET vs CHI,DeMar DeRozan,derozde01,78,CHI,0,DET,39,4,7,3,0,1,35.68333333,0,4,14,22,4,6,7,8,0,3,11,46,43,50,62.3
2023-24,202404110POR,4/11/2024,POR vs GSW,Jabari Walker,walkeja01,71,POR,1,GSW,17,16,1,1,0,0,36.28333333,7,9,6,14,2,3,3,4,3,1,17,18,33,34,40.7
2023-24,202404110POR,4/11/2024,POR vs GSW,Stephen Curry,curryst01,73,GSW,0,POR,22,7,8,1,2,2,36.36666667,0,7,8,22,5,16,1,1,0,3,15,30,29,37,49.4
2023-24,202404110DET,4/11/2024,DET vs CHI,Coby White,whiteco01,77,CHI,0,DET,18,3,5,0,1,3,37.06666667,0,3,7,15,4,8,0,0,3,1,8,23,21,26,29.1
2023-24,202404110DET,4/11/2024,DET vs CHI,Nikola Vucevic,vucevni01,75,CHI,0,DET,27,11,4,2,1,0,37.31666667,2,9,12,21,2,6,1,2,3,3,15,31,38,42,55.2
2023-24,202404110POR,4/11/2024,POR vs GSW,Scoot Henderson,hendesc01,61,POR,1,GSW,18,3,12,2,0,9,39.7,1,2,7,20,2,8,2,3,2,2,15,30,21,33,36.6
2023-24,202404110SAC,4/11/2024,SAC vs NOP,CJ McCollum,mccolcj01,64,NOP,0,SAC,31,4,7,2,0,0,40,1,3,11,18,9,12,0,0,0,2,11,38,35,42,52.3
2023-24,202404110UTA,4/11/2024,UTA vs HOU,Fred VanVleet,vanvlfr01,73,HOU,0,UTA,42,7,7,2,1,2,40.08333333,3,4,12,30,9,13,9,10,3,3,14,49,49,56,67.9
2023-24,202404110SAC,4/11/2024,SAC vs NOP,De'Aaron Fox,foxde01,72,SAC,1,NOP,33,5,8,2,0,6,40.75,0,5,11,18,3,7,8,10,3,2,13,41,38,46,51
2023-24,202404110BOS,4/11/2024,BOS vs NYK,Donte DiVincenzo,divindo01,79,NYK,0,BOS,17,4,4,1,0,1,41.3,0,4,7,15,3,7,0,0,1,1,8,21,21,25,29.8
2023-24,202404110POR,4/11/2024,POR vs GSW,Kris Murray,murrakr01,60,POR,1,GSW,14,4,2,1,1,0,44.55,2,2,4,12,1,7,5,6,5,2,6,16,18,20,27.8
2023-24,202404110SAC,4/11/2024,SAC vs NOP,Trey Murphy III,murphtr02,55,NOP,0,SAC,27,5,4,0,0,1,44.88333333,0,5,7,14,6,12,7,8,1,0,9,31,32,36,38
2023-24,202404100MIL,4/10/2024,MIL vs ORL,Andre Jackson Jr.,jacksan01,55,MIL,1,ORL,5,3,0,1,0,0,10.31666667,1,2,2,3,1,2,0,0,2,1,3,5,8,8,11.6
2023-24,202404100DEN,4/10/2024,DEN vs MIN,Jordan McLaughlin,mclaujo01,54,MIN,0,DEN,0,0,1,1,0,0,10.4,0,0,0,0,0,0,0,0,0,1,1,1,0,1,4.5
2023-24,202404100BRK,4/10/2024,BRK vs TOR,Day'Ron Sharpe,sharpda01,61,BRK,1,TOR,6,8,1,0,2,2,11.13333333,4,4,3,6,0,0,0,0,1,2,9,7,14,15,21.1
2023-24,202404100MIA,4/10/2024,MIA vs DAL,Patty Mills,millspa02,31,MIA,1,DAL,7,0,0,0,0,0,11.28333333,0,0,2,4,1,3,2,2,2,0,0,7,7,7,7
2023-24,202404100MIL,4/10/2024,MIL vs ORL,Caleb Houstan,houstca01,58,ORL,0,MIL,0,2,1,0,0,0,11.35,0,2,0,5,0,5,0,0,0,0,3,1,2,3,3.9
2023-24,202404100OKC,4/10/2024,OKC vs SAS,Bismack Biyombo,biyombi01,39,OKC,1,SAS,6,6,0,0,1,0,12,1,5,3,3,0,0,0,0,0,1,6,6,12,12,16.2
2023-24,202404100OKC,4/10/2024,OKC vs SAS,Jamaree Bouyea,bouyeja01,8,SAS,0,OKC,2,1,1,1,0,0,12,0,1,1,1,0,0,0,0,0,1,2,3,3,4,7.7
2023-24,202404100OKC,4/10/2024,OKC vs SAS,Isaiah Joe,joeis01,76,OKC,1,SAS,8,3,0,0,2,1,12.41666667,1,2,3,6,2,4,0,0,2,2,3,8,11,11,16.6
2023-24,202404100OKC,4/10/2024,OKC vs SAS,RaiQuan Gray,grayra01,2,SAS,0,OKC,13,0,2,1,0,0,12.55,0,0,5,8,3,5,0,0,0,1,2,15,13,15,19
2023-24,202404100LAC,4/10/2024,LAC vs PHO,Thaddeus Young,youngth01,32,PHO,0,LAC,0,2,2,2,0,0,13.26666667,2,0,0,2,0,1,0,0,2,2,4,2,2,4,11.4
2023-24,202404100MIL,4/10/2024,MIL vs ORL,Jonathan Isaac,isaacjo01,56,ORL,0,MIL,0,1,0,1,0,0,13.31666667,0,1,0,2,0,0,0,0,0,1,1,0,1,1,4.2
2023-24,202404100OKC,4/10/2024,OKC vs SAS,Jaylin Williams,willija07,67,OKC,1,SAS,8,8,3,1,1,0,13.31666667,2,6,3,4,2,2,0,1,1,2,11,11,16,19,28.1
2023-24,202404100BRK,4/10/2024,BRK vs TOR,Jalen McDaniels,mcdanja01,49,TOR,0,BRK,3,1,0,1,0,0,13.56666667,1,0,0,3,0,1,3,4,3,1,1,3,4,4,7.2
2023-24,202404100MIA,4/10/2024,MIA vs DAL,Josh Green,greenjo02,55,DAL,0,MIA,3,4,2,1,0,0,13.75,1,3,1,5,1,3,0,0,2,1,6,5,7,9,13.8
2023-24,202404100OKC,4/10/2024,OKC vs SAS,Chet Holmgren,holmgch01,80,OKC,1,SAS,9,6,2,1,0,0,14.61666667,1,5,3,8,1,2,2,2,3,1,8,11,15,17,22.2
2023-24,202404100CLE,4/10/2024,CLE vs MEM,Jack White,whiteja03,2,MEM,0,CLE,0,4,1,1,0,1,14.63333333,2,2,0,3,0,1,0,0,0,1,5,1,4,5,8.3
2023-24,202404100DEN,4/10/2024,DEN vs MIN,Monte Morris,morrimo01,31,MIN,0,DEN,6,1,1,0,1,0,14.76666667,0,1,2,4,2,2,0,0,1,1,2,7,7,8,11.7
2023-24,202404100DEN,4/10/2024,DEN vs MIN,Kyle Anderson,anderky01,77,MIN,0,DEN,4,1,2,0,2,0,15.21666667,0,1,1,5,0,1,2,2,4,2,3,6,5,7,14.2
2023-24,202404100OKC,4/10/2024,OKC vs SAS,Mike Muscala,muscami01,51,OKC,1,SAS,0,4,2,0,0,1,15.23333333,2,2,0,4,0,1,0,0,3,0,6,2,4,6,6.8
2023-24,202404100MIL,4/10/2024,MIL vs ORL,Joe Ingles,inglejo01,66,ORL,0,MIL,3,3,3,0,0,2,15.4,0,3,1,2,1,1,0,0,1,0,6,6,6,9,9.1
2023-24,202404100OKC,4/10/2024,OKC vs SAS,Kenrich Williams,willike04,67,OKC,1,SAS,3,1,3,0,0,1,15.4,0,1,1,6,1,3,0,0,0,0,4,6,4,7,7.7
2023-24,202404100MIL,4/10/2024,MIL vs ORL,A.J. Green,greenaj01,56,MIL,1,ORL,2,0,0,1,0,1,15.51666667,0,0,0,3,0,2,2,2,1,1,0,2,2,2,4
2023-24,202404100LAC,4/10/2024,LAC vs PHO,Xavier Moon,moonxa01,12,LAC,1,PHO,6,3,4,0,0,0,15.51666667,1,2,3,5,0,1,0,0,0,0,7,10,9,13,15.6
2023-24,202404100BRK,4/10/2024,BRK vs TOR,Trendon Watford,watfotr01,61,BRK,1,TOR,6,7,5,0,0,0,15.53333333,0,7,2,5,0,2,2,5,1,0,12,11,13,18,21.9
2023-24,202404100CLE,4/10/2024,CLE vs MEM,Timmy Allen,allenti01,3,MEM,0,CLE,2,4,1,0,0,0,16.28333333,0,4,1,2,0,0,0,0,6,0,5,3,6,7,8.3
2023-24,202404100ATL,4/10/2024,ATL vs CHO,Mouhamed Gueye,gueyemo02,4,ATL,1,CHO,3,7,3,1,1,0,17.15,2,5,1,3,1,1,0,0,4,2,10,6,10,13,21.9
2023-24,202404100OKC,4/10/2024,OKC vs SAS,Aaron Wiggins,wiggiaa01,76,OKC,1,SAS,7,2,3,2,0,1,17.21666667,0,2,2,6,2,2,1,2,1,2,5,10,9,12,18.9
2023-24,202404100CLE,4/10/2024,CLE vs MEM,Georges Niang,niangge01,80,CLE,1,MEM,4,2,1,0,1,1,17.95,0,2,1,3,1,2,1,2,2,1,3,5,6,7,9.9
2023-24,202404100OKC,4/10/2024,OKC vs SAS,David Duke Jr.,dukeda01,2,SAS,0,OKC,6,7,4,1,0,1,18,1,6,2,8,0,2,2,2,1,1,11,10,13,17,22.4
2023-24,202404100BRK,4/10/2024,BRK vs TOR,Jordan Nwora,nworajo01,50,TOR,0,BRK,11,4,2,0,1,0,18.08333333,1,3,4,10,2,5,1,2,1,1,6,13,15,17,21.8
2023-24,202404100ATL,4/10/2024,ATL vs CHO,Davis Bertans,bertada01,42,CHO,0,ATL,6,1,0,0,1,1,18.15,0,1,2,7,1,6,1,1,1,1,1,6,7,7,9.2
2023-24,202404100ATL,4/10/2024,ATL vs CHO,JT Thor,thorjt01,61,CHO,0,ATL,6,4,1,0,0,1,18.15,2,2,3,5,0,2,0,0,2,0,5,7,10,11,11.3
2023-24,202404100DEN,4/10/2024,DEN vs MIN,Nickeil Alexander-Walker,alexani01,80,MIN,0,DEN,5,1,2,1,0,2,18.23333333,1,0,2,4,1,1,0,0,1,1,3,7,6,8,10.2
2023-24,202404100MIA,4/10/2024,MIA vs DAL,Kevin Love,loveke01,53,MIA,1,DAL,16,11,0,0,0,2,18.3,1,10,6,9,4,5,0,0,3,0,11,16,27,27,27.2
2023-24,202404100MIA,4/10/2024,MIA vs DAL,Tim Hardaway Jr.,hardati02,77,DAL,0,MIA,5,2,1,0,0,1,18.35,1,1,2,8,1,6,0,0,0,0,3,6,7,8,7.9
2023-24,202404100MIA,4/10/2024,MIA vs DAL,Jaime Jaquez Jr.,jaqueja01,73,MIA,1,DAL,6,2,1,0,0,1,18.36666667,0,2,2,4,2,2,0,0,1,0,3,7,8,9,8.9
2023-24,202404100MIA,4/10/2024,MIA vs DAL,Dante Exum,exumda01,54,DAL,0,MIA,3,3,2,0,0,0,18.56666667,1,2,1,2,1,1,0,0,0,0,5,5,6,8,9.6
2023-24,202404100ATL,4/10/2024,ATL vs CHO,Nick Richards,richani01,67,CHO,0,ATL,7,2,1,1,0,1,18.73333333,0,2,3,4,0,0,1,1,6,1,3,8,9,10,12.9
2023-24,202404100BRK,4/10/2024,BRK vs TOR,Jalen Wilson,wilsoja03,41,BRK,1,TOR,2,6,2,0,0,0,19.5,2,4,1,3,0,2,0,0,2,0,8,4,8,10,12.2
2023-24,202404100OKC,4/10/2024,OKC vs SAS,Malaki Branham,branhma01,75,SAS,0,OKC,7,2,1,0,0,1,19.8,0,2,3,8,1,4,0,0,2,0,3,8,9,10,9.9
2023-24,202404100OKC,4/10/2024,OKC vs SAS,Gordon Hayward,haywago01,49,OKC,1,SAS,18,1,0,1,0,3,19.81666667,0,1,6,8,2,3,4,6,1,1,1,18,19,19,19.2
2023-24,202404100ATL,4/10/2024,ATL vs CHO,Trent Forrest,forretr01,37,ATL,1,CHO,6,2,5,1,0,2,19.95,1,1,3,5,0,0,0,1,0,1,7,11,8,13,16.9
2023-24,202404100DEN,4/10/2024,DEN vs MIN,Reggie Jackson,jacksre01,80,DEN,1,MIN,9,2,1,0,0,3,20.31666667,0,2,3,9,1,3,2,2,4,0,3,10,11,12,9.9
2023-24,202404100MIA,4/10/2024,MIA vs DAL,Maxi Kleber,klebima01,42,DAL,0,MIA,4,2,1,0,2,0,20.33333333,1,1,1,1,0,0,2,2,0,2,3,5,6,7,13.9
2023-24,202404100OKC,4/10/2024,OKC vs SAS,Devonte Graham,grahade01,21,SAS,0,OKC,2,3,1,0,0,1,20.55,0,3,1,7,0,4,0,0,0,0,4,3,5,6,6.1
2023-24,202404100ATL,4/10/2024,ATL vs CHO,Trae Young,youngtr01,52,ATL,1,CHO,14,4,11,1,0,5,20.63333333,0,4,5,5,2,2,2,2,1,1,15,25,18,29,33.3
2023-24,202404100MIL,4/10/2024,MIL vs ORL,Moritz Wagner,wagnemo01,78,ORL,0,MIL,7,4,0,0,0,2,20.76666667,1,3,3,6,0,2,1,1,3,0,4,7,11,11,9.8
2023-24,202404100ATL,4/10/2024,ATL vs CHO,Clint Capela,capelca01,72,ATL,1,CHO,15,6,0,1,0,0,20.91666667,0,6,7,10,0,0,1,2,0,1,6,15,21,21,25.2
2023-24,202404100ATL,4/10/2024,ATL vs CHO,Vasilije Micic,micicva01,58,CHO,0,ATL,2,2,5,1,0,2,21.71666667,0,2,0,3,0,2,2,2,0,1,7,7,4,9,12.9
2023-24,202404100ATL,4/10/2024,ATL vs CHO,Bogdan Bogdanovic,bogdabo01,77,ATL,1,CHO,19,1,8,1,0,2,22.05,0,1,6,11,5,10,2,2,2,1,9,27,20,28,33.2
2023-24,202404100MIL,4/10/2024,MIL vs ORL,Anthony Black,blackan01,68,ORL,0,MIL,5,0,1,0,0,1,22.18333333,0,0,2,2,1,1,0,0,2,0,1,6,5,6,5.5
2023-24,202404100MIL,4/10/2024,MIL vs ORL,Markelle Fultz,fultzma01,41,ORL,0,MIL,6,2,1,2,0,1,22.46666667,0,2,3,5,0,0,0,0,0,2,3,7,8,9,14.9
2023-24,202404100BRK,4/10/2024,BRK vs TOR,Mikal Bridges,bridgmi01,80,BRK,1,TOR,11,3,2,0,0,1,22.7,1,2,3,9,3,8,2,2,0,0,5,13,14,16,16.6
2023-24,202404100DEN,4/10/2024,DEN vs MIN,Peyton Watson,watsope01,78,DEN,1,MIN,3,4,4,0,6,0,23.01666667,1,3,1,2,0,0,1,2,2,6,8,7,7,11,31.8
2023-24,202404100BRK,4/10/2024,BRK vs TOR,Mouhamadou Gueye,gueyemo01,11,TOR,0,BRK,3,4,1,1,3,0,23.08333333,1,3,1,7,0,0,1,1,4,4,5,4,7,8,21.3
2023-24,202404100MIL,4/10/2024,MIL vs ORL,Wendell Carter Jr.,cartewe01,53,ORL,0,MIL,9,3,0,0,0,1,23.21666667,2,1,3,9,1,4,2,2,2,0,3,9,12,12,11.6
2023-24,202404100LAC,4/10/2024,LAC vs PHO,P.J. Tucker,tuckepj01,29,LAC,1,PHO,10,5,1,1,0,0,23.31666667,1,4,4,5,2,2,0,0,0,1,6,11,15,16,20.5
2023-24,202404100LAC,4/10/2024,LAC vs PHO,Grayson Allen,allengr01,73,PHO,0,LAC,6,4,1,0,0,0,23.48333333,1,3,2,5,2,5,0,0,4,0,5,7,10,11,12.3
2023-24,202404100OKC,4/10/2024,OKC vs SAS,Jalen Williams,willija06,69,OKC,1,SAS,10,7,2,3,1,1,23.58333333,0,7,5,11,0,2,0,0,1,4,9,12,17,19,32.4
2023-24,202404100MIA,4/10/2024,MIA vs DAL,Nikola Jovic,jovicni01,44,MIA,1,DAL,6,5,4,0,0,1,23.68333333,1,4,3,9,0,4,0,0,3,0,9,10,11,15,17
2023-24,202404100LAC,4/10/2024,LAC vs PHO,Eric Gordon,gordoer01,67,PHO,0,LAC,11,0,0,1,0,0,23.7,0,0,4,10,2,6,1,1,0,1,0,11,11,11,14
2023-24,202404100BRK,4/10/2024,BRK vs TOR,Javon Freeman-Liberty,freemja01,20,TOR,0,BRK,12,4,1,1,0,0,23.8,1,3,4,8,2,4,2,2,0,1,5,13,16,17,21.3
2023-24,202404100ATL,4/10/2024,ATL vs CHO,Kobe Bufkin,bufkiko01,15,ATL,1,CHO,11,2,1,0,1,1,23.85,1,1,4,12,1,3,2,3,5,1,3,12,13,14,16.9
2023-24,202404100BRK,4/10/2024,BRK vs TOR,Malik Williams,willima11,5,TOR,0,BRK,7,14,1,2,0,1,24.11666667,5,9,3,10,1,1,0,0,4,2,15,8,21,22,30.3
2023-24,202404100OKC,4/10/2024,OKC vs SAS,Julian Champagnie,champju02,72,SAS,0,OKC,5,3,0,1,1,2,24.13333333,0,3,1,7,0,6,3,4,3,2,3,5,8,8,12.6
2023-24,202404100MIA,4/10/2024,MIA vs DAL,Haywood Highsmith,highsha01,64,MIA,1,DAL,2,10,1,0,0,0,24.36666667,4,6,1,3,0,1,0,0,2,0,11,3,12,13,15.5
2023-24,202404100CLE,4/10/2024,CLE vs MEM,Zavier Simpson,simpsza01,5,MEM,0,CLE,4,8,4,1,0,1,24.36666667,1,7,2,5,0,1,0,0,5,1,12,8,12,16,21.6
2023-24,202404100OKC,4/10/2024,OKC vs SAS,Cason Wallace,wallaca01,80,OKC,1,SAS,0,4,3,3,1,0,24.5,0,4,0,5,0,4,0,0,1,4,7,3,4,7,21.3
2023-24,202404100MIL,4/10/2024,MIL vs ORL,Pat Connaughton,connapa01,74,MIL,1,ORL,5,2,3,0,0,1,24.51666667,1,1,2,5,0,2,1,1,3,0,5,8,7,10,10.9
2023-24,202404100MIL,4/10/2024,MIL vs ORL,Malik Beasley,beaslma01,77,MIL,1,ORL,8,5,0,0,0,0,24.66666667,0,5,3,9,2,8,0,0,4,0,5,8,13,13,14
2023-24,202404100ATL,4/10/2024,ATL vs CHO,Bruno Fernando,fernabr01,43,ATL,1,CHO,5,6,0,0,0,2,24.93333333,0,6,1,3,0,0,3,6,5,0,6,5,11,11,10.2
2023-24,202404100OKC,4/10/2024,OKC vs SAS,Blake Wesley,weslebl01,59,SAS,0,OKC,7,2,1,0,0,2,25.26666667,0,2,1,11,1,4,4,4,1,0,3,8,9,10,8.9
2023-24,202404100OKC,4/10/2024,OKC vs SAS,Sandro Mamukelashvili,mamuksa01,44,SAS,0,OKC,0,11,2,0,0,1,25.51666667,0,11,0,8,0,3,0,0,0,0,13,2,11,13,15.2
2023-24,202404100ATL,4/10/2024,ATL vs CHO,Aleksej Pokusevski,pokusal01,26,CHO,0,ATL,10,6,1,1,1,1,25.51666667,0,6,3,6,2,2,2,2,2,2,7,11,16,17,23.7
2023-24,202404100MIA,4/10/2024,MIA vs DAL,Daniel Gafford,gaffoda01,73,DAL,0,MIA,12,5,3,1,3,0,25.71666667,0,5,6,6,0,0,0,0,0,4,8,15,17,20,34.5
2023-24,202404100MIA,4/10/2024,MIA vs DAL,Derrick Jones Jr.,jonesde02,75,DAL,0,MIA,12,2,0,2,2,0,25.76666667,2,0,5,12,1,5,1,2,3,4,2,12,14,14,26.4
2023-24,202404100OKC,4/10/2024,OKC vs SAS,Zach Collins,colliza01,67,SAS,0,OKC,20,7,2,1,2,5,26.21666667,0,7,8,17,2,5,2,3,3,3,9,22,27,29,35.4
2023-24,202404100OKC,4/10/2024,OKC vs SAS,Shai Gilgeous-Alexander,gilgesh01,73,OKC,1,SAS,26,6,5,0,0,1,26.25,0,6,10,18,1,3,5,5,1,0,11,31,32,37,39.7
2023-24,202404100DEN,4/10/2024,DEN vs MIN,Kentavious Caldwell-Pope,caldwke01,74,DEN,1,MIN,9,3,1,0,1,0,26.3,1,2,4,9,1,5,0,0,4,1,4,10,12,13,17.1
2023-24,202404100ATL,4/10/2024,ATL vs CHO,Dylan Windler,windldy01,17,ATL,1,CHO,12,3,1,0,0,1,26.4,2,1,4,7,4,7,0,0,1,0,4,13,15,16,16.1
2023-24,202404100CLE,4/10/2024,CLE vs MEM,Isaac Okoro,okorois01,67,CLE,1,MEM,7,4,0,1,0,0,26.55,0,4,2,5,1,4,2,6,1,1,4,7,11,11,14.8
2023-24,202404100ATL,4/10/2024,ATL vs CHO,Grant Williams,willigr01,76,CHO,0,ATL,16,6,5,1,0,3,26.55,1,5,5,6,2,3,4,4,5,1,11,21,22,27,30.7
2023-24,202404100MIL,4/10/2024,MIL vs ORL,Jalen Suggs,suggsja01,73,ORL,0,MIL,18,3,0,1,0,0,26.56666667,1,2,6,11,2,6,4,6,5,1,3,18,21,21,24.6
2023-24,202404100BRK,4/10/2024,BRK vs TOR,Cameron Johnson,johnsca02,58,BRK,1,TOR,13,3,1,1,0,2,26.76666667,0,3,4,8,1,4,4,4,4,1,4,14,16,17,19.1
2023-24,202404100DEN,4/10/2024,DEN vs MIN,Christian Braun,braunch01,80,DEN,1,MIN,8,5,1,1,1,1,27.26666667,1,4,4,7,0,1,0,1,1,2,6,9,13,14,20.5
2023-24,202404100DEN,4/10/2024,DEN vs MIN,Jamal Murray,murraja01,57,DEN,1,MIN,20,4,6,0,0,4,27.38333333,2,2,8,13,4,6,0,0,1,0,10,26,24,30,29.8
2023-24,202404100CLE,4/10/2024,CLE vs MEM,Caris LeVert,leverca01,67,CLE,1,MEM,18,2,2,2,0,1,27.51666667,0,2,6,13,2,4,4,4,3,2,4,20,20,22,28.4
2023-24,202404100OKC,4/10/2024,OKC vs SAS,Tre Jones,jonestr01,75,SAS,0,OKC,13,6,7,3,1,2,27.68333333,0,6,6,14,1,4,0,0,1,4,13,20,19,26,40.7
2023-24,202404100LAC,4/10/2024,LAC vs PHO,Kobe Brown,brownko01,42,LAC,1,PHO,4,2,2,1,1,0,27.93333333,1,1,2,5,0,3,0,0,3,2,4,6,6,8,15.4
2023-24,202404100DEN,4/10/2024,DEN vs MIN,Aaron Gordon,gordoaa01,71,DEN,1,MIN,5,5,9,1,0,2,27.96666667,1,4,2,7,0,2,1,2,0,1,14,14,10,19,25.5
2023-24,202404100OKC,4/10/2024,OKC vs SAS,Sidy Cissoko,cissosi01,10,SAS,0,OKC,14,5,3,0,0,0,28.28333333,3,2,4,7,1,3,5,7,3,0,8,17,19,22,24.5
2023-24,202404100OKC,4/10/2024,OKC vs SAS,Josh Giddey,giddejo01,79,OKC,1,SAS,20,12,7,1,0,3,28.61666667,0,12,7,12,1,3,5,5,1,1,19,27,32,39,44.9
2023-24,202404100MIA,4/10/2024,MIA vs DAL,Bam Adebayo,adebaba01,69,MIA,1,DAL,8,3,0,0,0,0,29.68333333,2,1,3,13,0,2,2,2,2,0,3,8,11,11,11.6
2023-24,202404100CLE,4/10/2024,CLE vs MEM,Max Strus,strusma01,68,CLE,1,MEM,8,6,1,1,0,0,29.7,1,5,3,5,2,3,0,1,2,1,7,9,14,15,19.7
2023-24,202404100MIL,4/10/2024,MIL vs ORL,Patrick Beverley,beverpa01,71,MIL,1,ORL,13,8,6,1,0,0,29.75,2,6,4,6,3,3,2,2,2,1,14,19,21,27,34.6
2023-24,202404100ATL,4/10/2024,ATL vs CHO,Miles Bridges,bridgmi02,68,CHO,0,ATL,18,3,3,0,0,2,29.85,1,2,7,14,2,5,2,2,0,0,6,21,21,24,24.1
2023-24,202404100DEN,4/10/2024,DEN vs MIN,Mike Conley,conlemi01,74,MIN,0,DEN,19,4,2,1,0,3,30.23333333,1,3,7,12,5,9,0,0,0,1,6,21,23,25,26.8
2023-24,202404100LAC,4/10/2024,LAC vs PHO,Jusuf Nurkic,nurkiju01,74,PHO,0,LAC,3,19,10,0,1,4,30.23333333,3,16,1,1,0,0,1,2,2,1,29,13,22,32,39.8
2023-24,202404100MIL,4/10/2024,MIL vs ORL,Bobby Portis,portibo01,80,MIL,1,ORL,30,9,3,5,0,4,30.35,2,7,14,18,2,2,0,0,3,5,12,33,39,42,56.3
2023-24,202404100DEN,4/10/2024,DEN vs MIN,Naz Reid,reidna01,79,MIN,0,DEN,13,6,2,2,1,0,30.35,1,5,6,19,0,4,1,5,4,3,8,15,19,21,32.2
2023-24,202404100MIL,4/10/2024,MIL vs ORL,Jae Crowder,crowdja01,48,MIL,1,ORL,14,4,1,0,1,0,30.56666667,2,2,4,9,2,6,4,5,1,1,5,15,18,19,23.3
2023-24,202404100ATL,4/10/2024,ATL vs CHO,Garrison Mathews,mathega01,64,ATL,1,CHO,10,3,4,0,0,0,30.63333333,0,3,4,12,2,9,0,0,0,0,7,14,13,17,19.6
2023-24,202404100CLE,4/10/2024,CLE vs MEM,Darius Garland,garlada01,56,CLE,1,MEM,16,6,9,0,1,3,30.66666667,0,6,5,13,2,9,4,5,2,1,15,25,22,31,36.7
2023-24,202404100MIL,4/10/2024,MIL vs ORL,Brook Lopez,lopezbr01,77,MIL,1,ORL,10,4,4,1,3,1,30.7,2,2,4,10,2,6,0,1,0,4,8,14,14,18,31.8
2023-24,202404100CLE,4/10/2024,CLE vs MEM,Evan Mobley,mobleev01,48,CLE,1,MEM,12,12,1,3,4,4,31.45,3,9,4,10,2,4,2,2,1,7,13,13,24,25,44.9
2023-24,202404100MIL,4/10/2024,MIL vs ORL,Cole Anthony,anthoco01,79,ORL,0,MIL,23,4,4,0,1,5,32.63333333,0,4,9,14,3,4,2,2,1,1,8,27,27,31,31.8
2023-24,202404100BRK,4/10/2024,BRK vs TOR,Nic Claxton,claxtni01,69,BRK,1,TOR,14,11,4,0,5,3,32.76666667,2,9,6,7,0,0,2,4,1,5,15,18,25,29,45.2
2023-24,202404100LAC,4/10/2024,LAC vs PHO,Royce O'Neale,onealro01,77,PHO,0,LAC,15,7,5,3,1,1,33.26666667,2,5,6,12,3,9,0,0,2,4,12,20,22,27,41.9
2023-24,202404100ATL,4/10/2024,ATL vs CHO,Brandon Miller,millebr02,73,CHO,0,ATL,27,3,2,0,0,1,33.4,0,3,9,17,5,11,4,4,2,0,5,29,30,32,32.6
2023-24,202404100ATL,4/10/2024,ATL vs CHO,Vit Krejci,krejcvi01,20,ATL,1,CHO,19,4,2,2,0,3,33.48333333,1,3,8,14,3,8,0,0,2,2,6,21,23,25,29.8
2023-24,202404100BRK,4/10/2024,BRK vs TOR,Gradey Dick,dickgr01,58,TOR,0,BRK,24,4,0,0,0,1,33.5,1,3,9,20,6,14,0,0,3,0,4,24,28,28,27.8
2023-24,202404100DEN,4/10/2024,DEN vs MIN,Jaden McDaniels,mcdanja02,70,MIN,0,DEN,9,2,3,1,0,0,33.5,0,2,4,8,1,4,0,0,2,1,5,12,11,14,18.9
2023-24,202404100CLE,4/10/2024,CLE vs MEM,Donovan Mitchell,mitchdo01,54,CLE,1,MEM,29,4,8,3,1,3,33.6,1,3,9,17,5,10,6,7,2,4,12,37,33,41,54.8
2023-24,202404100CLE,4/10/2024,CLE vs MEM,Jarrett Allen,allenja01,75,CLE,1,MEM,16,10,5,0,3,1,33.61666667,6,4,7,13,0,1,2,2,1,3,15,21,26,31,43.5
2023-24,202404100MIL,4/10/2024,MIL vs ORL,Paolo Banchero,banchpa01,78,ORL,0,MIL,20,6,6,1,0,2,33.65,0,6,7,15,1,2,5,8,0,1,12,26,26,32,37.2
2023-24,202404100MIL,4/10/2024,MIL vs ORL,Damian Lillard,lillada01,72,MIL,1,ORL,29,6,9,0,0,4,33.66666667,0,6,10,19,3,8,6,7,2,0,15,38,35,44,45.7
2023-24,202404100BRK,4/10/2024,BRK vs TOR,Immanuel Quickley,quickim01,67,TOR,0,BRK,32,7,9,1,1,4,33.71666667,1,6,10,24,4,11,8,8,5,2,16,41,39,48,55.9
2023-24,202404100LAC,4/10/2024,LAC vs PHO,Bradley Beal,bealbr01,51,PHO,0,LAC,26,5,4,0,0,3,33.83333333,0,5,9,17,4,7,4,4,2,0,9,30,31,35,35
2023-24,202404100BRK,4/10/2024,BRK vs TOR,Ochai Agbaji,agbajoc01,76,TOR,0,BRK,7,1,1,0,0,0,34.4,0,1,3,6,0,1,1,1,1,0,2,8,8,9,9.7
2023-24,202404100MIA,4/10/2024,MIA vs DAL,P.J. Washington,washipj01,72,DAL,0,MIA,12,6,2,2,1,1,34.71666667,1,5,5,11,2,6,0,1,1,3,8,14,18,20,30.2
2023-24,202404100DEN,4/10/2024,DEN vs MIN,Anthony Edwards,edwaran01,77,MIN,0,DEN,25,2,4,0,0,1,34.86666667,0,2,9,18,2,6,5,7,1,0,6,29,27,31,32.4
2023-24,202404100LAC,4/10/2024,LAC vs PHO,Mason Plumlee,plumlma01,44,LAC,1,PHO,12,12,4,1,0,2,35.25,1,11,4,9,0,1,4,4,2,1,16,16,24,28,33.4
2023-24,202404100MIA,4/10/2024,MIA vs DAL,Tyler Herro,herroty01,40,MIA,1,DAL,21,7,6,0,0,4,35.66666667,1,6,6,15,2,5,7,7,0,0,13,27,28,34,34.4
2023-24,202404100CLE,4/10/2024,CLE vs MEM,GG Jackson II,jacksgg01,46,MEM,0,CLE,22,2,2,2,1,1,35.68333333,0,2,7,21,2,10,6,6,2,3,4,24,24,26,35.4
2023-24,202404100BRK,4/10/2024,BRK vs TOR,Garrett Temple,templga01,25,TOR,0,BRK,3,6,4,2,0,3,35.7,4,2,1,6,1,3,0,0,1,2,10,7,9,13,19.2
2023-24,202404100CLE,4/10/2024,CLE vs MEM,Scotty Pippen Jr.,pippesc02,19,MEM,0,CLE,18,4,6,2,0,3,35.76666667,2,2,7,15,2,4,2,2,3,2,10,24,22,28,34.8
2023-24,202404100MIA,4/10/2024,MIA vs DAL,Jimmy Butler,butleji01,58,MIA,1,DAL,12,4,3,2,0,5,35.83333333,1,3,5,8,2,3,0,0,0,2,7,15,16,19,22.3
2023-24,202404100CLE,4/10/2024,CLE vs MEM,Trey Jemison,jemistr01,23,MEM,0,CLE,4,9,3,1,4,1,35.93333333,2,7,2,7,0,0,0,0,2,5,12,7,13,16,33.3
2023-24,202404100MIA,4/10/2024,MIA vs DAL,Luka Doncic,doncilu01,70,DAL,0,MIA,29,9,9,0,0,3,35.98333333,1,8,9,23,4,15,7,8,4,0,18,38,38,47,50.3
2023-24,202404100BRK,4/10/2024,BRK vs TOR,Dennis Schroder,schrode01,80,BRK,1,TOR,21,7,9,2,0,1,36.16666667,2,5,7,18,2,8,5,5,4,2,16,30,28,37,47.9
2023-24,202404100ATL,4/10/2024,ATL vs CHO,Tre Mann,manntr01,39,CHO,0,ATL,16,3,7,7,0,1,36.75,1,2,5,13,1,4,5,6,0,7,10,23,19,26,50.1
2023-24,202404100BRK,4/10/2024,BRK vs TOR,Cam Thomas,thomaca02,64,BRK,1,TOR,23,4,0,0,1,2,36.9,1,3,7,22,5,10,4,4,3,1,4,23,27,27,28.8
2023-24,202404100LAC,4/10/2024,LAC vs PHO,Kevin Durant,duranke01,73,PHO,0,LAC,24,9,3,1,2,4,36.96666667,0,9,10,21,2,9,2,2,0,3,12,27,33,36,44.3
2023-24,202404100MIA,4/10/2024,MIA vs DAL,Kyrie Irving,irvinky01,58,DAL,0,MIA,25,3,4,2,0,1,37.06666667,0,3,10,15,5,8,0,0,2,2,7,29,28,32,39.6
2023-24,202404100LAC,4/10/2024,LAC vs PHO,Amir Coffey,coffeam01,68,LAC,1,PHO,11,5,1,1,1,0,37.08333333,1,4,4,13,2,6,1,2,2,2,6,12,16,17,24.5
2023-24,202404100CLE,4/10/2024,CLE vs MEM,Lamar Stevens,stevela01,38,MEM,0,CLE,16,6,3,1,4,1,37.28333333,2,4,4,13,2,5,6,6,2,5,9,19,22,25,41.7
2023-24,202404100DEN,4/10/2024,DEN vs MIN,Michael Porter Jr.,portemi01,79,DEN,1,MIN,18,8,2,0,0,1,37.36666667,3,5,7,14,2,4,2,2,2,0,10,20,26,28,29.6
2023-24,202404100MIA,4/10/2024,MIA vs DAL,Caleb Martin,martica02,62,MIA,1,DAL,14,4,6,1,1,2,38.28333333,2,2,5,14,2,4,2,2,3,2,10,20,18,24,31.8
2023-24,202404100DEN,4/10/2024,DEN vs MIN,Nikola Jokic,jokicni01,77,DEN,1,MIN,41,11,7,3,0,2,38.41666667,2,9,16,20,2,2,7,12,5,3,18,48,52,59,71.7
2023-24,202404100BRK,4/10/2024,BRK vs TOR,Noah Clowney,clownno01,21,BRK,1,TOR,10,7,1,1,7,2,38.5,2,5,5,8,0,2,0,0,0,8,8,11,17,18,41.9
2023-24,202404100DEN,4/10/2024,DEN vs MIN,Rudy Gobert,goberru01,74,MIN,0,DEN,13,15,3,2,1,2,38.76666667,5,10,6,7,0,0,1,3,5,3,18,16,28,31,42.5
2023-24,202404100LAC,4/10/2024,LAC vs PHO,Devin Booker,bookede01,66,PHO,0,LAC,37,1,4,1,1,1,39.15,1,0,13,24,5,12,6,6,1,2,5,41,38,42,49.2
2023-24,202404100LAC,4/10/2024,LAC vs PHO,Brandon Boston Jr.,bostobr01,30,LAC,1,PHO,23,7,2,2,1,3,39.91666667,4,3,10,24,2,9,1,2,1,3,9,25,30,32,40.4
2023-24,202404100CLE,4/10/2024,CLE vs MEM,Jake LaRavia,laravja01,33,MEM,0,CLE,32,7,1,2,1,5,40,1,6,10,18,8,11,4,5,1,3,8,33,39,40,45.9
2023-24,202404100LAC,4/10/2024,LAC vs PHO,Bones Hyland,hylanbo01,36,LAC,1,PHO,37,4,9,3,0,4,43.05,0,4,15,29,6,12,1,1,4,3,13,46,41,50,60.3
2023-24,202404090OKC,4/9/2024,OKC vs SAC,Alex Len,lenal01,45,SAC,0,OKC,0,4,2,0,1,1,10.3,2,2,0,0,0,0,0,0,3,1,6,2,4,6,9.8
2023-24,202404090PHI,4/9/2024,PHI vs DET,Jaylen Nowell,nowelja01,12,DET,0,PHI,2,1,1,0,0,0,10.45,0,1,1,2,0,0,0,0,0,0,2,3,3,4,4.7
2023-24,202404090PHI,4/9/2024,PHI vs DET,Ricky Council IV,councri01,30,PHI,1,DET,3,1,1,1,0,0,10.46666667,0,1,1,4,1,2,0,0,2,1,2,4,4,5,8.7
2023-24,202404090ATL,4/9/2024,ATL vs MIA,Kobe Bufkin,bufkiko01,14,ATL,1,MIA,4,4,3,1,0,2,10.51666667,1,3,2,9,0,3,0,1,1,1,7,7,8,11,14.3
2023-24,202404090MIN,4/9/2024,MIN vs WAS,Monte Morris,morrimo01,30,MIN,1,WAS,3,4,0,0,0,0,11.68333333,0,4,1,4,1,2,0,0,0,0,4,3,7,7,7.8
2023-24,202404090UTA,4/9/2024,UTA vs DEN,Zeke Nnaji,nnajize01,55,DEN,0,UTA,6,3,0,0,1,0,12.01666667,2,1,3,3,0,0,0,3,0,1,3,6,9,9,12.6
2023-24,202404090POR,4/9/2024,POR vs NOP,Duop Reath,reathdu01,65,POR,1,NOP,12,5,1,0,0,0,12.21666667,2,3,5,8,2,3,0,1,2,0,6,13,17,18,19.5
2023-24,202404090PHO,4/9/2024,PHO vs LAC,Drew Eubanks,eubandr01,73,PHO,1,LAC,6,5,1,1,0,0,12.23333333,3,2,3,6,0,0,0,0,0,1,6,7,11,12,16.5
2023-24,202404090HOU,4/9/2024,HOU vs ORL,Cole Anthony,anthoco01,78,ORL,0,HOU,2,0,2,1,0,0,12.36666667,0,0,1,4,0,0,0,0,2,1,2,4,2,4,8
2023-24,202404090MIN,4/9/2024,MIN vs WAS,Eugene Omoruyi,omorueu01,41,WAS,0,MIN,7,2,0,1,0,2,12.46666667,2,0,2,4,2,2,1,2,2,1,2,7,9,9,10.4
2023-24,202404090CHO,4/9/2024,CHO vs DAL,Aleksej Pokusevski,pokusal01,25,CHO,1,DAL,4,4,1,0,1,0,12.93333333,0,4,1,2,0,0,2,4,0,1,5,5,8,9,13.3
2023-24,202404090PHI,4/9/2024,PHI vs DET,Paul Reed,reedpa01,80,PHI,1,DET,8,6,0,1,0,0,13.21666667,4,2,4,7,0,0,0,0,2,1,6,8,14,14,18.2
2023-24,202404090CHO,4/9/2024,CHO vs DAL,Jaden Hardy,hardyja02,70,DAL,0,CHO,3,2,2,1,0,2,13.25,1,1,1,1,0,0,1,2,1,1,4,5,5,7,9.4
2023-24,202404090LAL,4/9/2024,LAL vs GSW,Gary Payton II,paytoga02,44,GSW,0,LAL,9,1,1,0,1,1,13.61666667,0,1,3,6,2,3,1,2,2,1,2,10,10,11,13.7
2023-24,202404090TOR,4/9/2024,TOR vs IND,Malik Williams,willima11,4,TOR,1,IND,6,9,0,0,1,0,14.2,5,4,3,8,0,1,0,2,3,1,9,6,15,15,19.8
2023-24,202404090PHI,4/9/2024,PHI vs DET,Jared Rhoden,rhodeja01,14,DET,0,PHI,2,1,0,0,2,0,14.66666667,0,1,1,5,0,2,0,0,3,2,1,2,3,3,9.2
2023-24,202404090CHI,4/9/2024,CHI vs NYK,Torrey Craig,craigto01,50,CHI,1,NYK,4,2,0,0,1,0,14.76666667,1,1,1,3,1,1,1,2,2,1,2,4,6,6,9.4
2023-24,202404090LAL,4/9/2024,LAL vs GSW,Gabe Vincent,vincega01,9,LAL,1,GSW,0,1,1,2,0,1,15.48333333,0,1,0,3,0,3,0,0,1,2,2,1,1,2,7.7
2023-24,202404090PHI,4/9/2024,PHI vs DET,De'Anthony Melton,meltode01,37,PHI,1,DET,5,3,3,2,0,0,15.81666667,1,2,2,9,1,5,0,0,1,2,6,8,8,11,19.1
2023-24,202404090TOR,4/9/2024,TOR vs IND,Jalen McDaniels,mcdanja01,48,TOR,1,IND,7,2,0,0,0,0,15.98333333,1,1,3,7,0,1,1,2,1,0,2,7,9,9,9.4
2023-24,202404090OKC,4/9/2024,OKC vs SAC,Jaylin Williams,willija07,66,OKC,1,SAC,4,1,2,0,0,1,16.2,0,1,2,3,0,1,0,0,3,0,3,6,5,7,7.2
2023-24,202404090HOU,4/9/2024,HOU vs ORL,Jeff Green,greenje02,75,HOU,1,ORL,6,2,2,1,0,1,16.53333333,1,1,2,4,0,1,2,2,1,1,4,8,8,10,13.4
2023-24,202404090PHO,4/9/2024,PHO vs LAC,Bones Hyland,hylanbo01,35,LAC,0,PHO,7,9,2,0,0,0,17.48333333,1,8,3,9,1,4,0,0,2,0,11,9,16,18,20.8
2023-24,202404090MEM,4/9/2024,MEM vs SAS,Zach Collins,colliza01,66,SAS,0,MEM,5,7,3,0,1,1,17.66666667,0,7,2,5,0,1,1,1,0,1,10,8,12,15,19.9
2023-24,202404090HOU,4/9/2024,HOU vs ORL,Joe Ingles,inglejo01,65,ORL,0,HOU,7,3,2,0,1,1,17.8,0,3,2,6,1,4,2,3,0,1,5,9,10,12,15.6
2023-24,202404090TOR,4/9/2024,TOR vs IND,Isaiah Jackson,jacksis01,60,IND,0,TOR,4,7,2,0,2,0,17.88333333,5,2,2,3,0,0,0,0,0,2,9,6,11,13,21.4
2023-24,202404090UTA,4/9/2024,UTA vs DEN,Justin Holiday,holidju01,55,DEN,0,UTA,6,1,0,0,0,0,18.31666667,0,1,2,5,2,4,0,0,1,0,1,6,7,7,7.2
2023-24,202404090OKC,4/9/2024,OKC vs SAC,Cason Wallace,wallaca01,79,OKC,1,SAC,3,2,2,1,1,0,18.4,0,2,1,5,1,2,0,0,0,2,4,5,5,7,14.4
2023-24,202404090MIL,4/9/2024,MIL vs BOS,Xavier Tillman Sr.,tillmxa01,51,BOS,0,MIL,6,0,2,1,2,0,18.41666667,0,0,2,7,2,5,0,0,1,3,2,8,6,8,18
2023-24,202404090OKC,4/9/2024,OKC vs SAC,Aaron Wiggins,wiggiaa01,75,OKC,1,SAC,7,4,1,0,1,0,18.68333333,1,3,3,4,0,1,1,1,1,1,5,8,11,12,16.3
2023-24,202404090MIL,4/9/2024,MIL vs BOS,A.J. Green,greenaj01,55,MIL,1,BOS,6,1,0,0,0,0,18.71666667,0,1,2,3,2,3,0,0,0,0,1,6,7,7,7.2
2023-24,202404090LAL,4/9/2024,LAL vs GSW,Taurean Prince,princta02,77,LAL,1,GSW,2,1,0,1,0,0,18.8,0,1,1,6,0,3,0,0,1,1,1,2,3,3,6.2
2023-24,202404090TOR,4/9/2024,TOR vs IND,Jordan Nwora,nworajo01,49,TOR,1,IND,11,3,2,1,2,2,19.13333333,2,1,4,6,2,2,1,2,1,3,5,13,14,16,24.6
2023-24,202404090CHI,4/9/2024,CHI vs NYK,Dalen Terry,terryda01,56,CHI,1,NYK,4,3,1,0,1,1,19.21666667,1,2,2,3,0,0,0,0,3,1,4,5,7,8,11.1
2023-24,202404090CHO,4/9/2024,CHO vs DAL,Maxi Kleber,klebima01,41,DAL,0,CHO,10,6,1,0,0,1,19.38333333,4,2,4,5,2,3,0,0,2,0,7,11,16,17,17.7
2023-24,202404090POR,4/9/2024,POR vs NOP,Larry Nance Jr.,nancela02,60,NOP,0,POR,2,4,2,2,0,1,19.56666667,4,0,0,2,0,1,2,2,0,2,6,4,6,8,14.8
2023-24,202404090CHI,4/9/2024,CHI vs NYK,Mitchell Robinson,robinmi01,28,NYK,0,CHI,0,1,0,2,0,0,19.65,0,1,0,0,0,0,0,0,1,2,1,0,1,1,7.2
2023-24,202404090POR,4/9/2024,POR vs NOP,Jose Alvarado,alvarjo01,53,NOP,0,POR,2,0,1,1,0,0,19.68333333,0,0,1,6,0,5,0,0,2,1,1,3,2,3,6.5
2023-24,202404090MIN,4/9/2024,MIN vs WAS,Johnny Davis,davisjo06,48,WAS,0,MIN,10,3,0,0,0,2,19.68333333,0,3,3,4,1,1,3,5,3,0,3,10,13,13,11.6
2023-24,202404090MIL,4/9/2024,MIL vs BOS,Pat Connaughton,connapa01,73,MIL,1,BOS,4,3,2,2,0,0,19.81666667,1,2,2,6,0,1,0,0,0,2,5,6,7,9,16.6
2023-24,202404090OKC,4/9/2024,OKC vs SAC,Isaiah Joe,joeis01,75,OKC,1,SAC,10,4,1,2,0,1,19.96666667,0,4,4,7,2,5,0,0,3,2,5,11,14,15,21.3
2023-24,202404090CHO,4/9/2024,CHO vs DAL,Dante Exum,exumda01,53,DAL,0,CHO,2,4,3,0,0,0,20.11666667,1,3,1,5,0,3,0,0,3,0,7,5,6,9,11.3
2023-24,202404090CHO,4/9/2024,CHO vs DAL,Nick Richards,richani01,66,CHO,1,DAL,8,7,1,0,0,2,20.11666667,2,5,4,4,0,0,0,0,2,0,8,9,15,16,15.9
2023-24,202404090LAL,4/9/2024,LAL vs GSW,Brandin Podziemski,podzibr01,71,GSW,0,LAL,13,3,2,0,0,1,20.35,1,2,5,6,3,3,0,0,0,0,5,15,16,18,18.6
2023-24,202404090PHI,4/9/2024,PHI vs DET,James Wiseman,wisemja01,60,DET,0,PHI,8,6,2,0,0,1,20.46666667,1,5,1,5,0,0,6,6,2,0,8,10,14,16,17.2
2023-24,202404090PHI,4/9/2024,PHI vs DET,Jeff Dowtin,dowtije01,10,PHI,1,DET,8,0,6,1,0,0,20.55,0,0,4,7,0,0,0,1,0,1,6,14,8,14,20
2023-24,202404090HOU,4/9/2024,HOU vs ORL,Wendell Carter Jr.,cartewe01,52,ORL,0,HOU,7,6,2,1,0,2,20.6,3,3,3,7,1,3,0,0,2,1,8,9,13,15,18.2
2023-24,202404090UTA,4/9/2024,UTA vs DEN,Brice Sensabaugh,sensabr01,29,UTA,1,DEN,10,5,2,0,0,0,20.66666667,1,4,2,9,1,2,5,5,2,0,7,12,15,17,19
2023-24,202404090ATL,4/9/2024,ATL vs MIA,Delon Wright,wrighde01,45,MIA,0,ATL,7,2,2,0,0,1,20.7,1,1,3,4,1,2,0,0,1,0,4,9,9,11,11.4
2023-24,202404090POR,4/9/2024,POR vs NOP,Jonas Valanciunas,valanjo01,79,NOP,0,POR,11,8,5,2,0,0,20.8,2,6,5,12,0,2,1,2,0,2,13,16,19,24,34.1
2023-24,202404090TOR,4/9/2024,TOR vs IND,Myles Turner,turnemy01,76,IND,0,TOR,16,4,1,0,1,2,20.88333333,1,3,6,10,3,7,1,4,3,1,5,17,20,21,23.3
2023-24,202404090TOR,4/9/2024,TOR vs IND,T.J. McConnell,mccontj01,70,IND,0,TOR,17,2,7,0,0,3,20.9,0,2,8,13,1,1,0,0,2,0,9,24,19,26,26.9
2023-24,202404090MIL,4/9/2024,MIL vs BOS,Luke Kornet,kornelu01,60,BOS,0,MIL,7,2,1,0,0,0,20.93333333,1,1,3,3,1,1,0,0,1,0,3,8,9,10,10.9
2023-24,202404090ATL,4/9/2024,ATL vs MIA,Garrison Mathews,mathega01,63,ATL,1,MIA,11,3,0,1,0,1,21.08333333,2,1,4,10,3,9,0,1,2,1,3,11,14,14,16.6
2023-24,202404090PHI,4/9/2024,PHI vs DET,Malachi Flynn,flynnma01,66,DET,0,PHI,12,0,4,0,0,2,21.16666667,0,0,5,9,2,4,0,0,2,0,4,16,12,16,16
2023-24,202404090MEM,4/9/2024,MEM vs SAS,Devonte Graham,grahade01,20,SAS,0,MEM,3,0,4,0,1,2,21.16666667,0,0,1,6,1,6,0,0,2,1,4,7,3,7,10
2023-24,202404090OKC,4/9/2024,OKC vs SAC,Josh Giddey,giddejo01,78,OKC,1,SAC,4,4,3,1,2,4,21.26666667,0,4,2,7,0,4,0,0,5,3,7,7,8,11,18.3
2023-24,202404090MEM,4/9/2024,MEM vs SAS,Sidy Cissoko,cissosi01,9,SAS,0,MEM,10,3,2,1,1,0,21.38333333,2,1,4,6,0,1,2,2,2,2,5,12,13,15,22.6
2023-24,202404090ATL,4/9/2024,ATL vs MIA,Bruno Fernando,fernabr01,42,ATL,1,MIA,12,4,0,0,0,0,21.4,0,4,4,5,0,0,4,4,2,0,4,12,16,16,16.8
2023-24,202404090LAL,4/9/2024,LAL vs GSW,Jonathan Kuminga,kuminjo01,72,GSW,0,LAL,8,6,3,1,0,0,21.41666667,0,6,2,8,1,3,3,4,3,1,9,11,14,17,22.7
2023-24,202404090POR,4/9/2024,POR vs NOP,Justin Minaya,minayju01,31,POR,1,NOP,3,4,2,0,0,0,21.5,1,3,1,4,1,3,0,0,2,0,6,5,7,9,10.8
2023-24,202404090HOU,4/9/2024,HOU vs ORL,Jonathan Isaac,isaacjo01,55,ORL,0,HOU,10,8,1,2,1,1,21.51666667,2,6,4,6,1,2,1,2,1,3,9,11,18,19,29.1
2023-24,202404090OKC,4/9/2024,OKC vs SAC,Davion Mitchell,mitchda01,69,SAC,0,OKC,8,1,2,0,0,1,21.56666667,0,1,3,10,1,6,1,1,2,0,3,10,9,11,11.2
2023-24,202404090UTA,4/9/2024,UTA vs DEN,Taylor Hendricks,hendrita0,37,UTA,1,DEN,3,5,1,1,1,0,21.71666667,1,4,1,5,1,2,0,0,0,2,6,4,8,9,16.5
2023-24,202404090CHI,4/9/2024,CHI vs NYK,Miles McBride,mcbrimi01,66,NYK,0,CHI,7,2,2,0,0,0,21.83333333,1,1,3,10,1,6,0,0,2,0,4,9,9,11,12.4
2023-24,202404090TOR,4/9/2024,TOR vs IND,Obi Toppin,toppiob01,81,IND,0,TOR,23,6,2,1,1,0,21.83333333,1,5,10,14,3,7,0,0,3,2,8,25,29,31,39.2
2023-24,202404090ATL,4/9/2024,ATL vs MIA,Jaime Jaquez Jr.,jaqueja01,72,MIA,0,ATL,3,4,1,0,0,2,21.88333333,2,2,1,2,1,1,0,0,2,0,5,4,7,8,7.3
2023-24,202404090HOU,4/9/2024,HOU vs ORL,Moritz Wagner,wagnemo01,77,ORL,0,HOU,12,5,1,1,0,1,21.95,2,3,4,8,0,0,4,4,1,1,6,13,17,18,21.5
2023-24,202404090MIL,4/9/2024,MIL vs BOS,Bobby Portis,portibo01,79,MIL,1,BOS,15,10,2,1,0,2,21.96666667,3,7,7,13,1,2,0,0,1,1,12,17,25,27,31
2023-24,202404090OKC,4/9/2024,OKC vs SAC,Trey Lyles,lylestr01,55,SAC,0,OKC,3,7,0,2,1,1,22.03333333,3,4,1,7,1,5,0,0,1,3,7,3,10,10,19.4
2023-24,202404090MIN,4/9/2024,MIN vs WAS,Jared Butler,butleja02,38,WAS,0,MIN,4,6,3,1,0,0,22.06666667,0,6,2,5,0,1,0,0,3,1,9,7,10,13,18.7
2023-24,202404090LAL,4/9/2024,LAL vs GSW,Spencer Dinwiddie,dinwisp01,74,LAL,1,GSW,12,4,0,0,0,0,22.38333333,0,4,4,7,3,5,1,1,1,0,4,12,16,16,16.8
2023-24,202404090MEM,4/9/2024,MEM vs SAS,Blake Wesley,weslebl01,58,SAS,0,MEM,13,2,3,0,0,5,22.5,0,2,5,7,2,3,1,1,2,0,5,16,15,18,14.9
2023-24,202404090PHI,4/9/2024,PHI vs DET,Troy Brown Jr.,browntr01,56,DET,0,PHI,0,3,0,2,0,0,22.58333333,1,2,0,2,0,1,0,0,1,2,3,0,3,3,9.6
2023-24,202404090CHO,4/9/2024,CHO vs DAL,Tim Hardaway Jr.,hardati02,76,DAL,0,CHO,15,4,1,1,0,1,22.61666667,0,4,6,10,3,7,0,0,0,1,5,16,19,20,23.3
2023-24,202404090HOU,4/9/2024,HOU vs ORL,Jock Landale,landajo01,53,HOU,1,ORL,8,2,4,1,2,0,23.33333333,0,2,3,4,1,2,1,2,2,3,6,12,10,14,25.4
2023-24,202404090CHO,4/9/2024,CHO vs DAL,Davis Bertans,bertada01,41,CHO,1,DAL,13,4,0,0,0,0,23.48333333,0,4,5,11,3,7,0,0,2,0,4,13,17,17,17.8
2023-24,202404090MIL,4/9/2024,MIL vs BOS,Payton Pritchard,pritcpa01,79,BOS,0,MIL,6,2,3,1,0,1,23.63333333,0,2,2,9,2,8,0,0,0,1,5,9,8,11,14.9
2023-24,202404090ATL,4/9/2024,ATL vs MIA,Jalen Johnson,johnsja05,56,ATL,1,MIA,13,8,3,1,0,1,23.71666667,2,6,6,7,1,1,0,0,2,1,11,16,21,24,29.1
2023-24,202404090UTA,4/9/2024,UTA vs DEN,Reggie Jackson,jacksre01,79,DEN,0,UTA,9,4,5,1,1,0,23.95,2,2,4,13,1,6,0,0,0,2,9,14,13,18,27.3
2023-24,202404090CHO,4/9/2024,CHO vs DAL,Derrick Jones Jr.,jonesde02,74,DAL,0,CHO,9,3,3,0,1,0,24.45,2,1,4,8,1,5,0,0,2,1,6,12,12,15,20.1
2023-24,202404090LAL,4/9/2024,LAL vs GSW,Trayce Jackson-Davis,jackstr02,65,GSW,0,LAL,7,7,0,0,3,1,24.73333333,2,5,2,5,0,0,3,5,0,3,7,7,14,14,23.4
2023-24,202404090CHO,4/9/2024,CHO vs DAL,Daniel Gafford,gaffoda01,72,DAL,0,CHO,26,7,1,1,2,0,24.75,2,5,12,12,0,0,2,4,1,3,8,27,33,34,44.9
2023-24,202404090LAL,4/9/2024,LAL vs GSW,Chris Paul,paulch01,55,GSW,0,LAL,11,6,9,0,0,3,24.95,0,6,5,10,1,4,0,0,2,0,15,20,17,26,28.7
2023-24,202404090MIN,4/9/2024,MIN vs WAS,Jordan McLaughlin,mclaujo01,53,MIN,1,WAS,6,3,7,1,0,0,25.11666667,2,1,2,3,0,1,2,2,0,1,10,13,9,16,23.1
2023-24,202404090MIL,4/9/2024,MIL vs BOS,Malik Beasley,beaslma01,76,MIL,1,BOS,5,2,1,0,0,0,25.26666667,0,2,2,7,1,5,0,0,0,0,3,6,7,8,8.9
2023-24,202404090UTA,4/9/2024,UTA vs DEN,Darius Bazley,bazleda01,6,UTA,1,DEN,8,5,0,1,0,0,25.31666667,1,4,2,5,0,2,4,4,0,1,5,8,13,13,17
2023-24,202404090PHI,4/9/2024,PHI vs DET,Buddy Hield,hieldbu01,83,PHI,1,DET,18,6,0,0,0,1,25.45,2,4,6,12,5,9,1,2,2,0,6,18,24,24,24.2
2023-24,202404090MEM,4/9/2024,MEM vs SAS,Jack White,whiteja03,1,MEM,1,SAS,6,2,0,1,1,0,25.51666667,0,2,2,7,2,5,0,0,1,2,2,6,8,8,14.4
2023-24,202404090TOR,4/9/2024,TOR vs IND,Aaron Nesmith,nesmiaa01,71,IND,0,TOR,8,4,2,2,0,2,25.98333333,1,3,3,8,0,4,2,2,4,2,6,10,12,14,19.8
2023-24,202404090MIL,4/9/2024,MIL vs BOS,Patrick Beverley,beverpa01,70,MIL,1,BOS,20,10,3,0,0,0,26.13333333,1,9,8,13,4,8,0,0,0,0,13,23,30,33,36.5
2023-24,202404090CHO,4/9/2024,CHO vs DAL,Vasilije Micic,micicva01,57,CHO,1,DAL,6,2,4,1,1,2,26.18333333,0,2,3,10,0,3,0,0,3,2,6,10,8,12,18.4
2023-24,202404090PHI,4/9/2024,PHI vs DET,Evan Fournier,fournev01,29,DET,0,PHI,21,3,0,1,2,0,26.35,0,3,7,11,3,5,4,4,1,3,3,21,24,24,33.6
2023-24,202404090MIN,4/9/2024,MIN vs WAS,Kyle Anderson,anderky01,76,MIN,1,WAS,1,2,3,1,0,0,26.4,0,2,0,3,0,0,1,2,2,1,5,4,3,6,10.9
2023-24,202404090MEM,4/9/2024,MEM vs SAS,Sandro Mamukelashvili,mamuksa01,43,SAS,0,MEM,11,16,4,0,1,2,26.43333333,4,12,4,6,1,3,2,2,1,1,20,15,27,31,37.2
2023-24,202404090TOR,4/9/2024,TOR vs IND,Pascal Siakam,siakapa01,78,IND,0,TOR,16,9,3,0,2,3,26.61666667,5,4,6,10,0,0,4,4,4,2,12,19,25,28,34.3
2023-24,202404090OKC,4/9/2024,OKC vs SAC,Harrison Barnes,barneha02,79,SAC,0,OKC,10,6,0,1,0,1,26.71666667,2,4,1,8,0,4,8,10,1,1,6,10,16,16,19.2
2023-24,202404090PHI,4/9/2024,PHI vs DET,Marcus Sasser,sassema01,68,DET,0,PHI,10,3,5,0,0,3,26.83333333,1,2,3,10,2,4,2,2,2,0,8,15,13,18,18.1
2023-24,202404090MEM,4/9/2024,MEM vs SAS,Brandon Clarke,clarkbr01,6,MEM,1,SAS,14,1,0,1,1,0,27,0,1,7,12,0,1,0,0,1,2,1,14,15,15,21.2
2023-24,202404090ATL,4/9/2024,ATL vs MIA,Caleb Martin,martica02,61,MIA,0,ATL,0,2,3,2,2,0,27.1,0,2,0,9,0,6,0,0,0,4,5,3,2,5,18.9
2023-24,202404090UTA,4/9/2024,UTA vs DEN,Jamal Murray,murraja01,56,DEN,0,UTA,28,2,4,4,4,1,27.11666667,0,2,11,20,4,10,2,4,1,8,6,32,30,34,59.4
2023-24,202404090TOR,4/9/2024,TOR vs IND,Ben Sheppard,sheppbe01,56,IND,0,TOR,11,2,2,2,0,0,27.35,1,1,4,12,3,9,0,0,2,2,4,13,13,15,22.4
2023-24,202404090PHI,4/9/2024,PHI vs DET,Cameron Payne,payneca01,76,PHI,1,DET,5,5,6,3,0,0,27.45,1,4,2,3,1,2,0,0,2,3,11,11,10,16,29
2023-24,202404090TOR,4/9/2024,TOR vs IND,Andrew Nembhard,nembhan01,66,IND,0,TOR,8,2,8,0,1,1,27.46666667,0,2,3,7,2,4,0,1,3,1,10,16,10,18,24.4
2023-24,202404090PHI,4/9/2024,PHI vs DET,Jalen Duren,durenja01,60,DET,0,PHI,15,11,2,0,0,2,27.53333333,0,11,5,12,0,0,5,6,3,0,13,17,26,28,29.2
2023-24,202404090MIN,4/9/2024,MIN vs WAS,Jaden McDaniels,mcdanja02,69,MIN,1,WAS,9,5,2,1,1,0,27.55,0,5,3,6,1,4,2,2,6,2,7,11,14,16,24
2023-24,202404090MEM,4/9/2024,MEM vs SAS,GG Jackson II,jacksgg01,45,MEM,1,SAS,11,4,2,0,1,0,27.6,1,3,4,17,2,8,1,2,1,1,6,13,15,17,21.8
2023-24,202404090TOR,4/9/2024,TOR vs IND,Bruce Brown,brownbr01,66,TOR,1,IND,16,3,5,0,0,2,27.76666667,0,3,7,12,0,1,2,4,0,0,8,21,19,24,25.1
2023-24,202404090MIL,4/9/2024,MIL vs BOS,Brook Lopez,lopezbr01,76,MIL,1,BOS,15,6,0,0,2,0,27.76666667,1,5,5,9,5,8,0,0,0,2,6,15,21,21,28.2
2023-24,202404090PHO,4/9/2024,PHO vs LAC,Ivica Zubac,zubaciv01,67,LAC,0,PHO,17,13,2,0,2,3,27.93333333,2,11,8,13,0,0,1,1,0,2,15,19,30,32,38.6
2023-24,202404090MIN,4/9/2024,MIN vs WAS,Mike Conley,conlemi01,73,MIN,1,WAS,15,2,3,1,0,2,28,1,1,5,11,5,9,0,0,1,1,5,18,17,20,22.9
2023-24,202404090MIL,4/9/2024,MIL vs BOS,Sam Hauser,hausesa01,76,BOS,0,MIL,8,5,2,2,0,1,28.01666667,2,3,3,8,2,6,0,0,0,2,7,10,13,15,22
2023-24,202404090POR,4/9/2024,POR vs NOP,Dyson Daniels,daniedy01,58,NOP,0,POR,4,6,5,1,1,3,28.08333333,0,6,2,4,0,1,0,0,1,2,11,9,10,15,21.7
2023-24,202404090PHI,4/9/2024,PHI vs DET,Tobias Harris,harrito02,68,PHI,1,DET,15,12,4,0,1,0,28.11666667,4,8,6,13,0,2,3,4,0,1,16,19,27,31,38.4
2023-24,202404090CHO,4/9/2024,CHO vs DAL,P.J. Washington,washipj01,71,DAL,0,CHO,1,7,3,1,0,3,28.15,2,5,0,7,0,6,1,2,3,1,10,4,8,11,13.9
2023-24,202404090POR,4/9/2024,POR vs NOP,Jabari Walker,walkeja01,70,POR,1,NOP,4,10,0,0,0,1,28.25,2,8,2,5,0,1,0,0,2,0,10,4,14,14,15
2023-24,202404090UTA,4/9/2024,UTA vs DEN,Christian Braun,braunch01,79,DEN,0,UTA,11,2,5,2,0,0,28.28333333,1,1,4,6,3,4,0,0,1,2,7,16,13,18,26.9
2023-24,202404090MEM,4/9/2024,MEM vs SAS,Malaki Branham,branhma01,74,SAS,0,MEM,10,4,2,1,0,1,28.31666667,0,4,4,13,2,8,0,0,1,1,6,12,14,16,19.8
2023-24,202404090LAL,4/9/2024,LAL vs GSW,Jaxson Hayes,hayesja02,69,LAL,1,GSW,11,6,1,1,1,2,28.31666667,3,3,5,6,0,0,1,2,4,2,7,12,17,18,23.7
2023-24,202404090CHI,4/9/2024,CHI vs NYK,Isaiah Hartenstein,harteis01,73,NYK,0,CHI,11,4,6,1,3,2,28.35,2,2,5,5,0,0,1,2,2,4,10,17,15,21,34.8
2023-24,202404090LAL,4/9/2024,LAL vs GSW,Andrew Wiggins,wiggian01,68,GSW,0,LAL,17,4,0,0,3,0,28.53333333,1,3,7,12,3,5,0,0,3,3,4,17,21,21,30.8
2023-24,202404090MIL,4/9/2024,MIL vs BOS,Giannis Antetokounmpo,antetgi01,73,MIL,1,BOS,15,8,7,1,2,4,28.6,3,5,7,11,0,0,1,2,1,3,15,22,23,30,40.1
2023-24,202404090PHI,4/9/2024,PHI vs DET,Nicolas Batum,batumni01,58,PHI,1,DET,2,3,1,0,1,1,28.63333333,1,2,1,4,0,3,0,0,1,1,4,3,5,6,9.1
2023-24,202404090PHI,4/9/2024,PHI vs DET,Kelly Oubre Jr.,oubreke01,66,PHI,1,DET,17,3,0,0,3,0,28.78333333,1,2,6,16,1,5,4,4,2,3,3,17,20,20,29.6
2023-24,202404090HOU,4/9/2024,HOU vs ORL,Jalen Suggs,suggsja01,72,ORL,0,HOU,21,2,4,2,2,1,28.78333333,0,2,7,13,2,5,5,5,3,4,6,25,23,27,40.4
2023-24,202404090PHO,4/9/2024,PHO vs LAC,Eric Gordon,gordoer01,66,PHO,1,LAC,11,0,0,4,1,2,28.88333333,0,0,4,9,3,8,0,0,0,5,0,11,11,11,24
2023-24,202404090UTA,4/9/2024,UTA vs DEN,Michael Porter Jr.,portemi01,78,DEN,0,UTA,12,5,0,1,1,0,28.88333333,1,4,5,13,2,7,0,0,1,2,5,12,17,17,24
2023-24,202404090TOR,4/9/2024,TOR vs IND,Ochai Agbaji,agbajoc01,75,TOR,1,IND,2,3,1,0,3,1,28.91666667,1,2,0,6,0,2,2,2,3,3,4,3,5,6,15.1
2023-24,202404090PHO,4/9/2024,PHO vs LAC,Royce O'Neale,onealro01,76,PHO,1,LAC,10,11,4,2,1,0,28.96666667,0,11,3,10,2,7,2,2,3,3,15,14,21,25,38.2
2023-24,202404090UTA,4/9/2024,UTA vs DEN,Kentavious Caldwell-Pope,caldwke01,73,DEN,0,UTA,6,2,4,0,1,1,29.21666667,1,1,3,5,0,2,0,0,3,1,6,10,8,12,16.4
2023-24,202404090MEM,4/9/2024,MEM vs SAS,Julian Champagnie,champju02,71,SAS,0,MEM,17,3,1,2,0,3,29.65,1,2,6,12,3,8,2,2,1,2,4,18,20,21,25.1
2023-24,202404090UTA,4/9/2024,UTA vs DEN,Keyonte George,georgke01,72,UTA,1,DEN,10,3,5,0,0,5,30.03333333,1,2,4,11,2,9,0,0,0,0,8,15,13,18,16.1
2023-24,202404090MEM,4/9/2024,MEM vs SAS,Trey Jemison,jemistr01,22,MEM,1,SAS,14,9,2,1,1,1,30.16666667,5,4,6,14,0,0,2,2,3,2,11,16,23,25,32.8
2023-24,202404090OKC,4/9/2024,OKC vs SAC,Luguentz Dort,dortlu01,77,OKC,1,SAC,18,2,2,2,0,0,30.43333333,0,2,6,11,3,6,3,4,2,2,4,20,20,22,29.4
2023-24,202404090UTA,4/9/2024,UTA vs DEN,Peyton Watson,watsope01,77,DEN,0,UTA,5,9,4,0,2,1,30.48333333,0,9,2,7,0,1,1,2,1,2,13,9,14,18,26.8
2023-24,202404090CHI,4/9/2024,CHI vs NYK,Javonte Green,greenja02,6,CHI,1,NYK,9,12,0,0,0,0,30.5,5,7,3,8,0,3,3,4,3,0,12,9,21,21,23.4
2023-24,202404090MEM,4/9/2024,MEM vs SAS,Victor Wembanyama,wembavi01,70,SAS,0,MEM,18,7,6,0,7,1,30.55,1,6,9,19,0,5,0,0,1,7,13,24,25,31,55.4
2023-24,202404090HOU,4/9/2024,HOU vs ORL,Gary Harris,harriga01,52,ORL,0,HOU,6,5,2,1,0,0,30.61666667,1,4,2,3,2,2,0,0,2,1,7,8,11,13,18
2023-24,202404090MEM,4/9/2024,MEM vs SAS,Zavier Simpson,simpsza01,4,MEM,1,SAS,12,3,5,1,0,2,30.61666667,0,3,5,15,2,6,0,0,0,1,8,17,15,20,24.1
2023-24,202404090LAL,4/9/2024,LAL vs GSW,Rui Hachimura,hachiru01,67,LAL,1,GSW,20,11,2,1,2,0,30.86666667,2,9,7,21,2,7,4,4,0,3,13,22,31,33,45.2
2023-24,202404090MIN,4/9/2024,MIN vs WAS,Nickeil Alexander-Walker,alexani01,79,MIN,1,WAS,23,4,5,2,2,2,31,1,3,9,19,4,9,1,2,1,4,9,28,27,32,45.3
2023-24,202404090TOR,4/9/2024,TOR vs IND,Tyrese Haliburton,halibty01,68,IND,0,TOR,30,5,5,2,1,2,31.08333333,0,5,10,16,3,8,7,10,1,3,10,35,35,40,50.5
2023-24,202404090POR,4/9/2024,POR vs NOP,Dalano Banton,bantoda01,52,POR,1,NOP,12,3,3,0,1,4,31.3,0,3,4,11,2,8,2,2,1,1,6,15,15,18,19.1
2023-24,202404090MIL,4/9/2024,MIL vs BOS,Derrick White,whitede01,72,BOS,0,MIL,9,4,3,2,0,1,31.31666667,1,3,3,10,3,9,0,0,1,2,7,12,13,16,23.3
2023-24,202404090PHO,4/9/2024,PHO vs LAC,Grayson Allen,allengr01,72,PHO,1,LAC,9,6,2,3,0,0,31.41666667,1,5,3,13,0,8,3,4,3,3,8,11,15,17,28.2
2023-24,202404090MEM,4/9/2024,MEM vs SAS,Timmy Allen,allenti01,2,MEM,1,SAS,6,4,2,2,0,0,31.45,1,3,3,9,0,3,0,0,4,2,6,8,10,12,19.8
2023-24,202404090MEM,4/9/2024,MEM vs SAS,Scotty Pippen Jr.,pippesc02,18,MEM,1,SAS,14,7,5,4,1,3,31.5,2,5,4,15,0,5,6,7,2,5,12,19,21,26,41.9
2023-24,202404090MIL,4/9/2024,MIL vs BOS,Jrue Holiday,holidjr01,68,BOS,0,MIL,12,7,5,1,1,2,31.65,3,4,5,13,2,6,0,0,0,2,12,17,19,24,31.9
2023-24,202404090UTA,4/9/2024,UTA vs DEN,Johnny Juzang,juzanjo01,17,UTA,1,DEN,5,2,3,0,0,1,31.75,0,2,2,8,1,4,0,0,2,0,5,8,7,10,10.9
2023-24,202404090PHI,4/9/2024,PHI vs DET,Jaden Ivey,iveyja01,74,DET,0,PHI,25,5,4,0,1,5,31.76666667,3,2,8,17,6,9,3,6,2,1,9,29,30,34,35
2023-24,202404090MEM,4/9/2024,MEM vs SAS,Tre Jones,jonestr01,74,SAS,0,MEM,8,7,4,1,0,0,32,2,5,4,10,0,4,0,0,0,1,11,12,15,19,25.4
2023-24,202404090ATL,4/9/2024,ATL vs MIA,Vit Krejci,krejcvi01,19,ATL,1,MIA,0,4,1,2,0,1,32.01666667,1,3,0,3,0,2,0,0,4,2,5,1,4,5,11.3
2023-24,202404090CHO,4/9/2024,CHO vs DAL,Grant Williams,willigr01,75,CHO,1,DAL,12,3,4,0,0,1,32.15,1,2,5,12,1,5,1,2,3,0,7,16,15,19,20.6
2023-24,202404090LAL,4/9/2024,LAL vs GSW,Draymond Green,greendr01,54,GSW,0,LAL,15,6,10,0,1,4,32.16666667,0,6,5,7,5,7,0,2,2,1,16,25,21,31,36.2
2023-24,202404090LAL,4/9/2024,LAL vs GSW,Stephen Curry,curryst01,72,GSW,0,LAL,23,7,8,1,2,1,32.31666667,0,7,7,9,6,6,3,4,2,3,15,31,30,38,51.4
2023-24,202404090UTA,4/9/2024,UTA vs DEN,Talen Horton-Tucker,hortota01,49,UTA,1,DEN,24,3,2,1,1,4,32.33333333,0,3,10,23,4,8,0,0,4,2,5,26,27,29,32.6
2023-24,202404090PHO,4/9/2024,PHO vs LAC,Norman Powell,powelno01,75,LAC,0,PHO,10,5,1,0,0,1,32.5,0,5,4,12,2,4,0,0,5,0,6,11,15,16,16.5
2023-24,202404090HOU,4/9/2024,HOU vs ORL,Dillon Brooks,brookdi01,70,HOU,1,ORL,15,5,3,0,0,1,32.66666667,0,5,5,10,3,4,2,2,6,0,8,18,20,23,24.5
2023-24,202404090TOR,4/9/2024,TOR vs IND,RJ Barrett,barrerj01,57,TOR,1,IND,23,4,4,1,0,5,32.76666667,2,2,10,19,0,3,3,3,2,1,8,27,27,31,31.8
2023-24,202404090MIN,4/9/2024,MIN vs WAS,Jordan Poole,poolejo01,78,WAS,0,MIN,24,3,6,1,0,2,32.76666667,1,2,9,22,5,13,1,1,2,1,9,30,27,33,37.6
2023-24,202404090LAL,4/9/2024,LAL vs GSW,Klay Thompson,thompkl01,75,GSW,0,LAL,27,0,3,1,1,2,33,0,0,10,16,5,10,2,2,2,2,3,30,27,30,35.5
2023-24,202404090POR,4/9/2024,POR vs NOP,Rayan Rupert,ruperra01,36,POR,1,NOP,6,4,4,0,0,1,33.21666667,0,4,2,9,2,6,0,0,1,0,8,10,10,14,15.8
2023-24,202404090POR,4/9/2024,POR vs NOP,Zion Williamson,willizi01,67,NOP,0,POR,22,7,3,1,1,2,33.21666667,2,5,7,18,0,0,8,9,1,2,10,25,29,32,38.9
2023-24,202404090MIL,4/9/2024,MIL vs BOS,Khris Middleton,middlkh01,53,MIL,1,BOS,12,6,9,1,0,7,33.23333333,0,6,5,8,2,4,0,0,2,1,15,21,18,27,28.7
2023-24,202404090TOR,4/9/2024,TOR vs IND,Javon Freeman-Liberty,freemja01,19,TOR,1,IND,20,8,1,1,0,1,33.43333333,3,5,7,10,2,3,4,4,3,1,9,21,28,29,33.1
2023-24,202404090POR,4/9/2024,POR vs NOP,CJ McCollum,mccolcj01,63,NOP,0,POR,29,5,3,2,0,1,33.8,1,4,10,19,5,10,4,4,0,2,8,32,34,37,44.5
2023-24,202404090TOR,4/9/2024,TOR vs IND,Kelly Olynyk,olynyke01,76,TOR,1,IND,22,5,4,1,0,1,33.8,1,4,6,7,1,1,9,10,2,1,9,26,27,31,36
2023-24,202404090HOU,4/9/2024,HOU vs ORL,Jalen Green,greenja05,79,HOU,1,ORL,14,5,5,1,0,2,33.83333333,0,5,6,17,2,9,0,2,1,1,10,19,19,24,28.5
2023-24,202404090OKC,4/9/2024,OKC vs SAC,Domantas Sabonis,sabondo01,79,SAC,0,OKC,8,13,5,1,0,5,33.88333333,8,5,2,7,0,0,4,7,5,1,18,13,21,26,29.1
2023-24,202404090TOR,4/9/2024,TOR vs IND,Gary Trent Jr.,trentga02,69,TOR,1,IND,16,3,4,4,0,3,34,1,2,7,19,0,7,2,4,5,4,7,20,19,23,34.6
2023-24,202404090UTA,4/9/2024,UTA vs DEN,Nikola Jokic,jokicni01,76,DEN,0,UTA,28,13,7,3,1,5,34.06666667,5,8,12,20,2,2,2,2,2,4,20,35,41,48,61.1
2023-24,202404090OKC,4/9/2024,OKC vs SAC,Chet Holmgren,holmgch01,79,OKC,1,SAC,15,9,2,2,2,0,34.1,3,6,5,9,2,5,3,6,1,4,11,17,24,26,40.8
2023-24,202404090HOU,4/9/2024,HOU vs ORL,Markelle Fultz,fultzma01,40,ORL,0,HOU,18,4,2,0,1,3,34.33333333,2,2,8,18,0,2,2,2,3,1,6,20,22,24,25.8
2023-24,202404090PHO,4/9/2024,PHO vs LAC,Amir Coffey,coffeam01,67,LAC,0,PHO,13,4,2,2,0,0,34.43333333,1,3,4,11,3,8,2,2,4,2,6,15,17,19,26.8
2023-24,202404090CHO,4/9/2024,CHO vs DAL,Luka Doncic,doncilu01,69,DAL,0,CHO,39,12,10,0,1,4,34.75,2,10,13,25,8,17,5,7,2,1,22,49,51,61,67.4
2023-24,202404090PHI,4/9/2024,PHI vs DET,Chimezie Metu,metuch01,48,DET,0,PHI,7,11,2,0,0,3,34.76666667,3,8,3,10,1,4,0,0,1,0,13,9,18,20,20.2
2023-24,202404090UTA,4/9/2024,UTA vs DEN,Luka Samanic,samanlu01,40,UTA,1,DEN,15,10,3,0,0,1,34.86666667,3,7,6,15,1,3,2,2,0,0,13,18,25,28,30.5
2023-24,202404090CHO,4/9/2024,CHO vs DAL,Tre Mann,manntr01,38,CHO,1,DAL,11,5,6,1,0,0,34.9,1,4,5,13,0,2,1,2,0,1,11,17,16,22,29
2023-24,202404090CHO,4/9/2024,CHO vs DAL,Brandon Miller,millebr02,72,CHO,1,DAL,21,6,4,3,0,3,34.9,1,5,6,15,4,8,5,5,3,3,10,25,27,31,40.2
2023-24,202404090LAL,4/9/2024,LAL vs GSW,Austin Reaves,reaveau01,81,LAL,1,GSW,22,7,6,0,0,0,34.9,3,4,8,15,4,7,2,3,3,0,13,28,29,35,39.4
2023-24,202404090MIN,4/9/2024,MIN vs WAS,Deni Avdija,avdijde01,73,WAS,0,MIN,15,6,5,0,1,2,35,0,6,4,12,3,5,4,5,4,1,11,20,21,26,30.7
2023-24,202404090CHI,4/9/2024,CHI vs NYK,OG Anunoby,anunoog01,47,NYK,0,CHI,24,3,1,0,1,2,35.13333333,0,3,10,18,4,6,0,0,4,1,4,25,27,28,30.1
2023-24,202404090ATL,4/9/2024,ATL vs MIA,Haywood Highsmith,highsha01,63,MIA,0,ATL,13,7,2,0,0,1,35.45,1,6,5,10,3,7,0,2,3,0,9,15,20,22,23.4
2023-24,202404090MIL,4/9/2024,MIL vs BOS,Jaylen Brown,brownja02,69,BOS,0,MIL,14,10,3,4,0,5,35.53333333,4,6,7,19,0,6,0,0,3,4,13,17,24,27,37.5
2023-24,202404090MIN,4/9/2024,MIN vs WAS,Anthony Gill,gillan01,48,WAS,0,MIN,15,9,3,0,3,0,35.53333333,1,8,6,11,1,3,2,2,2,3,12,18,24,27,39.3
2023-24,202404090LAL,4/9/2024,LAL vs GSW,LeBron James,jamesle01,70,LAL,1,GSW,33,7,11,2,0,4,35.53333333,1,6,14,22,1,3,4,5,0,2,18,44,40,51,59.9
2023-24,202404090POR,4/9/2024,POR vs NOP,Deandre Ayton,aytonde01,53,POR,1,NOP,30,13,1,1,0,3,35.65,3,10,15,22,0,1,0,0,2,1,14,31,43,44,47.1
2023-24,202404090OKC,4/9/2024,OKC vs SAC,Keon Ellis,elliske01,54,SAC,0,OKC,26,6,5,2,2,5,35.65,2,4,9,17,8,15,0,0,5,4,11,31,32,37,47.7
2023-24,202404090OKC,4/9/2024,OKC vs SAC,Jalen Williams,willija06,68,OKC,1,SAC,11,6,4,1,0,2,35.7,0,6,5,11,1,2,0,0,0,1,10,15,17,21,25.2
2023-24,202404090PHI,4/9/2024,PHI vs DET,Joel Embiid,embiijo01,38,PHI,1,DET,37,11,8,3,2,5,35.81666667,2,9,12,22,4,9,9,10,4,5,19,45,48,56,72.2
2023-24,202404090CHO,4/9/2024,CHO vs DAL,Miles Bridges,bridgmi02,67,CHO,1,DAL,22,5,3,1,1,2,36,1,4,8,15,2,4,4,4,3,2,8,25,27,30,36.5
2023-24,202404090MEM,4/9/2024,MEM vs SAS,Jordan Goodwin,goodwjo01,55,MEM,1,SAS,10,19,5,0,0,1,36.15,8,11,5,15,0,2,0,0,1,0,24,15,29,34,39.3
2023-24,202404090HOU,4/9/2024,HOU vs ORL,Paolo Banchero,banchpa01,77,ORL,0,HOU,21,7,6,0,0,4,36.2,0,7,7,19,0,5,7,7,1,0,13,27,28,34,34.4
2023-24,202404090MIN,4/9/2024,MIN vs WAS,Corey Kispert,kispeco01,78,WAS,0,MIN,25,3,5,0,0,2,36.25,1,2,9,17,5,10,2,2,0,0,8,30,28,33,34.1
2023-24,202404090MIL,4/9/2024,MIL vs BOS,Damian Lillard,lillada01,71,MIL,1,BOS,12,3,5,1,1,3,36.31666667,1,2,5,11,2,5,0,0,0,2,8,17,15,20,26.1
2023-24,202404090ATL,4/9/2024,ATL vs MIA,Clint Capela,capelca01,71,ATL,1,MIA,6,11,2,0,0,1,36.6,6,5,3,8,0,0,0,0,1,0,13,8,17,19,21.2
2023-24,202404090CHI,4/9/2024,CHI vs NYK,Alex Caruso,carusal01,69,CHI,1,NYK,9,5,6,2,2,1,37,2,3,3,7,3,5,0,0,3,4,11,15,14,20,35
2023-24,202404090LAL,4/9/2024,LAL vs GSW,D'Angelo Russell,russeda01,75,LAL,1,GSW,14,2,7,0,0,0,37.01666667,0,2,3,11,2,7,6,6,2,0,9,21,16,23,26.9
2023-24,202404090UTA,4/9/2024,UTA vs DEN,Omer Yurtseven,yurtsom01,45,UTA,1,DEN,20,11,2,2,0,3,37.26666667,4,7,9,14,0,1,2,2,1,2,13,22,31,33,39.2
2023-24,202404090CHO,4/9/2024,CHO vs DAL,Kyrie Irving,irvinky01,57,DAL,0,CHO,18,8,9,2,3,2,37.3,2,6,6,15,2,8,4,5,3,5,17,27,26,35,54.1
2023-24,202404090POR,4/9/2024,POR vs NOP,Kris Murray,murrakr01,59,POR,1,NOP,14,5,2,1,2,4,37.31666667,3,2,4,8,4,6,2,2,5,3,7,16,19,21,28
2023-24,202404090MIL,4/9/2024,MIL vs BOS,Jayson Tatum,tatumja01,73,BOS,0,MIL,22,5,6,0,1,2,37.43333333,0,5,9,19,4,9,0,0,1,1,11,28,27,33,38
2023-24,202404090MIN,4/9/2024,MIN vs WAS,Anthony Edwards,edwaran01,76,MIN,1,WAS,51,6,7,0,0,2,37.56666667,1,5,17,29,6,13,11,11,0,0,13,58,57,64,66.7
2023-24,202404090CHI,4/9/2024,CHI vs NYK,Donte DiVincenzo,divindo01,78,NYK,0,CHI,21,4,6,1,0,3,37.58333333,1,3,8,15,3,9,2,2,3,1,10,27,25,31,34.8
2023-24,202404090PHO,4/9/2024,PHO vs LAC,Terance Mann,mannte01,72,LAC,0,PHO,17,10,1,0,0,2,37.63333333,4,6,8,10,1,1,0,0,4,0,11,18,27,28,28.5
2023-24,202404090HOU,4/9/2024,HOU vs ORL,Amen Thompson,thompam01,59,HOU,1,ORL,13,8,4,2,1,4,37.63333333,3,5,6,7,0,0,1,2,2,3,12,17,21,25,33.6
2023-24,202404090HOU,4/9/2024,HOU vs ORL,Fred VanVleet,vanvlfr01,72,HOU,1,ORL,37,8,6,1,1,2,37.65,1,7,13,22,6,11,5,6,4,2,14,43,45,51,59.6
2023-24,202404090POR,4/9/2024,POR vs NOP,Herbert Jones,joneshe01,73,NOP,0,POR,7,4,2,2,0,1,37.78333333,2,2,1,5,1,4,4,4,2,2,6,9,11,13,19.8
2023-24,202404090POR,4/9/2024,POR vs NOP,Trey Murphy III,murphtr02,54,NOP,0,POR,31,8,3,2,0,0,37.86666667,1,7,9,17,5,12,8,8,1,2,11,34,39,42,51.1
2023-24,202404090OKC,4/9/2024,OKC vs SAC,Shai Gilgeous-Alexander,gilgesh01,72,OKC,1,SAC,40,7,4,2,2,5,37.88333333,1,6,11,21,2,3,16,20,2,4,11,44,47,51,61.4
2023-24,202404090OKC,4/9/2024,OKC vs SAC,Keegan Murray,murrake02,74,SAC,0,OKC,15,10,2,0,0,0,38.28333333,3,7,5,16,3,10,2,2,0,0,12,17,25,27,30
2023-24,202404090MIN,4/9/2024,MIN vs WAS,Patrick Baldwin Jr.,baldwpa01,36,WAS,0,MIN,15,6,4,2,0,1,38.35,1,5,6,11,3,8,0,0,4,2,10,19,21,25,33.2
2023-24,202404090MIN,4/9/2024,MIN vs WAS,Rudy Gobert,goberru01,73,MIN,1,WAS,19,16,3,2,4,1,38.35,5,11,5,9,0,0,9,13,3,6,19,22,35,38,59.7
2023-24,202404090CHI,4/9/2024,CHI vs NYK,Nikola Vucevic,vucevni01,74,CHI,1,NYK,26,5,1,0,1,0,38.73333333,2,3,12,16,2,3,0,0,2,1,6,27,31,32,36.5
2023-24,202404090PHO,4/9/2024,PHO vs LAC,Paul George,georgpa01,73,LAC,0,PHO,23,7,5,1,1,6,39.03333333,0,7,7,15,3,5,6,6,4,2,12,28,30,35,38.9
2023-24,202404090PHO,4/9/2024,PHO vs LAC,Bradley Beal,bealbr01,50,PHO,1,LAC,19,7,3,1,5,2,39.3,2,5,6,13,1,2,6,6,2,6,10,22,26,29,47.9
2023-24,202404090ATL,4/9/2024,ATL vs MIA,Nikola Jovic,jovicni01,43,MIA,0,ATL,23,8,1,0,0,1,39.51666667,0,8,8,12,5,8,2,2,2,0,9,24,31,32,33.1
2023-24,202404090PHO,4/9/2024,PHO vs LAC,Russell Westbrook,westbru01,67,LAC,0,PHO,16,15,15,2,0,5,39.68333333,2,13,7,17,2,4,0,0,3,2,30,31,31,46,57.5
2023-24,202404090PHO,4/9/2024,PHO vs LAC,Devin Booker,bookede01,65,PHO,1,LAC,12,3,5,2,0,3,39.75,1,2,1,11,0,4,10,11,2,2,8,17,15,20,26.1
2023-24,202404090PHO,4/9/2024,PHO vs LAC,Kevin Durant,duranke01,72,PHO,1,LAC,21,2,2,2,0,1,39.95,0,2,8,22,2,5,3,5,2,2,4,23,23,25,31.4
2023-24,202404090HOU,4/9/2024,HOU vs ORL,Jabari Smith Jr.,smithja05,73,HOU,1,ORL,23,7,5,0,2,2,40.48333333,1,6,9,17,3,5,2,2,3,2,12,28,30,35,42.9
2023-24,202404090POR,4/9/2024,POR vs NOP,Scoot Henderson,hendesc01,60,POR,1,NOP,19,3,15,1,0,8,40.53333333,2,1,7,18,2,10,3,3,4,1,18,34,22,37,40.1
2023-24,202404090CHI,4/9/2024,CHI vs NYK,Coby White,whiteco01,76,CHI,1,NYK,24,3,6,1,0,2,42.21666667,0,3,11,22,2,8,0,2,3,1,9,30,27,33,37.6
2023-24,202404090CHI,4/9/2024,CHI vs NYK,DeMar DeRozan,derozde01,77,CHI,1,NYK,34,5,6,0,0,4,42.33333333,0,5,12,22,1,3,9,11,2,0,11,40,39,45,45
2023-24,202404090CHI,4/9/2024,CHI vs NYK,Jalen Brunson,brunsja01,74,NYK,0,CHI,45,3,8,1,0,1,42.43333333,0,3,13,24,7,12,12,12,0,1,11,53,48,56,62.6
2023-24,202404090OKC,4/9/2024,OKC vs SAC,De'Aaron Fox,foxde01,71,SAC,0,OKC,33,8,6,2,0,2,42.7,0,8,12,29,7,17,2,4,2,2,14,39,41,47,55.6
2023-24,202404090ATL,4/9/2024,ATL vs MIA,Jimmy Butler,butleji01,57,MIA,0,ATL,25,8,9,3,0,3,44.01666667,0,8,7,14,1,3,10,13,1,3,17,34,33,42,54.1
2023-24,202404090ATL,4/9/2024,ATL vs MIA,Bogdan Bogdanovic,bogdabo01,76,ATL,1,MIA,11,1,2,1,1,5,44.63333333,0,1,4,17,1,11,2,2,3,2,3,13,12,14,16.2
2023-24,202404090CHI,4/9/2024,CHI vs NYK,Josh Hart,hartjo01,78,NYK,0,CHI,17,13,7,1,0,1,46.1,2,11,6,7,1,1,4,4,3,1,20,24,30,37,45.1
2023-24,202404090ATL,4/9/2024,ATL vs MIA,De'Andre Hunter,huntede01,55,ATL,1,MIA,23,11,3,2,1,0,46.63333333,1,10,10,23,2,8,1,2,4,3,14,26,34,37,49.7
2023-24,202404090ATL,4/9/2024,ATL vs MIA,Tyler Herro,herroty01,39,MIA,0,ATL,33,5,4,0,0,3,47.65,0,5,13,25,4,13,3,4,4,0,9,37,38,42,42
2023-24,202404090ATL,4/9/2024,ATL vs MIA,Bam Adebayo,adebaba01,68,MIA,0,ATL,10,7,7,3,1,5,47.68333333,0,7,4,8,2,2,0,0,2,4,14,17,17,24,35.9
2023-24,202404090ATL,4/9/2024,ATL vs MIA,Dejounte Murray,murrade01,76,ATL,1,MIA,29,13,13,4,0,4,48.7,4,9,12,31,3,12,2,2,4,4,26,42,42,55,72.1
2023-24,202404070IND,4/7/2024,IND vs MIA,Jalen Smith,smithja04,58,IND,1,MIA,4,1,2,0,0,0,10.68333333,0,1,2,6,0,2,0,0,1,0,3,6,5,7,8.2
2023-24,202404070ORL,4/7/2024,ORL vs CHI,Onuralp Bitim,bitimon01,21,CHI,0,ORL,4,0,0,0,0,0,10.86666667,0,0,2,4,0,1,0,0,1,0,0,4,4,4,4
2023-24,202404070BRK,4/7/2024,BRK vs SAC,Harrison Barnes,barneha02,78,SAC,0,BRK,2,0,0,0,0,0,11.25,0,0,1,4,0,2,0,0,1,0,0,2,2,2,2
2023-24,202404070LAL,4/7/2024,LAL vs MIN,Anthony Davis,davisan02,75,LAL,1,MIN,4,4,3,2,0,1,12,3,1,2,6,0,0,0,0,2,2,7,7,8,11,18.3
2023-24,202404070BOS,4/7/2024,BOS vs POR,Svi Mykhailiuk,mykhasv01,37,BOS,1,POR,5,2,2,0,0,1,12,0,2,2,4,1,2,0,0,2,0,4,7,7,9,9.4
2023-24,202404070IND,4/7/2024,IND vs MIA,Duncan Robinson,robindu01,68,MIA,0,IND,0,3,0,0,0,2,12,0,3,0,4,0,4,0,0,3,0,3,0,3,3,1.6
2023-24,202404070SAS,4/7/2024,SAS vs PHI,Jeff Dowtin,dowtije01,9,PHI,0,SAS,0,2,1,1,0,0,12.45,0,2,0,2,0,1,0,0,0,1,3,1,2,3,6.9
2023-24,202404070LAC,4/7/2024,LAC vs CLE,Marcus Morris,morrima03,48,CLE,0,LAC,2,1,0,0,0,0,12.55,0,1,1,1,0,0,0,0,3,0,1,2,3,3,3.2
2023-24,202404070IND,4/7/2024,IND vs MIA,Jaime Jaquez Jr.,jaqueja01,71,MIA,0,IND,3,3,1,0,0,0,12.63333333,1,2,1,2,0,0,1,1,2,0,4,4,6,7,8.1
2023-24,202404070MIL,4/7/2024,MIL vs NYK,Khris Middleton,middlkh01,52,MIL,1,NYK,5,4,2,0,0,2,13.01666667,2,2,2,4,1,1,0,0,0,0,6,7,9,11,10.8
2023-24,202404070GSW,4/7/2024,GSW vs UTA,Kevon Looney,looneke01,71,GSW,1,UTA,4,3,1,1,0,0,13.08333333,1,2,2,3,0,0,0,0,2,1,4,5,7,8,12.1
2023-24,202404070LAL,4/7/2024,LAL vs MIN,Jordan McLaughlin,mclaujo01,52,MIN,0,LAL,6,2,2,1,0,1,13.26666667,0,2,2,3,2,3,0,0,3,1,4,8,8,10,13.4
2023-24,202404070MIL,4/7/2024,MIL vs NYK,A.J. Green,greenaj01,54,MIL,1,NYK,2,0,0,1,0,0,13.46666667,0,0,1,3,0,2,0,0,1,1,0,2,2,2,5
2023-24,202404070LAL,4/7/2024,LAL vs MIN,Cam Reddish,reddica01,48,LAL,1,MIN,5,2,0,0,0,0,13.81666667,1,1,2,4,1,2,0,0,1,0,2,5,7,7,7.4
2023-24,202404070TOR,4/7/2024,TOR vs WAS,Justin Champagnie,champju01,13,WAS,0,TOR,2,1,0,1,1,1,13.91666667,1,0,1,3,0,2,0,0,0,2,1,2,3,3,8.2
2023-24,202404070LAC,4/7/2024,LAC vs CLE,Georges Niang,niangge01,79,CLE,0,LAC,2,2,2,1,0,0,14.05,0,2,1,5,0,2,0,0,2,1,4,4,4,6,10.4
2023-24,202404070PHO,4/7/2024,PHO vs NOP,Royce O'Neale,onealro01,75,PHO,1,NOP,0,2,1,1,2,1,14.05,1,1,0,2,0,2,0,0,0,3,3,1,2,3,11.9
2023-24,202404070DAL,4/7/2024,DAL vs HOU,Aaron Holiday,holidaa01,75,HOU,0,DAL,3,0,0,1,0,1,14.1,0,0,1,2,1,2,0,0,3,1,0,3,3,3,5
2023-24,202404070LAL,4/7/2024,LAL vs MIN,Monte Morris,morrimo01,29,MIN,0,LAL,5,2,1,1,0,1,14.36666667,0,2,2,4,1,2,0,0,1,1,3,6,7,8,10.9
2023-24,202404070LAC,4/7/2024,LAC vs CLE,P.J. Tucker,tuckepj01,28,LAC,1,CLE,0,1,1,0,0,0,14.46666667,1,0,0,1,0,1,0,0,1,0,2,1,1,2,2.7
2023-24,202404070SAS,4/7/2024,SAS vs PHI,Zach Collins,colliza01,65,SAS,1,PHI,9,4,2,0,2,3,14.7,3,1,3,7,0,0,3,3,3,2,6,11,13,15,19.8
2023-24,202404070CHO,4/7/2024,CHO vs OKC,Lindy Waters III,waterli01,35,OKC,0,CHO,10,0,0,1,0,0,14.86666667,0,0,4,5,2,3,0,0,1,1,0,10,10,10,13
2023-24,202404070SAS,4/7/2024,SAS vs PHI,Mo Bamba,bambamo01,54,PHI,0,SAS,3,7,1,0,2,0,14.88333333,1,6,1,6,1,3,0,0,4,2,8,4,10,11,18.9
2023-24,202404070ORL,4/7/2024,ORL vs CHI,Dalen Terry,terryda01,55,CHI,0,ORL,2,2,0,1,0,1,15.2,0,2,1,4,0,2,0,0,2,1,2,2,4,4,6.4
2023-24,202404070MIL,4/7/2024,MIL vs NYK,Jae Crowder,crowdja01,47,MIL,1,NYK,0,2,3,0,0,1,15.3,1,1,0,1,0,0,0,0,0,0,5,3,2,5,5.9
2023-24,202404070ORL,4/7/2024,ORL vs CHI,Moritz Wagner,wagnemo01,76,ORL,1,CHI,8,4,0,2,0,0,15.48333333,1,3,3,11,0,3,2,2,1,2,4,8,12,12,18.8
2023-24,202404070IND,4/7/2024,IND vs MIA,Obi Toppin,toppiob01,80,IND,1,MIA,13,3,2,0,0,0,15.53333333,0,3,5,7,3,4,0,0,3,0,5,15,16,18,19.6
2023-24,202404070BOS,4/7/2024,BOS vs POR,Duop Reath,reathdu01,64,POR,0,BOS,0,5,1,0,0,0,15.63333333,2,3,0,5,0,3,0,0,0,0,6,1,5,6,7.5
2023-24,202404070CHO,4/7/2024,CHO vs OKC,Jaylin Williams,willija07,65,OKC,0,CHO,6,2,3,0,0,0,15.9,1,1,2,6,2,4,0,0,1,0,5,9,8,11,12.9
2023-24,202404070DAL,4/7/2024,DAL vs HOU,Jock Landale,landajo01,52,HOU,0,DAL,13,1,2,1,0,2,15.98333333,1,0,5,7,0,0,3,6,3,1,3,15,14,16,18.2
2023-24,202404070GSW,4/7/2024,GSW vs UTA,Gary Payton II,paytoga02,43,GSW,1,UTA,4,3,2,0,0,0,16.1,0,3,2,2,0,0,0,0,3,0,5,6,7,9,10.6
2023-24,202404070DAL,4/7/2024,DAL vs HOU,Daniel Gafford,gaffoda01,71,DAL,1,HOU,6,1,0,0,1,2,16.31666667,0,1,3,3,0,0,0,1,5,1,1,6,7,7,8.2
2023-24,202404070GSW,4/7/2024,GSW vs UTA,Kira Lewis Jr.,lewiski01,27,UTA,0,GSW,5,1,2,1,0,0,16.36666667,0,1,2,4,0,1,1,2,0,1,3,7,6,8,12.2
2023-24,202404070ORL,4/7/2024,ORL vs CHI,Cole Anthony,anthoco01,77,ORL,1,CHI,6,2,0,0,1,2,16.46666667,0,2,2,8,0,2,2,2,0,1,2,6,8,8,9.4
2023-24,202404070PHO,4/7/2024,PHO vs NOP,Drew Eubanks,eubandr01,72,PHO,1,NOP,0,9,2,0,1,1,16.71666667,4,5,0,3,0,0,0,0,3,1,11,2,9,11,15.8
2023-24,202404070TOR,4/7/2024,TOR vs WAS,Jared Butler,butleja02,37,WAS,0,TOR,7,3,2,0,1,2,16.83333333,0,3,3,4,1,1,0,0,3,1,5,9,10,12,14.6
2023-24,202404070MIL,4/7/2024,MIL vs NYK,Bojan Bogdanovic,bogdabo02,53,NYK,0,MIL,15,1,1,0,0,0,16.98333333,0,1,6,9,1,1,2,2,1,0,2,16,16,17,17.7
2023-24,202404070BOS,4/7/2024,BOS vs POR,Xavier Tillman Sr.,tillmxa01,50,BOS,1,POR,9,5,1,1,2,0,17.2,0,5,4,7,1,2,0,0,0,3,6,10,14,15,25.5
2023-24,202404070LAC,4/7/2024,LAC vs CLE,Mason Plumlee,plumlma01,42,LAC,1,CLE,6,5,2,0,0,1,17.3,1,4,3,4,0,0,0,0,4,0,7,8,11,13,14
2023-24,202404070DAL,4/7/2024,DAL vs HOU,Jeff Green,greenje02,74,HOU,0,DAL,7,1,1,2,0,0,17.38333333,1,0,3,12,1,8,0,0,0,2,2,8,8,9,15.7
2023-24,202404070DAL,4/7/2024,DAL vs HOU,Tim Hardaway Jr.,hardati02,75,DAL,1,HOU,5,1,0,0,0,0,17.6,0,1,2,6,1,4,0,0,2,0,1,5,6,6,6.2
2023-24,202404070CHO,4/7/2024,CHO vs OKC,Nick Richards,richani01,65,CHO,1,OKC,10,4,1,1,0,1,17.9,2,2,4,6,0,0,2,2,3,1,5,11,14,15,18.3
2023-24,202404070SAS,4/7/2024,SAS vs PHI,Blake Wesley,weslebl01,57,SAS,1,PHI,6,4,0,0,0,0,17.91666667,1,3,3,4,0,1,0,0,2,0,4,6,10,10,10.8
2023-24,202404070MIL,4/7/2024,MIL vs NYK,Miles McBride,mcbrimi01,65,NYK,0,MIL,8,2,1,3,0,0,18,1,1,3,6,2,4,0,0,1,3,3,9,10,11,20.9
2023-24,202404070PHO,4/7/2024,PHO vs NOP,Eric Gordon,gordoer01,65,PHO,1,NOP,5,0,2,0,0,0,18.35,0,0,2,5,1,4,0,0,0,0,2,7,5,7,8
2023-24,202404070LAL,4/7/2024,LAL vs MIN,Kyle Anderson,anderky01,75,MIN,0,LAL,8,3,2,3,1,1,18.45,1,2,4,11,0,3,0,0,0,4,5,10,11,13,25.6
2023-24,202404070BOS,4/7/2024,BOS vs POR,Luke Kornet,kornelu01,59,BOS,1,POR,2,5,1,0,0,0,18.55,3,2,1,1,0,0,0,0,0,0,6,3,7,8,9.5
2023-24,202404070ORL,4/7/2024,ORL vs CHI,Torrey Craig,craigto01,49,CHI,0,ORL,0,1,1,1,0,1,18.73333333,1,0,0,2,0,2,0,0,0,1,2,1,1,2,4.7
2023-24,202404070SAS,4/7/2024,SAS vs PHI,Cameron Payne,payneca01,75,PHI,0,SAS,3,1,3,0,0,2,18.98333333,0,1,1,8,1,5,0,0,1,0,4,6,4,7,6.7
2023-24,202404070BRK,4/7/2024,BRK vs SAC,Keon Ellis,elliske01,53,SAC,0,BRK,6,2,1,0,1,2,19.01666667,0,2,2,7,2,6,0,0,2,1,3,7,8,9,10.9
2023-24,202404070IND,4/7/2024,IND vs MIA,Haywood Highsmith,highsha01,62,MIA,0,IND,0,4,1,0,1,0,19.11666667,1,3,0,1,0,1,0,0,1,1,5,1,4,5,9.3
2023-24,202404070MIL,4/7/2024,MIL vs NYK,Mitchell Robinson,robinmi01,27,NYK,0,MIL,1,6,0,0,3,0,19.15,3,3,0,2,0,0,1,2,4,3,6,1,7,7,17.2
2023-24,202404070GSW,4/7/2024,GSW vs UTA,Omer Yurtseven,yurtsom01,44,UTA,0,GSW,8,7,0,0,0,0,19.21666667,1,6,4,7,0,0,0,0,0,0,7,8,15,15,16.4
2023-24,202404070DAL,4/7/2024,DAL vs HOU,Cam Whitmore,whitmca01,43,HOU,0,DAL,11,4,0,1,2,0,19.23333333,0,4,3,6,1,3,4,4,2,3,4,11,15,15,24.8
2023-24,202404070SAS,4/7/2024,SAS vs PHI,Buddy Hield,hieldbu01,82,PHI,0,SAS,10,2,3,1,0,2,19.58333333,1,1,3,7,2,5,2,2,1,1,5,13,12,15,17.9
2023-24,202404070TOR,4/7/2024,TOR vs WAS,Bruce Brown,brownbr01,65,TOR,1,WAS,9,2,1,1,0,0,19.68333333,0,2,4,7,0,2,1,2,3,1,3,10,11,12,15.9
2023-24,202404070IND,4/7/2024,IND vs MIA,Ben Sheppard,sheppbe01,55,IND,1,MIA,0,1,2,0,0,0,19.95,0,1,0,3,0,3,0,0,3,0,3,2,1,3,4.2
2023-24,202404070ORL,4/7/2024,ORL vs CHI,Franz Wagner,wagnefr01,70,ORL,1,CHI,16,4,3,1,0,0,20.01666667,2,2,5,10,1,4,5,5,1,1,7,19,20,23,28.3
2023-24,202404070CHO,4/7/2024,CHO vs OKC,Aleksej Pokusevski,pokusal01,24,CHO,1,OKC,14,9,0,0,1,1,20.55,1,8,6,9,2,4,0,0,0,1,9,14,23,23,26.8
2023-24,202404070ORL,4/7/2024,ORL vs CHI,Joe Ingles,inglejo01,64,ORL,1,CHI,9,3,5,2,0,4,20.75,0,3,3,4,3,4,0,0,2,2,8,14,12,17,22.1
2023-24,202404070BOS,4/7/2024,BOS vs POR,Jrue Holiday,holidjr01,67,BOS,1,POR,12,1,2,0,0,0,20.91666667,0,1,5,8,2,3,0,0,1,0,3,14,13,15,16.2
2023-24,202404070BOS,4/7/2024,BOS vs POR,Al Horford,horfoal01,64,BOS,1,POR,7,6,3,1,0,1,20.91666667,1,5,3,6,1,4,0,0,0,1,9,10,13,16,20.7
2023-24,202404070GSW,4/7/2024,GSW vs UTA,Micah Potter,pottemi01,14,UTA,0,GSW,5,5,3,1,1,0,20.91666667,3,2,2,8,0,3,1,1,1,2,8,8,10,13,21.5
2023-24,202404070TOR,4/7/2024,TOR vs WAS,Eugene Omoruyi,omorueu01,40,WAS,0,TOR,4,1,2,2,0,0,21,1,0,1,6,0,2,2,3,1,2,3,6,5,7,14.2
2023-24,202404070CHO,4/7/2024,CHO vs OKC,Isaiah Joe,joeis01,74,OKC,0,CHO,10,1,3,1,0,0,21.01666667,0,1,4,6,2,4,0,0,0,1,4,13,11,14,18.7
2023-24,202404070GSW,4/7/2024,GSW vs UTA,Draymond Green,greendr01,53,GSW,1,UTA,3,3,3,2,1,2,21.06666667,1,2,1,4,1,2,0,0,1,3,6,6,6,9,18.1
2023-24,202404070IND,4/7/2024,IND vs MIA,Terry Rozier,roziete01,61,MIA,0,IND,4,0,4,2,0,0,21.75,0,0,2,7,0,1,0,0,2,2,4,8,4,8,16
2023-24,202404070ORL,4/7/2024,ORL vs CHI,Javonte Green,greenja02,5,CHI,0,ORL,15,8,1,1,3,1,21.88333333,1,7,6,7,2,3,1,2,3,4,9,16,23,24,37.1
2023-24,202404070SAS,4/7/2024,SAS vs PHI,Ricky Council IV,councri01,29,PHI,0,SAS,11,2,3,4,0,0,22,1,1,4,5,0,0,3,3,1,4,5,14,13,16,29.9
2023-24,202404070PHO,4/7/2024,PHO vs NOP,Jose Alvarado,alvarjo01,52,NOP,0,PHO,15,3,0,1,0,0,22.25,2,1,5,10,5,8,0,0,1,1,3,15,18,18,21.6
2023-24,202404070GSW,4/7/2024,GSW vs UTA,Trayce Jackson-Davis,jackstr02,64,GSW,1,UTA,16,7,0,0,4,2,22.83333333,2,5,8,10,0,0,0,0,2,4,7,16,23,23,34.4
2023-24,202404070BOS,4/7/2024,BOS vs POR,Justin Minaya,minayju01,30,POR,0,BOS,9,2,2,0,1,0,23.01666667,1,1,3,5,3,5,0,0,2,1,4,11,11,13,17.4
2023-24,202404070MIL,4/7/2024,MIL vs NYK,Malik Beasley,beaslma01,75,MIL,1,NYK,9,1,3,0,0,0,23.05,0,1,3,6,3,6,0,0,5,0,4,12,10,13,14.7
2023-24,202404070ORL,4/7/2024,ORL vs CHI,Markelle Fultz,fultzma01,39,ORL,1,CHI,17,6,2,0,1,0,23.05,3,3,8,12,1,1,0,0,2,1,8,19,23,25,30.2
2023-24,202404070DAL,4/7/2024,DAL vs HOU,Reggie Bullock,bullore01,40,HOU,0,DAL,11,3,1,0,1,0,23.18333333,0,3,4,4,3,3,0,0,6,1,4,12,14,15,19.1
2023-24,202404070BRK,4/7/2024,BRK vs SAC,Colby Jones,jonesco02,27,SAC,0,BRK,7,4,4,3,2,1,23.21666667,1,3,3,9,1,6,0,2,3,5,8,11,11,15,31.8
2023-24,202404070SAS,4/7/2024,SAS vs PHI,KJ Martin,martike04,60,PHI,0,SAS,8,2,1,1,0,0,23.4,0,2,4,5,0,0,0,0,1,1,3,9,10,11,14.9
2023-24,202404070TOR,4/7/2024,TOR vs WAS,Tristan Vukcevic,vukcetr01,9,WAS,0,TOR,11,9,4,0,3,2,23.4,3,6,4,10,1,5,2,2,4,3,13,15,20,24,34.8
2023-24,202404070SAS,4/7/2024,SAS vs PHI,Sandro Mamukelashvili,mamuksa01,42,SAS,1,PHI,6,7,3,0,0,0,23.58333333,1,6,1,6,0,2,4,4,2,0,10,9,13,16,18.9
2023-24,202404070SAS,4/7/2024,SAS vs PHI,Keldon Johnson,johnske04,69,SAS,1,PHI,7,4,1,1,1,3,23.7,1,3,2,8,1,5,2,2,3,2,5,8,11,12,16.3
2023-24,202404070CHO,4/7/2024,CHO vs OKC,Cason Wallace,wallaca01,78,OKC,0,CHO,10,4,3,2,0,0,23.83333333,3,1,4,6,2,4,0,0,3,2,7,13,14,17,25.3
2023-24,202404070BRK,4/7/2024,BRK vs SAC,Day'Ron Sharpe,sharpda01,60,BRK,1,SAC,4,4,2,1,1,1,24,2,2,2,5,0,1,0,0,2,2,6,6,8,10,16.8
2023-24,202404070IND,4/7/2024,IND vs MIA,Nikola Jovic,jovicni01,42,MIA,0,IND,18,2,0,0,0,0,24.05,0,2,6,10,2,5,4,4,2,0,2,18,20,20,20.4
2023-24,202404070CHO,4/7/2024,CHO vs OKC,Davis Bertans,bertada01,40,CHO,1,OKC,12,2,0,2,1,2,24.1,0,2,4,9,4,9,0,0,1,3,2,12,14,14,21.4
2023-24,202404070BRK,4/7/2024,BRK vs SAC,Mikal Bridges,bridgmi01,79,BRK,1,SAC,8,5,2,0,0,1,24.35,1,4,3,6,2,3,0,0,1,0,7,10,13,15,16
2023-24,202404070TOR,4/7/2024,TOR vs WAS,Gradey Dick,dickgr01,57,TOR,1,WAS,13,4,0,0,0,0,24.5,0,4,5,9,3,5,0,0,2,0,4,13,17,17,17.8
2023-24,202404070LAL,4/7/2024,LAL vs MIN,Nickeil Alexander-Walker,alexani01,78,MIN,0,LAL,15,2,4,0,0,1,24.51666667,0,2,5,9,2,6,3,3,1,0,6,19,17,21,22.4
2023-24,202404070ORL,4/7/2024,ORL vs CHI,Andre Drummond,drumman01,78,CHI,0,ORL,14,10,0,2,0,0,24.51666667,4,6,7,9,0,0,0,0,2,2,10,14,24,24,32
2023-24,202404070LAL,4/7/2024,LAL vs MIN,Taurean Prince,princta02,76,LAL,1,MIN,6,3,2,0,1,4,24.8,1,2,2,5,0,2,2,2,0,1,5,8,9,11,11.6
2023-24,202404070IND,4/7/2024,IND vs MIA,Andrew Nembhard,nembhan01,65,IND,1,MIA,10,2,2,3,0,0,24.88333333,0,2,5,7,0,1,0,0,4,3,4,12,12,14,24.4
2023-24,202404070LAC,4/7/2024,LAC vs CLE,Isaac Okoro,okorois01,66,CLE,0,LAC,11,3,0,0,0,0,25.28333333,1,2,4,4,0,0,3,4,2,0,3,11,14,14,14.6
2023-24,202404070LAC,4/7/2024,LAC vs CLE,Russell Westbrook,westbru01,66,LAC,1,CLE,8,7,6,1,1,2,25.41666667,2,5,3,9,0,2,2,2,2,2,13,14,15,21,29.4
2023-24,202404070BRK,4/7/2024,BRK vs SAC,Lonnie Walker IV,walkelo01,56,BRK,1,SAC,6,3,0,1,1,1,25.45,0,3,2,10,0,4,2,2,1,2,3,6,9,9,14.6
2023-24,202404070DAL,4/7/2024,DAL vs HOU,Derrick Jones Jr.,jonesde02,73,DAL,1,HOU,10,2,0,1,0,1,25.55,0,2,3,4,2,3,2,2,5,1,2,10,12,12,14.4
2023-24,202404070BOS,4/7/2024,BOS vs POR,Kris Murray,murrakr01,58,POR,0,BOS,10,7,2,1,0,2,25.65,4,3,4,9,2,4,0,0,1,1,9,12,17,19,22.4
2023-24,202404070BOS,4/7/2024,BOS vs POR,Payton Pritchard,pritcpa01,78,BOS,1,POR,20,3,8,1,0,2,25.73333333,0,3,9,13,2,4,0,0,1,1,11,28,23,31,36.6
2023-24,202404070LAL,4/7/2024,LAL vs MIN,Mike Conley,conlemi01,72,MIN,0,LAL,7,4,6,2,0,4,25.8,1,3,2,8,1,5,2,2,3,2,10,13,11,17,22.8
2023-24,202404070GSW,4/7/2024,GSW vs UTA,Moses Moody,moodymo01,62,GSW,1,UTA,8,6,2,1,1,0,25.98333333,1,5,3,12,2,6,0,0,5,2,8,10,14,16,24.2
2023-24,202404070LAC,4/7/2024,LAC vs CLE,James Harden,hardeja01,71,LAC,1,CLE,22,5,5,0,0,2,26.2,0,5,6,11,4,8,6,6,3,0,10,27,27,32,33.5
2023-24,202404070GSW,4/7/2024,GSW vs UTA,Taylor Hendricks,hendrita0,36,UTA,0,GSW,10,3,2,0,1,3,26.26666667,0,3,3,7,3,6,1,2,0,1,5,12,13,15,16.6
2023-24,202404070CHO,4/7/2024,CHO vs OKC,Kenrich Williams,willike04,65,OKC,0,CHO,7,1,2,0,0,3,26.36666667,0,1,3,7,1,3,0,0,5,0,3,9,8,10,8.2
2023-24,202404070IND,4/7/2024,IND vs MIA,T.J. McConnell,mccontj01,69,IND,1,MIA,22,0,5,1,0,2,26.55,0,0,11,14,0,1,0,0,1,1,5,27,22,27,30.5
2023-24,202404070BOS,4/7/2024,BOS vs POR,Sam Hauser,hausesa01,75,BOS,1,POR,10,2,3,1,0,0,27.08333333,0,2,4,6,2,4,0,0,3,1,5,13,12,15,19.9
2023-24,202404070GSW,4/7/2024,GSW vs UTA,Brice Sensabaugh,sensabr01,28,UTA,0,GSW,9,3,3,0,1,1,27.08333333,0,3,4,7,1,2,0,0,2,1,6,12,12,15,19.1
2023-24,202404070GSW,4/7/2024,GSW vs UTA,Collin Sexton,sextoco01,78,UTA,0,GSW,15,2,7,1,1,3,27.16666667,0,2,5,15,0,2,5,6,0,2,9,22,17,24,30.9
2023-24,202404070GSW,4/7/2024,GSW vs UTA,Jonathan Kuminga,kuminjo01,71,GSW,1,UTA,21,10,4,0,1,2,27.23333333,2,8,9,11,1,2,2,2,2,1,14,25,31,35,40
2023-24,202404070BOS,4/7/2024,BOS vs POR,Kristaps Porzingis,porzikr01,56,BOS,1,POR,12,10,2,3,5,2,27.3,1,9,3,7,1,3,5,8,1,8,12,14,22,24,49
2023-24,202404070LAC,4/7/2024,LAC vs CLE,Ivica Zubac,zubaciv01,66,LAC,1,CLE,14,11,1,0,0,3,27.38333333,4,7,7,10,0,0,0,0,1,0,12,15,25,26,25.7
2023-24,202404070BRK,4/7/2024,BRK vs SAC,Davion Mitchell,mitchda01,68,SAC,0,BRK,12,1,3,1,0,1,27.53333333,0,1,3,8,2,5,4,4,0,1,4,15,13,16,19.7
2023-24,202404070TOR,4/7/2024,TOR vs WAS,Ochai Agbaji,agbajoc01,74,TOR,1,WAS,9,3,1,1,1,0,27.56666667,0,3,3,7,0,3,3,6,3,2,4,10,12,13,20.1
2023-24,202404070PHO,4/7/2024,PHO vs NOP,Dyson Daniels,daniedy01,57,NOP,0,PHO,10,6,2,1,1,0,28.01666667,1,5,4,8,1,3,1,2,2,2,8,12,16,18,26.2
2023-24,202404070LAC,4/7/2024,LAC vs CLE,Amir Coffey,coffeam01,66,LAC,1,CLE,3,1,1,1,0,0,28.03333333,1,0,1,6,1,4,0,0,1,1,2,4,4,5,8.7
2023-24,202404070LAC,4/7/2024,LAC vs CLE,Norman Powell,powelno01,74,LAC,1,CLE,14,3,0,1,0,0,28.13333333,1,2,5,13,4,9,0,0,2,1,3,14,17,17,20.6
2023-24,202404070GSW,4/7/2024,GSW vs UTA,Klay Thompson,thompkl01,74,GSW,1,UTA,32,5,4,1,0,1,28.15,0,5,12,23,6,13,2,2,1,1,9,36,37,41,46
2023-24,202404070MIL,4/7/2024,MIL vs NYK,Brook Lopez,lopezbr01,75,MIL,1,NYK,13,5,1,0,3,3,28.76666667,1,4,4,8,2,6,3,4,2,3,6,14,18,19,26.5
2023-24,202404070ORL,4/7/2024,ORL vs CHI,Jalen Suggs,suggsja01,71,ORL,1,CHI,19,3,5,2,1,1,28.83333333,1,2,7,13,3,6,2,2,0,3,8,24,22,27,38.1
2023-24,202404070MIL,4/7/2024,MIL vs NYK,Isaiah Hartenstein,harteis01,72,NYK,0,MIL,18,10,1,1,0,2,28.85,3,7,8,9,0,0,2,3,2,1,11,19,28,29,32.5
2023-24,202404070LAC,4/7/2024,LAC vs CLE,Terance Mann,mannte01,71,LAC,1,CLE,14,4,3,1,0,2,28.95,0,4,6,6,2,2,0,0,5,1,7,17,18,21,24.3
2023-24,202404070BRK,4/7/2024,BRK vs SAC,Trey Lyles,lylestr01,54,SAC,0,BRK,14,10,2,1,2,0,29.21666667,2,8,6,8,2,3,0,0,0,3,12,16,24,26,38
2023-24,202404070MIL,4/7/2024,MIL vs NYK,Bobby Portis,portibo01,78,MIL,1,NYK,24,5,2,0,0,0,29.25,1,4,10,15,4,6,0,0,0,0,7,26,29,31,33
2023-24,202404070LAL,4/7/2024,LAL vs MIN,Jaden McDaniels,mcdanja02,68,MIN,0,LAL,11,3,2,0,0,0,29.46666667,0,3,5,9,0,2,1,1,2,0,5,13,14,16,17.6
2023-24,202404070BOS,4/7/2024,BOS vs POR,Jaylen Brown,brownja02,68,BOS,1,POR,26,4,2,1,1,2,29.83333333,0,4,10,17,3,5,3,3,2,2,6,28,30,32,37.8
2023-24,202404070GSW,4/7/2024,GSW vs UTA,Darius Bazley,bazleda01,5,UTA,0,GSW,6,4,2,0,2,1,30.2,2,2,2,3,0,0,2,2,1,2,6,8,10,12,18.8
2023-24,202404070BRK,4/7/2024,BRK vs SAC,Dennis Schroder,schrode01,79,BRK,1,SAC,4,7,6,0,1,1,30.21666667,0,7,1,12,0,6,2,2,1,1,13,10,11,17,23.4
2023-24,202404070DAL,4/7/2024,DAL vs HOU,Maxi Kleber,klebima01,40,DAL,1,HOU,9,4,3,2,1,1,30.38333333,0,4,1,3,1,3,6,8,4,3,7,12,13,16,26.3
2023-24,202404070SAS,4/7/2024,SAS vs PHI,Paul Reed,reedpa01,79,PHI,0,SAS,11,10,5,1,1,2,30.6,4,6,5,11,1,2,0,0,6,2,15,16,21,26,34.5
2023-24,202404070GSW,4/7/2024,GSW vs UTA,Brandin Podziemski,podzibr01,70,GSW,1,UTA,16,7,6,0,0,1,30.78333333,2,5,6,10,2,4,2,2,0,0,13,22,23,29,32.4
2023-24,202404070CHO,4/7/2024,CHO vs OKC,Chet Holmgren,holmgch01,78,OKC,0,CHO,20,10,2,2,3,3,30.95,3,7,6,12,3,6,5,7,3,5,12,22,30,32,47
2023-24,202404070BOS,4/7/2024,BOS vs POR,Derrick White,whitede01,71,BOS,1,POR,15,1,9,1,0,2,30.96666667,0,1,5,13,3,10,2,2,1,1,10,24,16,25,30.7
2023-24,202404070MIL,4/7/2024,MIL vs NYK,Pat Connaughton,connapa01,72,MIL,1,NYK,5,1,2,0,0,0,31.05,0,1,1,5,1,4,2,2,3,0,3,7,6,8,9.2
2023-24,202404070IND,4/7/2024,IND vs MIA,Tyler Herro,herroty01,38,MIA,0,IND,21,5,1,0,0,1,31.08333333,0,5,6,12,3,7,6,6,3,0,6,22,26,27,27.5
2023-24,202404070PHO,4/7/2024,PHO vs NOP,Jusuf Nurkic,nurkiju01,73,PHO,1,NOP,6,10,6,3,1,3,31.18333333,2,8,2,7,0,0,2,2,5,4,16,12,16,22,36
2023-24,202404070ORL,4/7/2024,ORL vs CHI,Nikola Vucevic,vucevni01,73,CHI,0,ORL,8,5,2,0,0,2,31.18333333,1,4,1,9,0,4,6,7,2,0,7,10,13,15,15
2023-24,202404070CHO,4/7/2024,CHO vs OKC,Vasilije Micic,micicva01,56,CHO,1,OKC,17,1,10,1,0,4,31.2,0,1,6,12,4,7,1,2,2,1,11,27,18,28,32.2
2023-24,202404070LAC,4/7/2024,LAC vs CLE,Evan Mobley,mobleev01,47,CLE,0,LAC,20,6,4,0,0,1,31.4,1,5,8,17,0,2,4,6,1,0,10,24,26,30,32.2
2023-24,202404070PHO,4/7/2024,PHO vs NOP,Larry Nance Jr.,nancela02,59,NOP,0,PHO,9,8,7,3,1,1,31.75,0,8,3,6,0,2,3,3,4,4,15,16,17,24,40.1
2023-24,202404070BRK,4/7/2024,BRK vs SAC,Jalen Wilson,wilsoja03,40,BRK,1,SAC,11,6,3,1,1,3,32.18333333,0,6,4,9,1,4,2,4,1,2,9,14,17,20,25.7
2023-24,202404070IND,4/7/2024,IND vs MIA,Pascal Siakam,siakapa01,77,IND,1,MIA,18,8,1,0,0,0,32.46666667,2,6,7,15,1,3,3,4,4,0,9,19,26,27,29.1
2023-24,202404070CHO,4/7/2024,CHO vs OKC,Tre Mann,manntr01,37,CHO,1,OKC,18,5,6,4,2,5,32.56666667,1,4,7,7,3,3,1,1,2,6,11,24,23,29,46
2023-24,202404070LAL,4/7/2024,LAL vs MIN,Jaxson Hayes,hayesja02,68,LAL,1,MIN,19,10,0,5,1,3,32.6,2,8,8,9,0,0,3,5,3,6,10,19,29,29,46
2023-24,202404070BRK,4/7/2024,BRK vs SAC,Trendon Watford,watfotr01,60,BRK,1,SAC,16,7,2,0,1,4,32.83333333,3,4,7,18,2,5,0,0,4,1,9,18,23,25,26.4
2023-24,202404070IND,4/7/2024,IND vs MIA,Tyrese Haliburton,halibty01,67,IND,1,MIA,12,4,8,0,2,3,32.95,0,4,3,10,2,7,4,4,2,2,12,20,16,24,31.8
2023-24,202404070ORL,4/7/2024,ORL vs CHI,Gary Harris,harriga01,51,ORL,1,CHI,0,1,1,3,0,0,32.98333333,0,1,0,2,0,1,0,0,0,3,2,1,1,2,11.7
2023-24,202404070GSW,4/7/2024,GSW vs UTA,Johnny Juzang,juzanjo01,16,UTA,0,GSW,27,2,1,1,0,2,33.18333333,0,2,9,12,7,8,2,3,4,1,3,28,29,30,31.9
2023-24,202404070BOS,4/7/2024,BOS vs POR,Rayan Rupert,ruperra01,35,POR,0,BOS,9,3,2,1,0,1,33.26666667,1,2,3,8,3,6,0,0,3,1,5,11,12,14,17.6
2023-24,202404070TOR,4/7/2024,TOR vs WAS,Patrick Baldwin Jr.,baldwpa01,35,WAS,0,TOR,16,11,1,2,2,0,33.43333333,1,10,5,10,3,7,3,4,5,4,12,17,27,28,42.7
2023-24,202404070BRK,4/7/2024,BRK vs SAC,De'Aaron Fox,foxde01,70,SAC,0,BRK,20,5,3,1,0,1,33.83333333,1,4,8,20,3,11,1,2,3,1,8,23,25,28,32.5
2023-24,202404070PHO,4/7/2024,PHO vs NOP,Herbert Jones,joneshe01,72,NOP,0,PHO,4,5,3,1,0,3,33.88333333,0,5,0,2,0,2,4,4,4,1,8,7,9,12,14.5
2023-24,202404070CHO,4/7/2024,CHO vs OKC,Luguentz Dort,dortlu01,76,OKC,0,CHO,12,3,2,1,1,3,33.96666667,1,2,4,10,3,5,1,2,0,2,5,14,15,17,21.6
2023-24,202404070GSW,4/7/2024,GSW vs UTA,Keyonte George,georgke01,71,UTA,0,GSW,25,2,1,0,0,1,34.23333333,0,2,8,16,4,11,5,5,1,0,3,26,27,28,27.9
2023-24,202404070BOS,4/7/2024,BOS vs POR,Jabari Walker,walkeja01,69,POR,0,BOS,14,18,0,1,0,2,34.33333333,6,12,5,16,0,3,4,4,3,1,18,14,32,32,36.6
2023-24,202404070ORL,4/7/2024,ORL vs CHI,Wendell Carter Jr.,cartewe01,51,ORL,1,CHI,11,8,3,2,1,0,34.48333333,2,6,5,11,1,6,0,0,5,3,11,14,19,22,34.1
2023-24,202404070TOR,4/7/2024,TOR vs WAS,Kelly Olynyk,olynyke01,75,TOR,1,WAS,21,9,5,3,1,2,34.55,2,7,8,12,2,5,3,4,4,4,14,26,30,35,49.3
2023-24,202404070LAL,4/7/2024,LAL vs MIN,Anthony Edwards,edwaran01,75,MIN,0,LAL,26,1,8,1,0,1,34.73333333,0,1,9,20,3,8,5,5,1,1,9,34,27,35,41.2
2023-24,202404070LAC,4/7/2024,LAC vs CLE,Jarrett Allen,allenja01,74,CLE,0,LAC,17,10,1,1,1,1,34.78333333,2,8,6,12,0,0,5,5,1,2,11,18,27,28,35.5
2023-24,202404070BRK,4/7/2024,BRK vs SAC,Noah Clowney,clownno01,20,BRK,1,SAC,7,10,1,1,0,1,34.86666667,1,9,3,8,0,0,1,2,3,1,11,8,17,18,22.5
2023-24,202404070SAS,4/7/2024,SAS vs PHI,Devonte Graham,grahade01,19,SAS,1,PHI,9,3,6,0,0,3,34.93333333,0,3,3,11,2,9,1,1,1,0,9,15,12,18,18.6
2023-24,202404070BRK,4/7/2024,BRK vs SAC,Domantas Sabonis,sabondo01,78,SAC,0,BRK,18,20,9,1,2,3,34.98333333,5,15,7,14,0,1,4,5,4,3,29,27,38,47,61.5
2023-24,202404070LAL,4/7/2024,LAL vs MIN,Austin Reaves,reaveau01,80,LAL,1,MIN,14,3,2,1,0,4,35.03333333,0,3,4,14,2,8,4,6,3,1,5,16,17,19,19.6
2023-24,202404070BOS,4/7/2024,BOS vs POR,Deandre Ayton,aytonde01,52,POR,0,BOS,22,14,2,2,1,0,35.06666667,7,7,11,23,0,1,0,0,1,3,16,24,36,38,50.8
2023-24,202404070TOR,4/7/2024,TOR vs WAS,Gary Trent Jr.,trentga02,68,TOR,1,WAS,20,7,5,3,0,0,35.1,0,7,9,16,2,4,0,0,0,3,12,25,27,32,44.9
2023-24,202404070DAL,4/7/2024,DAL vs HOU,Dante Exum,exumda01,52,DAL,1,HOU,14,9,2,0,0,4,35.15,1,8,5,11,2,4,2,2,3,0,11,16,23,25,23.8
2023-24,202404070LAL,4/7/2024,LAL vs MIN,Naz Reid,reidna01,77,MIN,0,LAL,31,11,1,2,1,1,35.41666667,1,10,12,16,6,8,1,3,5,3,12,32,42,43,53.7
2023-24,202404070ORL,4/7/2024,ORL vs CHI,Ayo Dosunmu,dosunay01,76,CHI,0,ORL,14,5,4,2,2,5,35.53333333,1,4,4,7,3,3,3,4,3,4,9,18,19,23,33
2023-24,202404070GSW,4/7/2024,GSW vs UTA,Chris Paul,paulch01,54,GSW,1,UTA,12,1,9,4,1,4,35.55,0,1,5,10,2,6,0,0,2,5,10,21,13,22,37.7
2023-24,202404070LAL,4/7/2024,LAL vs MIN,Spencer Dinwiddie,dinwisp01,73,LAL,1,MIN,18,5,7,0,0,2,35.58333333,1,4,4,7,3,5,7,7,2,0,12,25,23,30,32.5
2023-24,202404070CHO,4/7/2024,CHO vs OKC,Brandon Miller,millebr02,71,CHO,1,OKC,13,3,4,1,3,2,35.58333333,1,2,4,13,1,8,4,5,2,4,7,17,16,20,32.6
2023-24,202404070ORL,4/7/2024,ORL vs CHI,Paolo Banchero,banchpa01,76,ORL,1,CHI,24,6,5,0,0,2,35.7,0,6,8,17,1,5,7,8,5,0,11,29,30,35,36.7
2023-24,202404070CHO,4/7/2024,CHO vs OKC,Aaron Wiggins,wiggiaa01,74,OKC,0,CHO,26,2,5,6,0,2,35.96666667,0,2,11,20,2,6,2,2,2,6,7,31,28,33,51.9
2023-24,202404070LAL,4/7/2024,LAL vs MIN,Rui Hachimura,hachiru01,66,LAL,1,MIN,30,6,1,0,0,0,36,2,4,11,17,4,5,4,4,3,0,7,31,36,37,38.7
2023-24,202404070IND,4/7/2024,IND vs MIA,Caleb Martin,martica02,60,MIA,0,IND,20,3,2,0,0,1,36,1,2,8,10,1,1,3,5,2,0,5,22,23,25,25.6
2023-24,202404070BRK,4/7/2024,BRK vs SAC,Cam Thomas,thomaca02,63,BRK,1,SAC,21,4,1,1,0,4,36.1,0,4,8,18,2,7,3,3,1,1,5,22,25,26,26.3
2023-24,202404070TOR,4/7/2024,TOR vs WAS,RJ Barrett,barrerj01,56,TOR,1,WAS,22,8,7,0,1,6,36.18333333,2,6,9,19,0,3,4,6,3,1,15,29,30,37,39.1
2023-24,202404070TOR,4/7/2024,TOR vs WAS,Immanuel Quickley,quickim01,66,TOR,1,WAS,31,7,13,1,0,4,36.38333333,0,7,9,15,3,7,10,10,5,1,20,44,38,51,57.9
2023-24,202404070BOS,4/7/2024,BOS vs POR,Scoot Henderson,hendesc01,59,POR,0,BOS,15,1,8,2,0,5,36.43333333,0,1,3,13,3,7,6,6,2,2,9,23,16,24,29.2
2023-24,202404070BOS,4/7/2024,BOS vs POR,Dalano Banton,bantoda01,51,POR,0,BOS,28,3,9,1,0,4,36.6,1,2,11,23,3,9,3,3,0,1,12,37,31,40,44.1
2023-24,202404070LAC,4/7/2024,LAC vs CLE,Caris LeVert,leverca01,66,CLE,0,LAC,18,5,2,1,1,0,36.73333333,1,4,7,15,3,8,1,1,3,2,7,20,23,25,33
2023-24,202404070PHO,4/7/2024,PHO vs NOP,Grayson Allen,allengr01,71,PHO,1,NOP,11,5,1,2,2,3,36.78333333,0,5,4,11,3,10,0,0,2,4,6,12,16,17,27.5
2023-24,202404070LAL,4/7/2024,LAL vs MIN,Rudy Gobert,goberru01,72,MIN,0,LAL,18,16,3,2,1,3,36.85,8,8,9,13,0,0,0,0,2,3,19,21,34,37,47.7
2023-24,202404070IND,4/7/2024,IND vs MIA,Bam Adebayo,adebaba01,67,MIA,0,IND,20,12,3,0,1,1,37.01666667,3,9,8,18,1,4,3,4,5,1,15,23,32,35,40.9
2023-24,202404070CHO,4/7/2024,CHO vs OKC,Josh Giddey,giddejo01,77,OKC,0,CHO,20,13,13,1,0,5,37.13333333,2,11,7,15,1,1,5,6,2,1,26,33,33,46,53.1
2023-24,202404070IND,4/7/2024,IND vs MIA,Myles Turner,turnemy01,75,IND,1,MIA,22,13,2,0,2,0,37.31666667,1,12,6,12,2,6,8,8,2,2,15,24,35,37,46.6
2023-24,202404070MIL,4/7/2024,MIL vs NYK,Josh Hart,hartjo01,77,NYK,0,MIL,7,9,9,0,0,0,37.4,2,7,2,9,1,2,2,2,2,0,18,16,16,25,31.3
2023-24,202404070MIL,4/7/2024,MIL vs NYK,Donte DiVincenzo,divindo01,77,NYK,0,MIL,26,4,3,1,1,1,37.45,1,3,8,14,8,11,2,2,3,2,7,29,30,33,40.3
2023-24,202404070ORL,4/7/2024,ORL vs CHI,Coby White,whiteco01,75,CHI,0,ORL,11,2,6,0,0,3,37.6,0,2,4,11,1,5,2,2,3,0,8,17,13,19,19.4
2023-24,202404070MIL,4/7/2024,MIL vs NYK,OG Anunoby,anunoog01,46,NYK,0,MIL,4,3,2,4,2,1,37.78333333,2,1,2,10,0,5,0,0,4,6,5,6,7,9,27.6
2023-24,202404070PHO,4/7/2024,PHO vs NOP,Kevin Durant,duranke01,71,PHO,1,NOP,23,4,6,0,0,0,38.03333333,0,4,8,22,3,8,4,4,1,0,10,29,27,33,36.8
2023-24,202404070BRK,4/7/2024,BRK vs SAC,Keegan Murray,murrake02,73,SAC,0,BRK,19,6,4,0,4,0,38.05,2,4,7,18,3,10,2,2,1,4,10,23,25,29,44.2
2023-24,202404070CHO,4/7/2024,CHO vs OKC,Grant Williams,willigr01,74,CHO,1,OKC,19,3,5,2,1,2,38.33333333,1,2,7,10,2,2,3,4,3,3,8,24,22,27,37.1
2023-24,202404070MIL,4/7/2024,MIL vs NYK,Giannis Antetokounmpo,antetgi01,72,MIL,1,NYK,28,15,8,1,2,4,38.53333333,3,12,10,20,0,1,8,11,2,3,23,36,43,51,63
2023-24,202404070PHO,4/7/2024,PHO vs NOP,Bradley Beal,bealbr01,49,PHO,1,NOP,33,3,5,0,2,3,38.7,2,1,13,19,7,8,0,0,3,2,8,38,36,41,47.1
2023-24,202404070MIL,4/7/2024,MIL vs NYK,Damian Lillard,lillada01,70,MIL,1,NYK,23,4,6,1,2,4,38.7,0,4,4,11,1,7,14,15,2,3,10,29,27,33,41.8
2023-24,202404070PHO,4/7/2024,PHO vs NOP,Devin Booker,bookede01,64,PHO,1,NOP,25,3,7,1,0,4,38.71666667,0,3,9,16,0,6,7,8,3,1,10,32,28,35,38.1
2023-24,202404070PHO,4/7/2024,PHO vs NOP,Trey Murphy III,murphtr02,53,NOP,0,PHO,13,4,2,1,0,0,38.73333333,1,3,4,13,3,10,2,2,2,1,6,15,17,19,23.8
2023-24,202404070LAL,4/7/2024,LAL vs MIN,D'Angelo Russell,russeda01,74,LAL,1,MIN,15,7,11,1,0,1,38.85,0,7,5,19,1,7,4,4,0,1,18,26,22,33,41.9
2023-24,202404070IND,4/7/2024,IND vs MIA,Jimmy Butler,butleji01,56,MIA,0,IND,27,7,8,1,0,0,38.86666667,2,5,7,16,1,3,12,12,1,1,15,35,34,42,50.4
2023-24,202404070LAC,4/7/2024,LAC vs CLE,Max Strus,strusma01,67,CLE,0,LAC,20,4,9,1,0,4,39.21666667,0,4,5,11,4,9,6,6,2,1,13,29,24,33,37.3
2023-24,202404070MIL,4/7/2024,MIL vs NYK,Jalen Brunson,brunsja01,73,NYK,0,MIL,43,6,8,0,0,1,39.43333333,1,5,16,32,2,6,9,11,4,0,14,51,49,57,61.2
2023-24,202404070TOR,4/7/2024,TOR vs WAS,Corey Kispert,kispeco01,77,WAS,0,TOR,21,3,3,0,0,3,39.55,0,3,7,13,5,7,2,4,4,0,6,24,24,27,26.1
2023-24,202404070SAS,4/7/2024,SAS vs PHI,Julian Champagnie,champju02,70,SAS,1,PHI,17,8,3,2,0,0,39.58333333,1,7,5,10,3,6,4,5,3,2,11,20,25,28,37.1
2023-24,202404070IND,4/7/2024,IND vs MIA,Aaron Nesmith,nesmiaa01,70,IND,1,MIA,16,5,3,0,2,1,39.66666667,1,4,5,12,1,5,5,5,4,2,8,19,21,24,31.5
2023-24,202404070CHO,4/7/2024,CHO vs OKC,Miles Bridges,bridgmi02,66,CHO,1,OKC,15,9,3,1,1,1,39.76666667,1,8,7,17,1,7,0,0,1,2,12,18,24,27,35.3
2023-24,202404070PHO,4/7/2024,PHO vs NOP,Zion Williamson,willizi01,66,NOP,0,PHO,29,10,7,1,5,4,39.78333333,3,7,11,21,0,0,7,8,2,6,17,36,39,46,65.5
2023-24,202404070DAL,4/7/2024,DAL vs HOU,Jalen Green,greenja05,78,HOU,0,DAL,21,6,8,2,1,5,39.81666667,0,6,6,15,2,7,7,7,5,3,14,29,27,35,44.2
2023-24,202404070TOR,4/7/2024,TOR vs WAS,Jordan Poole,poolejo01,77,WAS,0,TOR,29,4,12,2,0,3,39.98333333,1,3,10,23,4,10,5,5,2,2,16,41,33,45,54.8
2023-24,202404070ORL,4/7/2024,ORL vs CHI,DeMar DeRozan,derozde01,76,CHI,0,ORL,30,3,5,0,0,7,40.03333333,0,3,13,22,0,0,4,7,1,0,8,35,33,38,34.1
2023-24,202404070LAC,4/7/2024,LAC vs CLE,Darius Garland,garlada01,55,CLE,0,LAC,28,5,8,5,0,5,40.11666667,2,3,10,22,4,8,4,5,1,5,13,36,33,41,56
2023-24,202404070DAL,4/7/2024,DAL vs HOU,Jabari Smith Jr.,smithja05,72,HOU,0,DAL,12,9,2,0,2,0,40.16666667,1,8,5,10,2,4,0,2,5,2,11,14,21,23,31.8
2023-24,202404070TOR,4/7/2024,TOR vs WAS,Deni Avdija,avdijde01,72,WAS,0,TOR,32,10,5,2,3,4,41.23333333,1,9,11,19,2,6,8,12,3,5,15,37,42,47,62.5
2023-24,202404070PHO,4/7/2024,PHO vs NOP,CJ McCollum,mccolcj01,62,NOP,0,PHO,31,4,5,0,0,3,41.56666667,0,4,12,22,7,12,0,0,2,0,9,36,35,40,40.3
2023-24,202404070DAL,4/7/2024,DAL vs HOU,Dillon Brooks,brookdi01,69,HOU,0,DAL,29,2,2,3,0,1,42.26666667,0,2,9,14,5,6,6,7,5,3,4,31,31,33,42.4
2023-24,202404070SAS,4/7/2024,SAS vs PHI,Victor Wembanyama,wembavi01,69,SAS,1,PHI,33,18,6,0,7,9,43.3,3,15,11,20,5,10,6,7,1,7,24,39,51,57,75.6
2023-24,202404070DAL,4/7/2024,DAL vs HOU,P.J. Washington,washipj01,70,DAL,1,HOU,14,13,2,0,2,0,43.38333333,2,11,5,12,2,7,2,2,1,2,15,16,27,29,38.6
2023-24,202404070SAS,4/7/2024,SAS vs PHI,Malaki Branham,branhma01,73,SAS,1,PHI,22,3,1,0,1,2,43.68333333,1,2,8,15,5,8,1,2,0,1,4,23,25,26,28.1
2023-24,202404070LAC,4/7/2024,LAC vs CLE,Paul George,georgpa01,72,LAC,1,CLE,39,11,7,1,1,5,44.11666667,1,10,10,24,3,9,16,16,3,2,18,46,50,57,63.7
2023-24,202404070DAL,4/7/2024,DAL vs HOU,Fred VanVleet,vanvlfr01,71,HOU,0,DAL,24,1,12,1,0,1,44.41666667,0,1,9,21,2,8,4,6,4,1,13,36,25,37,45.2
2023-24,202404070DAL,4/7/2024,DAL vs HOU,Kyrie Irving,irvinky01,56,DAL,1,HOU,48,7,2,1,0,2,44.71666667,0,7,15,25,3,8,15,17,1,1,9,50,55,57,60.4
2023-24,202404070DAL,4/7/2024,DAL vs HOU,Luka Doncic,doncilu01,68,DAL,1,HOU,37,9,12,0,2,7,45.41666667,2,7,12,21,4,10,9,9,5,2,21,49,46,58,64.8
2023-24,202404070SAS,4/7/2024,SAS vs PHI,Nicolas Batum,batumni01,57,PHI,0,SAS,9,7,2,3,0,0,45.66666667,0,7,3,7,3,7,0,0,2,3,9,11,16,18,29.4
2023-24,202404070SAS,4/7/2024,SAS vs PHI,Kelly Oubre Jr.,oubreke01,65,PHI,0,SAS,26,8,5,2,0,3,48.48333333,1,7,12,22,2,6,0,2,2,2,13,31,34,39,46.1
2023-24,202404070SAS,4/7/2024,SAS vs PHI,Tre Jones,jonestr01,73,SAS,1,PHI,17,8,9,2,0,5,48.6,3,5,8,17,0,3,1,2,2,2,17,26,25,34,41.1
2023-24,202404070SAS,4/7/2024,SAS vs PHI,Tyrese Maxey,maxeyty01,68,PHI,0,SAS,52,5,7,2,0,1,53.95,0,5,19,41,2,10,12,12,2,2,12,59,57,64,73.5
2023-24,202404060BRK,4/6/2024,BRK vs DET,Lonnie Walker IV,walkelo01,55,BRK,1,DET,3,1,0,0,0,1,11.21666667,0,1,1,3,1,2,0,0,0,0,1,3,4,4,3.2
2023-24,202404060LAL,4/6/2024,LAL vs CLE,Jaxson Hayes,hayesja02,67,LAL,1,CLE,4,3,0,1,2,1,11.68333333,1,2,2,2,0,0,0,0,2,3,3,4,7,7,15.6
2023-24,202404060MEM,4/6/2024,MEM vs PHI,Ricky Council IV,councri01,28,PHI,0,MEM,3,0,1,1,0,0,12,0,0,1,3,1,2,0,0,0,1,1,4,3,4,7.5
2023-24,202404060DEN,4/6/2024,DEN vs ATL,Julian Strawther,strawju01,47,DEN,1,ATL,5,4,3,0,0,2,12.18333333,0,4,1,4,1,3,2,2,2,0,7,8,9,12,12.3
2023-24,202404060LAL,4/6/2024,LAL vs CLE,Sam Merrill,merrisa01,60,CLE,0,LAL,0,2,1,0,0,0,12.41666667,0,2,0,4,0,4,0,0,0,0,3,1,2,3,3.9
2023-24,202404060DEN,4/6/2024,DEN vs ATL,Kobe Bufkin,bufkiko01,13,ATL,0,DEN,4,3,3,0,0,0,13.65,0,3,2,6,0,3,0,0,1,0,6,7,7,10,12.1
2023-24,202404060DEN,4/6/2024,DEN vs ATL,Zeke Nnaji,nnajize01,54,DEN,1,ATL,5,5,1,1,0,0,14.08333333,0,5,2,3,1,1,0,0,2,1,6,6,10,11,15.5
2023-24,202404060MEM,4/6/2024,MEM vs PHI,Jeff Dowtin,dowtije01,8,PHI,0,MEM,11,5,2,0,0,0,14.33333333,1,4,4,5,2,3,1,1,0,0,7,13,16,18,20
2023-24,202404060LAL,4/6/2024,LAL vs CLE,Gabe Vincent,vincega01,8,LAL,1,CLE,0,0,2,0,0,0,14.35,0,0,0,2,0,0,0,0,1,0,2,2,0,2,3
2023-24,202404060BRK,4/6/2024,BRK vs DET,Malachi Flynn,flynnma01,65,DET,0,BRK,3,3,5,0,0,1,14.81666667,0,3,1,7,1,5,0,0,5,0,8,8,6,11,13.1
2023-24,202404060BRK,4/6/2024,BRK vs DET,Trendon Watford,watfotr01,59,BRK,1,DET,7,2,1,0,0,4,15.68333333,0,2,2,3,0,0,3,4,3,0,3,8,9,10,6.9
2023-24,202404060DEN,4/6/2024,DEN vs ATL,Bruno Fernando,fernabr01,41,ATL,0,DEN,6,6,2,0,0,1,17.56666667,2,4,3,9,0,0,0,0,5,0,8,8,12,14,15.2
2023-24,202404060BRK,4/6/2024,BRK vs DET,Jalen Wilson,wilsoja03,39,BRK,1,DET,10,4,1,1,0,1,18.05,2,2,3,5,2,3,2,4,1,1,5,11,14,15,18.3
2023-24,202404060BRK,4/6/2024,BRK vs DET,Jaylen Nowell,nowelja01,11,DET,0,BRK,12,4,0,0,1,0,18.85,2,2,5,8,2,3,0,0,1,1,4,12,16,16,19.8
2023-24,202404060DEN,4/6/2024,DEN vs ATL,Garrison Mathews,mathega01,62,ATL,0,DEN,11,0,0,2,0,0,19.23333333,0,0,3,6,2,5,3,3,0,2,0,11,11,11,17
2023-24,202404060MEM,4/6/2024,MEM vs PHI,Cameron Payne,payneca01,74,PHI,0,MEM,3,1,4,2,2,2,20.46666667,0,1,1,7,1,6,0,0,2,4,5,7,4,8,20.2
2023-24,202404060BRK,4/6/2024,BRK vs DET,Jared Rhoden,rhodeja01,13,DET,0,BRK,7,2,1,1,1,0,20.58333333,0,2,3,8,0,3,1,2,5,2,3,8,9,10,16.9
2023-24,202404060MEM,4/6/2024,MEM vs PHI,Kyle Lowry,lowryky01,58,PHI,0,MEM,8,1,1,0,1,0,20.8,0,1,3,4,2,3,0,0,4,1,2,9,9,10,13.7
2023-24,202404060DEN,4/6/2024,DEN vs ATL,Jamal Murray,murraja01,55,DEN,1,ATL,16,3,6,0,1,3,20.85,0,3,6,11,2,4,2,2,1,1,9,22,19,25,28.6
2023-24,202404060LAL,4/6/2024,LAL vs CLE,Taurean Prince,princta02,75,LAL,1,CLE,18,4,1,1,0,1,20.88333333,0,4,7,9,4,5,0,0,1,1,5,19,22,23,26.3
2023-24,202404060MEM,4/6/2024,MEM vs PHI,Nicolas Batum,batumni01,56,PHI,0,MEM,9,3,0,0,0,0,20.96666667,1,2,3,5,3,5,0,0,0,0,3,9,12,12,12.6
2023-24,202404060MEM,4/6/2024,MEM vs PHI,KJ Martin,martike04,59,PHI,0,MEM,10,6,1,0,2,3,22.31666667,3,3,5,7,0,0,0,0,3,2,7,11,16,17,21.7
2023-24,202404060LAL,4/6/2024,LAL vs CLE,Georges Niang,niangge01,78,CLE,0,LAL,12,1,1,0,0,2,22.55,0,1,5,6,2,3,0,0,2,0,2,13,13,14,12.7
2023-24,202404060MEM,4/6/2024,MEM vs PHI,Joel Embiid,embiijo01,37,PHI,0,MEM,30,12,1,0,2,8,22.65,3,9,9,13,2,2,10,13,2,2,13,31,42,43,43.9
2023-24,202404060MEM,4/6/2024,MEM vs PHI,Paul Reed,reedpa01,78,PHI,0,MEM,6,5,5,4,0,3,23,0,5,3,4,0,0,0,0,1,4,10,11,11,16,28.5
2023-24,202404060MEM,4/6/2024,MEM vs PHI,Brandon Clarke,clarkbr01,5,MEM,1,PHI,6,8,2,1,0,2,23.46666667,3,5,3,9,0,1,0,2,1,1,10,8,14,16,19.6
2023-24,202404060DEN,4/6/2024,DEN vs ATL,Justin Holiday,holidju01,54,DEN,1,ATL,8,0,6,1,0,1,23.61666667,0,0,3,3,2,2,0,0,2,1,6,14,8,14,19
2023-24,202404060DEN,4/6/2024,DEN vs ATL,Reggie Jackson,jacksre01,78,DEN,1,ATL,18,5,3,0,0,1,23.9,2,3,7,13,3,6,1,2,3,0,8,21,23,26,27.5
2023-24,202404060BRK,4/6/2024,BRK vs DET,Dorian Finney-Smith,finnedo01,68,BRK,1,DET,2,7,1,0,0,3,24.15,2,5,1,5,0,3,0,0,2,0,8,3,9,10,8.9
2023-24,202404060BRK,4/6/2024,BRK vs DET,Noah Clowney,clownno01,19,BRK,1,DET,17,6,0,0,4,0,24.41666667,2,4,6,7,2,3,3,4,0,4,6,17,23,23,36.2
2023-24,202404060DEN,4/6/2024,DEN vs ATL,Christian Braun,braunch01,78,DEN,1,ATL,5,3,1,0,0,1,24.63333333,1,2,2,3,1,1,0,0,1,0,4,6,8,9,9.1
2023-24,202404060DEN,4/6/2024,DEN vs ATL,Michael Porter Jr.,portemi01,77,DEN,1,ATL,20,3,2,1,0,1,24.91666667,1,2,7,12,4,8,2,2,4,1,5,22,23,25,28.6
2023-24,202404060LAL,4/6/2024,LAL vs CLE,Spencer Dinwiddie,dinwisp01,72,LAL,1,CLE,6,2,2,3,0,0,25.05,0,2,2,5,2,4,0,0,0,3,4,8,8,10,20.4
2023-24,202404060MEM,4/6/2024,MEM vs PHI,Tyrese Maxey,maxeyty01,67,PHI,0,MEM,7,1,5,0,0,0,25.21666667,0,1,2,6,1,4,2,2,2,0,6,12,8,13,15.7
2023-24,202404060DEN,4/6/2024,DEN vs ATL,Vit Krejci,krejcvi01,18,ATL,0,DEN,3,5,2,1,0,0,25.28333333,1,4,1,3,1,2,0,0,2,1,7,5,8,10,15
2023-24,202404060MEM,4/6/2024,MEM vs PHI,Buddy Hield,hieldbu01,81,PHI,0,MEM,7,1,1,2,1,1,25.55,0,1,3,12,1,7,0,0,3,3,2,8,8,9,17.7
2023-24,202404060BRK,4/6/2024,BRK vs DET,James Wiseman,wisemja01,59,DET,0,BRK,4,5,0,1,0,2,26.05,1,4,2,5,0,0,0,0,5,1,5,4,9,9,11
2023-24,202404060MEM,4/6/2024,MEM vs PHI,Timmy Allen,allenti01,1,MEM,1,PHI,2,2,0,0,0,1,26.06666667,0,2,1,6,0,3,0,0,2,0,2,2,4,4,3.4
2023-24,202404060MEM,4/6/2024,MEM vs PHI,Kelly Oubre Jr.,oubreke01,64,PHI,0,MEM,17,5,5,2,1,1,26.53333333,1,4,5,10,2,5,5,7,3,3,10,22,22,27,38.5
2023-24,202404060DEN,4/6/2024,DEN vs ATL,Peyton Watson,watsope01,76,DEN,1,ATL,13,6,2,1,5,0,27.06666667,1,5,6,8,0,1,1,2,3,6,8,15,19,21,41.2
2023-24,202404060LAL,4/6/2024,LAL vs CLE,Rui Hachimura,hachiru01,65,LAL,1,CLE,7,5,0,0,1,1,27.11666667,0,5,3,9,1,5,0,2,0,1,5,7,12,12,15
2023-24,202404060DEN,4/6/2024,DEN vs ATL,Kentavious Caldwell-Pope,caldwke01,72,DEN,1,ATL,24,2,1,2,0,2,27.86666667,0,2,9,12,6,9,0,0,2,2,3,25,26,27,31.9
2023-24,202404060LAL,4/6/2024,LAL vs CLE,Caris LeVert,leverca01,65,CLE,0,LAL,21,7,2,0,0,1,28.25,1,6,8,14,1,3,4,4,0,0,9,23,28,30,31.4
2023-24,202404060MEM,4/6/2024,MEM vs PHI,GG Jackson II,jacksgg01,44,MEM,1,PHI,17,6,3,2,0,3,28.86666667,2,4,6,16,1,7,4,6,0,2,9,20,23,26,31.7
2023-24,202404060LAL,4/6/2024,LAL vs CLE,Evan Mobley,mobleev01,46,CLE,0,LAL,8,3,3,2,1,3,28.93333333,1,2,2,6,1,2,3,4,3,3,6,11,11,14,22.1
2023-24,202404060DEN,4/6/2024,DEN vs ATL,De'Andre Hunter,huntede01,54,ATL,0,DEN,18,1,2,1,0,3,29.45,0,1,5,11,2,8,6,7,2,1,3,20,19,21,22.2
2023-24,202404060LAL,4/6/2024,LAL vs CLE,Max Strus,strusma01,66,CLE,0,LAL,5,6,4,0,0,2,29.61666667,2,4,2,8,1,5,0,0,1,0,10,9,11,15,16.2
2023-24,202404060MEM,4/6/2024,MEM vs PHI,Zavier Simpson,simpsza01,3,MEM,1,PHI,14,4,4,2,2,2,30.11666667,2,2,4,12,3,4,3,4,2,4,8,18,18,22,34.8
2023-24,202404060MEM,4/6/2024,MEM vs PHI,Scotty Pippen Jr.,pippesc02,17,MEM,1,PHI,24,2,5,2,0,4,30.4,2,0,9,16,2,4,4,4,5,2,7,29,26,31,35.9
2023-24,202404060BRK,4/6/2024,BRK vs DET,Nic Claxton,claxtni01,68,BRK,1,DET,5,9,3,0,3,1,30.41666667,0,9,2,4,0,0,1,2,1,3,12,8,14,17,28.3
2023-24,202404060DEN,4/6/2024,DEN vs ATL,Clint Capela,capelca01,70,ATL,0,DEN,19,12,3,1,0,1,30.43333333,5,7,5,6,0,0,9,12,2,1,15,22,31,34,39.9
2023-24,202404060DEN,4/6/2024,DEN vs ATL,Nikola Jokic,jokicni01,75,DEN,1,ATL,19,14,11,2,0,4,30.66666667,1,13,6,13,2,3,5,6,1,2,25,30,33,44,54.3
2023-24,202404060BRK,4/6/2024,BRK vs DET,Jaden Ivey,iveyja01,73,DET,0,BRK,16,4,10,2,0,0,30.8,1,3,7,21,2,6,0,0,1,2,14,26,20,30,41.8
2023-24,202404060DEN,4/6/2024,DEN vs ATL,Bogdan Bogdanovic,bogdabo01,75,ATL,0,DEN,18,2,2,1,1,2,30.93333333,1,1,6,10,3,4,3,3,4,2,4,20,20,22,27.4
2023-24,202404060LAL,4/6/2024,LAL vs CLE,D'Angelo Russell,russeda01,73,LAL,1,CLE,28,5,2,1,1,6,31,0,5,11,17,6,12,0,0,2,2,7,30,33,35,37
2023-24,202404060BRK,4/6/2024,BRK vs DET,Mikal Bridges,bridgmi01,78,BRK,1,DET,13,2,3,1,0,3,31.25,0,2,5,10,3,6,0,0,2,1,5,16,15,18,19.9
2023-24,202404060MEM,4/6/2024,MEM vs PHI,Jordan Goodwin,goodwjo01,54,MEM,1,PHI,15,4,4,1,0,0,31.35,2,2,6,13,1,3,2,2,3,1,8,19,19,23,28.8
2023-24,202404060BRK,4/6/2024,BRK vs DET,Marcus Sasser,sassema01,67,DET,0,BRK,18,1,6,1,0,1,33.18333333,0,1,7,17,3,8,1,2,1,1,7,24,19,25,30.2
2023-24,202404060MEM,4/6/2024,MEM vs PHI,Trey Jemison,jemistr01,21,MEM,1,PHI,5,7,2,0,0,3,33.46666667,4,3,2,6,0,0,1,1,2,0,9,7,12,14,13.4
2023-24,202404060LAL,4/6/2024,LAL vs CLE,Austin Reaves,reaveau01,79,LAL,1,CLE,7,2,6,1,0,3,33.48333333,0,2,3,6,1,4,0,0,3,1,8,13,9,15,18.4
2023-24,202404060LAL,4/6/2024,LAL vs CLE,Jarrett Allen,allenja01,73,CLE,0,LAL,12,12,3,1,0,1,33.75,5,7,6,12,0,0,0,0,2,1,15,15,24,27,32.9
2023-24,202404060DEN,4/6/2024,DEN vs ATL,Jalen Johnson,johnsja05,55,ATL,0,DEN,17,6,4,1,0,6,33.85,1,5,8,18,1,5,0,0,0,1,10,21,23,27,27.2
2023-24,202404060BRK,4/6/2024,BRK vs DET,Troy Brown Jr.,browntr01,55,DET,0,BRK,15,2,0,1,0,1,34.35,1,1,5,12,5,8,0,0,2,1,2,15,17,17,19.4
2023-24,202404060LAL,4/6/2024,LAL vs CLE,Darius Garland,garlada01,54,CLE,0,LAL,26,2,2,5,0,1,34.91666667,1,1,11,25,4,9,0,0,1,5,4,28,28,30,45.4
2023-24,202404060DEN,4/6/2024,DEN vs ATL,Dejounte Murray,murrade01,75,ATL,0,DEN,14,2,12,1,1,2,35.88333333,0,2,4,15,3,8,3,4,2,2,14,26,16,28,38.4
2023-24,202404060BRK,4/6/2024,BRK vs DET,Dennis Schroder,schrode01,78,BRK,1,DET,24,5,6,0,0,3,35.88333333,2,3,8,10,1,2,7,8,1,0,11,30,29,35,36
2023-24,202404060LAL,4/6/2024,LAL vs CLE,LeBron James,jamesle01,69,LAL,1,CLE,24,5,12,1,1,5,35.9,0,5,10,18,1,5,3,5,1,2,17,36,29,41,49
2023-24,202404060MEM,4/6/2024,MEM vs PHI,Maozinha Pereira,pereima01,7,MEM,1,PHI,13,11,1,1,0,3,36.26666667,0,11,5,9,2,4,1,2,3,1,12,14,24,25,27.7
2023-24,202404060LAL,4/6/2024,LAL vs CLE,Anthony Davis,davisan02,74,LAL,1,CLE,22,13,4,3,6,0,36.31666667,4,9,7,11,1,1,7,9,2,9,17,26,35,39,70.6
2023-24,202404060LAL,4/6/2024,LAL vs CLE,Donovan Mitchell,mitchdo01,53,CLE,0,LAL,10,5,7,3,2,5,38.1,0,5,4,13,2,9,0,2,2,5,12,17,15,22,36.5
2023-24,202404060BRK,4/6/2024,BRK vs DET,Cam Thomas,thomaca02,62,BRK,1,DET,32,6,5,1,0,1,39.15,1,5,10,25,2,8,10,11,0,1,11,37,38,43,48.7
2023-24,202404060BRK,4/6/2024,BRK vs DET,Chimezie Metu,metuch01,47,DET,0,BRK,20,7,3,3,0,2,42.68333333,0,7,9,9,2,2,0,0,2,3,10,23,27,30,39.9
2023-24,202404050BOS,4/5/2024,BOS vs SAC,Kessler Edwards,edwarke02,51,SAC,0,BOS,3,1,0,1,0,0,10.05,0,1,1,5,1,4,0,0,0,1,1,3,4,4,7.2
2023-24,202404050DAL,4/5/2024,DAL vs GSW,Kevon Looney,looneke01,70,GSW,0,DAL,2,7,0,0,0,0,10.36666667,0,7,1,3,0,0,0,2,1,0,7,2,9,9,10.4
2023-24,202404050NOP,4/5/2024,NOP vs SAS,Matt Ryan,ryanma01,26,NOP,1,SAS,0,0,0,0,0,1,10.51666667,0,0,0,1,0,1,0,0,0,0,0,0,0,0,-1
2023-24,202404050WAS,4/5/2024,WAS vs POR,Duop Reath,reathdu01,63,POR,0,WAS,5,2,2,0,0,0,10.58333333,0,2,2,4,1,3,0,0,3,0,4,7,7,9,10.4
2023-24,202404050CHO,4/5/2024,CHO vs ORL,Moritz Wagner,wagnemo01,75,ORL,0,CHO,8,4,0,0,0,1,10.73333333,2,2,3,5,0,1,2,2,3,0,4,8,12,12,11.8
2023-24,202404050IND,4/5/2024,IND vs OKC,Isaiah Jackson,jacksis01,59,IND,1,OKC,4,0,0,0,2,0,11.03333333,0,0,1,2,0,0,2,2,3,2,0,4,4,4,10
2023-24,202404050CHI,4/5/2024,CHI vs NYK,Mitchell Robinson,robinmi01,26,NYK,0,CHI,5,5,1,1,0,0,11.1,3,2,2,4,0,0,1,3,1,1,6,6,10,11,15.5
2023-24,202404050CHI,4/5/2024,CHI vs NYK,Josh Hart,hartjo01,76,NYK,0,CHI,0,1,1,0,0,0,11.43333333,0,1,0,2,0,0,0,0,1,0,2,1,1,2,2.7
2023-24,202404050HOU,4/5/2024,HOU vs MIA,Reggie Bullock,bullore01,39,HOU,1,MIA,0,1,0,1,0,1,11.63333333,0,1,0,2,0,2,0,0,1,1,1,0,1,1,3.2
2023-24,202404050MIL,4/5/2024,MIL vs TOR,Jordan Nwora,nworajo01,48,TOR,0,MIL,4,1,1,0,0,1,11.78333333,0,1,2,4,0,1,0,0,0,0,2,5,5,6,5.7
2023-24,202404050BOS,4/5/2024,BOS vs SAC,Svi Mykhailiuk,mykhasv01,36,BOS,1,SAC,5,2,1,0,0,0,11.93333333,1,1,2,3,1,2,0,0,0,0,3,6,7,8,8.9
2023-24,202404050MIL,4/5/2024,MIL vs TOR,Javon Freeman-Liberty,freemja01,17,TOR,0,MIL,4,2,0,0,0,1,11.98333333,1,1,2,4,0,0,0,0,2,0,2,4,6,6,5.4
2023-24,202404050LAC,4/5/2024,LAC vs UTA,Kenneth Lofton Jr.,loftoke01,18,UTA,0,LAC,7,1,0,0,0,0,12,1,0,3,7,1,2,0,0,0,0,1,7,8,8,8.2
2023-24,202404050PHO,4/5/2024,PHO vs MIN,Bol Bol,bolbo01,39,PHO,1,MIN,2,3,0,1,1,0,12.05,0,3,1,2,0,0,0,0,1,2,3,2,5,5,11.6
2023-24,202404050IND,4/5/2024,IND vs OKC,Jaylin Williams,willija07,64,OKC,0,IND,4,1,0,0,1,2,12.21666667,0,1,2,3,0,1,0,0,0,1,1,4,5,5,6.2
2023-24,202404050IND,4/5/2024,IND vs OKC,Doug McDermott,mcderdo01,61,IND,1,OKC,6,1,1,0,0,0,12.3,0,1,2,4,2,3,0,0,1,0,2,7,7,8,8.7
2023-24,202404050LAC,4/5/2024,LAC vs UTA,Taylor Hendricks,hendrita0,35,UTA,0,LAC,5,2,0,0,0,0,12.35,0,2,2,3,1,1,0,0,0,0,2,5,7,7,7.4
2023-24,202404050IND,4/5/2024,IND vs OKC,Jalen Smith,smithja04,57,IND,1,OKC,12,6,2,0,0,1,12.63333333,2,4,3,6,0,2,6,7,0,0,8,14,18,20,21.2
2023-24,202404050WAS,4/5/2024,WAS vs POR,Jared Butler,butleja02,36,WAS,1,POR,6,2,2,1,0,1,12.76666667,1,1,1,7,0,5,4,4,1,1,4,8,8,10,13.4
2023-24,202404050CHI,4/5/2024,CHI vs NYK,Dalen Terry,terryda01,54,CHI,1,NYK,2,0,0,2,2,0,13,0,0,1,3,0,2,0,0,1,4,0,2,2,2,14
2023-24,202404050MIL,4/5/2024,MIL vs TOR,Jalen McDaniels,mcdanja01,46,TOR,0,MIL,2,1,4,0,1,0,13.05,0,1,1,4,0,1,0,0,0,1,5,6,3,7,12.2
2023-24,202404050IND,4/5/2024,IND vs OKC,Gordon Hayward,haywago01,48,OKC,0,IND,7,0,0,1,0,0,13.3,0,0,2,3,0,0,3,3,0,1,0,7,7,7,10
2023-24,202404050LAC,4/5/2024,LAC vs UTA,Brice Sensabaugh,sensabr01,27,UTA,0,LAC,4,4,1,0,1,1,13.45,0,4,1,4,0,1,2,2,4,1,5,5,8,9,12.3
2023-24,202404050WAS,4/5/2024,WAS vs POR,Justin Champagnie,champju01,12,WAS,1,POR,3,5,2,0,0,0,13.46666667,2,3,1,2,0,1,1,2,1,0,7,5,8,10,12
2023-24,202404050DAL,4/5/2024,DAL vs GSW,Jaden Hardy,hardyja02,68,DAL,1,GSW,5,3,2,0,0,1,13.63333333,0,3,2,5,1,2,0,0,1,0,5,7,8,10,10.6
2023-24,202404050PHO,4/5/2024,PHO vs MIN,Jordan McLaughlin,mclaujo01,51,MIN,0,PHO,4,1,0,1,0,0,13.83333333,0,1,1,4,0,3,2,2,0,1,1,4,5,5,8.2
2023-24,202404050CHI,4/5/2024,CHI vs NYK,Coby White,whiteco01,74,CHI,1,NYK,2,3,1,0,0,0,13.9,0,3,1,4,0,3,0,0,1,0,4,3,5,6,7.1
2023-24,202404050BOS,4/5/2024,BOS vs SAC,Sasha Vezenkov,vezenal01,39,SAC,0,BOS,6,2,1,0,0,0,13.98333333,0,2,2,7,2,6,0,0,2,0,3,7,8,9,9.9
2023-24,202404050LAC,4/5/2024,LAC vs UTA,P.J. Tucker,tuckepj01,27,LAC,1,UTA,3,0,1,1,0,0,14.11666667,0,0,1,2,1,1,0,0,1,1,1,4,3,4,7.5
2023-24,202404050NOP,4/5/2024,NOP vs SAS,Naji Marshall,marshna01,65,NOP,1,SAS,2,3,2,1,0,1,14.31666667,0,3,0,2,0,1,2,2,0,1,5,4,5,7,10.6
2023-24,202404050MEM,4/5/2024,MEM vs DET,James Wiseman,wisemja01,58,DET,0,MEM,0,3,0,0,1,3,14.68333333,1,2,0,1,0,0,0,0,1,1,3,0,3,3,3.6
2023-24,202404050HOU,4/5/2024,HOU vs MIA,Kevin Love,loveke01,50,MIA,0,HOU,6,5,0,1,0,1,14.75,2,3,3,5,0,1,0,0,3,1,5,6,11,11,14
2023-24,202404050HOU,4/5/2024,HOU vs MIA,Nikola Jovic,jovicni01,41,MIA,0,HOU,8,6,1,0,1,1,15.48333333,0,6,3,7,2,6,0,0,2,1,7,9,14,15,18.7
2023-24,202404050NOP,4/5/2024,NOP vs SAS,Blake Wesley,weslebl01,56,SAS,0,NOP,1,1,5,0,0,4,15.91666667,0,1,0,3,0,3,1,2,0,0,6,6,2,7,5.7
2023-24,202404050MIL,4/5/2024,MIL vs TOR,Andre Jackson Jr.,jacksan01,52,MIL,1,TOR,3,4,1,0,1,0,16.21666667,0,4,1,2,1,2,0,0,3,1,5,4,7,8,12.3
2023-24,202404050IND,4/5/2024,IND vs OKC,Aaron Wiggins,wiggiaa01,73,OKC,0,IND,4,1,1,0,0,0,16.33333333,0,1,2,5,0,1,0,0,2,0,2,5,5,6,6.7
2023-24,202404050PHO,4/5/2024,PHO vs MIN,Kyle Anderson,anderky01,74,MIN,0,PHO,6,1,3,0,0,2,16.73333333,0,1,3,7,0,0,0,0,4,0,4,9,7,10,9.7
2023-24,202404050LAC,4/5/2024,LAC vs UTA,Daniel Theis,theisda01,57,LAC,1,UTA,11,5,1,0,1,0,16.9,1,4,5,7,1,2,0,0,2,1,6,12,16,17,21.5
2023-24,202404050LAC,4/5/2024,LAC vs UTA,Jason Preston,prestja01,5,UTA,0,LAC,6,4,6,1,0,0,16.93333333,1,3,3,6,0,1,0,0,1,1,10,12,10,16,22.8
2023-24,202404050WAS,4/5/2024,WAS vs POR,Eugene Omoruyi,omorueu01,39,WAS,1,POR,5,6,0,1,1,0,17.06666667,2,4,2,3,0,1,1,4,2,2,6,5,11,11,18.2
2023-24,202404050BOS,4/5/2024,BOS vs SAC,Trey Lyles,lylestr01,53,SAC,0,BOS,3,2,0,0,0,0,17.16666667,0,2,1,7,1,5,0,0,1,0,2,3,5,5,5.4
2023-24,202404050PHO,4/5/2024,PHO vs MIN,Eric Gordon,gordoer01,64,PHO,1,MIN,4,1,1,2,0,1,17.18333333,0,1,1,3,0,0,2,3,0,2,2,5,5,6,11.7
2023-24,202404050BOS,4/5/2024,BOS vs SAC,Keon Ellis,elliske01,52,SAC,0,BOS,3,4,2,0,0,1,17.31666667,1,3,1,3,1,1,0,0,1,0,6,5,7,9,9.8
2023-24,202404050IND,4/5/2024,IND vs OKC,Lindy Waters III,waterli01,34,OKC,0,IND,12,4,3,2,0,0,17.53333333,1,3,5,9,1,5,1,1,0,2,7,15,16,19,27.3
2023-24,202404050IND,4/5/2024,IND vs OKC,Myles Turner,turnemy01,74,IND,1,OKC,16,3,0,1,1,1,17.56666667,0,3,6,11,2,3,2,2,4,2,3,16,19,19,24.6
2023-24,202404050PHO,4/5/2024,PHO vs MIN,Drew Eubanks,eubandr01,71,PHO,1,MIN,5,4,0,0,1,0,17.85,0,4,1,2,0,0,3,4,1,1,4,5,9,9,12.8
2023-24,202404050LAC,4/5/2024,LAC vs UTA,Collin Sexton,sextoco01,77,UTA,0,LAC,12,3,2,0,0,2,17.86666667,3,0,3,14,2,6,4,4,1,0,5,14,15,17,16.6
2023-24,202404050MIL,4/5/2024,MIL vs TOR,Jae Crowder,crowdja01,46,MIL,1,TOR,4,5,1,1,0,0,17.93333333,2,3,2,3,0,0,0,0,0,1,6,5,9,10,14.5
2023-24,202404050NOP,4/5/2024,NOP vs SAS,Jordan Hawkins,hawkijo01,66,NOP,1,SAS,6,3,0,1,1,1,18.05,1,2,2,4,2,4,0,0,1,2,3,6,9,9,14.6
2023-24,202404050BOS,4/5/2024,BOS vs SAC,Luke Kornet,kornelu01,58,BOS,1,SAC,6,5,1,1,2,0,18.33333333,2,3,3,4,0,0,0,0,1,3,6,7,11,12,22.5
2023-24,202404050CHO,4/5/2024,CHO vs ORL,Aleksej Pokusevski,pokusal01,23,CHO,1,ORL,10,2,2,0,0,2,18.35,0,2,2,3,1,2,5,5,0,0,4,12,12,14,13.4
2023-24,202404050CHI,4/5/2024,CHI vs NYK,Precious Achiuwa,achiupr01,70,NYK,0,CHI,0,4,1,1,0,1,18.56666667,1,3,0,2,0,1,0,0,4,1,5,1,4,5,8.3
2023-24,202404050LAC,4/5/2024,LAC vs UTA,Keyonte George,georgke01,70,UTA,0,LAC,6,2,5,0,0,5,18.78333333,0,2,2,9,0,4,2,2,2,0,7,11,8,13,10.9
2023-24,202404050CHO,4/5/2024,CHO vs ORL,Cole Anthony,anthoco01,76,ORL,0,CHO,2,1,1,1,0,0,18.98333333,0,1,1,8,0,4,0,0,2,1,2,3,3,4,7.7
2023-24,202404050BOS,4/5/2024,BOS vs SAC,Xavier Tillman Sr.,tillmxa01,49,BOS,1,SAC,9,4,2,0,0,0,19.15,1,3,4,7,1,3,0,0,0,0,6,11,13,15,16.8
2023-24,202404050HOU,4/5/2024,HOU vs MIA,Jaime Jaquez Jr.,jaqueja01,70,MIA,0,HOU,12,2,1,2,0,1,19.16666667,1,1,5,7,2,3,0,0,1,2,3,13,14,15,20.9
2023-24,202404050DAL,4/5/2024,DAL vs GSW,Trayce Jackson-Davis,jackstr02,63,GSW,0,DAL,8,8,1,1,1,1,19.73333333,5,3,3,8,0,0,2,4,0,2,9,9,16,17,24.1
2023-24,202404050CHO,4/5/2024,CHO vs ORL,Davis Bertans,bertada01,39,CHO,1,ORL,12,4,0,0,0,1,19.96666667,2,2,5,8,2,5,0,0,4,0,4,12,16,16,15.8
2023-24,202404050BOS,4/5/2024,BOS vs SAC,Al Horford,horfoal01,63,BOS,1,SAC,8,6,1,0,1,0,20.05,0,6,3,7,1,5,1,2,0,1,7,9,14,15,19.7
2023-24,202404050NOP,4/5/2024,NOP vs SAS,Larry Nance Jr.,nancela02,58,NOP,1,SAS,6,3,6,1,0,3,20.1,1,2,3,7,0,0,0,0,4,1,9,12,9,15,18.6
2023-24,202404050MIL,4/5/2024,MIL vs TOR,Brook Lopez,lopezbr01,74,MIL,1,TOR,15,4,1,0,2,1,20.15,2,2,6,12,1,4,2,3,2,2,5,16,19,20,26.3
2023-24,202404050PHO,4/5/2024,PHO vs MIN,Royce O'Neale,onealro01,74,PHO,1,MIN,3,3,0,0,0,0,20.18333333,0,3,1,5,1,4,0,0,1,0,3,3,6,6,6.6
2023-24,202404050MEM,4/5/2024,MEM vs DET,Jaylen Nowell,nowelja01,10,DET,0,MEM,12,3,2,1,1,1,20.21666667,1,2,5,9,0,1,2,4,1,2,5,14,15,17,23.6
2023-24,202404050CHI,4/5/2024,CHI vs NYK,Bojan Bogdanovic,bogdabo02,52,NYK,0,CHI,9,1,1,0,0,2,20.28333333,0,1,3,9,1,4,2,2,2,0,2,10,10,11,9.7
2023-24,202404050WAS,4/5/2024,WAS vs POR,Johnny Davis,davisjo06,46,WAS,1,POR,7,1,3,0,0,0,20.51666667,0,1,3,3,1,1,0,0,2,0,4,10,8,11,12.7
2023-24,202404050HOU,4/5/2024,HOU vs MIA,Cam Whitmore,whitmca01,42,HOU,1,MIA,12,4,1,0,0,1,20.53333333,2,2,4,12,2,4,2,2,1,0,5,13,16,17,17.3
2023-24,202404050IND,4/5/2024,IND vs OKC,T.J. McConnell,mccontj01,68,IND,1,OKC,16,5,10,0,1,2,20.76666667,2,3,7,12,0,0,2,2,1,1,15,26,21,31,38
2023-24,202404050IND,4/5/2024,IND vs OKC,Cason Wallace,wallaca01,77,OKC,0,IND,2,1,1,3,1,2,20.76666667,0,1,1,5,0,1,0,0,3,4,2,3,3,4,14.7
2023-24,202404050HOU,4/5/2024,HOU vs MIA,Duncan Robinson,robindu01,67,MIA,0,HOU,10,3,2,0,0,0,20.96666667,0,3,3,6,2,5,2,2,3,0,5,12,13,15,16.6
2023-24,202404050LAC,4/5/2024,LAC vs UTA,Paul George,georgpa01,71,LAC,1,UTA,14,2,3,0,0,1,20.98333333,0,2,5,9,2,5,2,2,3,0,5,17,16,19,19.9
2023-24,202404050LAC,4/5/2024,LAC vs UTA,Omer Yurtseven,yurtsom01,43,UTA,0,LAC,12,7,1,1,0,1,21.05,5,2,6,10,0,0,0,0,0,1,8,13,19,20,23.9
2023-24,202404050MEM,4/5/2024,MEM vs DET,Jared Rhoden,rhodeja01,12,DET,0,MEM,6,1,2,1,0,0,21.26666667,0,1,2,5,1,2,1,2,1,1,3,8,7,9,13.2
2023-24,202404050LAC,4/5/2024,LAC vs UTA,Russell Westbrook,westbru01,65,LAC,1,UTA,17,5,4,2,0,5,21.31666667,0,5,8,11,1,1,0,1,2,2,9,21,22,26,30
2023-24,202404050CHO,4/5/2024,CHO vs ORL,Joe Ingles,inglejo01,63,ORL,0,CHO,3,0,2,0,0,2,21.81666667,0,0,1,2,1,2,0,1,1,0,2,5,3,5,4
2023-24,202404050HOU,4/5/2024,HOU vs MIA,Jeff Green,greenje02,73,HOU,1,MIA,11,2,2,0,0,0,21.86666667,0,2,4,6,2,3,1,1,2,0,4,13,13,15,16.4
2023-24,202404050PHO,4/5/2024,PHO vs MIN,Nickeil Alexander-Walker,alexani01,77,MIN,0,PHO,13,5,2,1,0,1,22.01666667,0,5,4,9,3,5,2,2,2,1,7,15,18,20,24
2023-24,202404050PHO,4/5/2024,PHO vs MIN,Monte Morris,morrimo01,28,MIN,0,PHO,9,4,3,0,1,0,22.18333333,1,3,3,5,2,3,1,2,0,1,7,12,13,16,21.3
2023-24,202404050CHO,4/5/2024,CHO vs ORL,Jalen Suggs,suggsja01,70,ORL,0,CHO,8,1,2,1,0,0,22.21666667,0,1,4,8,0,3,0,0,3,1,3,10,9,11,15.2
2023-24,202404050MEM,4/5/2024,MEM vs DET,Chimezie Metu,metuch01,46,DET,0,MEM,6,6,1,4,0,2,22.35,2,4,3,6,0,3,0,0,3,4,7,7,12,13,24.7
2023-24,202404050MEM,4/5/2024,MEM vs DET,Troy Brown Jr.,browntr01,54,DET,0,MEM,5,7,3,2,0,1,22.6,2,5,2,6,1,3,0,0,1,2,10,8,12,15,22.9
2023-24,202404050MIL,4/5/2024,MIL vs TOR,A.J. Green,greenaj01,53,MIL,1,TOR,6,3,0,0,0,1,22.66666667,0,3,2,5,2,5,0,0,2,0,3,6,9,9,8.6
2023-24,202404050LAC,4/5/2024,LAC vs UTA,Terance Mann,mannte01,70,LAC,1,UTA,19,4,1,2,0,1,22.71666667,1,3,8,9,0,1,3,4,3,2,5,20,23,24,30.3
2023-24,202404050MEM,4/5/2024,MEM vs DET,Malachi Flynn,flynnma01,64,DET,0,MEM,3,1,6,2,0,2,22.73333333,0,1,0,12,0,7,3,4,0,2,7,9,4,10,17.2
2023-24,202404050IND,4/5/2024,IND vs OKC,Ben Sheppard,sheppbe01,54,IND,1,OKC,8,2,0,2,0,1,22.75,1,1,3,10,2,6,0,0,1,2,2,8,10,10,15.4
2023-24,202404050LAC,4/5/2024,LAC vs UTA,Kris Dunn,dunnkr01,66,UTA,0,LAC,10,1,1,1,0,1,23.6,1,0,3,5,0,1,4,5,3,1,2,11,11,12,14.7
2023-24,202404050LAC,4/5/2024,LAC vs UTA,Ivica Zubac,zubaciv01,65,LAC,1,UTA,12,10,2,1,3,0,23.95,2,8,5,6,0,0,2,2,4,4,12,14,22,24,39
2023-24,202404050MIL,4/5/2024,MIL vs TOR,Malik Beasley,beaslma01,74,MIL,1,TOR,3,4,2,1,0,1,24.01666667,0,4,1,7,1,5,0,0,0,1,6,5,7,9,12.8
2023-24,202404050CHI,4/5/2024,CHI vs NYK,Andre Drummond,drumman01,77,CHI,1,NYK,10,16,0,3,1,3,24.05,5,11,3,7,0,0,4,6,4,4,16,10,26,26,38.2
2023-24,202404050MEM,4/5/2024,MEM vs DET,Tosan Evbuomwan,evbuoto01,17,DET,0,MEM,8,2,3,1,1,1,24.11666667,1,1,3,5,0,1,2,3,1,2,5,11,10,13,19.9
2023-24,202404050WAS,4/5/2024,WAS vs POR,Tristan Vukcevic,vukcetr01,8,WAS,1,POR,17,7,2,2,1,1,24.2,1,6,7,16,0,5,3,6,5,3,9,19,24,26,36.4
2023-24,202404050MEM,4/5/2024,MEM vs DET,Jalen Duren,durenja01,59,DET,0,MEM,17,10,0,1,0,0,24.38333333,3,7,6,12,0,1,5,5,3,1,10,17,27,27,32
2023-24,202404050DAL,4/5/2024,DAL vs GSW,Gary Payton II,paytoga02,42,GSW,0,DAL,14,2,1,1,2,1,24.43333333,0,2,6,7,1,2,1,1,4,3,3,15,16,17,25.9
2023-24,202404050BOS,4/5/2024,BOS vs SAC,Kristaps Porzingis,porzikr01,55,BOS,1,SAC,20,11,2,2,1,1,24.45,1,10,7,10,2,2,4,4,3,3,13,22,31,33,44.2
2023-24,202404050NOP,4/5/2024,NOP vs SAS,Devonte Graham,grahade01,18,SAS,0,NOP,20,2,5,3,0,0,24.56666667,1,1,6,15,4,12,4,4,1,3,7,25,22,27,38.9
2023-24,202404050HOU,4/5/2024,HOU vs MIA,Terry Rozier,roziete01,60,MIA,0,HOU,13,3,3,2,0,1,24.76666667,0,3,4,10,3,4,2,3,1,2,6,16,16,19,26.1
2023-24,202404050PHO,4/5/2024,PHO vs MIN,Mike Conley,conlemi01,71,MIN,0,PHO,5,0,3,0,0,3,24.91666667,0,0,1,6,1,3,2,2,1,0,3,8,5,8,6.5
2023-24,202404050HOU,4/5/2024,HOU vs MIA,Tyler Herro,herroty01,37,MIA,0,HOU,17,5,6,0,0,0,24.96666667,0,5,7,14,1,4,2,4,1,0,11,23,22,28,32
2023-24,202404050BOS,4/5/2024,BOS vs SAC,Davion Mitchell,mitchda01,67,SAC,0,BOS,7,6,5,0,0,1,24.96666667,2,4,3,8,1,4,0,0,3,0,11,12,13,18,20.7
2023-24,202404050DAL,4/5/2024,DAL vs GSW,Brandin Podziemski,podzibr01,69,GSW,0,DAL,14,4,5,0,0,2,25.01666667,1,3,6,11,2,2,0,0,4,0,9,19,18,23,24.3
2023-24,202404050IND,4/5/2024,IND vs OKC,Obi Toppin,toppiob01,79,IND,1,OKC,15,8,1,2,1,1,25.15,2,6,6,10,1,3,2,2,1,3,9,16,23,24,34.1
2023-24,202404050IND,4/5/2024,IND vs OKC,Aaron Nesmith,nesmiaa01,69,IND,1,OKC,17,4,1,1,0,2,25.25,0,4,6,10,4,7,1,1,4,1,5,18,21,22,24.3
2023-24,202404050MEM,4/5/2024,MEM vs DET,Marcus Sasser,sassema01,66,DET,0,MEM,2,2,2,1,1,3,25.26666667,0,2,1,5,0,2,0,0,1,2,4,4,4,6,10.4
2023-24,202404050WAS,4/5/2024,WAS vs POR,Justin Minaya,minayju01,29,POR,0,WAS,2,4,2,2,2,0,25.48333333,2,2,1,4,0,2,0,0,2,4,6,4,6,8,21.8
2023-24,202404050IND,4/5/2024,IND vs OKC,Kenrich Williams,willike04,64,OKC,0,IND,18,8,3,0,1,2,25.61666667,3,5,7,7,2,2,2,2,3,1,11,21,26,29,33.1
2023-24,202404050LAC,4/5/2024,LAC vs UTA,Norman Powell,powelno01,73,LAC,1,UTA,18,2,1,1,0,1,25.86666667,0,2,5,12,4,8,4,4,2,1,3,19,20,21,23.9
2023-24,202404050MIL,4/5/2024,MIL vs TOR,Gradey Dick,dickgr01,56,TOR,0,MIL,10,5,0,1,0,0,25.91666667,1,4,4,7,2,4,0,0,2,1,5,10,15,15,19
2023-24,202404050PHO,4/5/2024,PHO vs MIN,Jusuf Nurkic,nurkiju01,72,PHO,1,MIN,11,15,6,3,1,4,26.11666667,3,12,5,11,0,0,1,3,5,4,21,17,26,32,46
2023-24,202404050PHO,4/5/2024,PHO vs MIN,Jaden McDaniels,mcdanja02,67,MIN,0,PHO,6,2,1,1,1,2,26.35,0,2,3,6,0,2,0,0,2,2,3,7,8,9,13.9
2023-24,202404050HOU,4/5/2024,HOU vs MIA,Jock Landale,landajo01,51,HOU,1,MIA,10,6,4,1,0,0,26.36666667,2,4,4,7,0,1,2,2,0,1,10,14,16,20,26.2
2023-24,202404050LAC,4/5/2024,LAC vs UTA,Talen Horton-Tucker,hortota01,48,UTA,0,LAC,17,3,1,2,0,1,26.4,0,3,5,14,2,5,5,7,2,2,4,18,20,21,27.1
2023-24,202404050DAL,4/5/2024,DAL vs GSW,Moses Moody,moodymo01,61,GSW,0,DAL,9,2,2,0,0,0,26.51666667,1,1,3,8,1,3,2,3,1,0,4,11,11,13,14.4
2023-24,202404050MEM,4/5/2024,MEM vs DET,GG Jackson II,jacksgg01,43,MEM,1,DET,15,3,4,0,0,2,26.58333333,0,3,6,12,3,6,0,1,1,0,7,19,18,22,22.6
2023-24,202404050PHO,4/5/2024,PHO vs MIN,Bradley Beal,bealbr01,48,PHO,1,MIN,14,3,2,0,0,2,26.68333333,0,3,6,9,2,3,0,0,3,0,5,16,17,19,18.6
2023-24,202404050HOU,4/5/2024,HOU vs MIA,Haywood Highsmith,highsha01,61,MIA,0,HOU,4,5,3,1,1,0,26.95,2,3,2,5,0,3,0,0,2,2,8,7,9,12,20.5
2023-24,202404050NOP,4/5/2024,NOP vs SAS,Sandro Mamukelashvili,mamuksa01,41,SAS,0,NOP,15,5,2,1,1,0,26.96666667,1,4,7,11,1,3,0,1,3,2,7,17,20,22,30
2023-24,202404050IND,4/5/2024,IND vs OKC,Andrew Nembhard,nembhan01,64,IND,1,OKC,3,3,2,1,0,2,27.23333333,0,3,1,5,1,4,0,0,2,1,5,5,6,8,10.6
2023-24,202404050NOP,4/5/2024,NOP vs SAS,Zach Collins,colliza01,64,SAS,0,NOP,15,7,3,0,0,1,27.4,2,5,7,11,1,3,0,1,2,0,10,18,22,25,26.9
2023-24,202404050NOP,4/5/2024,NOP vs SAS,Jonas Valanciunas,valanjo01,77,NOP,1,SAS,26,7,7,1,0,4,27.73333333,1,6,10,12,0,1,6,6,5,1,14,33,33,40,43.9
2023-24,202404050MIL,4/5/2024,MIL vs TOR,Bobby Portis,portibo01,77,MIL,1,TOR,19,10,1,0,1,1,27.85,6,4,8,18,1,4,2,2,1,1,11,20,29,30,34.5
2023-24,202404050MEM,4/5/2024,MEM vs DET,Lamar Stevens,stevela01,37,MEM,1,DET,15,8,1,3,0,0,27.96666667,0,8,7,16,0,3,1,2,1,3,9,16,23,24,35.1
2023-24,202404050WAS,4/5/2024,WAS vs POR,Kris Murray,murrakr01,57,POR,0,WAS,13,5,0,0,0,2,28.08333333,5,0,6,13,1,5,0,1,2,0,5,13,18,18,17
2023-24,202404050IND,4/5/2024,IND vs OKC,Chet Holmgren,holmgch01,77,OKC,0,IND,15,8,0,0,3,2,28.11666667,0,8,4,12,1,6,6,8,4,3,8,15,23,23,31.6
2023-24,202404050BOS,4/5/2024,BOS vs SAC,Harrison Barnes,barneha02,77,SAC,0,BOS,10,5,1,0,0,0,28.13333333,1,4,3,9,2,8,2,4,0,0,6,11,15,16,17.5
2023-24,202404050MEM,4/5/2024,MEM vs DET,Jordan Goodwin,goodwjo01,53,MEM,1,DET,14,6,6,1,0,2,28.23333333,1,5,4,9,2,2,4,4,3,1,12,20,20,26,31.2
2023-24,202404050CHO,4/5/2024,CHO vs ORL,Franz Wagner,wagnefr01,69,ORL,0,CHO,22,7,1,1,0,1,28.43333333,3,4,8,16,0,4,6,8,4,1,8,23,29,30,33.9
2023-24,202404050CHO,4/5/2024,CHO vs ORL,Gary Harris,harriga01,50,ORL,0,CHO,12,3,6,2,0,0,28.66666667,1,2,4,8,4,8,0,0,0,2,9,18,15,21,30.6
2023-24,202404050CHI,4/5/2024,CHI vs NYK,OG Anunoby,anunoog01,45,NYK,0,CHI,12,1,0,2,0,1,28.68333333,0,1,5,8,2,4,0,0,1,2,1,12,13,13,18.2
2023-24,202404050HOU,4/5/2024,HOU vs MIA,Jimmy Butler,butleji01,55,MIA,0,HOU,22,3,3,1,0,2,28.83333333,0,3,6,14,2,6,8,8,1,1,6,25,25,28,31.1
2023-24,202404050MEM,4/5/2024,MEM vs DET,Scotty Pippen Jr.,pippesc02,16,MEM,1,DET,16,3,7,4,1,5,29.01666667,2,1,7,10,2,4,0,0,3,5,10,23,19,26,40.1
2023-24,202404050PHO,4/5/2024,PHO vs MIN,Rudy Gobert,goberru01,71,MIN,0,PHO,4,6,1,0,2,1,29.05,2,4,2,5,0,0,0,0,4,2,7,5,10,11,17.7
2023-24,202404050HOU,4/5/2024,HOU vs MIA,Caleb Martin,martica02,59,MIA,0,HOU,9,4,2,0,1,2,29.33333333,1,3,4,9,1,4,0,0,2,1,6,11,13,15,17.8
2023-24,202404050CHI,4/5/2024,CHI vs NYK,Isaiah Hartenstein,harteis01,71,NYK,0,CHI,10,7,2,3,1,4,29.5,3,4,3,5,0,0,4,6,3,4,9,12,17,19,29.4
2023-24,202404050IND,4/5/2024,IND vs OKC,Pascal Siakam,siakapa01,76,IND,1,OKC,21,5,2,0,0,1,29.61666667,1,4,8,10,1,1,4,5,5,0,7,23,26,28,29
2023-24,202404050DAL,4/5/2024,DAL vs GSW,Tim Hardaway Jr.,hardati02,74,DAL,1,GSW,13,3,3,0,0,2,30,0,3,4,13,1,7,4,4,3,0,6,16,16,19,19.1
2023-24,202404050WAS,4/5/2024,WAS vs POR,Scoot Henderson,hendesc01,58,POR,0,WAS,19,3,7,1,0,3,30.45,0,3,8,14,2,4,1,1,5,1,10,26,22,29,33.1
2023-24,202404050MEM,4/5/2024,MEM vs DET,Maozinha Pereira,pereima01,6,MEM,1,DET,17,9,0,1,1,0,30.45,3,6,6,10,2,4,3,3,1,2,9,17,26,26,33.8
2023-24,202404050WAS,4/5/2024,WAS vs POR,Anthony Gill,gillan01,47,WAS,1,POR,8,3,1,2,1,1,30.6,3,0,4,11,0,0,0,0,4,3,4,9,11,12,21.1
2023-24,202404050LAC,4/5/2024,LAC vs UTA,Amir Coffey,coffeam01,65,LAC,1,UTA,11,4,0,1,0,1,30.68333333,1,3,4,9,1,4,2,2,3,1,4,11,15,15,17.8
2023-24,202404050BOS,4/5/2024,BOS vs SAC,Jrue Holiday,holidjr01,66,BOS,1,SAC,10,4,7,0,0,1,30.75,1,3,5,8,0,2,0,0,0,0,11,17,14,21,24.3
2023-24,202404050DAL,4/5/2024,DAL vs GSW,Chris Paul,paulch01,53,GSW,0,DAL,9,5,8,4,1,3,30.98333333,0,5,3,7,1,4,2,2,4,5,13,17,14,22,39
2023-24,202404050DAL,4/5/2024,DAL vs GSW,Daniel Gafford,gaffoda01,70,DAL,1,GSW,10,15,5,0,3,2,31.23333333,4,11,5,7,0,0,0,2,3,3,20,15,25,30,42.5
2023-24,202404050MEM,4/5/2024,MEM vs DET,Trey Jemison,jemistr01,20,MEM,1,DET,17,13,1,1,3,4,31.3,8,5,7,9,0,0,3,3,4,4,14,18,30,31,42.1
2023-24,202404050CHO,4/5/2024,CHO vs ORL,Tre Mann,manntr01,36,CHO,1,ORL,7,4,5,3,0,1,31.56666667,0,4,2,5,1,2,2,2,2,3,9,12,11,16,27.3
2023-24,202404050LAC,4/5/2024,LAC vs UTA,Johnny Juzang,juzanjo01,15,UTA,0,LAC,9,7,3,1,1,0,31.75,2,5,3,8,2,5,1,2,1,2,10,12,16,19,27.9
2023-24,202404050CHO,4/5/2024,CHO vs ORL,Markelle Fultz,fultzma01,38,ORL,0,CHO,15,6,3,2,0,2,31.8,3,3,6,11,0,1,3,3,1,2,9,18,21,24,30.7
2023-24,202404050IND,4/5/2024,IND vs OKC,Isaiah Joe,joeis01,73,OKC,0,IND,10,4,3,1,0,0,31.86666667,2,2,3,8,2,5,2,2,0,1,7,13,14,17,22.3
2023-24,202404050IND,4/5/2024,IND vs OKC,Luguentz Dort,dortlu01,75,OKC,0,IND,22,2,1,0,0,2,31.91666667,0,2,8,15,2,7,4,5,3,0,3,23,24,25,23.9
2023-24,202404050WAS,4/5/2024,WAS vs POR,Rayan Rupert,ruperra01,34,POR,0,WAS,3,7,4,2,1,1,31.98333333,1,6,1,8,1,5,0,0,5,3,11,7,10,14,25.4
2023-24,202404050CHI,4/5/2024,CHI vs NYK,Nikola Vucevic,vucevni01,72,CHI,1,NYK,16,13,6,0,1,2,32.06666667,6,7,7,18,2,2,0,0,1,1,19,22,29,35,41.6
2023-24,202404050PHO,4/5/2024,PHO vs MIN,Naz Reid,reidna01,76,MIN,0,PHO,8,11,2,2,2,5,32.16666667,1,10,3,13,1,5,1,2,3,4,13,10,19,21,31.2
2023-24,202404050MEM,4/5/2024,MEM vs DET,Jaden Ivey,iveyja01,72,DET,0,MEM,31,3,3,0,0,4,32.21666667,0,3,10,15,6,8,5,6,2,0,6,34,34,37,35.1
2023-24,202404050CHI,4/5/2024,CHI vs NYK,Alex Caruso,carusal01,68,CHI,1,NYK,7,1,4,1,0,2,32.35,0,1,3,6,1,4,0,0,2,1,5,11,8,12,15.2
2023-24,202404050HOU,4/5/2024,HOU vs MIA,Jabari Smith Jr.,smithja05,71,HOU,1,MIA,15,8,2,2,1,1,32.48333333,1,7,5,12,3,9,2,2,3,3,10,17,23,25,35.6
2023-24,202404050BOS,4/5/2024,BOS vs SAC,Jayson Tatum,tatumja01,72,BOS,1,SAC,17,6,5,0,0,3,32.5,0,6,5,15,1,6,6,8,0,0,11,22,23,28,28.7
2023-24,202404050PHO,4/5/2024,PHO vs MIN,Anthony Edwards,edwaran01,74,MIN,0,PHO,17,8,3,3,0,4,32.58333333,3,5,6,19,2,6,3,3,3,3,11,20,25,28,36.1
2023-24,202404050LAC,4/5/2024,LAC vs UTA,James Harden,hardeja01,70,LAC,1,UTA,13,10,15,0,0,5,32.6,0,10,4,10,2,7,3,3,1,0,25,28,23,38,42.5
2023-24,202404050MEM,4/5/2024,MEM vs DET,Zavier Simpson,simpsza01,2,MEM,1,DET,2,2,3,2,1,3,32.73333333,0,2,1,9,0,4,0,0,1,3,5,5,4,7,14.9
2023-24,202404050MIL,4/5/2024,MIL vs TOR,Kelly Olynyk,olynyke01,74,TOR,0,MIL,12,7,2,0,0,2,32.75,1,6,3,6,1,3,5,6,3,0,9,14,19,21,21.4
2023-24,202404050CHI,4/5/2024,CHI vs NYK,Javonte Green,greenja02,4,CHI,1,NYK,25,13,1,2,1,1,33,5,8,10,14,1,2,4,4,1,3,14,26,38,39,50.1
2023-24,202404050CHI,4/5/2024,CHI vs NYK,Donte DiVincenzo,divindo01,76,NYK,0,CHI,10,4,3,0,1,2,33.05,1,3,4,12,2,7,0,0,0,1,7,13,14,17,20.3
2023-24,202404050DAL,4/5/2024,DAL vs GSW,Klay Thompson,thompkl01,73,GSW,0,DAL,16,3,2,3,0,2,33.06666667,1,2,7,17,2,8,0,0,0,3,5,18,19,21,29.6
2023-24,202404050NOP,4/5/2024,NOP vs SAS,Tre Jones,jonestr01,72,SAS,0,NOP,14,2,4,2,0,3,33.1,0,2,6,9,2,4,0,0,2,2,6,18,16,20,25.4
2023-24,202404050PHO,4/5/2024,PHO vs MIN,Grayson Allen,allengr01,70,PHO,1,MIN,23,8,1,2,0,1,33.2,2,6,6,14,4,8,7,8,0,2,9,24,31,32,39.1
2023-24,202404050DAL,4/5/2024,DAL vs GSW,Dante Exum,exumda01,51,DAL,1,GSW,11,2,7,0,0,2,33.21666667,0,2,5,8,1,2,0,0,1,0,9,18,13,20,21.9
2023-24,202404050HOU,4/5/2024,HOU vs MIA,Bam Adebayo,adebaba01,66,MIA,0,HOU,18,12,6,1,1,1,33.31666667,2,10,7,12,0,0,4,4,2,2,18,24,30,36,46.4
2023-24,202404050BOS,4/5/2024,BOS vs SAC,Payton Pritchard,pritcpa01,77,BOS,1,SAC,21,1,3,2,0,1,33.41666667,1,0,8,16,5,10,0,0,3,2,4,24,22,25,31.7
2023-24,202404050MIL,4/5/2024,MIL vs TOR,Pat Connaughton,connapa01,71,MIL,1,TOR,4,4,2,2,2,0,33.45,1,3,2,6,0,4,0,0,3,4,6,6,8,10,23.8
2023-24,202404050LAC,4/5/2024,LAC vs UTA,Darius Bazley,bazleda01,4,UTA,0,LAC,12,6,0,3,1,3,33.46666667,1,5,4,8,1,3,3,5,0,4,6,12,18,18,28.2
2023-24,202404050WAS,4/5/2024,WAS vs POR,Dalano Banton,bantoda01,50,POR,0,WAS,21,8,8,0,0,1,33.56666667,2,6,8,20,2,6,3,5,3,0,16,29,29,37,41.6
2023-24,202404050MEM,4/5/2024,MEM vs DET,Jake LaRavia,laravja01,32,MEM,1,DET,12,5,2,1,1,4,33.71666667,1,4,4,15,1,8,3,3,0,2,7,14,17,19,23
2023-24,202404050MIL,4/5/2024,MIL vs TOR,Khris Middleton,middlkh01,51,MIL,1,TOR,21,5,6,3,0,2,33.71666667,1,4,9,16,2,6,1,2,5,3,11,27,26,32,43
2023-24,202404050BOS,4/5/2024,BOS vs SAC,Domantas Sabonis,sabondo01,77,SAC,0,BOS,16,16,6,1,1,2,33.8,5,11,6,13,0,0,4,7,1,2,22,22,32,38,48.2
2023-24,202404050NOP,4/5/2024,NOP vs SAS,Victor Wembanyama,wembavi01,68,SAS,0,NOP,17,12,9,1,3,2,33.96666667,2,10,5,12,3,6,4,4,1,4,21,26,29,38,54.9
2023-24,202404050PHO,4/5/2024,PHO vs MIN,Devin Booker,bookede01,63,PHO,1,MIN,13,3,13,3,0,7,34.11666667,1,2,3,12,1,5,6,6,3,3,16,26,16,29,38.1
2023-24,202404050MIL,4/5/2024,MIL vs TOR,RJ Barrett,barrerj01,55,TOR,0,MIL,26,7,2,2,1,5,34.18333333,2,5,8,18,1,4,9,11,4,3,9,28,33,35,41.4
2023-24,202404050NOP,4/5/2024,NOP vs SAS,Malaki Branham,branhma01,72,SAS,0,NOP,14,1,2,1,0,4,34.28333333,0,1,5,10,4,7,0,0,3,1,3,16,15,17,17.2
2023-24,202404050DAL,4/5/2024,DAL vs GSW,Draymond Green,greendr01,52,GSW,0,DAL,6,7,3,2,1,4,34.46666667,2,5,3,9,0,2,0,0,3,3,10,9,13,16,23.9
2023-24,202404050NOP,4/5/2024,NOP vs SAS,Trey Murphy III,murphtr02,52,NOP,1,SAS,16,8,4,2,0,1,34.61666667,4,4,7,13,1,6,1,1,4,2,12,20,24,28,36.6
2023-24,202404050CHO,4/5/2024,CHO vs ORL,Vasilije Micic,micicva01,55,CHO,1,ORL,14,5,9,1,0,3,34.8,0,5,4,9,1,5,5,5,3,1,14,23,19,28,33.5
2023-24,202404050PHO,4/5/2024,PHO vs MIN,Kevin Durant,duranke01,70,PHO,1,MIN,22,6,6,1,0,1,34.83333333,1,5,9,14,1,4,3,3,4,1,12,28,28,34,40.2
2023-24,202404050MIL,4/5/2024,MIL vs TOR,Ochai Agbaji,agbajoc01,73,TOR,0,MIL,3,8,3,1,0,4,35.01666667,3,5,1,2,0,0,1,2,4,1,11,6,11,14,16.1
2023-24,202404050DAL,4/5/2024,DAL vs GSW,Stephen Curry,curryst01,71,GSW,0,DAL,28,6,5,1,0,2,35.41666667,1,5,9,23,5,14,5,6,2,1,11,33,34,39,43.7
2023-24,202404050IND,4/5/2024,IND vs OKC,Josh Giddey,giddejo01,76,OKC,0,IND,14,9,12,1,0,5,35.46666667,2,7,6,17,0,2,2,2,2,1,21,26,23,35,40.8
2023-24,202404050WAS,4/5/2024,WAS vs POR,Jordan Poole,poolejo01,76,WAS,1,POR,20,5,9,0,0,2,35.48333333,1,4,8,20,3,10,1,2,1,0,14,29,25,34,37.5
2023-24,202404050DAL,4/5/2024,DAL vs GSW,Derrick Jones Jr.,jonesde02,72,DAL,1,GSW,9,3,1,0,3,1,35.68333333,2,1,3,11,2,7,1,2,2,3,4,10,12,13,22.1
2023-24,202404050IND,4/5/2024,IND vs OKC,Tyrese Haliburton,halibty01,66,IND,1,OKC,8,2,11,1,0,2,35.7,0,2,3,8,2,6,0,0,1,1,13,19,10,21,27.9
2023-24,202404050MIL,4/5/2024,MIL vs TOR,Immanuel Quickley,quickim01,65,TOR,0,MIL,25,11,9,3,0,1,36.01666667,1,10,4,12,3,8,14,15,1,3,20,34,36,45,59.7
2023-24,202404050BOS,4/5/2024,BOS vs SAC,Sam Hauser,hausesa01,74,BOS,1,SAC,3,7,3,1,0,0,36.28333333,1,6,1,18,1,13,0,0,1,1,10,6,10,13,18.9
2023-24,202404050HOU,4/5/2024,HOU vs MIA,Fred VanVleet,vanvlfr01,70,HOU,1,MIA,13,6,8,0,0,2,36.6,1,5,4,13,2,7,3,4,3,0,14,21,19,27,30.2
2023-24,202404050HOU,4/5/2024,HOU vs MIA,Dillon Brooks,brookdi01,68,HOU,1,MIA,18,5,3,1,0,0,36.91666667,1,4,5,13,3,7,5,6,1,1,8,21,23,26,31.5
2023-24,202404050MIL,4/5/2024,MIL vs TOR,Gary Trent Jr.,trentga02,67,TOR,0,MIL,31,5,3,2,0,2,37.1,0,5,11,22,7,15,2,2,2,2,8,34,36,39,45.5
2023-24,202404050NOP,4/5/2024,NOP vs SAS,Dyson Daniels,daniedy01,56,NOP,1,SAS,7,7,2,2,0,1,37.16666667,2,5,3,8,1,2,0,0,2,2,9,9,14,16,23.4
2023-24,202404050CHO,4/5/2024,CHO vs ORL,Wendell Carter Jr.,cartewe01,50,ORL,0,CHO,13,7,1,1,1,1,37.26666667,3,4,5,10,3,7,0,0,4,2,8,14,20,21,27.9
2023-24,202404050CHI,4/5/2024,CHI vs NYK,Miles McBride,mcbrimi01,64,NYK,0,CHI,19,7,2,0,0,1,37.63333333,0,7,6,11,4,7,3,3,1,0,9,21,26,28,29.4
2023-24,202404050NOP,4/5/2024,NOP vs SAS,Julian Champagnie,champju02,69,SAS,0,NOP,15,4,4,1,4,1,37.81666667,0,4,6,11,2,7,1,1,0,5,8,19,19,23,39.8
2023-24,202404050MIL,4/5/2024,MIL vs TOR,Damian Lillard,lillada01,69,MIL,1,TOR,36,5,6,1,0,7,37.86666667,0,5,10,24,4,12,12,14,6,1,11,42,41,47,47
2023-24,202404050HOU,4/5/2024,HOU vs MIA,Jalen Green,greenja05,77,HOU,1,MIA,21,7,4,2,1,3,37.95,1,6,6,18,2,9,7,8,1,3,11,25,28,32,41.4
2023-24,202404050NOP,4/5/2024,NOP vs SAS,Herbert Jones,joneshe01,71,NOP,1,SAS,15,4,3,3,0,2,38.03333333,0,4,6,10,1,2,2,2,1,3,7,18,19,22,31.3
2023-24,202404050CHO,4/5/2024,CHO vs ORL,Grant Williams,willigr01,73,CHO,1,ORL,18,6,7,0,1,3,38.46666667,1,5,7,13,3,4,1,1,4,1,13,25,24,31,35.7
2023-24,202404050WAS,4/5/2024,WAS vs POR,Deni Avdija,avdijde01,71,WAS,1,POR,22,12,0,1,2,2,38.5,1,11,7,12,0,2,8,8,2,3,12,22,34,34,43.4
2023-24,202404050CHO,4/5/2024,CHO vs ORL,Brandon Miller,millebr02,70,CHO,1,ORL,32,6,2,1,1,5,39.31666667,0,6,11,13,5,6,5,5,3,2,8,34,38,40,43.2
2023-24,202404050WAS,4/5/2024,WAS vs POR,Jabari Walker,walkeja01,68,POR,0,WAS,11,13,3,0,0,3,39.4,3,10,2,6,2,4,5,8,3,0,16,14,24,27,28.1
2023-24,202404050CHI,4/5/2024,CHI vs NYK,Ayo Dosunmu,dosunay01,75,CHI,1,NYK,24,6,5,2,0,4,39.41666667,3,3,10,20,3,7,1,2,4,2,11,29,30,35,40.7
2023-24,202404050NOP,4/5/2024,NOP vs SAS,CJ McCollum,mccolcj01,61,NOP,1,SAS,31,6,4,0,1,3,39.46666667,2,4,13,29,4,12,1,1,0,1,10,35,37,41,44.2
2023-24,202404050CHO,4/5/2024,CHO vs ORL,Paolo Banchero,banchpa01,75,ORL,0,CHO,32,8,8,1,2,3,40.06666667,3,5,10,26,1,8,11,12,1,3,16,40,40,48,59.6
2023-24,202404050DAL,4/5/2024,DAL vs GSW,P.J. Washington,washipj01,69,DAL,1,GSW,32,5,3,5,2,4,40.33333333,0,5,12,18,5,8,3,5,2,7,8,35,37,40,59.5
2023-24,202404050WAS,4/5/2024,WAS vs POR,Deandre Ayton,aytonde01,51,POR,0,WAS,34,13,3,2,2,2,40.45,3,10,13,25,0,0,8,9,0,4,16,37,47,50,64.1
2023-24,202404050WAS,4/5/2024,WAS vs POR,Corey Kispert,kispeco01,76,WAS,1,POR,12,3,5,2,0,1,40.58333333,0,3,4,11,1,7,3,3,2,2,8,17,15,20,28.1
2023-24,202404050CHI,4/5/2024,CHI vs NYK,Jalen Brunson,brunsja01,72,NYK,0,CHI,35,6,11,2,0,5,41.58333333,1,5,13,28,1,5,8,10,1,2,17,46,41,52,59.7
2023-24,202404050BOS,4/5/2024,BOS vs SAC,Keegan Murray,murrake02,72,SAC,0,BOS,10,11,4,1,1,2,41.63333333,4,7,4,15,2,10,0,0,2,2,15,14,21,25,33.2
2023-24,202404050CHO,4/5/2024,CHO vs ORL,Miles Bridges,bridgmi02,65,CHO,1,ORL,23,6,4,0,1,3,41.66666667,0,6,8,17,2,6,5,5,2,1,10,27,29,33,36.2
2023-24,202404050CHI,4/5/2024,CHI vs NYK,DeMar DeRozan,derozde01,75,CHI,1,NYK,20,5,10,1,0,4,42.23333333,0,5,8,18,0,2,4,4,4,1,15,30,25,35,40
2023-24,202404050DAL,4/5/2024,DAL vs GSW,Kyrie Irving,irvinky01,55,DAL,1,GSW,26,8,7,2,1,5,42.31666667,1,7,9,19,2,7,6,6,3,3,15,33,34,41,50.1
2023-24,202404050BOS,4/5/2024,BOS vs SAC,De'Aaron Fox,foxde01,69,SAC,0,BOS,40,4,2,1,0,1,44.11666667,1,3,16,29,7,13,1,2,2,1,6,42,44,46,49.8
2023-24,202404040MIA,4/4/2024,MIA vs PHI,Cameron Payne,payneca01,73,PHI,0,MIA,6,0,1,2,0,2,10.45,0,0,2,2,2,2,0,0,5,2,1,7,6,7,11.5
2023-24,202404040NYK,4/4/2024,NYK vs SAC,Alex Len,lenal01,42,SAC,0,NYK,2,1,2,0,0,0,11.06666667,0,1,1,1,0,0,0,0,1,0,3,4,3,5,6.2
2023-24,202404040MIA,4/4/2024,MIA vs PHI,Buddy Hield,hieldbu01,80,PHI,0,MIA,2,2,0,0,0,0,11.96666667,1,1,0,6,0,4,2,2,0,0,2,2,4,4,4.4
2023-24,202404040NYK,4/4/2024,NYK vs SAC,Bojan Bogdanovic,bogdabo02,51,NYK,1,SAC,12,1,0,0,0,1,12.13333333,0,1,5,7,2,3,0,0,1,0,1,12,13,13,12.2
2023-24,202404040DAL,4/4/2024,DAL vs ATL,Kobe Bufkin,bufkiko01,12,ATL,0,DAL,9,3,1,1,0,0,12.65,0,3,4,8,1,4,0,0,3,1,4,10,12,13,17.1
2023-24,202404040LAC,4/4/2024,LAC vs DEN,Mason Plumlee,plumlma01,40,LAC,1,DEN,2,2,0,0,1,0,13.08333333,1,1,1,1,0,0,0,0,5,1,2,2,4,4,7.4
2023-24,202404040NYK,4/4/2024,NYK vs SAC,Sasha Vezenkov,vezenal01,38,SAC,0,NYK,11,2,2,0,0,0,13.73333333,0,2,4,8,3,7,0,0,0,0,4,13,13,15,16.4
2023-24,202404040HOU,4/4/2024,HOU vs GSW,Gary Payton II,paytoga02,41,GSW,0,HOU,8,2,0,1,0,2,14.11666667,2,0,3,3,1,1,1,2,1,1,2,8,10,10,11.4
2023-24,202404040NYK,4/4/2024,NYK vs SAC,Harrison Barnes,barneha02,76,SAC,0,NYK,0,1,0,1,0,3,14.78333333,0,1,0,2,0,1,0,0,0,1,1,0,1,1,1.2
2023-24,202404040DAL,4/4/2024,DAL vs ATL,Vit Krejci,krejcvi01,17,ATL,0,DAL,4,2,3,0,0,0,14.93333333,0,2,1,2,1,2,1,1,2,0,5,7,6,9,10.9
2023-24,202404040DAL,4/4/2024,DAL vs ATL,Garrison Mathews,mathega01,61,ATL,0,DAL,14,2,0,0,0,1,15.26666667,1,1,5,6,3,3,1,1,2,0,2,14,16,16,15.4
2023-24,202404040MIA,4/4/2024,MIA vs PHI,Paul Reed,reedpa01,77,PHI,0,MIA,5,4,0,2,2,0,15.33333333,0,4,2,2,0,0,1,2,0,4,4,5,9,9,21.8
2023-24,202404040HOU,4/4/2024,HOU vs GSW,Jock Landale,landajo01,50,HOU,1,GSW,8,6,1,1,0,0,15.4,5,1,4,5,0,0,0,0,2,1,7,9,14,15,19.7
2023-24,202404040NYK,4/4/2024,NYK vs SAC,Mitchell Robinson,robinmi01,25,NYK,1,SAC,2,7,2,0,1,0,15.4,5,2,0,1,0,0,2,6,0,1,9,4,9,11,16.4
2023-24,202404040LAC,4/4/2024,LAC vs DEN,P.J. Tucker,tuckepj01,26,LAC,1,DEN,0,3,1,0,0,0,16.61666667,1,2,0,2,0,1,0,0,4,0,4,1,3,4,5.1
2023-24,202404040HOU,4/4/2024,HOU vs GSW,Jeff Green,greenje02,72,HOU,1,GSW,8,1,1,1,0,0,17.23333333,1,0,1,5,0,3,6,8,0,1,2,9,9,10,13.7
2023-24,202404040HOU,4/4/2024,HOU vs GSW,Aaron Holiday,holidaa01,73,HOU,1,GSW,6,0,1,0,0,0,17.56666667,0,0,2,4,2,4,0,0,2,0,1,7,6,7,7.5
2023-24,202404040LAC,4/4/2024,LAC vs DEN,Terance Mann,mannte01,69,LAC,1,DEN,6,3,1,2,0,0,18.05,1,2,2,6,0,2,2,2,3,2,4,7,9,10,17.1
2023-24,202404040LAC,4/4/2024,LAC vs DEN,Peyton Watson,watsope01,75,DEN,0,LAC,2,2,0,0,0,1,18.23333333,0,2,0,2,0,1,2,2,2,0,2,2,4,4,3.4
2023-24,202404040MIA,4/4/2024,MIA vs PHI,Kevin Love,loveke01,49,MIA,1,PHI,11,16,4,0,0,2,18.56666667,4,12,5,10,1,6,0,0,2,0,20,15,27,31,34.2
2023-24,202404040DAL,4/4/2024,DAL vs ATL,Bruno Fernando,fernabr01,40,ATL,0,DAL,10,5,2,1,1,1,19.36666667,1,4,3,6,0,0,4,6,2,2,7,12,15,17,24
2023-24,202404040MIA,4/4/2024,MIA vs PHI,Duncan Robinson,robindu01,66,MIA,1,PHI,2,0,1,2,0,0,19.56666667,0,0,1,4,0,3,0,0,0,2,1,3,2,3,9.5
2023-24,202404040MIA,4/4/2024,MIA vs PHI,Nikola Jovic,jovicni01,40,MIA,1,PHI,11,5,1,0,0,2,19.83333333,0,5,4,9,1,4,2,2,1,0,6,12,16,17,16.5
2023-24,202404040MIA,4/4/2024,MIA vs PHI,Jaime Jaquez Jr.,jaqueja01,69,MIA,1,PHI,6,4,3,1,2,1,20.38333333,2,2,2,5,0,2,2,3,1,3,7,9,10,13,23.3
2023-24,202404040DAL,4/4/2024,DAL vs ATL,Tim Hardaway Jr.,hardati02,73,DAL,1,ATL,8,2,3,1,0,1,20.76666667,0,2,3,9,2,7,0,0,2,1,5,11,10,13,16.9
2023-24,202404040DAL,4/4/2024,DAL vs ATL,Maxi Kleber,klebima01,39,DAL,1,ATL,7,6,2,0,1,1,21,2,4,2,5,1,3,2,2,2,1,8,9,13,15,19.2
2023-24,202404040MIA,4/4/2024,MIA vs PHI,KJ Martin,martike04,58,PHI,0,MIA,4,4,1,0,1,1,21.3,4,0,2,6,0,0,0,0,0,1,5,5,8,9,12.3
2023-24,202404040LAC,4/4/2024,LAC vs DEN,Reggie Jackson,jacksre01,77,DEN,0,LAC,7,2,3,0,0,2,21.5,0,2,2,6,1,2,2,2,1,0,5,10,9,12,11.9
2023-24,202404040HOU,4/4/2024,HOU vs GSW,Chris Paul,paulch01,52,GSW,0,HOU,8,2,3,1,0,3,21.7,0,2,3,9,2,4,0,0,1,1,5,11,10,13,14.9
2023-24,202404040DAL,4/4/2024,DAL vs ATL,Dante Exum,exumda01,50,DAL,1,ATL,0,5,2,1,0,0,22.38333333,0,5,0,4,0,3,0,0,1,1,7,2,5,7,12
2023-24,202404040HOU,4/4/2024,HOU vs GSW,Andrew Wiggins,wiggian01,67,GSW,0,HOU,10,5,2,0,0,1,22.56666667,0,5,3,8,1,5,3,4,1,0,7,12,15,17,18
2023-24,202404040DAL,4/4/2024,DAL vs ATL,Daniel Gafford,gaffoda01,69,DAL,1,ATL,6,3,1,1,2,0,22.71666667,1,2,3,5,0,0,0,0,4,3,4,7,9,10,20.1
2023-24,202404040HOU,4/4/2024,HOU vs GSW,Cam Whitmore,whitmca01,41,HOU,1,GSW,17,4,0,0,1,2,23.33333333,1,3,6,14,1,6,4,5,1,1,4,17,21,21,22.8
2023-24,202404040LAC,4/4/2024,LAC vs DEN,Amir Coffey,coffeam01,64,LAC,1,DEN,9,6,1,1,0,0,23.46666667,0,6,3,5,1,2,2,3,1,1,7,10,15,16,20.7
2023-24,202404040HOU,4/4/2024,HOU vs GSW,Dillon Brooks,brookdi01,67,HOU,1,GSW,8,0,0,2,0,0,23.66666667,0,0,3,9,2,6,0,0,4,2,0,8,8,8,14
2023-24,202404040LAC,4/4/2024,LAC vs DEN,Russell Westbrook,westbru01,64,LAC,1,DEN,12,6,5,1,1,2,23.73333333,1,5,4,9,0,2,4,4,1,2,11,17,18,23,30.7
2023-24,202404040HOU,4/4/2024,HOU vs GSW,Moses Moody,moodymo01,60,GSW,0,HOU,9,3,1,0,0,0,23.81666667,1,2,3,4,1,2,2,2,3,0,4,10,12,13,14.1
2023-24,202404040HOU,4/4/2024,HOU vs GSW,Brandin Podziemski,podzibr01,68,GSW,0,HOU,4,4,2,1,0,2,24.4,2,2,2,5,0,0,0,0,1,1,6,6,8,10,12.8
2023-24,202404040NYK,4/4/2024,NYK vs SAC,Davion Mitchell,mitchda01,66,SAC,0,NYK,11,2,1,0,0,0,24.98333333,0,2,5,8,1,2,0,2,1,0,3,12,13,14,14.9
2023-24,202404040HOU,4/4/2024,HOU vs GSW,Trayce Jackson-Davis,jackstr02,62,GSW,0,HOU,20,5,4,1,1,1,27.8,2,3,8,10,0,0,4,4,3,2,9,24,25,29,37
2023-24,202404040NYK,4/4/2024,NYK vs SAC,Trey Lyles,lylestr01,52,SAC,0,NYK,10,3,1,0,0,2,28.56666667,1,2,4,8,1,5,1,2,2,0,4,11,13,14,13.1
2023-24,202404040MIA,4/4/2024,MIA vs PHI,Haywood Highsmith,highsha01,60,MIA,1,PHI,12,9,2,4,1,1,28.6,3,6,5,7,2,4,0,0,1,5,11,14,21,23,39.8
2023-24,202404040DAL,4/4/2024,DAL vs ATL,Clint Capela,capelca01,69,ATL,0,DAL,6,13,2,1,1,5,28.63333333,5,8,3,7,0,0,0,2,2,2,15,8,19,21,25.6
2023-24,202404040DAL,4/4/2024,DAL vs ATL,Derrick Jones Jr.,jonesde02,71,DAL,1,ATL,14,5,0,1,1,1,28.66666667,2,3,4,8,1,3,5,6,0,2,5,14,19,19,25
2023-24,202404040HOU,4/4/2024,HOU vs GSW,Draymond Green,greendr01,51,GSW,0,HOU,5,8,5,1,1,2,28.98333333,2,6,2,3,0,1,1,2,5,2,13,10,13,18,26.1
2023-24,202404040NYK,4/4/2024,NYK vs SAC,Isaiah Hartenstein,harteis01,70,NYK,1,SAC,7,7,9,2,0,0,29.05,1,6,3,4,0,0,1,2,4,2,16,16,14,23,34.9
2023-24,202404040HOU,4/4/2024,HOU vs GSW,Klay Thompson,thompkl01,72,GSW,0,HOU,29,3,4,0,0,3,29.23333333,0,3,11,15,7,11,0,0,3,0,7,33,32,36,35.6
2023-24,202404040MIA,4/4/2024,MIA vs PHI,Bam Adebayo,adebaba01,65,MIA,1,PHI,14,11,3,0,1,2,29.43333333,4,7,6,15,1,1,1,1,2,1,14,17,25,28,32.7
2023-24,202404040HOU,4/4/2024,HOU vs GSW,Amen Thompson,thompam01,57,HOU,1,GSW,8,4,1,1,0,2,29.66666667,2,2,3,7,0,0,2,3,3,1,5,9,12,13,15.3
2023-24,202404040HOU,4/4/2024,HOU vs GSW,Jalen Green,greenja05,76,HOU,1,GSW,13,4,7,1,0,4,29.78333333,1,3,4,12,3,8,2,2,1,1,11,20,17,24,27.3
2023-24,202404040HOU,4/4/2024,HOU vs GSW,Stephen Curry,curryst01,70,GSW,0,HOU,29,6,6,0,0,3,30.65,0,6,9,14,2,6,9,9,2,0,12,35,35,41,42.2
2023-24,202404040NYK,4/4/2024,NYK vs SAC,Keon Ellis,elliske01,51,SAC,0,NYK,11,3,4,2,0,2,30.95,2,1,3,6,3,4,2,2,6,2,7,15,14,18,24.6
2023-24,202404040MIA,4/4/2024,MIA vs PHI,Caleb Martin,martica02,58,MIA,1,PHI,7,0,3,0,0,3,30.95,0,0,2,7,1,6,2,3,2,0,3,10,7,10,8.5
2023-24,202404040NYK,4/4/2024,NYK vs SAC,Keegan Murray,murrake02,71,SAC,0,NYK,18,2,0,0,1,1,31.61666667,1,1,7,14,4,10,0,0,5,1,2,18,20,20,22.4
2023-24,202404040HOU,4/4/2024,HOU vs GSW,Jabari Smith Jr.,smithja05,70,HOU,1,GSW,24,3,2,0,0,2,31.75,1,2,8,17,4,10,4,4,0,0,5,26,27,29,28.6
2023-24,202404040MIA,4/4/2024,MIA vs PHI,Nicolas Batum,batumni01,55,PHI,0,MIA,0,4,7,2,1,2,32.1,0,4,0,4,0,3,0,0,1,3,11,7,4,11,22.3
2023-24,202404040MIA,4/4/2024,MIA vs PHI,Joel Embiid,embiijo01,36,PHI,0,MIA,29,4,3,1,1,1,32.66666667,0,4,11,25,3,6,4,5,2,2,7,32,33,36,43.3
2023-24,202404040MIA,4/4/2024,MIA vs PHI,Terry Rozier,roziete01,59,MIA,1,PHI,22,2,2,1,0,3,32.85,1,1,7,20,6,13,2,2,1,1,4,24,24,26,27.4
2023-24,202404040HOU,4/4/2024,HOU vs GSW,Fred VanVleet,vanvlfr01,69,HOU,1,GSW,10,4,9,5,0,1,33.38333333,0,4,2,7,0,3,6,6,4,5,13,19,14,23,42.3
2023-24,202404040MIA,4/4/2024,MIA vs PHI,Kyle Lowry,lowryky01,57,PHI,0,MIA,8,6,5,1,0,1,33.71666667,0,6,3,7,2,5,0,0,2,1,11,13,14,19,24.7
2023-24,202404040LAC,4/4/2024,LAC vs DEN,Christian Braun,braunch01,77,DEN,0,LAC,7,8,3,1,0,0,33.88333333,2,6,3,9,1,4,0,0,2,1,11,10,15,18,24.1
2023-24,202404040LAC,4/4/2024,LAC vs DEN,Ivica Zubac,zubaciv01,64,LAC,1,DEN,14,15,1,1,0,0,34.81666667,1,14,4,11,0,0,6,6,4,1,16,15,29,30,36.5
2023-24,202404040DAL,4/4/2024,DAL vs ATL,Kyrie Irving,irvinky01,54,DAL,1,ATL,26,5,1,0,1,4,34.85,2,3,10,21,3,7,3,3,1,1,6,27,31,32,32.5
2023-24,202404040DAL,4/4/2024,DAL vs ATL,Dejounte Murray,murrade01,74,ATL,0,DAL,16,5,4,1,0,4,35.33333333,2,3,6,17,3,9,1,2,1,1,9,20,21,25,27
2023-24,202404040LAC,4/4/2024,LAC vs DEN,Norman Powell,powelno01,72,LAC,1,DEN,11,3,3,1,0,0,35.36666667,1,2,4,12,2,7,1,2,0,1,6,14,14,17,22.1
2023-24,202404040NYK,4/4/2024,NYK vs SAC,Domantas Sabonis,sabondo01,76,SAC,0,NYK,17,11,7,0,1,4,35.55,4,7,7,13,0,0,3,5,5,1,18,24,28,35,39.7
2023-24,202404040LAC,4/4/2024,LAC vs DEN,Aaron Gordon,gordoaa01,70,DEN,0,LAC,18,6,7,1,2,1,35.6,2,4,5,10,0,2,8,14,4,3,13,25,24,31,43.7
2023-24,202404040DAL,4/4/2024,DAL vs ATL,P.J. Washington,washipj01,68,DAL,1,ATL,19,8,3,1,1,1,36.15,1,7,6,11,5,8,2,2,2,2,11,22,27,30,38.1
2023-24,202404040DAL,4/4/2024,DAL vs ATL,Bogdan Bogdanovic,bogdabo01,74,ATL,0,DAL,17,7,2,1,0,4,36.35,1,6,6,15,3,10,2,2,3,1,9,19,24,26,27.4
2023-24,202404040DAL,4/4/2024,DAL vs ATL,Jalen Johnson,johnsja05,54,ATL,0,DAL,6,16,4,1,0,2,36.43333333,1,15,3,12,0,1,0,0,1,1,20,10,22,26,32.2
2023-24,202404040DAL,4/4/2024,DAL vs ATL,De'Andre Hunter,huntede01,53,ATL,0,DAL,13,3,3,1,0,4,36.51666667,0,3,3,10,2,7,5,7,5,1,6,16,16,19,20.1
2023-24,202404040LAC,4/4/2024,LAC vs DEN,Paul George,georgpa01,70,LAC,1,DEN,28,4,2,3,0,3,36.58333333,0,4,10,21,2,6,6,8,2,3,6,30,32,34,41.8
2023-24,202404040DAL,4/4/2024,DAL vs ATL,Luka Doncic,doncilu01,67,DAL,1,ATL,25,12,8,2,1,5,37.03333333,0,12,8,25,6,15,3,3,3,3,20,33,37,45,55.4
2023-24,202404040LAC,4/4/2024,LAC vs DEN,Kentavious Caldwell-Pope,caldwke01,71,DEN,0,LAC,16,4,3,1,1,1,37.5,0,4,6,13,4,7,0,1,4,2,7,19,20,23,30.3
2023-24,202404040LAC,4/4/2024,LAC vs DEN,Michael Porter Jr.,portemi01,76,DEN,0,LAC,14,9,1,0,1,2,37.93333333,1,8,6,18,2,10,0,0,4,1,10,15,23,24,27.3
2023-24,202404040NYK,4/4/2024,NYK vs SAC,Jalen Brunson,brunsja01,71,NYK,1,SAC,35,2,11,3,0,3,38.21666667,0,2,12,20,2,5,9,10,2,3,13,46,37,48,59.9
2023-24,202404040LAC,4/4/2024,LAC vs DEN,James Harden,hardeja01,69,LAC,1,DEN,20,6,8,1,0,1,38.26666667,1,5,6,23,2,13,6,7,0,1,14,28,26,34,41.2
2023-24,202404040NYK,4/4/2024,NYK vs SAC,Donte DiVincenzo,divindo01,75,NYK,1,SAC,21,5,1,0,1,1,38.6,0,5,6,13,5,9,4,5,3,1,6,22,26,27,30.5
2023-24,202404040NYK,4/4/2024,NYK vs SAC,De'Aaron Fox,foxde01,68,SAC,0,NYK,29,7,7,3,1,4,39.38333333,1,6,11,26,6,13,1,1,2,4,14,36,36,43,55.9
2023-24,202404040MIA,4/4/2024,MIA vs PHI,Jimmy Butler,butleji01,54,MIA,1,PHI,20,4,5,0,0,1,39.78333333,2,2,7,17,1,4,5,5,0,0,9,25,24,29,31.3
2023-24,202404040LAC,4/4/2024,LAC vs DEN,Nikola Jokic,jokicni01,74,DEN,0,LAC,36,17,10,0,0,5,40.1,1,16,14,24,3,8,5,6,2,0,27,46,53,63,66.4
2023-24,202404040MIA,4/4/2024,MIA vs PHI,Kelly Oubre Jr.,oubreke01,63,PHI,0,MIA,18,8,0,2,1,3,41.08333333,1,7,8,14,2,6,0,0,2,3,8,18,26,26,33.6
2023-24,202404040MIA,4/4/2024,MIA vs PHI,Tyrese Maxey,maxeyty01,66,PHI,0,MIA,37,9,11,1,1,1,41.36666667,2,7,15,26,5,14,2,2,3,2,20,48,46,57,69.3
2023-24,202404040NYK,4/4/2024,NYK vs SAC,Miles McBride,mcbrimi01,63,NYK,1,SAC,12,4,3,0,0,1,42.83333333,2,2,4,13,3,10,1,2,4,0,7,15,16,19,20.3
2023-24,202404040NYK,4/4/2024,NYK vs SAC,Josh Hart,hartjo01,75,NYK,1,SAC,31,9,8,2,0,4,43.26666667,1,8,14,19,0,0,3,4,3,2,17,39,40,48,55.8
2023-24,202404030BOS,4/3/2024,BOS vs OKC,Lindy Waters III,waterli01,33,OKC,0,BOS,4,1,1,0,0,0,10.21666667,0,1,2,3,0,1,0,0,1,0,2,5,5,6,6.7
2023-24,202404030BRK,4/3/2024,BRK vs IND,Jalen Wilson,wilsoja03,38,BRK,1,IND,4,4,0,0,0,0,10.35,1,3,1,1,0,0,2,2,1,0,4,4,8,8,8.8
2023-24,202404030WAS,4/3/2024,WAS vs LAL,Eugene Omoruyi,omorueu01,38,WAS,1,LAL,4,2,0,1,1,0,10.48333333,0,2,2,6,0,2,0,0,0,2,2,4,6,6,12.4
2023-24,202404030CHO,4/3/2024,CHO vs POR,Duop Reath,reathdu01,62,POR,0,CHO,7,3,0,0,0,0,10.76666667,1,2,3,10,1,6,0,0,2,0,3,7,10,10,10.6
2023-24,202404030PHO,4/3/2024,PHO vs CLE,Georges Niang,niangge01,77,CLE,0,PHO,0,2,0,0,0,0,11.35,0,2,0,4,0,3,0,0,2,0,2,0,2,2,2.4
2023-24,202404030NOP,4/3/2024,NOP vs ORL,Jeremiah Robinson-Earl,robinje02,34,NOP,1,ORL,0,4,1,0,0,2,12.31666667,1,3,0,3,0,3,0,0,1,0,5,1,4,5,4.3
2023-24,202404030BRK,4/3/2024,BRK vs IND,Trendon Watford,watfotr01,58,BRK,1,IND,4,1,0,0,0,1,12.55,0,1,1,4,0,0,2,2,0,0,1,4,5,5,4.2
2023-24,202404030ATL,4/3/2024,ATL vs DET,Kobe Bufkin,bufkiko01,11,ATL,1,DET,9,1,1,2,2,0,12.56666667,1,0,4,8,1,5,0,0,1,4,2,10,10,11,23.7
2023-24,202404030CHO,4/3/2024,CHO vs POR,Ashton Hagans,haganas01,18,POR,0,CHO,0,3,1,0,0,1,12.61666667,2,1,0,4,0,2,0,0,2,0,4,1,3,4,4.1
2023-24,202404030NOP,4/3/2024,NOP vs ORL,Larry Nance Jr.,nancela02,57,NOP,1,ORL,2,1,1,0,0,2,13.25,1,0,1,2,0,1,0,0,2,0,2,3,3,4,2.7
2023-24,202404030MIN,4/3/2024,MIN vs TOR,T.J. Warren,warretj01,9,MIN,1,TOR,8,4,0,0,0,0,13.88333333,0,4,3,5,0,2,2,2,0,0,4,8,12,12,12.8
2023-24,202404030WAS,4/3/2024,WAS vs LAL,Gabe Vincent,vincega01,7,LAL,0,WAS,0,1,0,0,0,1,14.35,1,0,0,1,0,1,0,0,1,0,1,0,1,1,0.2
2023-24,202404030CHO,4/3/2024,CHO vs POR,Marques Bolden,boldema01,6,CHO,1,POR,7,8,0,1,1,0,14.58333333,1,7,3,3,0,0,1,2,0,2,8,7,15,15,22.6
2023-24,202404030NOP,4/3/2024,NOP vs ORL,Markelle Fultz,fultzma01,37,ORL,0,NOP,5,1,0,1,0,1,14.8,0,1,2,3,0,0,1,1,4,1,1,5,6,6,8.2
2023-24,202404030BOS,4/3/2024,BOS vs OKC,Jaylin Williams,willija07,63,OKC,0,BOS,7,3,4,0,0,0,14.86666667,1,2,1,3,0,2,5,6,0,0,7,11,10,14,16.6
2023-24,202404030PHO,4/3/2024,PHO vs CLE,Drew Eubanks,eubandr01,70,PHO,1,CLE,4,5,0,1,0,0,14.88333333,1,4,2,4,0,0,0,0,1,1,5,4,9,9,13
2023-24,202404030NOP,4/3/2024,NOP vs ORL,Moritz Wagner,wagnemo01,74,ORL,0,NOP,18,3,1,0,0,0,14.93333333,1,2,7,9,1,2,3,3,1,0,4,19,21,22,23.1
2023-24,202404030NOP,4/3/2024,NOP vs ORL,Joe Ingles,inglejo01,62,ORL,0,NOP,4,3,2,2,0,0,15.1,0,3,1,3,1,3,1,1,0,2,5,6,7,9,16.6
2023-24,202404030ATL,4/3/2024,ATL vs DET,Evan Fournier,fournev01,27,DET,0,ATL,0,1,2,1,0,0,15.18333333,0,1,0,5,0,3,0,0,0,1,3,2,1,3,7.2
2023-24,202404030CHO,4/3/2024,CHO vs POR,Leaky Black,blackle01,23,CHO,1,POR,4,1,1,0,2,0,15.25,0,1,2,2,0,0,0,0,1,2,2,5,5,6,12.7
2023-24,202404030WAS,4/3/2024,WAS vs LAL,Taurean Prince,princta02,74,LAL,0,WAS,5,7,1,1,0,1,15.9,1,6,2,4,1,3,0,0,1,1,8,6,12,13,16.9
2023-24,202404030MIN,4/3/2024,MIN vs TOR,Jordan McLaughlin,mclaujo01,50,MIN,1,TOR,0,0,3,0,0,0,16.56666667,0,0,0,2,0,2,0,0,0,0,3,3,0,3,4.5
2023-24,202404030BRK,4/3/2024,BRK vs IND,Noah Clowney,clownno01,18,BRK,1,IND,22,10,1,0,1,1,16.78333333,5,5,7,9,3,4,5,7,4,1,11,23,32,33,37.5
2023-24,202404030MIN,4/3/2024,MIN vs TOR,Kyle Anderson,anderky01,73,MIN,1,TOR,3,3,5,1,0,0,17.46666667,0,3,1,4,1,2,0,0,2,1,8,8,6,11,17.1
2023-24,202404030ATL,4/3/2024,ATL vs DET,Bruno Fernando,fernabr01,39,ATL,1,DET,0,1,3,0,1,0,17.55,0,1,0,0,0,0,0,0,4,1,4,3,1,4,8.7
2023-24,202404030NOP,4/3/2024,NOP vs ORL,Cole Anthony,anthoco01,75,ORL,0,NOP,5,2,6,2,0,1,18,0,2,2,6,1,3,0,0,0,2,8,11,7,13,21.4
2023-24,202404030BOS,4/3/2024,BOS vs OKC,Gordon Hayward,haywago01,47,OKC,0,BOS,0,2,2,1,0,0,18.31666667,0,2,0,4,0,1,0,0,0,1,4,2,2,4,8.4
2023-24,202404030CHO,4/3/2024,CHO vs POR,Bryce McGowens,mcgowbr01,55,CHO,1,POR,7,3,0,0,1,1,18.45,0,3,3,9,1,2,0,0,2,1,3,7,10,10,12.6
2023-24,202404030CHO,4/3/2024,CHO vs POR,Nick Smith Jr.,smithni01,48,CHO,1,POR,4,3,1,0,0,1,18.48333333,0,3,2,9,0,2,0,0,1,0,4,5,7,8,8.1
2023-24,202404030NOP,4/3/2024,NOP vs ORL,Jonas Valanciunas,valanjo01,76,NOP,1,ORL,11,6,1,0,0,1,18.53333333,1,5,4,6,0,0,3,3,2,0,7,12,17,18,18.7
2023-24,202404030WAS,4/3/2024,WAS vs LAL,Justin Champagnie,champju01,11,WAS,1,LAL,13,7,2,1,0,0,18.58333333,3,4,5,8,3,5,0,0,0,1,9,15,20,22,27.4
2023-24,202404030MIN,4/3/2024,MIN vs TOR,Mouhamadou Gueye,gueyemo01,10,TOR,0,MIN,3,6,0,0,3,1,18.76666667,3,3,1,4,0,1,1,2,3,3,6,3,9,9,18.2
2023-24,202404030MIL,4/3/2024,MIL vs MEM,Trey Jemison,jemistr01,19,MEM,0,MIL,7,4,0,0,2,0,18.96666667,2,2,3,7,0,0,1,2,0,2,4,7,11,11,17.8
2023-24,202404030BRK,4/3/2024,BRK vs IND,T.J. McConnell,mccontj01,67,IND,0,BRK,8,3,5,0,0,1,19.1,1,2,4,6,0,0,0,0,5,0,8,13,11,16,18.1
2023-24,202404030WAS,4/3/2024,WAS vs LAL,Spencer Dinwiddie,dinwisp01,71,LAL,0,WAS,4,2,1,0,0,1,19.15,0,2,1,4,0,3,2,2,1,0,3,5,6,7,6.9
2023-24,202404030ATL,4/3/2024,ATL vs DET,Garrison Mathews,mathega01,60,ATL,1,DET,9,3,0,0,0,0,19.16666667,0,3,3,3,3,3,0,0,2,0,3,9,12,12,12.6
2023-24,202404030MIL,4/3/2024,MIL vs MEM,Scotty Pippen Jr.,pippesc02,15,MEM,0,MIL,6,2,3,0,1,2,19.38333333,0,2,3,7,0,1,0,0,1,1,5,9,8,11,13.9
2023-24,202404030ATL,4/3/2024,ATL vs DET,Vit Krejci,krejcvi01,16,ATL,1,DET,4,0,1,0,0,1,19.51666667,0,0,2,4,0,2,0,0,1,0,1,5,4,5,4.5
2023-24,202404030MIL,4/3/2024,MIL vs MEM,Brandon Clarke,clarkbr01,4,MEM,0,MIL,14,7,3,0,2,0,19.95,2,5,7,10,0,1,0,2,1,2,10,17,21,24,32.9
2023-24,202404030BRK,4/3/2024,BRK vs IND,Obi Toppin,toppiob01,78,IND,0,BRK,14,8,1,1,3,2,20,3,5,5,9,3,6,1,1,2,4,9,15,22,23,35.1
2023-24,202404030ATL,4/3/2024,ATL vs DET,James Wiseman,wisemja01,57,DET,0,ATL,9,5,2,0,1,0,20.15,2,3,4,5,0,0,1,1,1,1,7,11,14,16,21
2023-24,202404030BOS,4/3/2024,BOS vs OKC,Isaiah Joe,joeis01,72,OKC,0,BOS,13,3,0,1,1,0,20.41666667,0,3,4,5,2,3,3,4,0,2,3,13,16,16,22.6
2023-24,202404030WAS,4/3/2024,WAS vs LAL,Tristan Vukcevic,vukcetr01,7,WAS,1,LAL,15,3,1,0,1,1,20.53333333,1,2,5,9,3,6,2,2,5,1,4,16,18,19,22.1
2023-24,202404030CHO,4/3/2024,CHO vs POR,Aleksej Pokusevski,pokusal01,22,CHO,1,POR,11,3,1,0,2,0,20.56666667,1,2,2,6,1,3,6,8,2,2,4,12,14,15,22.1
2023-24,202404030WAS,4/3/2024,WAS vs LAL,Anthony Gill,gillan01,46,WAS,1,LAL,6,2,3,1,0,0,20.73333333,1,1,3,7,0,2,0,0,4,1,5,9,8,11,15.9
2023-24,202404030MIL,4/3/2024,MIL vs MEM,A.J. Green,greenaj01,52,MIL,1,MEM,9,4,2,1,1,1,21.01666667,1,3,3,7,3,6,0,1,0,2,6,11,13,15,21.8
2023-24,202404030NOP,4/3/2024,NOP vs ORL,Dyson Daniels,daniedy01,55,NOP,1,ORL,16,2,3,2,0,1,21.35,0,2,6,8,4,5,0,0,5,2,5,19,18,21,27.9
2023-24,202404030BOS,4/3/2024,BOS vs OKC,Sam Hauser,hausesa01,73,BOS,1,OKC,10,2,0,0,0,0,21.51666667,0,2,4,8,2,5,0,0,3,0,2,10,12,12,12.4
2023-24,202404030WAS,4/3/2024,WAS vs LAL,Deni Avdija,avdijde01,70,WAS,1,LAL,7,2,2,1,0,2,21.6,1,1,2,5,1,2,2,3,0,1,4,9,9,11,13.4
2023-24,202404030NOP,4/3/2024,NOP vs ORL,Jonathan Isaac,isaacjo01,53,ORL,0,NOP,8,5,2,1,1,0,21.88333333,1,4,3,5,1,3,1,2,1,2,7,10,13,15,23
2023-24,202404030BRK,4/3/2024,BRK vs IND,Isaiah Jackson,jacksis01,58,IND,0,BRK,6,5,1,0,2,1,22.15,4,1,3,6,0,0,0,0,3,2,6,7,11,12,18.5
2023-24,202404030PHO,4/3/2024,PHO vs CLE,Bol Bol,bolbo01,38,PHO,1,CLE,15,6,1,2,2,2,22.21666667,1,5,5,8,3,4,2,2,1,4,7,16,21,22,33.7
2023-24,202404030BRK,4/3/2024,BRK vs IND,Jalen Smith,smithja04,56,IND,0,BRK,8,9,2,1,2,0,22.25,3,6,4,11,0,3,0,0,1,3,11,10,17,19,30.8
2023-24,202404030BRK,4/3/2024,BRK vs IND,Ben Sheppard,sheppbe01,53,IND,0,BRK,8,1,2,2,0,1,22.41666667,1,0,2,8,2,7,2,2,0,2,3,10,9,11,17.2
2023-24,202404030BRK,4/3/2024,BRK vs IND,Cameron Johnson,johnsca02,57,BRK,1,IND,5,3,2,1,0,0,22.48333333,1,2,2,8,1,4,0,0,1,1,5,7,8,10,14.6
2023-24,202404030MIN,4/3/2024,MIN vs TOR,Nickeil Alexander-Walker,alexani01,76,MIN,1,TOR,14,2,3,1,0,1,22.51666667,0,2,5,7,4,6,0,0,1,1,5,17,16,19,22.9
2023-24,202404030MIL,4/3/2024,MIL vs MEM,Lamar Stevens,stevela01,36,MEM,0,MIL,9,9,1,0,1,0,23.88333333,5,4,4,10,1,1,0,0,2,1,10,10,18,19,24.3
2023-24,202404030PHO,4/3/2024,PHO vs CLE,Caris LeVert,leverca01,64,CLE,0,PHO,11,3,1,3,0,5,24.03333333,0,3,3,5,2,4,3,4,2,3,4,12,14,15,20.1
2023-24,202404030NOP,4/3/2024,NOP vs ORL,Wendell Carter Jr.,cartewe01,49,ORL,0,NOP,14,11,3,0,0,2,24.15,2,9,5,7,3,4,1,2,3,0,14,17,25,28,29.7
2023-24,202404030ATL,4/3/2024,ATL vs DET,Troy Brown Jr.,browntr01,53,DET,0,ATL,6,5,2,1,0,0,24.3,1,4,2,4,0,2,2,2,1,1,7,8,11,13,18
2023-24,202404030PHO,4/3/2024,PHO vs CLE,Eric Gordon,gordoer01,63,PHO,1,CLE,3,1,1,1,0,1,24.45,0,1,1,3,1,3,0,0,3,1,2,4,4,5,7.7
2023-24,202404030BOS,4/3/2024,BOS vs OKC,Al Horford,horfoal01,62,BOS,1,OKC,16,4,2,0,1,2,24.68333333,2,2,7,10,2,4,0,0,1,1,6,18,20,22,24.8
2023-24,202404030MIN,4/3/2024,MIN vs TOR,Monte Morris,morrimo01,27,MIN,1,TOR,13,4,5,1,2,0,24.81666667,0,4,5,8,3,5,0,0,1,3,9,18,17,22,34.3
2023-24,202404030MIL,4/3/2024,MIL vs MEM,Jae Crowder,crowdja01,45,MIL,1,MEM,6,2,0,0,1,0,24.98333333,1,1,2,8,1,5,1,2,0,1,2,6,8,8,11.4
2023-24,202404030MIN,4/3/2024,MIN vs TOR,Jaden McDaniels,mcdanja02,66,MIN,1,TOR,8,4,2,2,3,1,25.06666667,1,3,3,8,0,1,2,2,1,5,6,10,12,14,29.8
2023-24,202404030BOS,4/3/2024,BOS vs OKC,Kenrich Williams,willike04,63,OKC,0,BOS,7,1,0,1,0,1,25.45,0,1,3,9,1,3,0,0,2,1,1,7,8,8,10.2
2023-24,202404030MIN,4/3/2024,MIN vs TOR,Naz Reid,reidna01,75,MIN,1,TOR,23,7,1,1,2,2,25.78333333,1,6,8,15,6,10,1,2,0,3,8,24,30,31,39.9
2023-24,202404030NOP,4/3/2024,NOP vs ORL,Naji Marshall,marshna01,64,NOP,1,ORL,8,3,3,1,0,1,25.96666667,1,2,3,5,1,1,1,1,3,1,6,11,11,14,18.1
2023-24,202404030ATL,4/3/2024,ATL vs DET,Jaden Ivey,iveyja01,71,DET,0,ATL,8,3,4,0,0,1,26.88333333,0,3,3,15,1,4,1,2,2,0,7,12,11,15,16.6
2023-24,202404030MIL,4/3/2024,MIL vs MEM,Luke Kennard,kennalu01,39,MEM,0,MIL,3,3,4,0,0,2,26.95,0,3,1,4,1,2,0,0,0,0,7,7,6,10,10.6
2023-24,202404030CHO,4/3/2024,CHO vs POR,Davis Bertans,bertada01,38,CHO,1,POR,7,1,4,4,0,1,27.15,0,1,2,7,1,6,2,2,3,4,5,11,8,12,25.2
2023-24,202404030MIN,4/3/2024,MIN vs TOR,Javon Freeman-Liberty,freemja01,16,TOR,0,MIN,16,5,6,1,0,5,27.28333333,0,5,6,10,2,4,2,2,1,1,11,22,21,27,29
2023-24,202404030CHO,4/3/2024,CHO vs POR,JT Thor,thorjt01,58,CHO,1,POR,9,5,1,0,1,1,27.43333333,0,5,4,5,0,1,1,1,1,1,6,10,14,15,18.5
2023-24,202404030MIN,4/3/2024,MIN vs TOR,Rudy Gobert,goberru01,70,MIN,1,TOR,11,15,3,1,2,4,27.46666667,5,10,3,6,0,0,5,8,3,3,18,14,26,29,38.5
2023-24,202404030WAS,4/3/2024,WAS vs LAL,Rui Hachimura,hachiru01,64,LAL,0,WAS,19,7,1,0,1,2,27.46666667,2,5,9,12,1,2,0,1,2,1,8,20,26,27,29.9
2023-24,202404030BOS,4/3/2024,BOS vs OKC,Chet Holmgren,holmgch01,76,OKC,0,BOS,11,7,2,0,0,1,27.46666667,1,6,5,14,0,3,1,2,1,0,9,13,18,20,21.4
2023-24,202404030MIL,4/3/2024,MIL vs MEM,Jake LaRavia,laravja01,31,MEM,0,MIL,9,2,2,2,1,1,27.65,0,2,2,5,1,3,4,4,3,3,4,11,11,13,22.4
2023-24,202404030MIL,4/3/2024,MIL vs MEM,Bobby Portis,portibo01,76,MIL,1,MEM,19,7,3,1,2,0,27.78333333,1,6,8,16,3,5,0,0,2,3,10,22,26,29,40.9
2023-24,202404030BOS,4/3/2024,BOS vs OKC,Payton Pritchard,pritcpa01,76,BOS,1,OKC,11,4,8,2,0,0,27.78333333,1,3,4,10,1,4,2,2,0,2,12,19,15,23,33.8
2023-24,202404030ATL,4/3/2024,ATL vs DET,Chimezie Metu,metuch01,45,DET,0,ATL,9,5,3,5,1,1,27.81666667,1,4,4,9,0,2,1,1,2,6,8,12,14,17,36.5
2023-24,202404030ATL,4/3/2024,ATL vs DET,Jalen Duren,durenja01,58,DET,0,ATL,11,4,1,2,0,2,27.85,2,2,5,13,0,0,1,1,0,2,5,12,15,16,21.3
2023-24,202404030BRK,4/3/2024,BRK vs IND,Aaron Nesmith,nesmiaa01,68,IND,0,BRK,9,5,2,0,0,0,27.91666667,2,3,4,7,0,3,1,1,5,0,7,11,14,16,18
2023-24,202404030BOS,4/3/2024,BOS vs OKC,Josh Giddey,giddejo01,75,OKC,0,BOS,17,6,2,0,0,2,28.23333333,2,4,7,11,1,2,2,2,0,0,8,19,23,25,25.2
2023-24,202404030BOS,4/3/2024,BOS vs OKC,Cason Wallace,wallaca01,76,OKC,0,BOS,12,1,5,4,1,4,28.25,0,1,4,9,0,3,4,4,1,5,6,17,13,18,31.7
2023-24,202404030BOS,4/3/2024,BOS vs OKC,Luguentz Dort,dortlu01,74,OKC,0,BOS,15,5,0,0,1,1,28.35,1,4,3,10,0,5,9,9,3,1,5,15,20,20,23
2023-24,202404030BRK,4/3/2024,BRK vs IND,Andrew Nembhard,nembhan01,63,IND,0,BRK,8,2,3,1,0,2,28.53333333,1,1,3,6,0,1,2,2,2,1,5,11,10,13,15.9
2023-24,202404030MIL,4/3/2024,MIL vs MEM,Jordan Goodwin,goodwjo01,52,MEM,0,MIL,13,12,7,0,0,1,28.61666667,4,8,6,10,0,2,1,2,1,0,19,20,25,32,36.9
2023-24,202404030MIN,4/3/2024,MIN vs TOR,Immanuel Quickley,quickim01,64,TOR,0,MIN,16,1,3,1,0,1,28.61666667,0,1,7,17,2,7,0,0,1,1,4,19,17,20,23.7
2023-24,202404030BOS,4/3/2024,BOS vs OKC,Aaron Wiggins,wiggiaa01,72,OKC,0,BOS,10,1,5,1,1,4,28.68333333,0,1,4,11,1,1,1,1,3,2,6,15,11,16,20.7
2023-24,202404030BOS,4/3/2024,BOS vs OKC,Jayson Tatum,tatumja01,71,BOS,1,OKC,24,7,3,1,0,0,28.9,3,4,7,15,2,5,8,8,2,1,10,27,31,34,39.9
2023-24,202404030NOP,4/3/2024,NOP vs ORL,Zion Williamson,willizi01,65,NOP,1,ORL,15,2,5,2,1,2,29.31666667,0,2,7,16,0,0,1,4,4,3,7,20,17,22,31.9
2023-24,202404030WAS,4/3/2024,WAS vs LAL,Jared Butler,butleja02,35,WAS,1,LAL,9,3,7,3,1,3,29.33333333,0,3,3,8,1,5,2,2,4,4,10,16,12,19,32.1
2023-24,202404030MIN,4/3/2024,MIN vs TOR,Jordan Nwora,nworajo01,47,TOR,0,MIN,14,13,5,0,0,4,29.66666667,3,10,4,9,1,4,5,6,0,0,18,19,27,32,33.1
2023-24,202404030CHO,4/3/2024,CHO vs POR,Brandon Miller,millebr02,69,CHO,1,POR,21,2,1,2,1,2,29.9,0,2,9,20,1,8,2,3,1,3,3,22,23,24,31.9
2023-24,202404030NOP,4/3/2024,NOP vs ORL,Jalen Suggs,suggsja01,69,ORL,0,NOP,7,4,2,2,0,1,30,1,3,3,6,1,2,0,2,4,2,6,9,11,13,19.8
2023-24,202404030MIN,4/3/2024,MIN vs TOR,Anthony Edwards,edwaran01,73,MIN,1,TOR,28,3,6,2,0,0,30.11666667,0,3,10,23,5,12,3,5,0,2,9,34,31,37,46.6
2023-24,202404030NOP,4/3/2024,NOP vs ORL,Gary Harris,harriga01,49,ORL,0,NOP,0,2,2,0,0,1,30.18333333,1,1,0,3,0,3,0,0,4,0,4,2,2,4,4.4
2023-24,202404030ATL,4/3/2024,ATL vs DET,Clint Capela,capelca01,68,ATL,1,DET,11,16,1,0,2,1,30.45,2,14,5,9,0,0,1,2,1,2,17,12,27,28,36.7
2023-24,202404030BOS,4/3/2024,BOS vs OKC,Kristaps Porzingis,porzikr01,54,BOS,1,OKC,27,12,4,1,5,0,30.88333333,3,9,11,14,3,3,2,2,3,6,16,31,39,43,65.4
2023-24,202404030ATL,4/3/2024,ATL vs DET,Tosan Evbuomwan,evbuoto01,16,DET,0,ATL,9,6,1,1,1,0,31.01666667,1,5,3,5,1,2,2,2,2,2,7,10,15,16,23.7
2023-24,202404030MIN,4/3/2024,MIN vs TOR,Malik Williams,willima11,1,TOR,0,MIN,0,5,1,1,2,1,31.11666667,1,4,0,7,0,2,0,0,1,3,6,1,5,6,15.5
2023-24,202404030BOS,4/3/2024,BOS vs OKC,Derrick White,whitede01,70,BOS,1,OKC,8,1,6,1,1,0,31.18333333,0,1,2,5,2,4,2,2,4,2,7,14,9,15,24.2
2023-24,202404030BRK,4/3/2024,BRK vs IND,Nic Claxton,claxtni01,67,BRK,1,IND,14,13,2,0,4,3,31.33333333,4,9,7,10,0,0,0,2,2,4,15,16,27,29,41.6
2023-24,202404030BOS,4/3/2024,BOS vs OKC,Jrue Holiday,holidjr01,65,BOS,1,OKC,12,7,4,0,1,3,31.56666667,1,6,5,9,2,6,0,0,1,1,11,16,19,23,26.4
2023-24,202404030PHO,4/3/2024,PHO vs CLE,Jusuf Nurkic,nurkiju01,71,PHO,1,CLE,2,10,6,2,0,2,31.66666667,4,6,0,4,0,0,2,2,2,2,16,8,12,18,27
2023-24,202404030CHO,4/3/2024,CHO vs POR,Kris Murray,murrakr01,56,POR,0,CHO,6,3,0,0,1,1,32.11666667,1,2,3,6,0,2,0,1,3,1,3,6,9,9,11.6
2023-24,202404030MIL,4/3/2024,MIL vs MEM,Giannis Antetokounmpo,antetgi01,71,MIL,1,MEM,21,7,8,1,5,3,32.2,1,6,10,23,0,4,1,3,4,6,15,29,28,36,56.4
2023-24,202404030PHO,4/3/2024,PHO vs CLE,Bradley Beal,bealbr01,47,PHO,1,CLE,7,6,7,2,0,1,32.43333333,2,4,3,9,1,3,0,0,3,2,13,14,13,20,29.7
2023-24,202404030ATL,4/3/2024,ATL vs DET,Marcus Sasser,sassema01,65,DET,0,ATL,11,2,4,1,0,2,32.73333333,1,1,4,13,3,8,0,0,3,1,6,15,13,17,20.4
2023-24,202404030BOS,4/3/2024,BOS vs OKC,Jaylen Brown,brownja02,67,BOS,1,OKC,23,7,4,1,2,5,32.81666667,1,6,9,20,3,9,2,3,4,3,11,27,30,34,41.4
2023-24,202404030ATL,4/3/2024,ATL vs DET,Bogdan Bogdanovic,bogdabo01,73,ATL,1,DET,10,2,4,2,2,1,33.15,0,2,4,15,2,10,0,0,2,4,6,14,12,16,29.4
2023-24,202404030NOP,4/3/2024,NOP vs ORL,Franz Wagner,wagnefr01,68,ORL,0,NOP,24,2,5,0,1,4,33.18333333,0,2,8,14,3,6,5,6,1,1,7,29,26,31,32.9
2023-24,202404030CHO,4/3/2024,CHO vs POR,Grant Williams,willigr01,72,CHO,1,POR,5,7,11,0,0,1,33.41666667,0,7,1,6,1,3,2,2,3,0,18,16,12,23,28.9
2023-24,202404030MIN,4/3/2024,MIN vs TOR,Garrett Temple,templga01,23,TOR,0,MIN,7,2,0,0,1,1,33.51666667,1,1,3,11,1,5,0,0,3,1,2,7,9,9,11.4
2023-24,202404030MIN,4/3/2024,MIN vs TOR,Gradey Dick,dickgr01,55,TOR,0,MIN,16,8,0,1,0,4,33.78333333,0,8,6,17,1,6,3,3,2,1,8,16,24,24,24.6
2023-24,202404030CHO,4/3/2024,CHO vs POR,Dalano Banton,bantoda01,49,POR,0,CHO,12,2,3,2,0,2,33.9,0,2,5,13,1,4,1,2,0,2,5,15,14,17,22.9
2023-24,202404030WAS,4/3/2024,WAS vs LAL,Jordan Poole,poolejo01,75,WAS,1,LAL,29,2,5,2,0,3,34.01666667,0,2,10,19,5,9,4,4,1,2,7,34,31,36,41.9
2023-24,202404030ATL,4/3/2024,ATL vs DET,Malachi Flynn,flynnma01,63,DET,0,ATL,50,6,5,3,0,4,34.05,0,6,18,25,5,9,9,12,2,3,11,55,56,61,69.7
2023-24,202404030PHO,4/3/2024,PHO vs CLE,Royce O'Neale,onealro01,73,PHO,1,CLE,17,6,2,1,0,1,34.55,0,6,6,9,5,7,0,0,2,1,8,19,23,25,29.2
2023-24,202404030BRK,4/3/2024,BRK vs IND,Pascal Siakam,siakapa01,75,IND,0,BRK,26,9,3,1,0,2,34.68333333,3,6,12,27,0,3,2,4,3,1,12,29,35,38,42.3
2023-24,202404030MIL,4/3/2024,MIL vs MEM,Pat Connaughton,connapa01,70,MIL,1,MEM,6,6,8,2,0,2,34.7,2,4,2,12,2,9,0,0,1,2,14,14,12,20,29.2
2023-24,202404030CHO,4/3/2024,CHO vs POR,Tre Mann,manntr01,35,CHO,1,POR,11,3,2,3,0,2,34.76666667,0,3,4,11,0,6,3,4,1,3,5,13,14,16,24.6
2023-24,202404030CHO,4/3/2024,CHO vs POR,Rayan Rupert,ruperra01,33,POR,0,CHO,4,5,1,1,0,3,34.76666667,1,4,1,5,0,1,2,2,4,1,6,5,9,10,11.5
2023-24,202404030WAS,4/3/2024,WAS vs LAL,Corey Kispert,kispeco01,75,WAS,1,LAL,17,3,3,0,0,4,34.85,0,3,7,10,3,4,0,0,4,0,6,20,20,23,21.1
2023-24,202404030WAS,4/3/2024,WAS vs LAL,Austin Reaves,reaveau01,78,LAL,0,WAS,16,4,4,2,0,1,35.03333333,2,2,7,15,2,6,0,0,1,2,8,20,20,24,31.8
2023-24,202404030ATL,4/3/2024,ATL vs DET,Dejounte Murray,murrade01,73,ATL,1,DET,24,4,11,1,0,5,35.43333333,1,3,10,21,2,8,2,3,1,1,15,35,28,39,43.3
2023-24,202404030ATL,4/3/2024,ATL vs DET,De'Andre Hunter,huntede01,52,ATL,1,DET,26,7,4,0,0,5,35.45,0,7,11,16,3,6,1,3,1,0,11,30,33,37,35.4
2023-24,202404030BRK,4/3/2024,BRK vs IND,Dorian Finney-Smith,finnedo01,67,BRK,1,IND,10,2,1,1,0,2,35.56666667,1,1,4,7,1,4,1,2,3,1,3,11,12,13,14.9
2023-24,202404030BRK,4/3/2024,BRK vs IND,Dennis Schroder,schrode01,77,BRK,1,IND,12,6,11,0,0,2,35.58333333,0,6,5,14,1,3,1,1,4,0,17,23,18,29,33.7
2023-24,202404030PHO,4/3/2024,PHO vs CLE,Kevin Durant,duranke01,69,PHO,1,CLE,32,6,7,1,0,4,35.65,0,6,13,23,3,7,3,4,2,1,13,39,38,45,48.7
2023-24,202404030BRK,4/3/2024,BRK vs IND,Mikal Bridges,bridgmi01,77,BRK,1,IND,17,7,4,2,1,2,35.96666667,2,5,6,13,3,6,2,3,1,3,11,21,24,28,38.4
2023-24,202404030PHO,4/3/2024,PHO vs CLE,Evan Mobley,mobleev01,45,CLE,0,PHO,20,9,5,1,1,2,36.08333333,2,7,8,13,1,2,3,3,2,2,14,25,29,34,42.3
2023-24,202404030WAS,4/3/2024,WAS vs LAL,LeBron James,jamesle01,68,LAL,0,WAS,25,7,9,3,0,4,36.18333333,2,5,9,18,0,1,7,9,2,3,16,34,32,41,51.9
2023-24,202404030ATL,4/3/2024,ATL vs DET,Jalen Johnson,johnsja05,53,ATL,1,DET,28,14,11,4,1,3,36.71666667,2,12,10,14,2,4,6,7,0,5,25,39,42,53,73.3
2023-24,202404030PHO,4/3/2024,PHO vs CLE,Devin Booker,bookede01,62,PHO,1,CLE,40,1,8,1,0,4,36.88333333,0,1,13,25,5,9,9,9,2,1,9,48,41,49,52.2
2023-24,202404030BRK,4/3/2024,BRK vs IND,Tyrese Haliburton,halibty01,65,IND,0,BRK,24,3,8,2,2,0,36.96666667,1,2,9,22,5,14,1,1,0,4,11,32,27,35,51.6
2023-24,202404030CHO,4/3/2024,CHO vs POR,Scoot Henderson,hendesc01,57,POR,0,CHO,22,1,10,1,0,6,37.05,0,1,9,16,4,7,0,2,3,1,11,32,23,33,35.2
2023-24,202404030MIL,4/3/2024,MIL vs MEM,Jaren Jackson Jr.,jacksja02,66,MEM,0,MIL,35,3,4,3,1,0,37.13333333,0,3,14,26,2,7,5,6,2,4,7,39,38,42,56.6
2023-24,202404030NOP,4/3/2024,NOP vs ORL,Trey Murphy III,murphtr02,51,NOP,1,ORL,14,7,2,1,0,0,37.16666667,1,6,3,7,2,6,6,7,2,1,9,16,21,23,28.4
2023-24,202404030CHO,4/3/2024,CHO vs POR,Deandre Ayton,aytonde01,50,POR,0,CHO,24,16,2,0,0,2,37.23333333,6,10,12,22,0,1,0,0,1,0,18,26,40,42,44.2
2023-24,202404030MIN,4/3/2024,MIN vs TOR,Jalen McDaniels,mcdanja01,45,TOR,0,MIN,13,8,4,0,0,3,37.25,2,6,6,15,0,1,1,1,4,0,12,17,21,25,25.6
2023-24,202404030PHO,4/3/2024,PHO vs CLE,Jarrett Allen,allenja01,72,CLE,0,PHO,20,5,4,0,0,0,37.26666667,3,2,9,15,0,0,2,2,2,0,9,24,25,29,32
2023-24,202404030MIL,4/3/2024,MIL vs MEM,GG Jackson II,jacksgg01,42,MEM,0,MIL,15,12,1,0,0,2,37.45,0,12,6,12,2,6,1,1,2,0,13,16,27,28,28.9
2023-24,202404030WAS,4/3/2024,WAS vs LAL,D'Angelo Russell,russeda01,72,LAL,0,WAS,18,3,2,2,0,2,37.53333333,0,3,7,16,4,10,0,0,0,2,5,20,21,23,28.6
2023-24,202404030NOP,4/3/2024,NOP vs ORL,Paolo Banchero,banchpa01,74,ORL,0,NOP,32,6,4,1,0,3,37.75,1,5,10,24,2,6,10,13,2,1,10,36,38,42,45.2
2023-24,202404030MIL,4/3/2024,MIL vs MEM,Brook Lopez,lopezbr01,73,MIL,1,MEM,25,10,1,0,0,5,37.86666667,5,5,9,14,5,7,2,3,5,0,11,26,35,36,33.5
2023-24,202404030PHO,4/3/2024,PHO vs CLE,Donovan Mitchell,mitchdo01,52,CLE,0,PHO,24,3,2,2,2,1,37.9,0,3,8,17,2,7,6,6,1,4,5,26,27,29,41.6
2023-24,202404030WAS,4/3/2024,WAS vs LAL,Anthony Davis,davisan02,73,LAL,0,WAS,35,18,1,2,3,2,38.13333333,3,15,10,17,0,1,15,15,1,5,19,36,53,54,71.1
2023-24,202404030MIL,4/3/2024,MIL vs MEM,Malik Beasley,beaslma01,73,MIL,1,MEM,10,3,2,0,0,0,38.36666667,0,3,3,10,3,7,1,1,0,0,5,12,13,15,16.6
2023-24,202404030PHO,4/3/2024,PHO vs CLE,Max Strus,strusma01,65,CLE,0,PHO,9,12,8,1,1,4,38.48333333,1,11,4,9,1,5,0,0,3,2,20,17,21,29,37.4
2023-24,202404030WAS,4/3/2024,WAS vs LAL,Kyle Kuzma,kuzmaky01,70,WAS,1,LAL,17,12,3,1,1,4,38.55,0,12,7,16,2,5,1,1,0,2,15,20,29,32,37.9
2023-24,202404030BRK,4/3/2024,BRK vs IND,Cam Thomas,thomaca02,61,BRK,1,IND,27,4,1,0,2,2,39.31666667,1,3,9,21,3,11,6,8,0,2,5,28,31,32,37.3
2023-24,202404030PHO,4/3/2024,PHO vs CLE,Darius Garland,garlada01,53,CLE,0,PHO,15,1,8,2,0,3,39.81666667,0,1,7,17,1,4,0,0,1,2,9,23,16,24,31.2
2023-24,202404030NOP,4/3/2024,NOP vs ORL,Herbert Jones,joneshe01,70,NOP,1,ORL,6,0,1,1,0,1,40.71666667,0,0,2,5,0,1,2,2,4,1,1,7,6,7,9.5
2023-24,202404030NOP,4/3/2024,NOP vs ORL,CJ McCollum,mccolcj01,60,NOP,1,ORL,36,10,4,2,0,4,41.08333333,2,8,10,24,5,12,11,11,3,2,14,40,46,50,56
2023-24,202404030CHO,4/3/2024,CHO vs POR,Jabari Walker,walkeja01,67,POR,0,CHO,14,22,2,0,1,0,41.53333333,3,19,4,17,1,3,5,5,4,1,24,16,36,38,46.4
2023-24,202404020MIA,4/2/2024,MIA vs NYK,Mitchell Robinson,robinmi01,24,NYK,0,MIA,0,1,0,1,0,0,10.13333333,1,0,0,1,0,0,0,2,2,1,1,0,1,1,4.2
2023-24,202404020MIN,4/2/2024,MIN vs HOU,Monte Morris,morrimo01,26,MIN,1,HOU,2,1,1,1,0,0,10.21666667,0,1,1,3,0,1,0,0,2,1,2,3,3,4,7.7
2023-24,202404020TOR,4/2/2024,TOR vs LAL,Kobi Simmons,simmoko01,4,TOR,1,LAL,5,3,3,1,1,0,10.26666667,0,3,2,3,1,2,0,0,1,2,6,8,8,11,19.1
2023-24,202404020PHI,4/2/2024,PHI vs OKC,KJ Martin,martike04,57,PHI,1,OKC,2,0,2,0,0,0,11.85,0,0,1,2,0,0,0,0,0,0,2,4,2,4,5
2023-24,202404020SAC,4/2/2024,SAC vs LAC,Alex Len,lenal01,41,SAC,1,LAC,4,7,1,1,3,2,11.98333333,2,5,2,2,0,0,0,0,3,4,8,5,11,12,23.9
2023-24,202404020MIA,4/2/2024,MIA vs NYK,Jaime Jaquez Jr.,jaqueja01,68,MIA,1,NYK,3,2,0,1,0,2,12.41666667,0,2,1,2,0,1,1,1,2,1,2,3,5,5,6.4
2023-24,202404020UTA,4/2/2024,UTA vs CLE,Talen Horton-Tucker,hortota01,47,UTA,1,CLE,12,1,0,1,0,0,12.6,0,1,5,7,2,3,0,0,2,1,1,12,13,13,16.2
2023-24,202404020WAS,4/2/2024,WAS vs MIL,A.J. Green,greenaj01,51,MIL,0,WAS,6,0,1,0,0,1,13.56666667,0,0,2,4,2,4,0,0,1,0,1,7,6,7,6.5
2023-24,202404020PHI,4/2/2024,PHI vs OKC,Cason Wallace,wallaca01,75,OKC,0,PHI,6,3,1,1,0,1,13.71666667,1,2,3,8,0,1,0,0,1,1,4,7,9,10,13.1
2023-24,202404020TOR,4/2/2024,TOR vs LAL,Javon Freeman-Liberty,freemja01,15,TOR,1,LAL,5,5,1,2,0,1,13.93333333,1,4,2,5,0,1,1,2,2,2,6,6,10,11,17.5
2023-24,202404020WAS,4/2/2024,WAS vs MIL,Eugene Omoruyi,omorueu01,37,WAS,1,MIL,3,1,1,0,0,0,14.01666667,0,1,1,5,0,3,1,1,2,0,2,4,4,5,5.7
2023-24,202404020TOR,4/2/2024,TOR vs LAL,Mouhamadou Gueye,gueyemo01,9,TOR,1,LAL,6,2,2,1,3,5,14.23333333,0,2,3,7,0,1,0,0,2,4,4,8,8,10,18.4
2023-24,202404020PHI,4/2/2024,PHI vs OKC,Kenrich Williams,willike04,62,OKC,0,PHI,8,1,0,1,0,1,14.28333333,1,0,3,4,2,2,0,0,1,1,1,8,9,9,11.2
2023-24,202404020DEN,4/2/2024,DEN vs SAS,Blake Wesley,weslebl01,55,SAS,0,DEN,2,1,4,0,0,2,15.06666667,0,1,1,5,0,1,0,2,2,0,5,6,3,7,7.2
2023-24,202404020MIA,4/2/2024,MIA vs NYK,Kevin Love,loveke01,48,MIA,1,NYK,8,3,3,0,1,1,15.5,0,3,2,8,2,7,2,2,1,1,6,11,11,14,18.1
2023-24,202404020GSW,4/2/2024,GSW vs DAL,Gary Payton II,paytoga02,40,GSW,1,DAL,8,2,0,1,0,0,15.61666667,1,1,4,8,0,3,0,0,4,1,2,8,10,10,13.4
2023-24,202404020GSW,4/2/2024,GSW vs DAL,Maxi Kleber,klebima01,38,DAL,0,GSW,0,3,2,1,3,0,16.68333333,1,2,0,4,0,1,0,0,1,4,5,2,3,5,18.6
2023-24,202404020UTA,4/2/2024,UTA vs CLE,Kira Lewis Jr.,lewiski01,26,UTA,1,CLE,2,0,2,1,0,1,17.38333333,0,0,1,4,0,3,0,0,2,1,2,4,2,4,7
2023-24,202404020WAS,4/2/2024,WAS vs MIL,Jared Butler,butleja02,34,WAS,1,MIL,17,3,3,2,0,0,17.48333333,1,2,7,10,3,3,0,0,0,2,6,20,20,23,31.1
2023-24,202404020DEN,4/2/2024,DEN vs SAS,Zach Collins,colliza01,63,SAS,0,DEN,13,8,2,0,1,0,17.6,1,7,6,11,1,3,0,1,3,1,10,15,21,23,28.6
2023-24,202404020SAC,4/2/2024,SAC vs LAC,Daniel Theis,theisda01,56,LAC,0,SAC,3,5,0,0,0,0,17.76666667,1,4,1,3,1,1,0,0,3,0,5,3,8,8,9
2023-24,202404020WAS,4/2/2024,WAS vs MIL,Johnny Davis,davisjo06,45,WAS,1,MIL,1,2,1,1,0,0,17.86666667,0,2,0,2,0,1,1,2,4,1,3,2,3,4,7.9
2023-24,202404020GSW,4/2/2024,GSW vs DAL,Derrick Jones Jr.,jonesde02,70,DAL,0,GSW,0,3,1,0,2,1,18.03333333,1,2,0,4,0,1,0,0,1,2,4,1,3,4,10.1
2023-24,202404020MIN,4/2/2024,MIN vs HOU,Jordan McLaughlin,mclaujo01,49,MIN,1,HOU,11,1,7,0,0,1,18.21666667,0,1,4,7,3,4,0,0,0,0,8,18,12,19,21.7
2023-24,202404020DEN,4/2/2024,DEN vs SAS,Cedi Osman,osmande01,72,SAS,0,DEN,10,3,1,0,0,0,18.21666667,0,3,4,7,2,4,0,0,1,0,4,11,13,14,15.1
2023-24,202404020MIA,4/2/2024,MIA vs NYK,Isaiah Hartenstein,harteis01,69,NYK,0,MIA,4,1,2,3,1,0,18.33333333,0,1,2,2,0,0,0,0,1,4,3,6,5,7,20.2
2023-24,202404020TOR,4/2/2024,TOR vs LAL,Jaxson Hayes,hayesja02,65,LAL,0,TOR,7,7,2,0,0,1,18.55,4,3,3,5,0,0,1,1,4,0,9,9,14,16,17.4
2023-24,202404020PHI,4/2/2024,PHI vs OKC,Paul Reed,reedpa01,76,PHI,1,OKC,12,9,1,0,1,1,18.56666667,2,7,6,8,0,0,0,0,1,1,10,13,21,22,26.3
2023-24,202404020UTA,4/2/2024,UTA vs CLE,Luka Samanic,samanlu01,37,UTA,1,CLE,12,5,1,0,1,1,18.7,0,5,3,6,1,4,5,7,1,1,6,13,17,18,21.5
2023-24,202404020MIN,4/2/2024,MIN vs HOU,Jock Landale,landajo01,49,HOU,0,MIN,4,2,0,0,0,2,18.75,1,1,1,3,0,1,2,2,1,0,2,4,6,6,4.4
2023-24,202404020UTA,4/2/2024,UTA vs CLE,Georges Niang,niangge01,76,CLE,0,UTA,8,3,1,3,0,2,18.76666667,0,3,3,10,0,7,2,2,4,3,4,9,11,12,20.1
2023-24,202404020MIN,4/2/2024,MIN vs HOU,Nickeil Alexander-Walker,alexani01,75,MIN,1,HOU,7,1,0,0,0,0,18.81666667,0,1,3,3,1,1,0,0,4,0,1,7,8,8,8.2
2023-24,202404020DEN,4/2/2024,DEN vs SAS,Devonte Graham,grahade01,17,SAS,0,DEN,2,2,3,1,0,0,19.38333333,0,2,1,5,0,4,0,0,3,1,5,5,4,7,11.9
2023-24,202404020MIA,4/2/2024,MIA vs NYK,Bojan Bogdanovic,bogdabo02,50,NYK,0,MIA,16,6,0,0,0,1,19.43333333,2,4,6,10,1,4,3,4,1,0,6,16,22,22,22.2
2023-24,202404020UTA,4/2/2024,UTA vs CLE,Marcus Morris,morrima03,45,CLE,0,UTA,8,0,2,1,1,1,19.46666667,0,0,3,6,2,4,0,0,1,2,2,10,8,10,16
2023-24,202404020GSW,4/2/2024,GSW vs DAL,Chris Paul,paulch01,51,GSW,1,DAL,14,1,5,0,0,0,19.58333333,0,1,6,11,2,3,0,0,0,0,6,19,15,20,22.7
2023-24,202404020PHI,4/2/2024,PHI vs OKC,Gordon Hayward,haywago01,46,OKC,0,PHI,7,2,2,0,1,0,19.6,0,2,3,5,1,2,0,0,1,1,4,9,9,11,15.4
2023-24,202404020DEN,4/2/2024,DEN vs SAS,Peyton Watson,watsope01,74,DEN,1,SAS,7,6,2,0,2,1,19.81666667,2,4,3,6,1,3,0,0,3,2,8,9,13,15,22.2
2023-24,202404020TOR,4/2/2024,TOR vs LAL,Max Christie,chrisma02,63,LAL,0,TOR,12,7,3,2,1,0,20.16666667,2,5,5,10,2,4,0,0,1,3,10,15,19,22,33.9
2023-24,202404020GSW,4/2/2024,GSW vs DAL,Moses Moody,moodymo01,59,GSW,1,DAL,12,3,0,1,0,0,20.18333333,0,3,4,8,4,6,0,0,2,1,3,12,15,15,18.6
2023-24,202404020WAS,4/2/2024,WAS vs MIL,Jae Crowder,crowdja01,44,MIL,0,WAS,5,2,1,1,0,0,20.73333333,0,2,2,7,1,6,0,0,1,1,3,6,7,8,11.9
2023-24,202404020PHI,4/2/2024,PHI vs OKC,Buddy Hield,hieldbu01,79,PHI,1,OKC,7,2,0,2,0,2,21,1,1,2,6,1,2,2,2,2,2,2,7,9,9,13.4
2023-24,202404020GSW,4/2/2024,GSW vs DAL,Trayce Jackson-Davis,jackstr02,61,GSW,1,DAL,4,10,1,0,0,3,21.03333333,2,8,2,3,0,0,0,0,0,0,11,5,14,15,14.5
2023-24,202404020GSW,4/2/2024,GSW vs DAL,Dante Exum,exumda01,49,DAL,0,GSW,3,3,4,0,0,2,21.11666667,1,2,1,3,1,2,0,0,2,0,7,7,6,10,10.6
2023-24,202404020MIN,4/2/2024,MIN vs HOU,Jeff Green,greenje02,71,HOU,0,MIN,8,6,2,0,0,0,21.13333333,2,4,3,6,2,5,0,0,1,0,8,10,14,16,18.2
2023-24,202404020SAC,4/2/2024,SAC vs LAC,Brandon Boston Jr.,bostobr01,27,LAC,0,SAC,9,4,0,0,0,0,21.38333333,0,4,3,6,1,3,2,3,5,0,4,9,13,13,13.8
2023-24,202404020SAC,4/2/2024,SAC vs LAC,Keon Ellis,elliske01,50,SAC,1,LAC,3,7,1,1,0,0,21.76666667,2,5,0,1,0,1,3,4,6,1,8,4,10,11,15.9
2023-24,202404020WAS,4/2/2024,WAS vs MIL,Patrick Beverley,beverpa01,69,MIL,0,WAS,2,5,3,1,1,0,21.95,1,4,1,4,0,2,0,0,1,2,8,5,7,10,18.5
2023-24,202404020DEN,4/2/2024,DEN vs SAS,Justin Holiday,holidju01,52,DEN,1,SAS,5,3,1,1,2,0,22.65,1,2,2,6,1,2,0,0,0,3,4,6,8,9,19.1
2023-24,202404020UTA,4/2/2024,UTA vs CLE,Kris Dunn,dunnkr01,65,UTA,1,CLE,2,4,5,2,0,0,23.13333333,1,3,1,3,0,1,0,0,2,2,9,7,6,11,20.3
2023-24,202404020MIN,4/2/2024,MIN vs HOU,Cam Whitmore,whitmca01,40,HOU,0,MIN,14,1,0,1,0,3,23.28333333,1,0,5,11,3,6,1,2,1,1,1,14,15,15,15.2
2023-24,202404020SAC,4/2/2024,SAC vs LAC,Amir Coffey,coffeam01,63,LAC,0,SAC,3,2,1,1,0,1,23.53333333,1,1,1,6,1,4,0,0,1,1,3,4,5,6,8.9
2023-24,202404020MIA,4/2/2024,MIA vs NYK,Caleb Martin,martica02,57,MIA,1,NYK,7,2,3,0,2,3,23.58333333,0,2,3,8,1,3,0,0,4,2,5,10,9,12,16.9
2023-24,202404020SAC,4/2/2024,SAC vs LAC,Russell Westbrook,westbru01,63,LAC,0,SAC,20,2,2,0,0,4,24.01666667,0,2,7,14,2,3,4,4,5,0,4,22,22,24,21.4
2023-24,202404020DEN,4/2/2024,DEN vs SAS,Sandro Mamukelashvili,mamuksa01,40,SAS,0,DEN,10,9,1,0,0,1,24.11666667,5,4,3,8,2,4,2,2,1,0,10,11,19,20,21.3
2023-24,202404020TOR,4/2/2024,TOR vs LAL,Taurean Prince,princta02,73,LAL,0,TOR,8,5,5,2,1,1,24.18333333,2,3,3,8,2,2,0,0,2,3,10,13,13,18,29.5
2023-24,202404020SAC,4/2/2024,SAC vs LAC,Harrison Barnes,barneha02,75,SAC,1,LAC,6,2,1,1,0,0,24.56666667,1,1,2,7,2,5,0,0,1,1,3,7,8,9,12.9
2023-24,202404020TOR,4/2/2024,TOR vs LAL,Spencer Dinwiddie,dinwisp01,70,LAL,0,TOR,9,1,1,1,3,0,24.96666667,0,1,3,6,3,6,0,0,3,4,2,10,10,11,23.7
2023-24,202404020TOR,4/2/2024,TOR vs LAL,Austin Reaves,reaveau01,77,LAL,0,TOR,7,4,6,0,3,1,25.2,1,3,2,9,1,5,2,2,2,3,10,13,11,17,28.8
2023-24,202404020MIA,4/2/2024,MIA vs NYK,Nikola Jovic,jovicni01,39,MIA,1,NYK,5,3,6,1,0,1,25.3,0,3,1,2,1,2,2,2,1,1,9,11,8,14,19.6
2023-24,202404020SAC,4/2/2024,SAC vs LAC,Davion Mitchell,mitchda01,65,SAC,1,LAC,14,4,3,0,0,0,25.38333333,2,2,5,10,4,7,0,0,0,0,7,17,18,21,23.3
2023-24,202404020MIN,4/2/2024,MIN vs HOU,Amen Thompson,thompam01,56,HOU,0,MIN,9,9,4,3,0,0,25.41666667,4,5,4,9,0,0,1,3,2,3,13,13,18,22,34.8
2023-24,202404020WAS,4/2/2024,WAS vs MIL,Bobby Portis,portibo01,75,MIL,0,WAS,12,12,3,0,1,1,25.48333333,5,7,6,14,0,3,0,0,1,1,15,15,24,27,32.9
2023-24,202404020TOR,4/2/2024,TOR vs LAL,Jordan Nwora,nworajo01,46,TOR,1,LAL,6,5,1,1,0,4,25.68333333,0,5,2,6,2,4,0,0,0,1,6,7,11,12,12.5
2023-24,202404020TOR,4/2/2024,TOR vs LAL,Rui Hachimura,hachiru01,63,LAL,0,TOR,14,4,4,1,0,0,25.88333333,1,3,6,9,2,4,0,0,1,1,8,18,18,22,27.8
2023-24,202404020DEN,4/2/2024,DEN vs SAS,Reggie Jackson,jacksre01,76,DEN,1,SAS,9,0,3,0,1,2,25.88333333,0,0,4,13,1,3,0,0,2,1,3,12,9,12,14.5
2023-24,202404020SAC,4/2/2024,SAC vs LAC,Trey Lyles,lylestr01,51,SAC,1,LAC,15,4,5,1,1,1,26.08333333,2,2,6,11,3,8,0,1,1,2,9,20,19,24,32.3
2023-24,202404020GSW,4/2/2024,GSW vs DAL,Tim Hardaway Jr.,hardati02,72,DAL,0,GSW,7,3,3,0,0,0,26.4,0,3,3,6,1,4,0,0,0,0,6,10,10,13,15.1
2023-24,202404020WAS,4/2/2024,WAS vs MIL,Brook Lopez,lopezbr01,72,MIL,0,WAS,6,2,1,1,3,0,26.41666667,1,1,3,9,0,4,0,0,1,4,3,7,8,9,21.9
2023-24,202404020TOR,4/2/2024,TOR vs LAL,RJ Barrett,barrerj01,54,TOR,1,LAL,28,6,6,0,0,0,26.45,0,6,11,18,2,3,4,7,3,0,12,34,34,40,44.2
2023-24,202404020SAC,4/2/2024,SAC vs LAC,Terance Mann,mannte01,68,LAC,0,SAC,7,1,1,0,0,2,26.61666667,1,0,3,5,0,1,1,2,2,0,2,8,8,9,7.7
2023-24,202404020TOR,4/2/2024,TOR vs LAL,Kelly Olynyk,olynyke01,73,TOR,1,LAL,14,7,4,1,2,1,26.83333333,2,5,6,10,0,2,2,2,4,3,11,18,21,25,36.4
2023-24,202404020MIA,4/2/2024,MIA vs NYK,Precious Achiuwa,achiupr01,68,NYK,0,MIA,2,6,0,1,0,0,26.93333333,3,3,1,4,0,0,0,0,2,1,6,2,8,8,12.2
2023-24,202404020GSW,4/2/2024,GSW vs DAL,Daniel Gafford,gaffoda01,68,DAL,0,GSW,10,8,3,1,0,1,27.05,3,5,5,8,0,0,0,0,5,1,11,13,18,21,26.1
2023-24,202404020TOR,4/2/2024,TOR vs LAL,Immanuel Quickley,quickim01,63,TOR,1,LAL,20,3,6,1,0,3,27.16666667,0,3,7,12,3,7,3,3,1,1,9,26,23,29,32.6
2023-24,202404020MIN,4/2/2024,MIN vs HOU,Jaden McDaniels,mcdanja02,65,MIN,1,HOU,8,3,1,2,0,3,27.38333333,2,1,4,9,0,3,0,0,3,2,4,9,11,12,16.1
2023-24,202404020DEN,4/2/2024,DEN vs SAS,Christian Braun,braunch01,76,DEN,1,SAS,5,2,7,0,0,0,27.46666667,0,2,1,5,1,3,2,2,1,0,9,12,7,14,17.9
2023-24,202404020PHI,4/2/2024,PHI vs OKC,Kyle Lowry,lowryky01,56,PHI,1,OKC,4,1,4,0,0,1,27.5,0,1,1,1,1,1,1,2,3,0,5,8,5,9,10.2
2023-24,202404020TOR,4/2/2024,TOR vs LAL,Anthony Davis,davisan02,72,LAL,0,TOR,21,12,1,0,0,5,27.51666667,2,10,10,20,0,4,1,4,3,0,13,22,33,34,31.9
2023-24,202404020UTA,4/2/2024,UTA vs CLE,Taylor Hendricks,hendrita0,34,UTA,1,CLE,18,3,1,2,0,1,27.53333333,1,2,7,13,4,6,0,0,3,2,4,19,21,22,28.1
2023-24,202404020PHI,4/2/2024,PHI vs OKC,Josh Giddey,giddejo01,74,OKC,0,PHI,10,5,3,0,1,2,27.63333333,1,4,4,8,0,1,2,4,1,1,8,13,15,18,21.5
2023-24,202404020PHI,4/2/2024,PHI vs OKC,Isaiah Joe,joeis01,71,OKC,0,PHI,14,4,7,2,1,2,27.88333333,1,3,4,13,4,11,2,2,0,3,11,21,18,25,36.3
2023-24,202404020MIA,4/2/2024,MIA vs NYK,Haywood Highsmith,highsha01,59,MIA,1,NYK,14,8,1,1,0,0,28.06666667,4,4,6,11,2,4,0,0,2,1,9,15,22,23,28.1
2023-24,202404020TOR,4/2/2024,TOR vs LAL,Bruce Brown,brownbr01,64,TOR,1,LAL,5,6,1,2,0,1,28.11666667,1,5,2,6,0,2,1,1,3,2,7,6,11,12,18.7
2023-24,202404020TOR,4/2/2024,TOR vs LAL,Garrett Temple,templga01,22,TOR,1,LAL,6,1,0,2,0,2,28.11666667,0,1,2,8,0,5,2,4,3,2,1,6,7,7,11.2
2023-24,202404020GSW,4/2/2024,GSW vs DAL,Klay Thompson,thompkl01,71,GSW,1,DAL,14,3,2,1,0,2,28.25,0,3,5,14,2,8,2,2,3,1,5,16,17,19,21.6
2023-24,202404020SAC,4/2/2024,SAC vs LAC,Norman Powell,powelno01,71,LAC,0,SAC,17,2,1,1,0,2,28.35,0,2,4,7,3,4,6,6,1,1,3,18,19,20,21.9
2023-24,202404020PHI,4/2/2024,PHI vs OKC,Jaylin Williams,willija07,62,OKC,0,PHI,6,6,12,1,0,2,28.43333333,1,5,2,8,0,5,2,2,4,1,18,18,12,24,32.2
2023-24,202404020SAC,4/2/2024,SAC vs LAC,Ivica Zubac,zubaciv01,63,LAC,0,SAC,10,11,3,1,1,0,28.55,4,7,5,14,0,0,0,2,3,2,14,13,21,24,33.7
2023-24,202404020TOR,4/2/2024,TOR vs LAL,LeBron James,jamesle01,67,LAL,0,TOR,23,4,9,0,0,1,28.78333333,0,4,10,12,1,1,2,5,0,0,13,32,27,36,40.3
2023-24,202404020MIA,4/2/2024,MIA vs NYK,Duncan Robinson,robindu01,65,MIA,1,NYK,6,2,1,1,0,2,28.98333333,0,2,2,7,2,7,0,0,4,1,3,7,8,9,10.9
2023-24,202404020MIN,4/2/2024,MIN vs HOU,Dillon Brooks,brookdi01,66,HOU,0,MIN,5,1,1,0,0,2,29,0,1,2,6,1,4,0,0,4,0,2,6,6,7,5.7
2023-24,202404020PHI,4/2/2024,PHI vs OKC,Chet Holmgren,holmgch01,75,OKC,0,PHI,22,7,1,0,2,3,29.1,1,6,7,14,3,6,5,5,4,2,8,23,29,30,34.9
2023-24,202404020WAS,4/2/2024,WAS vs MIL,Pat Connaughton,connapa01,69,MIL,0,WAS,15,8,5,0,1,1,29.15,3,5,4,11,3,10,4,4,2,1,13,20,23,28,34.1
2023-24,202404020PHI,4/2/2024,PHI vs OKC,Joel Embiid,embiijo01,35,PHI,1,OKC,24,6,7,3,0,6,29.35,1,5,6,14,0,3,12,12,4,3,13,31,30,37,44.7
2023-24,202404020SAC,4/2/2024,SAC vs LAC,Paul George,georgpa01,69,LAC,0,SAC,18,4,1,2,0,1,29.41666667,1,3,5,12,2,5,6,6,1,2,5,19,22,23,29.3
2023-24,202404020PHI,4/2/2024,PHI vs OKC,Cameron Payne,payneca01,72,PHI,1,OKC,10,10,5,1,0,0,29.61666667,3,7,4,11,2,5,0,0,3,1,15,15,20,25,32.5
2023-24,202404020MIN,4/2/2024,MIN vs HOU,Mike Conley,conlemi01,70,MIN,1,HOU,14,2,6,3,0,4,29.78333333,0,2,4,7,3,4,3,3,2,3,8,20,16,22,30.4
2023-24,202404020WAS,4/2/2024,WAS vs MIL,Malik Beasley,beaslma01,72,MIL,0,WAS,5,2,1,2,0,1,29.9,1,1,2,13,1,10,0,0,3,2,3,6,7,8,13.9
2023-24,202404020MIN,4/2/2024,MIN vs HOU,Kyle Anderson,anderky01,72,MIN,1,HOU,13,6,9,2,2,2,30.15,1,5,6,8,1,2,0,0,1,4,15,22,19,28,43.7
2023-24,202404020UTA,4/2/2024,UTA vs CLE,Omer Yurtseven,yurtsom01,42,UTA,1,CLE,11,6,2,0,1,3,30.26666667,3,3,5,10,0,1,1,1,3,1,8,13,17,19,21.2
2023-24,202404020PHI,4/2/2024,PHI vs OKC,Nicolas Batum,batumni01,54,PHI,1,OKC,7,2,2,1,1,3,30.36666667,0,2,3,6,1,4,0,0,2,2,4,9,9,11,15.4
2023-24,202404020UTA,4/2/2024,UTA vs CLE,Brice Sensabaugh,sensabr01,26,UTA,1,CLE,22,7,4,1,0,2,30.4,1,6,8,14,6,9,0,0,3,1,11,26,29,33,37.4
2023-24,202404020GSW,4/2/2024,GSW vs DAL,Brandin Podziemski,podzibr01,67,GSW,1,DAL,5,10,5,0,0,1,30.66666667,1,9,2,4,1,1,0,0,3,0,15,10,15,20,23.5
2023-24,202404020GSW,4/2/2024,GSW vs DAL,Draymond Green,greendr01,50,GSW,1,DAL,11,8,6,4,1,3,30.75,3,5,5,8,0,1,1,1,3,5,14,17,19,25,41.6
2023-24,202404020WAS,4/2/2024,WAS vs MIL,Khris Middleton,middlkh01,50,MIL,0,WAS,24,9,6,2,0,4,30.85,3,6,9,19,3,8,3,4,3,2,15,30,33,39,45.8
2023-24,202404020WAS,4/2/2024,WAS vs MIL,Tristan Vukcevic,vukcetr01,6,WAS,1,MIL,14,7,3,1,0,1,31.03333333,1,6,5,11,1,6,3,3,4,1,10,17,21,24,28.9
2023-24,202404020SAC,4/2/2024,SAC vs LAC,James Harden,hardeja01,68,LAC,0,SAC,6,5,8,1,0,5,31.08333333,1,4,1,7,1,5,3,4,0,1,13,14,11,19,22
2023-24,202404020UTA,4/2/2024,UTA vs CLE,Evan Mobley,mobleev01,44,CLE,0,UTA,21,7,5,2,2,1,31.13333333,3,4,9,14,1,2,2,3,2,4,12,26,28,33,47.9
2023-24,202404020GSW,4/2/2024,GSW vs DAL,Stephen Curry,curryst01,69,GSW,1,DAL,13,7,7,1,2,4,31.56666667,0,7,5,18,3,5,0,0,1,3,14,20,20,27,36.9
2023-24,202404020UTA,4/2/2024,UTA vs CLE,Darius Garland,garlada01,52,CLE,0,UTA,8,3,8,0,1,2,31.86666667,0,3,2,6,2,4,2,2,3,1,11,16,11,19,24.6
2023-24,202404020UTA,4/2/2024,UTA vs CLE,Sam Merrill,merrisa01,58,CLE,0,UTA,18,4,5,0,0,1,32.03333333,1,3,6,13,6,12,0,0,1,0,9,23,22,27,29.3
2023-24,202404020PHI,4/2/2024,PHI vs OKC,Aaron Wiggins,wiggiaa01,71,OKC,0,PHI,15,4,1,3,1,0,32.2,2,2,5,13,0,2,5,5,5,4,5,16,19,20,33.3
2023-24,202404020DEN,4/2/2024,DEN vs SAS,Tre Jones,jonestr01,71,SAS,0,DEN,10,12,11,1,1,0,32.3,3,9,4,11,2,5,0,0,1,2,23,21,22,33,46.9
2023-24,202404020TOR,4/2/2024,TOR vs LAL,Gradey Dick,dickgr01,54,TOR,1,LAL,14,2,0,0,0,0,32.33333333,1,1,6,14,2,5,0,0,0,0,2,14,16,16,16.4
2023-24,202404020MIA,4/2/2024,MIA vs NYK,Bam Adebayo,adebaba01,64,MIA,1,NYK,15,9,1,1,0,1,32.53333333,2,7,6,9,0,0,3,4,0,1,10,16,24,25,29.3
2023-24,202404020TOR,4/2/2024,TOR vs LAL,D'Angelo Russell,russeda01,71,LAL,0,TOR,25,2,7,0,0,4,32.55,0,2,9,17,7,14,0,0,1,0,9,32,27,34,33.9
2023-24,202404020UTA,4/2/2024,UTA vs CLE,Max Strus,strusma01,64,CLE,0,UTA,15,4,6,2,0,2,32.68333333,0,4,4,8,3,7,4,4,1,2,10,21,19,25,32.8
2023-24,202404020GSW,4/2/2024,GSW vs DAL,Andrew Wiggins,wiggian01,66,GSW,1,DAL,23,4,2,1,1,3,32.73333333,2,2,8,16,3,5,4,4,1,2,6,25,27,29,33.8
2023-24,202404020DEN,4/2/2024,DEN vs SAS,Kentavious Caldwell-Pope,caldwke01,70,DEN,1,SAS,4,0,2,1,1,0,32.75,0,0,1,8,1,5,1,2,2,2,2,6,4,6,13
2023-24,202404020DEN,4/2/2024,DEN vs SAS,Aaron Gordon,gordoaa01,69,DEN,1,SAS,23,7,4,1,1,0,33.05,2,5,9,12,2,4,3,3,3,2,11,27,30,34,43.4
2023-24,202404020UTA,4/2/2024,UTA vs CLE,Jarrett Allen,allenja01,71,CLE,0,UTA,21,12,5,1,0,0,33.2,4,8,8,11,0,0,5,6,0,1,17,26,33,38,45.9
2023-24,202404020PHI,4/2/2024,PHI vs OKC,Luguentz Dort,dortlu01,73,OKC,0,PHI,15,8,3,2,2,3,33.23333333,2,6,5,10,3,6,2,4,1,4,11,18,23,26,38.1
2023-24,202404020SAC,4/2/2024,SAC vs LAC,De'Aaron Fox,foxde01,67,SAC,1,LAC,20,3,7,1,1,0,33.8,0,3,6,20,1,7,7,7,2,2,10,27,23,30,40.1
2023-24,202404020DEN,4/2/2024,DEN vs SAS,Victor Wembanyama,wembavi01,67,SAS,0,DEN,23,15,8,1,9,2,33.95,5,10,9,29,2,11,3,6,3,10,23,31,38,46,81
2023-24,202404020MIN,4/2/2024,MIN vs HOU,Naz Reid,reidna01,74,MIN,1,HOU,25,6,2,2,1,3,33.98333333,1,5,10,17,3,5,2,2,1,3,8,27,31,33,41.2
2023-24,202404020UTA,4/2/2024,UTA vs CLE,Caris LeVert,leverca01,63,CLE,0,UTA,26,6,5,1,1,4,34.03333333,0,6,9,13,2,3,6,7,2,2,11,31,32,37,42.7
2023-24,202404020UTA,4/2/2024,UTA vs CLE,Collin Sexton,sextoco01,76,UTA,1,CLE,19,3,7,0,0,7,34.48333333,1,2,6,14,2,5,5,6,4,0,10,26,22,29,26.1
2023-24,202404020SAC,4/2/2024,SAC vs LAC,Domantas Sabonis,sabondo01,75,SAC,1,LAC,22,20,9,2,0,4,34.85,7,13,8,17,0,3,6,10,1,2,29,31,42,51,61.5
2023-24,202404020MIA,4/2/2024,MIA vs NYK,Terry Rozier,roziete01,58,MIA,1,NYK,34,5,3,0,1,3,34.9,0,5,10,15,8,11,6,6,0,1,8,37,39,42,44.5
2023-24,202404020PHI,4/2/2024,PHI vs OKC,Tobias Harris,harrito02,67,PHI,1,OKC,18,6,4,0,1,1,34.98333333,0,6,5,14,5,8,3,4,3,1,10,22,24,28,33.2
2023-24,202404020MIN,4/2/2024,MIN vs HOU,Rudy Gobert,goberru01,69,MIN,1,HOU,12,14,0,0,2,1,35.2,1,13,4,7,0,0,4,6,3,2,14,12,26,26,33.8
2023-24,202404020DEN,4/2/2024,DEN vs SAS,Michael Porter Jr.,portemi01,75,DEN,1,SAS,15,16,3,1,1,1,35.23333333,2,14,5,16,3,8,2,3,1,2,19,18,31,34,43.7
2023-24,202404020MIA,4/2/2024,MIA vs NYK,Donte DiVincenzo,divindo01,74,NYK,0,MIA,31,4,4,4,0,4,35.25,0,4,11,21,6,15,3,3,3,4,8,35,35,39,49.8
2023-24,202404020WAS,4/2/2024,WAS vs MIL,Jordan Poole,poolejo01,74,WAS,1,MIL,16,4,13,2,0,3,35.3,0,4,6,14,1,6,3,3,3,2,17,29,20,33,43.3
2023-24,202404020GSW,4/2/2024,GSW vs DAL,P.J. Washington,washipj01,67,DAL,0,GSW,20,5,0,3,1,2,35.68333333,0,5,8,19,3,10,1,2,1,4,5,20,25,25,36
2023-24,202404020MIN,4/2/2024,MIN vs HOU,Jabari Smith Jr.,smithja05,69,HOU,0,MIN,18,8,3,0,0,1,35.93333333,1,7,7,14,2,8,2,2,3,0,11,21,26,29,31.1
2023-24,202404020MIN,4/2/2024,MIN vs HOU,Anthony Edwards,edwaran01,72,MIN,1,HOU,21,5,3,2,0,3,36.2,1,4,5,16,0,6,11,11,1,2,8,24,26,29,34.5
2023-24,202404020WAS,4/2/2024,WAS vs MIL,Giannis Antetokounmpo,antetgi01,70,MIL,0,WAS,35,15,10,0,0,2,36.31666667,3,12,15,21,0,0,5,9,2,0,25,45,50,60,66
2023-24,202404020MIA,4/2/2024,MIA vs NYK,Jalen Brunson,brunsja01,70,NYK,0,MIA,20,2,10,0,0,5,36.31666667,0,2,5,18,1,6,9,10,2,0,12,30,22,32,32.4
2023-24,202404020UTA,4/2/2024,UTA vs CLE,Keyonte George,georgke01,69,UTA,1,CLE,9,4,3,0,0,4,36.31666667,0,4,2,11,1,5,4,4,1,0,7,12,13,16,14.3
2023-24,202404020PHI,4/2/2024,PHI vs OKC,Kelly Oubre Jr.,oubreke01,62,PHI,1,OKC,25,6,2,1,1,2,36.75,2,4,8,16,4,7,5,5,2,2,8,27,31,33,39.2
2023-24,202404020DEN,4/2/2024,DEN vs SAS,Malaki Branham,branhma01,71,SAS,0,DEN,24,3,1,0,0,1,37.08333333,0,3,10,19,3,8,1,2,4,0,4,25,27,28,28.1
2023-24,202404020DEN,4/2/2024,DEN vs SAS,Julian Champagnie,champju02,68,SAS,0,DEN,11,5,2,1,1,1,37.26666667,1,4,4,10,1,4,2,3,0,2,7,13,16,18,25
2023-24,202404020DEN,4/2/2024,DEN vs SAS,Nikola Jokic,jokicni01,73,DEN,1,SAS,42,16,6,1,2,4,37.58333333,4,12,18,32,1,6,5,6,2,3,22,48,58,64,75.2
2023-24,202404020SAC,4/2/2024,SAC vs LAC,Keegan Murray,murrake02,70,SAC,1,LAC,19,5,2,1,1,2,37.88333333,2,3,8,18,2,7,1,1,1,2,7,21,24,26,32
2023-24,202404020WAS,4/2/2024,WAS vs MIL,Anthony Gill,gillan01,45,WAS,1,MIL,12,9,0,0,0,2,38.01666667,1,8,6,11,0,2,0,0,3,0,9,12,21,21,20.8
2023-24,202404020WAS,4/2/2024,WAS vs MIL,Corey Kispert,kispeco01,74,WAS,1,MIL,27,7,0,1,1,0,38.06666667,1,6,10,18,4,11,3,4,0,2,7,27,34,34,41.4
2023-24,202404020MIN,4/2/2024,MIN vs HOU,Jalen Green,greenja05,75,HOU,0,MIN,26,5,6,0,0,5,38.25,1,4,10,22,2,11,4,4,4,0,11,32,31,37,36
2023-24,202404020MIA,4/2/2024,MIA vs NYK,Jimmy Butler,butleji01,53,MIA,1,NYK,17,5,6,0,0,4,38.68333333,1,4,5,12,1,3,6,6,3,0,11,23,22,28,28
2023-24,202404020GSW,4/2/2024,GSW vs DAL,Kyrie Irving,irvinky01,53,DAL,0,GSW,27,1,2,3,1,4,38.8,0,1,10,19,4,8,3,3,3,4,3,29,28,30,39.2
2023-24,202404020WAS,4/2/2024,WAS vs MIL,Deni Avdija,avdijde01,69,WAS,1,MIL,23,8,5,1,1,3,38.81666667,1,7,10,17,0,5,3,4,4,2,13,28,31,36,43.1
2023-24,202404020GSW,4/2/2024,GSW vs DAL,Luka Doncic,doncilu01,66,DAL,0,GSW,30,12,11,0,0,5,39.2,1,11,11,22,5,11,3,4,1,0,23,41,42,53,55.9
2023-24,202404020MIN,4/2/2024,MIN vs HOU,Fred VanVleet,vanvlfr01,68,HOU,0,MIN,22,5,5,5,0,1,40.58333333,2,3,9,20,4,13,0,1,5,5,10,27,27,32,49.5
2023-24,202404020MIA,4/2/2024,MIA vs NYK,Miles McBride,mcbrimi01,62,NYK,0,MIA,24,2,2,0,1,2,44.75,0,2,9,16,4,8,2,2,3,1,4,26,26,28,30.4
2023-24,202404020MIA,4/2/2024,MIA vs NYK,Josh Hart,hartjo01,74,NYK,0,MIA,2,6,7,2,0,2,45.58333333,1,5,1,3,0,0,0,0,3,2,13,9,8,15,23.7
2023-24,202404010ORL,4/1/2024,ORL vs POR,Moritz Wagner,wagnemo01,73,ORL,1,POR,8,1,0,0,0,1,11.85,1,0,3,4,2,3,0,0,3,0,1,8,9,9,8.2
2023-24,202404010NOP,4/1/2024,NOP vs PHO,Drew Eubanks,eubandr01,69,PHO,0,NOP,4,2,1,0,1,0,12.16666667,1,1,1,2,0,0,2,2,4,1,3,5,6,7,10.9
2023-24,202404010IND,4/1/2024,IND vs BRK,Day'Ron Sharpe,sharpda01,58,BRK,0,IND,6,11,0,0,0,2,12.51666667,6,5,3,8,0,1,0,0,1,0,11,6,17,17,17.2
2023-24,202404010CHI,4/1/2024,CHI vs ATL,Torrey Craig,craigto01,47,CHI,1,ATL,0,2,0,0,0,0,12.63333333,1,1,0,1,0,1,0,0,0,0,2,0,2,2,2.4
2023-24,202404010ORL,4/1/2024,ORL vs POR,Markelle Fultz,fultzma01,36,ORL,1,POR,0,3,4,0,0,2,13.15,3,0,0,6,0,0,0,0,2,0,7,4,3,7,7.6
2023-24,202404010DET,4/1/2024,DET vs MEM,Jared Rhoden,rhodeja01,11,DET,1,MEM,1,1,1,0,2,0,13.15,0,1,0,0,0,0,1,2,2,2,2,2,2,3,9.7
2023-24,202404010CHO,4/1/2024,CHO vs BOS,Oshae Brissett,brissos01,49,BOS,0,CHO,1,2,2,0,0,0,13.2,0,2,0,1,0,1,1,2,0,0,4,3,3,5,6.4
2023-24,202404010ORL,4/1/2024,ORL vs POR,Ashton Hagans,haganas01,17,POR,0,ORL,2,0,2,1,0,0,13.2,0,0,0,0,0,0,2,2,1,1,2,4,2,4,8
2023-24,202404010CHO,4/1/2024,CHO vs BOS,Luke Kornet,kornelu01,56,BOS,0,CHO,4,4,1,1,0,0,13.2,1,3,2,2,0,0,0,0,0,1,5,5,8,9,13.3
2023-24,202404010IND,4/1/2024,IND vs BRK,Jarace Walker,walkeja02,32,IND,1,BRK,4,2,2,0,0,1,13.31666667,1,1,2,4,0,0,0,0,1,0,4,6,6,8,8.4
2023-24,202404010DET,4/1/2024,DET vs MEM,Malachi Flynn,flynnma01,62,DET,1,MEM,9,2,0,0,1,2,13.96666667,0,2,3,7,2,5,1,2,1,1,2,9,11,11,12.4
2023-24,202404010IND,4/1/2024,IND vs BRK,Myles Turner,turnemy01,73,IND,1,BRK,9,6,0,1,5,2,14.21666667,0,6,3,5,2,4,1,2,1,6,6,9,15,15,32.2
2023-24,202404010IND,4/1/2024,IND vs BRK,Isaiah Jackson,jacksis01,57,IND,1,BRK,8,3,0,0,2,0,14.26666667,1,2,3,3,0,0,2,2,1,2,3,8,11,11,17.6
2023-24,202404010NOP,4/1/2024,NOP vs PHO,Jordan Hawkins,hawkijo01,64,NOP,1,PHO,3,1,0,0,0,0,14.91666667,0,1,1,3,1,2,0,0,0,0,1,3,4,4,4.2
2023-24,202404010CHO,4/1/2024,CHO vs BOS,Marques Bolden,boldema01,5,CHO,1,BOS,4,5,0,0,0,0,14.98333333,2,3,2,3,0,0,0,0,3,0,5,4,9,9,10
2023-24,202404010NOP,4/1/2024,NOP vs PHO,Royce O'Neale,onealro01,72,PHO,0,NOP,2,4,1,1,0,1,15.08333333,2,2,1,4,0,3,0,0,1,1,5,3,6,7,10.3
2023-24,202404010ORL,4/1/2024,ORL vs POR,Cole Anthony,anthoco01,74,ORL,1,POR,9,3,1,0,0,2,15.23333333,0,3,3,6,1,3,2,2,0,0,4,10,12,13,12.1
2023-24,202404010ORL,4/1/2024,ORL vs POR,Joe Ingles,inglejo01,61,ORL,1,POR,0,2,2,0,0,1,15.36666667,0,2,0,1,0,1,0,0,2,0,4,2,2,4,4.4
2023-24,202404010NOP,4/1/2024,NOP vs PHO,Naji Marshall,marshna01,63,NOP,1,PHO,4,1,1,1,0,0,15.36666667,0,1,2,3,0,0,0,1,3,1,2,5,5,6,9.7
2023-24,202404010IND,4/1/2024,IND vs BRK,Jalen Smith,smithja04,55,IND,1,BRK,17,10,0,0,1,1,15.56666667,6,4,7,11,1,1,2,3,1,1,10,17,27,27,31
2023-24,202404010CHO,4/1/2024,CHO vs BOS,Aleksej Pokusevski,pokusal01,21,CHO,1,BOS,3,4,2,1,0,0,15.61666667,1,3,1,7,1,3,0,0,0,1,6,5,7,9,13.8
2023-24,202404010IND,4/1/2024,IND vs BRK,Ben Sheppard,sheppbe01,52,IND,1,BRK,3,1,1,0,0,1,16.35,0,1,1,3,0,1,1,1,4,0,2,4,4,5,4.7
2023-24,202404010ORL,4/1/2024,ORL vs POR,Duop Reath,reathdu01,61,POR,0,ORL,2,3,0,1,1,0,16.5,0,3,1,4,0,2,0,0,1,2,3,2,5,5,11.6
2023-24,202404010CHI,4/1/2024,CHI vs ATL,Kobe Bufkin,bufkiko01,10,ATL,0,CHI,3,2,3,0,1,1,17.18333333,0,2,1,4,1,3,0,0,1,1,5,6,5,8,11.9
2023-24,202404010CHI,4/1/2024,CHI vs ATL,Garrison Mathews,mathega01,59,ATL,0,CHI,9,1,1,0,0,0,17.2,0,1,3,7,3,7,0,0,2,0,2,10,10,11,11.7
2023-24,202404010ORL,4/1/2024,ORL vs POR,Jonathan Isaac,isaacjo01,52,ORL,1,POR,6,4,0,0,2,1,17.4,1,3,2,4,0,1,2,2,1,2,4,6,10,10,15.8
2023-24,202404010IND,4/1/2024,IND vs BRK,T.J. McConnell,mccontj01,66,IND,1,BRK,10,4,8,2,0,0,17.93333333,0,4,5,13,0,0,0,0,2,2,12,18,14,22,32.8
2023-24,202404010DET,4/1/2024,DET vs MEM,Troy Brown Jr.,browntr01,52,DET,1,MEM,0,4,0,2,0,0,18.28333333,0,4,0,2,0,0,0,0,0,2,4,0,4,4,10.8
2023-24,202404010IND,4/1/2024,IND vs BRK,Obi Toppin,toppiob01,77,IND,1,BRK,14,4,3,1,0,1,18.55,1,3,6,9,1,3,1,2,2,1,7,17,18,21,25.3
2023-24,202404010IND,4/1/2024,IND vs BRK,Doug McDermott,mcderdo01,59,IND,1,BRK,6,1,0,0,0,0,18.83333333,0,1,2,6,2,6,0,0,2,0,1,6,7,7,7.2
2023-24,202404010NOP,4/1/2024,NOP vs PHO,Larry Nance Jr.,nancela02,56,NOP,1,PHO,9,7,1,0,0,0,19.33333333,5,2,3,7,2,2,1,1,2,0,8,10,16,17,18.9
2023-24,202404010NOP,4/1/2024,NOP vs PHO,Eric Gordon,gordoer01,62,PHO,0,NOP,3,1,1,1,0,0,19.48333333,0,1,1,7,1,6,0,0,1,1,2,4,4,5,8.7
2023-24,202404010IND,4/1/2024,IND vs BRK,Lonnie Walker IV,walkelo01,54,BRK,0,IND,14,7,3,0,1,0,19.75,1,6,5,13,3,6,1,2,0,1,10,17,21,24,29.9
2023-24,202404010CHI,4/1/2024,CHI vs ATL,Andre Drummond,drumman01,76,CHI,1,ATL,13,18,0,0,0,1,20.06666667,8,10,5,8,0,0,3,6,2,0,18,13,31,31,33.6
2023-24,202404010DET,4/1/2024,DET vs MEM,Scotty Pippen Jr.,pippesc02,14,MEM,0,DET,0,0,3,3,0,1,20.83333333,0,0,0,3,0,3,0,0,2,3,3,3,0,3,12.5
2023-24,202404010IND,4/1/2024,IND vs BRK,Dennis Schroder,schrode01,76,BRK,0,IND,7,3,4,0,0,2,20.93333333,2,1,2,5,1,1,2,2,3,0,7,11,10,14,14.6
2023-24,202404010CHI,4/1/2024,CHI vs ATL,Bruno Fernando,fernabr01,38,ATL,0,CHI,10,4,4,1,0,2,21.93333333,1,3,4,6,0,0,2,3,4,1,8,14,14,18,21.8
2023-24,202404010IND,4/1/2024,IND vs BRK,Noah Clowney,clownno01,17,BRK,0,IND,4,3,2,1,0,2,21.96666667,1,2,2,4,0,0,0,0,2,1,5,6,7,9,11.6
2023-24,202404010CHO,4/1/2024,CHO vs BOS,Davis Bertans,bertada01,37,CHO,1,BOS,8,1,1,1,1,0,22.68333333,0,1,3,6,2,5,0,0,2,2,2,9,9,10,16.7
2023-24,202404010IND,4/1/2024,IND vs BRK,Dorian Finney-Smith,finnedo01,66,BRK,0,IND,5,4,2,0,1,1,22.83333333,0,4,2,4,1,2,0,0,2,1,6,7,9,11,14.8
2023-24,202404010DET,4/1/2024,DET vs MEM,Lamar Stevens,stevela01,35,MEM,0,DET,7,3,1,3,1,0,23.01666667,1,2,3,8,0,2,1,3,2,4,4,8,10,11,24.1
2023-24,202404010DET,4/1/2024,DET vs MEM,Santi Aldama,aldamsa01,61,MEM,0,DET,2,3,2,0,3,0,23.13333333,0,3,1,3,0,2,0,0,2,3,5,4,5,7,17.6
2023-24,202404010DET,4/1/2024,DET vs MEM,Brandon Clarke,clarkbr01,3,MEM,0,DET,15,7,0,1,2,1,23.36666667,5,2,7,12,1,1,0,0,2,3,7,15,22,22,31.4
2023-24,202404010IND,4/1/2024,IND vs BRK,Pascal Siakam,siakapa01,74,IND,1,BRK,15,6,2,1,0,2,23.65,2,4,7,15,1,2,0,0,0,1,8,17,21,23,26.2
2023-24,202404010NOP,4/1/2024,NOP vs PHO,Jonas Valanciunas,valanjo01,75,NOP,1,PHO,11,7,1,0,0,0,23.81666667,1,6,5,10,0,2,1,4,1,0,8,12,18,19,20.9
2023-24,202404010IND,4/1/2024,IND vs BRK,Andrew Nembhard,nembhan01,62,IND,1,BRK,7,2,6,0,0,1,23.86666667,1,1,2,6,1,3,2,2,1,0,8,13,9,15,17.4
2023-24,202404010IND,4/1/2024,IND vs BRK,Jalen Wilson,wilsoja03,37,BRK,0,IND,6,1,1,0,0,1,23.9,0,1,2,5,1,3,1,2,1,0,2,7,7,8,7.7
2023-24,202404010DET,4/1/2024,DET vs MEM,Jordan Goodwin,goodwjo01,51,MEM,0,DET,4,13,5,0,0,1,24.08333333,5,8,2,8,0,3,0,0,2,0,18,9,17,22,26.1
2023-24,202404010CHO,4/1/2024,CHO vs BOS,Sam Hauser,hausesa01,72,BOS,0,CHO,25,5,0,0,0,1,24.23333333,1,4,9,13,7,11,0,0,2,0,5,25,30,30,30
2023-24,202404010DET,4/1/2024,DET vs MEM,Jake LaRavia,laravja01,30,MEM,0,DET,12,4,2,0,0,3,24.71666667,2,2,3,11,2,4,4,4,4,0,6,14,16,18,16.8
2023-24,202404010CHO,4/1/2024,CHO vs BOS,Al Horford,horfoal01,61,BOS,0,CHO,15,5,3,0,0,0,24.83333333,3,2,6,11,3,6,0,0,0,0,8,18,20,23,25.5
2023-24,202404010CHI,4/1/2024,CHI vs ATL,Vit Krejci,krejcvi01,15,ATL,0,CHI,18,4,3,0,0,1,24.9,0,4,6,6,6,6,0,0,1,0,7,21,22,25,26.3
2023-24,202404010CHI,4/1/2024,CHI vs ATL,Jalen Johnson,johnsja05,52,ATL,0,CHI,11,4,1,2,0,1,24.96666667,1,3,4,12,2,5,1,2,2,2,5,12,15,16,22.3
2023-24,202404010NOP,4/1/2024,NOP vs PHO,Dyson Daniels,daniedy01,54,NOP,1,PHO,9,7,5,2,0,0,25.28333333,2,5,4,8,1,3,0,0,3,2,12,14,16,21,30.9
2023-24,202404010IND,4/1/2024,IND vs BRK,Aaron Nesmith,nesmiaa01,67,IND,1,BRK,11,4,0,0,0,0,25.43333333,2,2,5,9,1,3,0,0,2,0,4,11,15,15,15.8
2023-24,202404010CHO,4/1/2024,CHO vs BOS,Tre Mann,manntr01,34,CHO,1,BOS,4,4,4,0,0,2,25.58333333,0,4,2,7,0,3,0,0,2,0,8,8,8,12,12.8
2023-24,202404010IND,4/1/2024,IND vs BRK,Nic Claxton,claxtni01,66,BRK,0,IND,7,11,0,0,1,2,25.78333333,1,10,3,4,0,0,1,4,2,1,11,7,18,18,21.2
2023-24,202404010CHI,4/1/2024,CHI vs ATL,Clint Capela,capelca01,67,ATL,0,CHI,15,11,1,1,2,1,26.06666667,5,6,6,9,0,0,3,7,2,3,12,16,26,27,37.7
2023-24,202404010IND,4/1/2024,IND vs BRK,Tyrese Haliburton,halibty01,64,IND,1,BRK,27,4,13,1,1,0,26.71666667,0,4,9,15,4,7,5,5,1,2,17,40,31,44,57.3
2023-24,202404010DET,4/1/2024,DET vs MEM,Chimezie Metu,metuch01,44,DET,1,MEM,17,8,0,0,2,1,27.73333333,4,4,6,10,1,3,4,4,3,2,8,17,25,25,31.6
2023-24,202404010CHO,4/1/2024,CHO vs BOS,Payton Pritchard,pritcpa01,75,BOS,0,CHO,7,3,5,0,0,1,27.91666667,1,2,3,7,0,4,1,2,4,0,8,12,10,15,17.1
2023-24,202404010DET,4/1/2024,DET vs MEM,James Wiseman,wisemja01,56,DET,1,MEM,10,10,0,0,1,2,28.38333333,2,8,5,8,0,0,0,1,5,1,10,10,20,20,23
2023-24,202404010IND,4/1/2024,IND vs BRK,Cam Thomas,thomaca02,60,BRK,0,IND,22,1,2,0,0,1,29.03333333,0,1,7,16,0,3,8,9,4,0,3,24,23,25,25.2
2023-24,202404010DET,4/1/2024,DET vs MEM,Evan Fournier,fournev01,26,DET,1,MEM,5,3,4,1,1,0,29.16666667,0,3,2,8,1,5,0,0,2,2,7,9,8,12,20.6
2023-24,202404010ORL,4/1/2024,ORL vs POR,Kris Murray,murrakr01,55,POR,0,ORL,7,5,1,3,0,0,29.18333333,2,3,2,7,1,4,2,2,3,3,6,8,12,13,23.5
2023-24,202404010IND,4/1/2024,IND vs BRK,Mikal Bridges,bridgmi01,76,BRK,0,IND,19,0,6,1,0,0,29.48333333,0,0,7,17,3,8,2,2,0,1,6,25,19,25,31
2023-24,202404010CHO,4/1/2024,CHO vs BOS,Kristaps Porzingis,porzikr01,53,BOS,0,CHO,20,7,5,0,1,1,30.26666667,2,5,6,10,1,3,7,8,1,1,12,25,27,32,37.9
2023-24,202404010CHO,4/1/2024,CHO vs BOS,Jrue Holiday,holidjr01,64,BOS,0,CHO,2,5,2,0,0,1,30.35,1,4,1,11,0,8,0,0,2,0,7,4,7,9,10
2023-24,202404010DET,4/1/2024,DET vs MEM,GG Jackson II,jacksgg01,41,MEM,0,DET,11,4,4,0,1,0,30.46666667,0,4,4,9,1,4,2,2,2,1,8,15,15,19,24.8
2023-24,202404010CHI,4/1/2024,CHI vs ATL,Nikola Vucevic,vucevni01,71,CHI,1,ATL,5,14,3,1,0,1,31.15,1,13,2,7,1,2,0,0,4,1,17,8,19,22,28.3
2023-24,202404010ORL,4/1/2024,ORL vs POR,Wendell Carter Jr.,cartewe01,48,ORL,1,POR,17,13,5,3,1,2,31.2,3,10,6,10,1,4,4,7,2,4,18,22,30,35,50.1
2023-24,202404010ORL,4/1/2024,ORL vs POR,Rayan Rupert,ruperra01,32,POR,0,ORL,11,1,2,1,0,1,31.43333333,0,1,4,11,3,6,0,0,3,1,3,13,12,14,17.2
2023-24,202404010NOP,4/1/2024,NOP vs PHO,Trey Murphy III,murphtr02,50,NOP,1,PHO,21,6,4,2,0,3,32.3,1,5,7,14,4,10,3,4,0,2,10,25,27,31,37.2
2023-24,202404010NOP,4/1/2024,NOP vs PHO,Herbert Jones,joneshe01,69,NOP,1,PHO,9,1,3,4,0,0,32.63333333,0,1,4,7,1,2,0,0,3,4,4,12,10,13,26.7
2023-24,202404010ORL,4/1/2024,ORL vs POR,Franz Wagner,wagnefr01,67,ORL,1,POR,20,6,1,0,0,1,32.63333333,1,5,6,10,1,2,7,9,2,0,7,21,26,27,27.7
2023-24,202404010ORL,4/1/2024,ORL vs POR,Jalen Suggs,suggsja01,68,ORL,1,POR,15,3,7,0,2,2,32.76666667,0,3,5,8,2,5,3,3,1,2,10,22,18,25,33.1
2023-24,202404010CHI,4/1/2024,CHI vs ATL,De'Andre Hunter,huntede01,51,ATL,0,CHI,8,6,4,0,0,2,32.8,0,6,3,12,2,10,0,0,2,0,10,12,14,18,19.2
2023-24,202404010CHI,4/1/2024,CHI vs ATL,Alex Caruso,carusal01,67,CHI,1,ATL,8,5,3,2,2,1,32.91666667,1,4,3,13,2,7,0,0,1,4,8,11,13,16,29.5
2023-24,202404010CHO,4/1/2024,CHO vs BOS,Grant Williams,willigr01,71,CHO,1,BOS,23,7,2,0,0,1,33.01666667,3,4,10,16,2,4,1,2,3,0,9,25,30,32,33.4
2023-24,202404010NOP,4/1/2024,NOP vs PHO,Grayson Allen,allengr01,69,PHO,0,NOP,11,2,4,0,1,1,33.41666667,0,2,4,8,2,5,1,2,2,1,6,15,13,17,21.4
2023-24,202404010CHI,4/1/2024,CHI vs ATL,Dejounte Murray,murrade01,72,ATL,0,CHI,17,8,6,0,0,5,33.41666667,1,7,7,17,3,6,0,0,5,0,14,23,25,31,30.6
2023-24,202404010IND,4/1/2024,IND vs BRK,Trendon Watford,watfotr01,57,BRK,0,IND,21,2,0,1,1,4,33.8,1,1,8,11,1,2,4,7,4,2,2,21,23,23,25.4
2023-24,202404010CHI,4/1/2024,CHI vs ATL,Bogdan Bogdanovic,bogdabo01,72,ATL,0,CHI,20,4,6,0,2,1,33.96666667,0,4,6,7,2,2,6,6,1,2,10,26,24,30,38.8
2023-24,202404010DET,4/1/2024,DET vs MEM,Cade Cunningham,cunnica01,62,DET,1,MEM,36,4,8,2,1,4,34.03333333,1,3,13,22,3,4,7,8,1,3,12,44,40,48,57.8
2023-24,202404010DET,4/1/2024,DET vs MEM,Jaren Jackson Jr.,jacksja02,65,MEM,0,DET,40,7,3,3,2,3,34.38333333,2,5,13,23,2,3,12,14,2,5,10,43,47,50,64.9
2023-24,202404010CHO,4/1/2024,CHO vs BOS,Jayson Tatum,tatumja01,70,BOS,0,CHO,25,10,4,2,1,4,34.38333333,0,10,9,19,4,10,3,3,2,3,14,29,35,39,48
2023-24,202404010ORL,4/1/2024,ORL vs POR,Gary Harris,harriga01,48,ORL,1,POR,14,4,2,1,0,1,34.65,0,4,5,10,2,6,2,2,3,1,6,16,18,20,23.8
2023-24,202404010ORL,4/1/2024,ORL vs POR,Scoot Henderson,hendesc01,56,POR,0,ORL,13,8,9,0,0,5,34.8,2,6,6,16,1,5,0,0,5,0,17,22,21,30,31.1
2023-24,202404010DET,4/1/2024,DET vs MEM,Jaden Ivey,iveyja01,70,DET,1,MEM,20,3,6,0,0,2,34.85,0,3,7,17,2,8,4,5,1,0,9,26,23,29,30.6
2023-24,202404010DET,4/1/2024,DET vs MEM,Tosan Evbuomwan,evbuoto01,15,DET,1,MEM,10,5,2,1,1,1,35.35,2,3,4,5,2,3,0,0,0,2,7,12,15,17,24
2023-24,202404010ORL,4/1/2024,ORL vs POR,Dalano Banton,bantoda01,48,POR,0,ORL,26,5,5,3,2,1,35.38333333,0,5,8,17,4,8,6,8,1,5,10,31,31,36,53.5
2023-24,202404010CHI,4/1/2024,CHI vs ATL,Ayo Dosunmu,dosunay01,74,CHI,1,ATL,15,3,1,1,0,1,35.61666667,1,2,7,13,1,5,0,0,2,1,4,16,18,19,22.1
2023-24,202404010CHO,4/1/2024,CHO vs BOS,Derrick White,whitede01,69,BOS,0,CHO,19,9,5,0,1,2,35.63333333,2,7,7,15,4,10,1,1,3,1,14,24,28,33,38.3
2023-24,202404010ORL,4/1/2024,ORL vs POR,Paolo Banchero,banchpa01,73,ORL,1,POR,15,4,4,0,1,2,35.75,0,4,6,17,2,7,1,2,1,1,8,19,19,23,26.8
2023-24,202404010NOP,4/1/2024,NOP vs PHO,Jusuf Nurkic,nurkiju01,70,PHO,0,NOP,19,19,4,1,2,1,35.83333333,8,11,5,11,1,2,8,11,5,3,23,23,38,42,55.8
2023-24,202404010ORL,4/1/2024,ORL vs POR,Deandre Ayton,aytonde01,49,POR,0,ORL,20,12,3,0,0,2,36,4,8,10,18,0,0,0,0,4,0,15,23,32,35,36.9
2023-24,202404010DET,4/1/2024,DET vs MEM,Luke Kennard,kennalu01,38,MEM,0,DET,19,3,8,1,0,3,36,0,3,7,14,5,11,0,0,0,1,11,27,22,30,34.6
2023-24,202404010NOP,4/1/2024,NOP vs PHO,Zion Williamson,willizi01,64,NOP,1,PHO,30,2,5,1,0,3,36.75,1,1,10,20,0,0,10,13,4,1,7,35,32,37,39.9
2023-24,202404010CHO,4/1/2024,CHO vs BOS,Vasilije Micic,micicva01,54,CHO,1,BOS,13,2,9,0,0,1,36.95,0,2,5,13,1,6,2,2,1,0,11,22,15,24,27.9
2023-24,202404010NOP,4/1/2024,NOP vs PHO,Bradley Beal,bealbr01,46,PHO,0,NOP,13,9,6,2,1,3,39.08333333,3,6,5,8,3,4,0,0,3,3,15,19,22,28,38.8
2023-24,202404010CHI,4/1/2024,CHI vs ATL,DeMar DeRozan,derozde01,74,CHI,1,ATL,31,2,5,2,0,3,39.08333333,0,2,10,23,0,3,11,12,4,2,7,36,33,38,43.9
2023-24,202404010CHI,4/1/2024,CHI vs ATL,Coby White,whiteco01,73,CHI,1,ATL,22,3,3,1,0,1,39.31666667,1,2,8,21,2,7,4,4,4,1,6,25,25,28,32.1
2023-24,202404010NOP,4/1/2024,NOP vs PHO,Devin Booker,bookede01,61,PHO,0,NOP,52,3,9,0,1,3,39.36666667,1,2,19,28,8,16,6,7,3,1,12,61,55,64,69.1
2023-24,202404010NOP,4/1/2024,NOP vs PHO,CJ McCollum,mccolcj01,59,NOP,1,PHO,15,5,9,0,1,3,39.6,2,3,6,17,2,6,1,1,1,1,14,24,20,29,34.5
2023-24,202404010ORL,4/1/2024,ORL vs POR,Jabari Walker,walkeja01,66,POR,0,ORL,18,9,5,0,0,0,40.35,3,6,7,15,2,6,2,3,2,0,14,23,27,32,36.3
2023-24,202404010CHO,4/1/2024,CHO vs BOS,Brandon Miller,millebr02,68,CHO,1,BOS,19,5,2,1,0,1,40.36666667,1,4,7,15,3,6,2,2,4,1,7,21,24,26,30
2023-24,202404010NOP,4/1/2024,NOP vs PHO,Kevin Durant,duranke01,68,PHO,0,NOP,20,7,3,2,0,3,40.95,1,6,7,19,3,11,3,3,2,2,10,23,27,30,35.9
2023-24,202404010CHO,4/1/2024,CHO vs BOS,Miles Bridges,bridgmi02,64,CHO,1,BOS,26,11,8,0,0,1,42.65,1,10,10,23,3,9,3,3,0,0,19,34,37,45,50.2
2023-24,202403310WAS,3/31/2024,WAS vs MIA,Thomas Bryant,bryanth01,37,MIA,0,WAS,4,3,0,0,1,2,10.11666667,0,3,2,3,0,0,0,0,3,1,3,4,7,7,8.6
2023-24,202403310SAC,3/31/2024,SAC vs UTA,Kessler Edwards,edwarke02,48,SAC,1,UTA,3,0,0,0,0,0,10.28333333,0,0,1,2,1,2,0,2,0,0,0,3,3,3,3
2023-24,202403310TOR,3/31/2024,TOR vs PHI,KJ Martin,martike04,56,PHI,0,TOR,2,5,2,0,0,0,10.28333333,1,4,1,2,0,0,0,0,1,0,7,4,7,9,11
2023-24,202403310NYK,3/31/2024,NYK vs OKC,Kenrich Williams,willike04,61,OKC,0,NYK,7,2,1,0,1,0,10.4,1,1,3,4,1,2,0,0,1,1,3,8,9,10,13.9
2023-24,202403310NYK,3/31/2024,NYK vs OKC,Bojan Bogdanovic,bogdabo02,49,NYK,1,OKC,5,1,0,0,0,0,10.73333333,0,1,2,4,0,1,1,2,0,0,1,5,6,6,6.2
2023-24,202403310HOU,3/31/2024,HOU vs DAL,Reggie Bullock,bullore01,36,HOU,1,DAL,3,1,1,0,0,0,10.78333333,0,1,1,3,1,2,0,0,0,0,2,4,4,5,5.7
2023-24,202403310MIN,3/31/2024,MIN vs CHI,Dalen Terry,terryda01,52,CHI,0,MIN,0,1,1,0,1,1,11.11666667,0,1,0,2,0,2,0,0,3,1,2,1,1,2,4.7
2023-24,202403310NYK,3/31/2024,NYK vs OKC,Gordon Hayward,haywago01,45,OKC,0,NYK,5,1,0,1,0,0,11.16666667,1,0,2,5,1,2,0,0,1,1,1,5,6,6,9.2
2023-24,202403310SAS,3/31/2024,SAS vs GSW,Blake Wesley,weslebl01,54,SAS,1,GSW,1,1,5,0,0,0,11.6,1,0,0,1,0,1,1,2,1,0,6,6,2,7,9.7
2023-24,202403310SAC,3/31/2024,SAC vs UTA,Alex Len,lenal01,40,SAC,1,UTA,0,2,1,0,1,1,12.11666667,0,2,0,0,0,0,0,0,4,1,3,1,2,3,5.9
2023-24,202403310DEN,3/31/2024,DEN vs CLE,Marcus Morris,morrima03,44,CLE,0,DEN,7,0,0,0,0,2,12.31666667,0,0,3,7,1,3,0,0,1,0,0,7,7,7,5
2023-24,202403310SAC,3/31/2024,SAC vs UTA,Omer Yurtseven,yurtsom01,41,UTA,0,SAC,4,4,1,0,0,1,12.36666667,2,2,2,6,0,0,0,0,1,0,5,5,8,9,9.3
2023-24,202403310NYK,3/31/2024,NYK vs OKC,Alec Burks,burksal01,62,NYK,1,OKC,5,2,1,0,0,0,12.41666667,0,2,2,8,1,3,0,0,0,0,3,6,7,8,8.9
2023-24,202403310MIN,3/31/2024,MIN vs CHI,Torrey Craig,craigto01,46,CHI,0,MIN,3,4,0,0,0,1,12.95,1,3,1,2,1,1,0,0,2,0,4,3,7,7,6.8
2023-24,202403310TOR,3/31/2024,TOR vs PHI,Mo Bamba,bambamo01,53,PHI,0,TOR,4,4,1,1,1,1,13.31666667,0,4,1,3,0,2,2,2,1,2,5,5,8,9,15.3
2023-24,202403310HOU,3/31/2024,HOU vs DAL,Dereck Lively II,livelde01,55,DAL,0,HOU,2,2,0,1,2,0,13.33333333,1,1,1,1,0,0,0,0,1,3,2,2,4,4,13.4
2023-24,202403310WAS,3/31/2024,WAS vs MIA,Tristan Vukcevic,vukcetr01,5,WAS,1,MIA,3,2,2,0,0,0,13.33333333,0,2,1,3,1,2,0,0,3,0,4,5,5,7,8.4
2023-24,202403310NYK,3/31/2024,NYK vs OKC,Aaron Wiggins,wiggiaa01,70,OKC,0,NYK,4,3,2,1,1,1,13.85,2,1,2,5,0,2,0,0,2,2,5,6,7,9,15.6
2023-24,202403310BRK,3/31/2024,BRK vs LAL,Gabe Vincent,vincega01,6,LAL,0,BRK,2,1,1,1,0,1,14.01666667,0,1,1,4,0,2,0,0,2,1,2,3,3,4,6.7
2023-24,202403310MIN,3/31/2024,MIN vs CHI,Jordan McLaughlin,mclaujo01,48,MIN,1,CHI,0,1,3,0,0,0,14.03333333,0,1,0,1,0,0,0,0,0,0,4,3,1,4,5.7
2023-24,202403310BRK,3/31/2024,BRK vs LAL,Taurean Prince,princta02,72,LAL,0,BRK,0,2,0,0,0,0,14.93333333,0,2,0,2,0,1,0,0,0,0,2,0,2,2,2.4
2023-24,202403310BRK,3/31/2024,BRK vs LAL,Noah Clowney,clownno01,16,BRK,1,LAL,3,6,0,1,0,0,15.38333333,1,5,1,2,0,0,1,2,1,1,6,3,9,9,13.2
2023-24,202403310TOR,3/31/2024,TOR vs PHI,Kobi Simmons,simmoko01,3,TOR,1,PHI,6,1,3,0,0,0,15.51666667,0,1,3,6,0,1,0,0,0,0,4,9,7,10,11.7
2023-24,202403310NYK,3/31/2024,NYK vs OKC,Cason Wallace,wallaca01,74,OKC,0,NYK,6,2,0,0,0,0,15.58333333,0,2,2,3,2,2,0,0,1,0,2,6,8,8,8.4
2023-24,202403310NYK,3/31/2024,NYK vs OKC,Isaiah Joe,joeis01,70,OKC,0,NYK,6,2,0,0,0,1,15.61666667,0,2,2,3,2,3,0,0,0,0,2,6,8,8,7.4
2023-24,202403310DEN,3/31/2024,DEN vs CLE,Sam Merrill,merrisa01,57,CLE,0,DEN,3,0,1,0,0,0,15.66666667,0,0,1,5,1,4,0,0,2,0,1,4,3,4,4.5
2023-24,202403310HOU,3/31/2024,HOU vs DAL,Jaden Hardy,hardyja02,65,DAL,0,HOU,8,2,1,0,0,2,15.68333333,0,2,3,7,2,5,0,0,2,0,3,9,10,11,9.9
2023-24,202403310CHO,3/31/2024,CHO vs LAC,Amir Coffey,coffeam01,62,LAC,0,CHO,2,0,2,0,1,1,15.71666667,0,0,1,2,0,1,0,0,3,1,2,4,2,4,7
2023-24,202403310MIN,3/31/2024,MIN vs CHI,Javonte Green,greenja02,3,CHI,0,MIN,3,6,1,0,1,1,15.78333333,3,3,1,4,1,2,0,0,0,1,7,4,9,10,13.7
2023-24,202403310MIN,3/31/2024,MIN vs CHI,Monte Morris,morrimo01,25,MIN,1,CHI,9,2,1,2,0,0,16.25,0,2,2,4,1,3,4,4,0,2,3,10,11,12,18.9
2023-24,202403310SAS,3/31/2024,SAS vs GSW,Zach Collins,colliza01,62,SAS,1,GSW,13,8,2,0,0,0,16.41666667,3,5,4,10,2,3,3,3,1,0,10,15,21,23,25.6
2023-24,202403310MIN,3/31/2024,MIN vs CHI,Andre Drummond,drumman01,75,CHI,0,MIN,6,9,0,1,0,0,16.91666667,2,7,3,6,0,0,0,0,4,1,9,6,15,15,19.8
2023-24,202403310TOR,3/31/2024,TOR vs PHI,Paul Reed,reedpa01,75,PHI,0,TOR,9,2,0,0,1,0,17.78333333,0,2,4,7,0,1,1,3,3,1,2,9,11,11,14.4
2023-24,202403310WAS,3/31/2024,WAS vs MIA,Patrick Baldwin Jr.,baldwpa01,32,WAS,1,MIA,0,3,0,0,0,1,17.91666667,0,3,0,8,0,8,0,0,3,0,3,0,3,3,2.6
2023-24,202403310TOR,3/31/2024,TOR vs PHI,Jalen McDaniels,mcdanja01,43,TOR,1,PHI,8,4,1,0,0,0,17.93333333,0,4,3,6,0,1,2,2,0,0,5,9,12,13,14.3
2023-24,202403310HOU,3/31/2024,HOU vs DAL,Dante Exum,exumda01,48,DAL,0,HOU,13,1,2,0,0,0,18.21666667,1,0,5,5,3,3,0,0,0,0,3,15,14,16,17.2
2023-24,202403310SAS,3/31/2024,SAS vs GSW,Devonte Graham,grahade01,16,SAS,1,GSW,6,1,2,0,0,2,18.3,0,1,2,4,2,4,0,0,1,0,3,8,7,9,8.2
2023-24,202403310NYK,3/31/2024,NYK vs OKC,Jaylin Williams,willija07,61,OKC,0,NYK,8,8,2,0,1,1,18.53333333,2,6,2,4,1,1,3,4,2,1,10,10,16,18,22.6
2023-24,202403310WAS,3/31/2024,WAS vs MIA,Johnny Davis,davisjo06,44,WAS,1,MIA,4,5,0,0,0,0,18.73333333,1,4,2,3,0,0,0,0,0,0,5,4,9,9,10
2023-24,202403310SAC,3/31/2024,SAC vs UTA,Trey Lyles,lylestr01,50,SAC,1,UTA,11,4,3,0,1,2,18.93333333,2,2,3,8,3,5,2,2,2,1,7,14,15,18,21.3
2023-24,202403310HOU,3/31/2024,HOU vs DAL,Jock Landale,landajo01,48,HOU,1,DAL,11,4,1,1,0,0,19.13333333,2,2,5,12,0,0,1,1,0,1,5,12,15,16,20.3
2023-24,202403310WAS,3/31/2024,WAS vs MIA,Jaime Jaquez Jr.,jaqueja01,67,MIA,0,WAS,9,1,2,0,1,4,19.3,0,1,3,5,1,2,2,2,0,1,3,11,10,12,12.2
2023-24,202403310DEN,3/31/2024,DEN vs CLE,Justin Holiday,holidju01,51,DEN,1,CLE,7,1,0,1,1,1,19.63333333,1,0,3,7,1,3,0,0,1,2,1,7,8,8,13.2
2023-24,202403310CHO,3/31/2024,CHO vs LAC,Russell Westbrook,westbru01,62,LAC,0,CHO,11,5,4,2,0,3,19.73333333,2,3,4,6,0,0,3,4,1,2,9,15,16,20,26
2023-24,202403310SAC,3/31/2024,SAC vs UTA,Micah Potter,pottemi01,12,UTA,0,SAC,8,4,0,1,1,1,19.76666667,0,4,3,4,2,2,0,0,0,2,4,8,12,12,17.8
2023-24,202403310BRK,3/31/2024,BRK vs LAL,Cameron Johnson,johnsca02,56,BRK,1,LAL,5,3,0,1,2,0,19.9,0,3,2,10,1,5,0,0,1,3,3,5,8,8,17.6
2023-24,202403310DEN,3/31/2024,DEN vs CLE,Peyton Watson,watsope01,73,DEN,1,CLE,9,3,2,1,2,2,19.91666667,1,2,4,5,0,0,1,2,1,3,5,11,12,14,22.6
2023-24,202403310WAS,3/31/2024,WAS vs MIA,Anthony Gill,gillan01,44,WAS,1,MIA,18,4,0,0,0,0,20.01666667,2,2,7,12,1,2,3,5,3,0,4,18,22,22,22.8
2023-24,202403310SAS,3/31/2024,SAS vs GSW,Gary Payton II,paytoga02,39,GSW,0,SAS,4,3,1,1,1,0,20.11666667,0,3,2,3,0,1,0,0,2,2,4,5,7,8,15.1
2023-24,202403310HOU,3/31/2024,HOU vs DAL,Amen Thompson,thompam01,55,HOU,1,DAL,8,7,1,2,0,1,20.21666667,2,5,3,8,0,1,2,2,3,2,8,9,15,16,22.9
2023-24,202403310HOU,3/31/2024,HOU vs DAL,Maxi Kleber,klebima01,37,DAL,0,HOU,2,4,0,0,0,2,20.3,1,3,1,2,0,1,0,0,2,0,4,2,6,6,4.8
2023-24,202403310MIN,3/31/2024,MIN vs CHI,Kyle Anderson,anderky01,71,MIN,1,CHI,5,1,2,2,1,0,20.76666667,1,0,2,5,0,0,1,1,0,3,3,7,6,8,18.2
2023-24,202403310SAC,3/31/2024,SAC vs UTA,Johnny Juzang,juzanjo01,14,UTA,0,SAC,3,2,1,0,0,0,20.96666667,0,2,1,7,1,7,0,0,2,0,3,4,5,6,6.9
2023-24,202403310SAC,3/31/2024,SAC vs UTA,Davion Mitchell,mitchda01,64,SAC,1,UTA,8,5,3,1,0,1,21.15,1,4,3,6,1,2,1,2,3,1,8,11,13,16,20.5
2023-24,202403310BRK,3/31/2024,BRK vs LAL,Spencer Dinwiddie,dinwisp01,69,LAL,0,BRK,0,2,2,0,1,3,21.18333333,1,1,0,2,0,2,0,0,1,1,4,2,2,4,5.4
2023-24,202403310HOU,3/31/2024,HOU vs DAL,Derrick Jones Jr.,jonesde02,69,DAL,0,HOU,2,5,1,1,0,2,21.18333333,1,4,1,6,0,1,0,0,1,1,6,3,7,8,10.5
2023-24,202403310WAS,3/31/2024,WAS vs MIA,Delon Wright,wrighde01,44,MIA,0,WAS,9,1,4,4,1,0,21.28333333,0,1,2,2,1,1,4,4,2,5,5,13,10,14,31.2
2023-24,202403310HOU,3/31/2024,HOU vs DAL,Daniel Gafford,gaffoda01,67,DAL,0,HOU,6,4,3,1,5,1,21.56666667,1,3,3,4,0,0,0,0,2,6,7,9,10,13,32.3
2023-24,202403310SAS,3/31/2024,SAS vs GSW,Andrew Wiggins,wiggian01,65,GSW,0,SAS,4,5,0,0,0,1,21.56666667,2,3,2,12,0,2,0,0,2,0,5,4,9,9,9
2023-24,202403310TOR,3/31/2024,TOR vs PHI,Buddy Hield,hieldbu01,78,PHI,0,TOR,13,3,3,0,1,3,21.85,0,3,5,7,3,5,0,0,1,1,6,16,16,19,21.1
2023-24,202403310NYK,3/31/2024,NYK vs OKC,Precious Achiuwa,achiupr01,67,NYK,1,OKC,8,9,0,0,2,0,21.95,4,5,3,5,0,1,2,4,2,2,9,8,17,17,24.8
2023-24,202403310SAS,3/31/2024,SAS vs GSW,Moses Moody,moodymo01,58,GSW,0,SAS,10,4,1,0,0,1,21.96666667,0,4,3,6,2,3,2,2,1,0,5,11,14,15,15.3
2023-24,202403310SAS,3/31/2024,SAS vs GSW,Chris Paul,paulch01,50,GSW,0,SAS,9,4,2,2,0,0,22.08333333,0,4,4,9,1,3,0,0,1,2,6,11,13,15,22.8
2023-24,202403310HOU,3/31/2024,HOU vs DAL,Cam Whitmore,whitmca01,39,HOU,1,DAL,13,5,1,3,0,0,22.13333333,4,1,5,12,2,6,1,4,0,3,6,14,18,19,29.5
2023-24,202403310MIN,3/31/2024,MIN vs CHI,Nickeil Alexander-Walker,alexani01,74,MIN,1,CHI,5,2,2,0,0,1,22.18333333,0,2,2,7,1,5,0,0,1,0,4,7,7,9,9.4
2023-24,202403310WAS,3/31/2024,WAS vs MIA,Nikola Jovic,jovicni01,38,MIA,0,WAS,12,8,4,1,1,0,22.45,2,6,4,9,2,6,2,2,2,2,12,16,20,24,33.6
2023-24,202403310HOU,3/31/2024,HOU vs DAL,Aaron Holiday,holidaa01,71,HOU,1,DAL,16,5,2,2,0,1,22.66666667,1,4,6,11,2,5,2,2,2,2,7,18,21,23,30
2023-24,202403310WAS,3/31/2024,WAS vs MIA,Jared Butler,butleja02,33,WAS,1,MIA,14,2,7,0,0,3,22.75,0,2,5,6,2,3,2,2,3,0,9,21,16,23,23.9
2023-24,202403310DEN,3/31/2024,DEN vs CLE,Reggie Jackson,jacksre01,75,DEN,1,CLE,19,3,3,0,0,0,22.98333333,1,2,6,10,5,5,2,2,3,0,6,22,22,25,27.1
2023-24,202403310DEN,3/31/2024,DEN vs CLE,Georges Niang,niangge01,75,CLE,0,DEN,4,5,2,1,0,2,23.23333333,1,4,2,8,0,3,0,0,2,1,7,6,9,11,14
2023-24,202403310SAS,3/31/2024,SAS vs GSW,Brandin Podziemski,podzibr01,66,GSW,0,SAS,12,7,4,2,0,1,23.58333333,3,4,5,11,2,5,0,0,1,2,11,16,19,23,31.4
2023-24,202403310HOU,3/31/2024,HOU vs DAL,Tim Hardaway Jr.,hardati02,71,DAL,0,HOU,9,5,0,0,0,1,24.23333333,0,5,3,8,3,6,0,0,0,0,5,9,14,14,14
2023-24,202403310CHO,3/31/2024,CHO vs LAC,Nick Richards,richani01,64,CHO,1,LAC,8,2,0,1,1,0,24.58333333,1,1,4,6,0,0,0,0,2,2,2,8,10,10,16.4
2023-24,202403310SAS,3/31/2024,SAS vs GSW,Sandro Mamukelashvili,mamuksa01,39,SAS,1,GSW,10,11,2,0,1,1,24.61666667,4,7,4,6,0,1,2,2,1,1,13,12,21,23,28.2
2023-24,202403310CHO,3/31/2024,CHO vs LAC,Terance Mann,mannte01,67,LAC,0,CHO,7,3,2,0,0,0,24.9,0,3,2,4,1,3,2,2,2,0,5,9,10,12,13.6
2023-24,202403310CHO,3/31/2024,CHO vs LAC,Davis Bertans,bertada01,36,CHO,1,LAC,15,2,1,0,0,0,24.96666667,0,2,5,9,5,9,0,0,4,0,3,16,17,18,18.9
2023-24,202403310BRK,3/31/2024,BRK vs LAL,Dorian Finney-Smith,finnedo01,65,BRK,1,LAL,5,3,1,2,0,0,24.98333333,1,2,2,5,1,3,0,0,1,2,4,6,8,9,16.1
2023-24,202403310CHO,3/31/2024,CHO vs LAC,Tre Mann,manntr01,33,CHO,1,LAC,9,2,5,1,0,6,25.83333333,0,2,3,7,1,2,2,2,2,1,7,14,11,16,15.9
2023-24,202403310WAS,3/31/2024,WAS vs MIA,Marvin Bagley III,baglema01,49,WAS,1,MIA,12,10,0,2,0,3,25.88333333,3,7,5,9,0,0,2,2,3,2,10,12,22,22,27
2023-24,202403310NYK,3/31/2024,NYK vs OKC,Chet Holmgren,holmgch01,74,OKC,0,NYK,5,5,0,0,1,3,26.21666667,1,4,2,8,1,6,0,2,4,1,5,5,10,10,11
2023-24,202403310BRK,3/31/2024,BRK vs LAL,Nic Claxton,claxtni01,65,BRK,1,LAL,10,6,2,4,0,3,26.26666667,3,3,5,7,0,0,0,1,3,4,8,12,16,18,29.2
2023-24,202403310CHO,3/31/2024,CHO vs LAC,Norman Powell,powelno01,70,LAC,0,CHO,16,1,1,0,0,0,26.33333333,0,1,4,11,2,5,6,7,1,0,2,17,17,18,18.7
2023-24,202403310DEN,3/31/2024,DEN vs CLE,Jarrett Allen,allenja01,70,CLE,0,DEN,19,4,1,0,1,2,26.5,0,4,9,15,0,0,1,2,2,1,5,20,23,24,26.3
2023-24,202403310DEN,3/31/2024,DEN vs CLE,Max Strus,strusma01,63,CLE,0,DEN,9,2,2,2,0,1,27.13333333,1,1,3,5,1,2,2,3,1,2,4,11,11,13,19.4
2023-24,202403310SAC,3/31/2024,SAC vs UTA,Kris Dunn,dunnkr01,64,UTA,0,SAC,5,5,7,0,0,1,27.15,2,3,2,9,0,3,1,2,1,0,12,12,10,17,20.5
2023-24,202403310SAC,3/31/2024,SAC vs UTA,Keon Ellis,elliske01,49,SAC,1,UTA,5,8,3,1,0,1,27.45,2,6,1,4,1,2,2,2,3,1,11,8,13,16,21.1
2023-24,202403310HOU,3/31/2024,HOU vs DAL,Dillon Brooks,brookdi01,65,HOU,1,DAL,0,3,1,0,0,1,27.5,0,3,0,8,0,7,0,0,3,0,4,1,3,4,4.1
2023-24,202403310SAC,3/31/2024,SAC vs UTA,Taylor Hendricks,hendrita0,33,UTA,0,SAC,18,3,1,0,0,1,27.96666667,2,1,6,11,4,6,2,3,3,0,4,19,21,22,22.1
2023-24,202403310WAS,3/31/2024,WAS vs MIA,Duncan Robinson,robindu01,64,MIA,0,WAS,6,3,1,0,1,1,28.08333333,1,2,2,7,2,7,0,0,4,1,4,7,9,10,13.1
2023-24,202403310HOU,3/31/2024,HOU vs DAL,P.J. Washington,washipj01,66,DAL,0,HOU,12,6,2,1,1,0,28.15,2,4,4,8,3,5,1,2,5,2,8,14,18,20,28.2
2023-24,202403310SAS,3/31/2024,SAS vs GSW,Trayce Jackson-Davis,jackstr02,60,GSW,0,SAS,7,7,3,2,1,1,28.28333333,4,3,3,5,0,0,1,2,2,3,10,10,14,17,27.9
2023-24,202403310TOR,3/31/2024,TOR vs PHI,Nicolas Batum,batumni01,53,PHI,0,TOR,19,6,2,2,0,0,28.3,1,5,7,8,5,6,0,0,0,2,8,21,25,27,35.2
2023-24,202403310DEN,3/31/2024,DEN vs CLE,Christian Braun,braunch01,75,DEN,1,CLE,10,6,1,1,1,3,28.3,1,5,4,8,2,3,0,0,2,2,7,11,16,17,21.7
2023-24,202403310BRK,3/31/2024,BRK vs LAL,Dennis Schroder,schrode01,75,BRK,1,LAL,14,3,3,1,0,0,28.33333333,0,3,5,12,2,6,2,2,3,1,6,17,17,20,25.1
2023-24,202403310DEN,3/31/2024,DEN vs CLE,Aaron Gordon,gordoaa01,68,DEN,1,CLE,8,8,5,1,0,2,28.56666667,3,5,3,7,1,3,1,2,3,1,13,13,16,21,26.1
2023-24,202403310DEN,3/31/2024,DEN vs CLE,Evan Mobley,mobleev01,43,CLE,0,DEN,23,4,1,0,2,0,28.6,2,2,9,10,1,2,4,5,1,2,5,24,27,28,35.3
2023-24,202403310DEN,3/31/2024,DEN vs CLE,Michael Porter Jr.,portemi01,74,DEN,1,CLE,19,6,0,0,0,2,28.61666667,0,6,8,16,3,5,0,0,1,0,6,19,25,25,24.2
2023-24,202403310DEN,3/31/2024,DEN vs CLE,Darius Garland,garlada01,51,CLE,0,DEN,5,2,7,2,0,3,28.7,0,2,2,8,0,1,1,2,0,2,9,12,7,14,20.9
2023-24,202403310NYK,3/31/2024,NYK vs OKC,Luguentz Dort,dortlu01,72,OKC,0,NYK,4,1,1,0,0,1,28.76666667,0,1,1,5,1,5,1,4,5,0,2,5,5,6,5.7
2023-24,202403310SAC,3/31/2024,SAC vs UTA,Collin Sexton,sextoco01,75,UTA,0,SAC,22,1,4,1,0,2,28.86666667,0,1,7,12,1,3,7,10,4,1,5,26,23,27,30.2
2023-24,202403310SAC,3/31/2024,SAC vs UTA,Harrison Barnes,barneha02,74,SAC,1,UTA,24,2,2,0,0,0,29.13333333,1,1,9,12,5,7,1,2,0,0,4,26,26,28,29.4
2023-24,202403310MIN,3/31/2024,MIN vs CHI,Mike Conley,conlemi01,69,MIN,1,CHI,19,1,7,4,0,1,29.13333333,0,1,7,11,5,9,0,0,2,4,8,26,20,27,41.7
2023-24,202403310BRK,3/31/2024,BRK vs LAL,Trendon Watford,watfotr01,56,BRK,1,LAL,15,8,2,1,1,3,29.18333333,1,7,7,10,1,2,0,0,3,2,10,17,23,25,30.6
2023-24,202403310SAS,3/31/2024,SAS vs GSW,Klay Thompson,thompkl01,70,GSW,0,SAS,13,2,3,2,0,2,29.26666667,0,2,5,13,2,8,1,1,0,2,5,16,15,18,23.9
2023-24,202403310WAS,3/31/2024,WAS vs MIA,Haywood Highsmith,highsha01,58,MIA,0,WAS,10,4,0,0,1,1,29.31666667,1,3,4,12,2,6,0,0,4,1,4,10,14,14,16.8
2023-24,202403310NYK,3/31/2024,NYK vs OKC,Isaiah Hartenstein,harteis01,68,NYK,1,OKC,17,12,5,1,0,1,29.45,6,6,6,8,0,0,5,7,2,1,17,22,29,34,40.9
2023-24,202403310TOR,3/31/2024,TOR vs PHI,Tobias Harris,harrito02,66,PHI,0,TOR,21,9,3,0,3,1,30.03333333,3,6,8,13,1,3,4,4,2,3,12,24,30,33,44.3
2023-24,202403310TOR,3/31/2024,TOR vs PHI,Jordan Nwora,nworajo01,45,TOR,1,PHI,19,4,3,0,1,1,30.43333333,2,2,8,18,2,7,1,1,0,1,7,22,23,26,30.3
2023-24,202403310MIN,3/31/2024,MIN vs CHI,Naz Reid,reidna01,73,MIN,1,CHI,14,3,4,1,2,3,30.51666667,0,3,5,14,3,9,1,1,2,3,7,18,17,21,29.6
2023-24,202403310DEN,3/31/2024,DEN vs CLE,Donovan Mitchell,mitchdo01,51,CLE,0,DEN,13,0,6,1,0,2,30.88333333,0,0,3,12,2,6,5,5,2,1,6,19,13,19,23
2023-24,202403310NYK,3/31/2024,NYK vs OKC,Josh Giddey,giddejo01,73,OKC,0,NYK,16,13,12,1,2,2,30.9,1,12,7,11,2,3,0,2,2,3,25,28,29,41,56.6
2023-24,202403310TOR,3/31/2024,TOR vs PHI,Gradey Dick,dickgr01,53,TOR,1,PHI,12,0,2,2,0,2,31.1,0,0,3,8,1,3,5,7,2,2,2,14,12,14,19
2023-24,202403310HOU,3/31/2024,HOU vs DAL,Jalen Green,greenja05,74,HOU,1,DAL,12,6,5,1,0,2,31.15,0,6,5,15,0,5,2,2,2,1,11,17,18,23,27.7
2023-24,202403310SAS,3/31/2024,SAS vs GSW,Malaki Branham,branhma01,70,SAS,1,GSW,12,3,4,0,0,4,31.2,2,1,5,14,1,6,1,1,2,0,7,16,15,19,17.6
2023-24,202403310TOR,3/31/2024,TOR vs PHI,Javon Freeman-Liberty,freemja01,14,TOR,1,PHI,11,7,2,1,0,1,31.3,1,6,4,11,1,3,2,2,2,1,9,13,18,20,24.4
2023-24,202403310SAS,3/31/2024,SAS vs GSW,Victor Wembanyama,wembavi01,66,SAS,1,GSW,32,9,5,4,3,5,31.36666667,1,8,10,22,3,10,9,10,2,7,14,37,41,46,66.3
2023-24,202403310SAS,3/31/2024,SAS vs GSW,Draymond Green,greendr01,49,GSW,0,SAS,21,6,11,6,1,5,31.76666667,2,4,8,9,2,2,3,4,3,7,17,32,27,38,60.7
2023-24,202403310TOR,3/31/2024,TOR vs PHI,Gary Trent Jr.,trentga02,66,TOR,1,PHI,23,2,2,2,0,1,31.83333333,0,2,10,20,3,9,0,0,1,2,4,25,25,27,33.4
2023-24,202403310BRK,3/31/2024,BRK vs LAL,D'Angelo Russell,russeda01,70,LAL,0,BRK,18,6,6,4,0,4,31.86666667,0,6,6,13,4,11,2,4,3,4,12,24,24,30,42.2
2023-24,202403310TOR,3/31/2024,TOR vs PHI,Kelly Olynyk,olynyke01,72,TOR,1,PHI,18,5,11,3,0,5,31.93333333,2,3,7,8,1,2,3,4,3,3,16,29,23,34,44.5
2023-24,202403310HOU,3/31/2024,HOU vs DAL,Fred VanVleet,vanvlfr01,67,HOU,1,DAL,10,2,7,0,0,3,32.03333333,0,2,3,4,3,4,1,1,3,0,9,17,12,19,19.9
2023-24,202403310SAS,3/31/2024,SAS vs GSW,Tre Jones,jonestr01,70,SAS,1,GSW,12,5,6,1,0,2,32.25,3,2,5,11,2,4,0,0,1,1,11,18,17,23,28
2023-24,202403310SAC,3/31/2024,SAC vs UTA,Walker Kessler,kesslwa01,63,UTA,0,SAC,6,8,3,1,3,0,32.3,4,4,3,6,0,0,0,0,4,4,11,9,14,17,32.1
2023-24,202403310SAS,3/31/2024,SAS vs GSW,Stephen Curry,curryst01,68,GSW,0,SAS,33,1,8,0,0,4,32.53333333,0,1,12,23,7,15,2,2,1,0,9,41,34,42,42.2
2023-24,202403310DEN,3/31/2024,DEN vs CLE,Caris LeVert,leverca01,62,CLE,0,DEN,15,6,5,4,1,3,32.88333333,0,6,5,9,2,3,3,3,0,5,11,20,21,26,41.7
2023-24,202403310MIN,3/31/2024,MIN vs CHI,Nikola Vucevic,vucevni01,70,CHI,0,MIN,19,8,6,2,0,2,33.08333333,1,7,8,16,2,6,1,2,1,2,14,25,27,33,41.6
2023-24,202403310CHO,3/31/2024,CHO vs LAC,Ivica Zubac,zubaciv01,62,LAC,0,CHO,24,12,1,0,3,2,33.11666667,2,10,7,8,0,0,10,10,4,3,13,25,36,37,46.9
2023-24,202403310MIN,3/31/2024,MIN vs CHI,Jaden McDaniels,mcdanja02,64,MIN,1,CHI,8,6,3,1,0,2,33.31666667,2,4,3,10,1,6,1,2,2,1,9,11,14,17,20.7
2023-24,202403310CHO,3/31/2024,CHO vs LAC,Grant Williams,willigr01,70,CHO,1,LAC,18,5,5,0,0,1,33.46666667,0,5,8,10,2,4,0,1,5,0,10,23,23,28,30.5
2023-24,202403310SAC,3/31/2024,SAC vs UTA,Brice Sensabaugh,sensabr01,25,UTA,0,SAC,22,4,3,2,0,4,33.68333333,1,3,6,14,5,10,5,6,1,2,7,25,26,29,33.3
2023-24,202403310TOR,3/31/2024,TOR vs PHI,Bruce Brown,brownbr01,63,TOR,1,PHI,18,4,6,2,0,2,33.88333333,1,3,7,9,3,4,1,2,4,2,10,24,22,28,35.8
2023-24,202403310SAC,3/31/2024,SAC vs UTA,Domantas Sabonis,sabondo01,74,SAC,1,UTA,17,11,6,1,1,4,33.88333333,5,6,7,14,0,1,3,3,3,2,17,23,28,34,41.2
2023-24,202403310WAS,3/31/2024,WAS vs MIA,Jordan Poole,poolejo01,73,WAS,1,MIA,22,4,8,1,0,4,34.1,1,3,8,20,4,12,2,2,3,1,12,30,26,34,37.8
2023-24,202403310NYK,3/31/2024,NYK vs OKC,Jalen Williams,willija06,67,OKC,0,NYK,33,4,8,2,2,1,34.1,0,4,14,18,1,4,4,8,1,4,12,41,37,45,60.8
2023-24,202403310HOU,3/31/2024,HOU vs DAL,Kyrie Irving,irvinky01,52,DAL,0,HOU,24,3,7,1,0,1,34.25,1,2,9,19,4,9,2,2,3,1,10,31,27,34,40.1
2023-24,202403310BRK,3/31/2024,BRK vs LAL,Cam Thomas,thomaca02,59,BRK,1,LAL,30,2,6,1,0,2,34.58333333,0,2,8,22,4,7,10,12,4,1,8,36,32,38,42.4
2023-24,202403310MIN,3/31/2024,MIN vs CHI,Alex Caruso,carusal01,66,CHI,0,MIN,21,5,5,5,0,4,34.63333333,1,4,7,8,7,8,0,0,3,5,10,26,26,31,45.5
2023-24,202403310DEN,3/31/2024,DEN vs CLE,Nikola Jokic,jokicni01,72,DEN,1,CLE,26,18,16,1,0,3,34.63333333,4,14,11,18,1,2,3,5,2,1,34,42,44,60,71.6
2023-24,202403310BRK,3/31/2024,BRK vs LAL,Austin Reaves,reaveau01,76,LAL,0,BRK,12,7,6,1,0,1,34.63333333,1,6,5,11,0,4,2,2,0,1,13,18,19,25,31.4
2023-24,202403310NYK,3/31/2024,NYK vs OKC,Jalen Brunson,brunsja01,69,NYK,1,OKC,30,2,7,1,0,3,34.85,0,2,11,25,4,11,4,8,3,1,9,37,32,39,42.9
2023-24,202403310WAS,3/31/2024,WAS vs MIA,Jimmy Butler,butleji01,52,MIA,0,WAS,17,7,4,0,0,0,34.86666667,2,5,5,11,0,0,7,9,1,0,11,21,24,28,31.4
2023-24,202403310NYK,3/31/2024,NYK vs OKC,Shai Gilgeous-Alexander,gilgesh01,71,OKC,0,NYK,19,2,3,1,0,2,34.86666667,1,1,7,16,1,4,4,4,4,1,5,22,21,24,26.9
2023-24,202403310DEN,3/31/2024,DEN vs CLE,Kentavious Caldwell-Pope,caldwke01,69,DEN,1,CLE,22,3,4,1,0,1,34.98333333,0,3,7,10,6,9,2,2,3,1,7,26,25,29,33.6
2023-24,202403310BRK,3/31/2024,BRK vs LAL,Anthony Davis,davisan02,71,LAL,0,BRK,24,14,0,0,3,4,35.05,1,13,9,12,1,3,5,6,3,3,14,24,38,38,45.8
2023-24,202403310WAS,3/31/2024,WAS vs MIA,Terry Rozier,roziete01,57,MIA,0,WAS,27,4,2,4,1,0,35.05,0,4,11,19,5,11,0,0,1,5,6,29,31,33,49.8
2023-24,202403310HOU,3/31/2024,HOU vs DAL,Luka Doncic,doncilu01,65,DAL,0,HOU,47,12,7,2,0,4,35.2,0,12,18,30,9,16,2,5,1,2,19,54,59,66,73.9
2023-24,202403310SAC,3/31/2024,SAC vs UTA,Keegan Murray,murrake02,69,SAC,1,UTA,25,4,3,0,1,0,35.35,2,2,10,18,5,12,0,0,2,1,7,28,29,32,37.3
2023-24,202403310CHO,3/31/2024,CHO vs LAC,Vasilije Micic,micicva01,53,CHO,1,LAC,10,5,13,1,0,0,35.43333333,3,2,4,14,2,7,0,2,4,1,18,23,15,28,38.5
2023-24,202403310MIN,3/31/2024,MIN vs CHI,Ayo Dosunmu,dosunay01,73,CHI,0,MIN,13,3,6,2,0,1,35.58333333,0,3,5,9,1,2,2,2,3,2,9,19,16,22,30.6
2023-24,202403310SAS,3/31/2024,SAS vs GSW,Cedi Osman,osmande01,71,SAS,1,GSW,18,2,1,1,0,2,35.96666667,1,1,7,12,4,7,0,0,1,1,3,19,20,21,22.9
2023-24,202403310SAC,3/31/2024,SAC vs UTA,De'Aaron Fox,foxde01,66,SAC,1,UTA,24,6,12,3,2,5,36.08333333,0,6,7,15,2,7,8,10,3,5,18,36,30,42,59.2
2023-24,202403310MIN,3/31/2024,MIN vs CHI,Anthony Edwards,edwaran01,71,MIN,1,CHI,22,11,5,0,1,6,36.11666667,2,9,9,20,0,5,4,6,1,1,16,27,33,38,39.7
2023-24,202403310HOU,3/31/2024,HOU vs DAL,Jabari Smith Jr.,smithja05,68,HOU,1,DAL,28,7,2,0,3,0,36.15,2,5,9,14,5,7,5,5,1,3,9,30,35,37,48.4
2023-24,202403310CHO,3/31/2024,CHO vs LAC,James Harden,hardeja01,67,LAC,0,CHO,6,6,10,1,0,0,36.23333333,0,6,1,3,1,3,3,4,0,1,16,16,12,22,31.2
2023-24,202403310SAC,3/31/2024,SAC vs UTA,Keyonte George,georgke01,68,UTA,0,SAC,18,2,2,1,0,2,36.91666667,0,2,4,14,3,10,7,7,2,1,4,20,20,22,24.4
2023-24,202403310TOR,3/31/2024,TOR vs PHI,Kelly Oubre Jr.,oubreke01,61,PHI,0,TOR,32,7,3,2,2,4,36.98333333,2,5,10,20,6,11,6,7,2,4,10,35,39,42,52.9
2023-24,202403310CHO,3/31/2024,CHO vs LAC,Kawhi Leonard,leonaka01,68,LAC,0,CHO,23,5,2,0,0,2,37.13333333,1,4,10,19,2,5,1,2,2,0,7,25,28,30,30
2023-24,202403310BRK,3/31/2024,BRK vs LAL,LeBron James,jamesle01,66,LAL,0,BRK,40,7,5,0,0,4,37.2,1,6,13,17,9,10,5,6,0,0,12,45,47,52,51.9
2023-24,202403310WAS,3/31/2024,WAS vs MIA,Bam Adebayo,adebaba01,63,MIA,0,WAS,22,10,5,2,1,5,37.33333333,0,10,6,12,0,2,10,12,2,3,15,27,32,37,45.5
2023-24,202403310BRK,3/31/2024,BRK vs LAL,Rui Hachimura,hachiru01,62,LAL,0,BRK,20,10,4,0,1,0,37.38333333,2,8,8,12,1,4,3,4,3,1,14,24,30,34,41
2023-24,202403310TOR,3/31/2024,TOR vs PHI,Cameron Payne,payneca01,71,PHI,0,TOR,24,1,3,0,0,2,37.61666667,0,1,9,16,6,10,0,0,3,0,4,27,25,28,27.7
2023-24,202403310MIN,3/31/2024,MIN vs CHI,Rudy Gobert,goberru01,68,MIN,1,CHI,19,10,1,2,1,0,37.66666667,3,7,8,9,0,0,3,7,2,3,11,20,29,30,41.5
2023-24,202403310BRK,3/31/2024,BRK vs LAL,Mikal Bridges,bridgmi01,75,BRK,1,LAL,13,3,4,1,0,1,37.81666667,1,2,5,16,3,11,0,0,1,1,7,17,16,20,24.6
2023-24,202403310TOR,3/31/2024,TOR vs PHI,Kyle Lowry,lowryky01,55,PHI,0,TOR,11,1,10,1,2,2,37.83333333,1,0,4,6,3,5,0,0,3,3,11,21,12,22,34.2
2023-24,202403310WAS,3/31/2024,WAS vs MIA,Deni Avdija,avdijde01,68,WAS,1,MIA,15,9,6,1,1,3,38.26666667,0,9,5,12,1,3,4,4,1,2,15,21,24,30,37.8
2023-24,202403310SAS,3/31/2024,SAS vs GSW,Julian Champagnie,champju02,67,SAS,1,GSW,9,5,4,1,1,3,38.26666667,1,4,3,9,3,7,0,0,2,2,9,13,14,18,24
2023-24,202403310MIN,3/31/2024,MIN vs CHI,DeMar DeRozan,derozde01,73,CHI,0,MIN,27,2,8,1,1,4,39.35,0,2,11,23,1,2,4,7,0,2,10,35,29,37,43.4
2023-24,202403310NYK,3/31/2024,NYK vs OKC,Donte DiVincenzo,divindo01,73,NYK,1,OKC,15,1,2,2,1,1,39.56666667,0,1,4,18,4,16,3,4,5,3,3,17,16,18,27.2
2023-24,202403310CHO,3/31/2024,CHO vs LAC,Brandon Miller,millebr02,67,CHO,1,LAC,22,6,4,0,1,2,39.88333333,1,5,8,19,5,13,1,2,4,1,10,26,28,32,36.2
2023-24,202403310CHO,3/31/2024,CHO vs LAC,Paul George,georgpa01,68,LAC,0,CHO,41,7,4,1,0,0,40.01666667,1,6,14,21,8,12,5,5,2,1,11,45,48,52,58.4
2023-24,202403310MIN,3/31/2024,MIN vs CHI,Coby White,whiteco01,72,CHI,0,MIN,17,5,3,0,0,2,40.58333333,0,5,6,10,4,6,1,1,2,0,8,20,22,25,25.5
2023-24,202403310WAS,3/31/2024,WAS vs MIA,Corey Kispert,kispeco01,73,WAS,1,MIA,13,2,3,2,0,1,40.8,0,2,5,13,1,7,2,4,3,2,5,16,15,18,24.9
2023-24,202403310CHO,3/31/2024,CHO vs LAC,Miles Bridges,bridgmi02,63,CHO,1,LAC,33,7,3,0,0,0,43.13333333,0,7,11,20,7,14,4,4,2,0,10,36,40,43,45.9
2023-24,202403310NYK,3/31/2024,NYK vs OKC,Josh Hart,hartjo01,73,NYK,1,OKC,13,15,6,1,0,4,45.23333333,3,12,4,9,0,1,5,6,4,1,21,19,28,34,39
2023-24,202403310NYK,3/31/2024,NYK vs OKC,Miles McBride,mcbrimi01,61,NYK,1,OKC,19,4,3,3,0,1,45.68333333,2,2,6,15,4,10,3,3,3,3,7,22,23,26,36.3
2023-24,202403300NOP,3/30/2024,NOP vs BOS,Xavier Tillman Sr.,tillmxa01,47,BOS,0,NOP,3,2,1,0,0,0,10.46666667,1,1,1,3,0,0,1,2,0,0,3,4,5,6,6.9
2023-24,202403300NOP,3/30/2024,NOP vs BOS,Dyson Daniels,daniedy01,53,NOP,1,BOS,2,3,2,2,0,1,10.65,3,0,1,3,0,2,0,0,1,2,5,4,5,7,13.6
2023-24,202403300ATL,3/30/2024,ATL vs MIL,A.J. Green,greenaj01,50,MIL,0,ATL,2,0,0,0,1,0,11.45,0,0,1,3,0,2,0,0,1,1,0,2,2,2,5
2023-24,202403300ORL,3/30/2024,ORL vs MEM,Anthony Black,blackan01,65,ORL,1,MEM,2,0,0,1,0,0,12,0,0,1,2,0,1,0,0,0,1,0,2,2,2,5
2023-24,202403300ORL,3/30/2024,ORL vs MEM,Moritz Wagner,wagnemo01,72,ORL,1,MEM,4,1,0,0,0,3,12.38333333,0,1,1,1,1,1,1,2,3,0,1,4,5,5,2.2
2023-24,202403300ATL,3/30/2024,ATL vs MIL,Jae Crowder,crowdja01,43,MIL,0,ATL,5,2,0,0,0,1,13.45,1,1,1,5,0,3,3,3,0,0,2,5,7,7,6.4
2023-24,202403300NOP,3/30/2024,NOP vs BOS,Sam Hauser,hausesa01,71,BOS,0,NOP,3,3,1,1,0,0,13.53333333,0,3,1,3,1,3,0,0,1,1,4,4,6,7,11.1
2023-24,202403300NOP,3/30/2024,NOP vs BOS,Jonas Valanciunas,valanjo01,74,NOP,1,BOS,2,5,2,0,0,1,15.28333333,0,5,1,5,0,1,0,0,1,0,7,4,7,9,10
2023-24,202403300ATL,3/30/2024,ATL vs MIL,Pat Connaughton,connapa01,68,MIL,0,ATL,4,3,4,0,0,1,16.31666667,1,2,1,3,0,2,2,4,3,0,7,8,7,11,12.6
2023-24,202403300ORL,3/30/2024,ORL vs MEM,Cole Anthony,anthoco01,73,ORL,1,MEM,15,3,3,1,0,1,16.81666667,0,3,5,11,5,8,0,0,1,1,6,18,18,21,25.1
2023-24,202403300NOP,3/30/2024,NOP vs BOS,Payton Pritchard,pritcpa01,74,BOS,0,NOP,2,3,0,0,0,1,17.08333333,2,1,1,3,0,2,0,0,1,0,3,2,5,5,4.6
2023-24,202403300ATL,3/30/2024,ATL vs MIL,Garrison Mathews,mathega01,58,ATL,1,MIL,3,1,1,0,0,0,17.36666667,0,1,1,3,1,3,0,0,1,0,2,4,4,5,5.7
2023-24,202403300ORL,3/30/2024,ORL vs MEM,Joe Ingles,inglejo01,60,ORL,1,MEM,11,0,2,0,0,2,17.65,0,0,3,4,3,4,2,2,1,0,2,13,11,13,12
2023-24,202403300ATL,3/30/2024,ATL vs MIL,Wesley Matthews,matthwe02,33,ATL,1,MIL,9,1,1,1,0,0,18.36666667,1,0,4,9,1,3,0,0,3,1,2,10,10,11,14.7
2023-24,202403300ORL,3/30/2024,ORL vs MEM,Brandon Clarke,clarkbr01,2,MEM,0,ORL,13,4,3,1,1,0,19.68333333,0,4,6,9,0,1,1,2,2,2,7,16,17,20,28.3
2023-24,202403300NOP,3/30/2024,NOP vs BOS,Larry Nance Jr.,nancela02,55,NOP,1,BOS,5,3,2,0,0,0,20.71666667,0,3,2,5,1,3,0,0,2,0,5,7,8,10,11.6
2023-24,202403300ORL,3/30/2024,ORL vs MEM,Caleb Houstan,houstca01,56,ORL,1,MEM,9,1,0,0,0,0,20.85,0,1,3,4,3,4,0,0,2,0,1,9,10,10,10.2
2023-24,202403300ATL,3/30/2024,ATL vs MIL,Bruno Fernando,fernabr01,37,ATL,1,MIL,10,4,2,0,1,1,21.03333333,2,2,4,7,0,0,2,3,4,1,6,12,14,16,19.8
2023-24,202403300ORL,3/30/2024,ORL vs MEM,Lamar Stevens,stevela01,34,MEM,0,ORL,7,4,2,1,0,0,21.11666667,1,3,3,10,1,5,0,0,1,1,6,9,11,13,17.8
2023-24,202403300ORL,3/30/2024,ORL vs MEM,Scotty Pippen Jr.,pippesc02,13,MEM,0,ORL,11,3,2,1,1,3,21.15,0,3,4,10,1,4,2,2,3,2,5,13,14,16,20.6
2023-24,202403300ATL,3/30/2024,ATL vs MIL,Bobby Portis,portibo01,74,MIL,0,ATL,13,4,2,2,0,0,21.31666667,0,4,6,10,0,2,1,2,1,2,6,15,17,19,26.8
2023-24,202403300NOP,3/30/2024,NOP vs BOS,Naji Marshall,marshna01,62,NOP,1,BOS,5,5,1,0,1,1,23.16666667,0,5,2,4,1,1,0,0,1,1,6,6,10,11,14.5
2023-24,202403300ORL,3/30/2024,ORL vs MEM,Jalen Suggs,suggsja01,67,ORL,1,MEM,15,1,4,2,2,3,24.11666667,1,0,4,5,3,4,4,4,2,4,5,19,16,20,31.2
2023-24,202403300ORL,3/30/2024,ORL vs MEM,Markelle Fultz,fultzma01,35,ORL,1,MEM,12,4,5,1,1,1,25.28333333,2,2,5,13,2,3,0,0,1,2,9,17,16,21,29.3
2023-24,202403300ORL,3/30/2024,ORL vs MEM,Jaren Jackson Jr.,jacksja02,64,MEM,0,ORL,4,4,1,1,1,3,25.7,1,3,1,9,0,3,2,2,3,2,5,5,8,9,13.3
2023-24,202403300ORL,3/30/2024,ORL vs MEM,Jordan Goodwin,goodwjo01,50,MEM,0,ORL,16,11,3,2,0,2,26.65,5,6,6,15,4,6,0,0,3,2,14,19,27,30,37.7
2023-24,202403300ATL,3/30/2024,ATL vs MIL,Clint Capela,capelca01,66,ATL,1,MIL,10,8,2,1,2,0,26.96666667,3,5,5,9,0,0,0,0,2,3,10,12,18,20,31.6
2023-24,202403300ORL,3/30/2024,ORL vs MEM,Jake LaRavia,laravja01,29,MEM,0,ORL,10,2,1,1,0,2,27.95,1,1,4,9,2,5,0,0,1,1,3,11,12,13,14.9
2023-24,202403300ORL,3/30/2024,ORL vs MEM,Wendell Carter Jr.,cartewe01,47,ORL,1,MEM,15,13,2,2,1,1,28.2,1,12,4,10,3,7,4,4,2,3,15,17,28,30,41.6
2023-24,202403300ORL,3/30/2024,ORL vs MEM,Franz Wagner,wagnefr01,66,ORL,1,MEM,13,4,4,1,0,0,28.55,0,4,4,9,0,4,5,6,2,1,8,17,17,21,26.8
2023-24,202403300ORL,3/30/2024,ORL vs MEM,Maozinha Pereira,pereima01,5,MEM,0,ORL,7,8,1,2,3,1,28.61666667,4,4,2,5,0,1,3,4,4,5,9,8,15,16,32.1
2023-24,202403300NOP,3/30/2024,NOP vs BOS,Al Horford,horfoal01,60,BOS,0,NOP,9,6,2,1,1,0,30.05,0,6,4,7,1,3,0,0,1,2,8,11,15,17,25.2
2023-24,202403300ORL,3/30/2024,ORL vs MEM,Luke Kennard,kennalu01,37,MEM,0,ORL,9,5,5,0,1,4,30.08333333,0,5,3,10,2,7,1,1,1,1,10,14,14,19,21.5
2023-24,202403300ORL,3/30/2024,ORL vs MEM,GG Jackson II,jacksgg01,40,MEM,0,ORL,11,3,3,1,0,3,30.11666667,0,3,2,8,2,4,5,6,0,1,6,14,14,17,19.1
2023-24,202403300ORL,3/30/2024,ORL vs MEM,Paolo Banchero,banchpa01,72,ORL,1,MEM,13,9,7,0,4,2,30.38333333,0,9,5,12,1,5,2,2,0,4,16,20,22,29,44.3
2023-24,202403300NOP,3/30/2024,NOP vs BOS,Kristaps Porzingis,porzikr01,52,BOS,0,NOP,19,10,3,2,4,2,31.46666667,0,10,6,14,1,6,6,6,4,6,13,22,29,32,51.5
2023-24,202403300NOP,3/30/2024,NOP vs BOS,Derrick White,whitede01,68,BOS,0,NOP,15,3,3,0,0,0,31.58333333,1,2,5,9,3,7,2,2,1,0,6,18,18,21,23.1
2023-24,202403300ATL,3/30/2024,ATL vs MIL,Vit Krejci,krejcvi01,14,ATL,1,MIL,8,2,1,1,0,0,32.2,0,2,3,5,2,4,0,0,3,1,3,9,10,11,14.9
2023-24,202403300ATL,3/30/2024,ATL vs MIL,Brook Lopez,lopezbr01,71,MIL,0,ATL,13,3,0,0,2,3,32.83333333,0,3,3,3,1,1,6,6,4,2,3,13,16,16,19.6
2023-24,202403300ATL,3/30/2024,ATL vs MIL,De'Andre Hunter,huntede01,50,ATL,1,MIL,13,2,1,1,0,1,34.75,0,2,5,13,2,5,1,1,3,1,3,14,15,16,18.9
2023-24,202403300NOP,3/30/2024,NOP vs BOS,Jaylen Brown,brownja02,66,BOS,0,NOP,17,7,6,1,1,2,35,2,5,6,16,3,4,2,2,2,2,13,23,24,30,38.4
2023-24,202403300ATL,3/30/2024,ATL vs MIL,Malik Beasley,beaslma01,71,MIL,0,ATL,10,1,2,0,0,1,35.03333333,0,1,4,12,2,9,0,0,2,0,3,12,11,13,13.2
2023-24,202403300NOP,3/30/2024,NOP vs BOS,Jrue Holiday,holidjr01,63,BOS,0,NOP,13,8,7,2,1,3,35.31666667,1,7,5,10,3,6,0,0,2,3,15,20,21,28,39.1
2023-24,202403300NOP,3/30/2024,NOP vs BOS,Jayson Tatum,tatumja01,69,BOS,0,NOP,23,9,4,0,0,4,35.5,1,8,10,17,3,6,0,0,1,0,13,27,32,36,35.8
2023-24,202403300ATL,3/30/2024,ATL vs MIL,Khris Middleton,middlkh01,49,MIL,0,ATL,21,6,6,1,0,1,35.8,0,6,9,10,3,3,0,0,3,1,12,27,27,33,39.2
2023-24,202403300ATL,3/30/2024,ATL vs MIL,Patrick Beverley,beverpa01,68,MIL,0,ATL,18,5,5,1,1,0,36.11666667,0,5,6,10,2,5,4,4,2,2,10,23,23,28,37.5
2023-24,202403300NOP,3/30/2024,NOP vs BOS,CJ McCollum,mccolcj01,58,NOP,1,BOS,24,2,5,2,1,1,36.56666667,0,2,10,23,4,11,0,0,4,3,7,29,26,31,41.9
2023-24,202403300ATL,3/30/2024,ATL vs MIL,Bogdan Bogdanovic,bogdabo01,71,ATL,1,MIL,38,10,4,1,0,3,37.38333333,1,9,12,23,5,9,9,10,5,1,14,42,48,52,56
2023-24,202403300ATL,3/30/2024,ATL vs MIL,Giannis Antetokounmpo,antetgi01,69,MIL,0,ATL,36,16,8,3,1,3,37.68333333,4,12,12,22,0,1,12,16,2,4,24,44,52,60,76.2
2023-24,202403300NOP,3/30/2024,NOP vs BOS,Trey Murphy III,murphtr02,49,NOP,1,BOS,11,9,2,2,1,1,38.76666667,1,8,3,10,3,6,2,2,1,3,11,13,20,22,32.8
2023-24,202403300NOP,3/30/2024,NOP vs BOS,Herbert Jones,joneshe01,68,NOP,1,BOS,18,5,3,2,0,0,40.08333333,2,3,6,15,4,9,2,2,1,2,8,21,23,26,34.5
2023-24,202403300NOP,3/30/2024,NOP vs BOS,Zion Williamson,willizi01,63,NOP,1,BOS,25,9,4,1,0,4,40.35,4,5,9,17,0,0,7,14,0,1,13,29,34,38,40.8
2023-24,202403300ATL,3/30/2024,ATL vs MIL,Dejounte Murray,murrade01,71,ATL,1,MIL,20,8,12,0,0,5,42.06666667,1,7,7,19,3,10,3,4,5,0,20,32,28,40,42.6
2023-24,202403290DEN,3/29/2024,DEN vs MIN,DeAndre Jordan,jordade01,33,DEN,1,MIN,11,7,0,0,0,1,10.26666667,3,4,5,7,0,0,1,1,1,0,7,11,18,18,18.4
2023-24,202403290UTA,3/29/2024,UTA vs HOU,Aaron Holiday,holidaa01,70,HOU,0,UTA,0,0,1,0,0,1,10.35,0,0,0,2,0,2,0,0,1,0,1,1,0,1,0.5
2023-24,202403290CHO,3/29/2024,CHO vs GSW,Kevon Looney,looneke01,66,GSW,0,CHO,8,7,1,0,0,1,10.48333333,1,6,3,4,0,0,2,2,1,0,8,9,15,16,16.9
2023-24,202403290IND,3/29/2024,IND vs LAL,Jaxson Hayes,hayesja02,64,LAL,0,IND,2,2,2,0,0,0,10.5,1,1,1,1,0,0,0,0,1,0,4,4,4,6,7.4
2023-24,202403290MIA,3/29/2024,MIA vs POR,Justin Minaya,minayju01,28,POR,0,MIA,2,2,0,0,1,1,10.55,1,1,1,2,0,0,0,0,3,1,2,2,4,4,6.4
2023-24,202403290DEN,3/29/2024,DEN vs MIN,Monte Morris,morrimo01,24,MIN,0,DEN,2,2,0,0,0,0,10.6,1,1,1,2,0,1,0,0,0,0,2,2,4,4,4.4
2023-24,202403290OKC,3/29/2024,OKC vs PHO,Gordon Hayward,haywago01,44,OKC,1,PHO,4,1,2,0,0,0,10.71666667,0,1,2,5,0,1,0,0,0,0,3,6,5,7,8.2
2023-24,202403290SAC,3/29/2024,SAC vs DAL,Kessler Edwards,edwarke02,47,SAC,1,DAL,9,2,0,1,0,0,11.01666667,1,1,3,3,3,3,0,0,2,1,2,9,11,11,14.4
2023-24,202403290DEN,3/29/2024,DEN vs MIN,Peyton Watson,watsope01,72,DEN,1,MIN,0,3,1,0,0,0,11.21666667,0,3,0,2,0,1,0,0,0,0,4,1,3,4,5.1
2023-24,202403290SAC,3/29/2024,SAC vs DAL,Alex Len,lenal01,39,SAC,1,DAL,0,3,3,0,0,0,11.56666667,2,1,0,1,0,0,0,0,1,0,6,3,3,6,8.1
2023-24,202403290MIA,3/29/2024,MIA vs POR,Jamal Cain,cainja01,21,MIA,1,POR,3,0,3,0,1,1,12,0,0,1,4,1,2,0,0,3,1,3,6,3,6,9.5
2023-24,202403290BRK,3/29/2024,BRK vs CHI,Torrey Craig,craigto01,45,CHI,0,BRK,7,1,0,0,1,1,12.33333333,0,1,2,3,1,2,2,2,0,1,1,7,8,8,10.2
2023-24,202403290ORL,3/29/2024,ORL vs LAC,Mason Plumlee,plumlma01,38,LAC,0,ORL,8,4,0,0,0,1,12.61666667,2,2,4,6,0,0,0,0,1,0,4,8,12,12,11.8
2023-24,202403290SAS,3/29/2024,SAS vs NYK,Blake Wesley,weslebl01,53,SAS,1,NYK,4,5,3,0,0,1,12.83333333,0,5,1,1,0,0,2,2,4,0,8,7,9,12,13.5
2023-24,202403290DEN,3/29/2024,DEN vs MIN,Jordan McLaughlin,mclaujo01,47,MIN,0,DEN,5,4,1,0,0,0,12.96666667,0,4,2,2,1,1,0,0,1,0,5,6,9,10,11.3
2023-24,202403290CHO,3/29/2024,CHO vs GSW,Gary Payton II,paytoga02,38,GSW,0,CHO,6,1,1,0,1,0,13,0,1,3,5,0,1,0,0,3,1,2,7,7,8,11.7
2023-24,202403290OKC,3/29/2024,OKC vs PHO,Bol Bol,bolbo01,36,PHO,0,OKC,0,1,1,0,0,0,13.31666667,0,1,0,0,0,0,0,0,1,0,2,1,1,2,2.7
2023-24,202403290IND,3/29/2024,IND vs LAL,Cam Reddish,reddica01,46,LAL,0,IND,0,4,0,0,2,0,13.31666667,3,1,0,2,0,0,0,0,1,2,4,0,4,4,10.8
2023-24,202403290WAS,3/29/2024,WAS vs DET,James Wiseman,wisemja01,55,DET,0,WAS,0,2,0,0,0,2,13.31666667,0,2,0,3,0,0,0,0,4,0,2,0,2,2,0.4
2023-24,202403290UTA,3/29/2024,UTA vs HOU,Micah Potter,pottemi01,11,UTA,1,HOU,0,4,0,0,0,0,13.33333333,1,3,0,2,0,1,0,0,1,0,4,0,4,4,4.8
2023-24,202403290OKC,3/29/2024,OKC vs PHO,Josh Okogie,okogijo01,56,PHO,0,OKC,5,2,1,0,1,1,13.53333333,1,1,1,2,1,2,2,2,2,1,3,6,7,8,10.9
2023-24,202403290WAS,3/29/2024,WAS vs DET,Malachi Flynn,flynnma01,61,DET,0,WAS,3,2,3,1,0,1,14.03333333,0,2,1,3,0,2,1,2,0,1,5,6,5,8,11.9
2023-24,202403290MIA,3/29/2024,MIA vs POR,Duop Reath,reathdu01,60,POR,0,MIA,6,2,0,0,0,1,14.1,0,2,3,8,0,4,0,0,0,0,2,6,8,8,7.4
2023-24,202403290ORL,3/29/2024,ORL vs LAC,Caleb Houstan,houstca01,55,ORL,1,LAC,8,1,1,0,0,0,14.13333333,1,0,3,4,2,3,0,0,1,0,2,9,9,10,10.7
2023-24,202403290OKC,3/29/2024,OKC vs PHO,Jaylin Williams,willija07,60,OKC,1,PHO,3,3,6,0,3,0,14.33333333,0,3,1,1,1,1,0,0,2,3,9,9,6,12,24.6
2023-24,202403290IND,3/29/2024,IND vs LAL,Taurean Prince,princta02,71,LAL,0,IND,5,0,0,0,0,1,14.58333333,0,0,2,5,1,3,0,0,0,0,0,5,5,5,4
2023-24,202403290CLE,3/29/2024,CLE vs PHI,Isaac Okoro,okorois01,65,CLE,1,PHI,2,0,0,0,0,1,14.78333333,0,0,1,4,0,2,0,0,4,0,0,2,2,2,1
2023-24,202403290SAC,3/29/2024,SAC vs DAL,Maxi Kleber,klebima01,36,DAL,0,SAC,6,2,2,0,0,0,15.06666667,1,1,2,2,2,2,0,0,0,0,4,8,8,10,11.4
2023-24,202403290SAS,3/29/2024,SAS vs NYK,Zach Collins,colliza01,61,SAS,1,NYK,3,3,2,0,1,1,15.16666667,1,2,1,4,0,3,1,2,2,1,5,5,6,8,11.6
2023-24,202403290SAS,3/29/2024,SAS vs NYK,Bojan Bogdanovic,bogdabo02,48,NYK,0,SAS,4,2,0,0,0,2,15.33333333,1,1,2,7,0,3,0,0,2,0,2,4,6,6,4.4
2023-24,202403290BRK,3/29/2024,BRK vs CHI,Noah Clowney,clownno01,15,BRK,1,CHI,3,0,0,0,0,0,15.35,0,0,1,3,1,2,0,0,3,0,0,3,3,3,3
2023-24,202403290SAS,3/29/2024,SAS vs NYK,Precious Achiuwa,achiupr01,66,NYK,0,SAS,6,5,0,0,1,1,15.68333333,2,3,3,3,0,0,0,0,4,1,5,6,11,11,14
2023-24,202403290DEN,3/29/2024,DEN vs MIN,Justin Holiday,holidju01,50,DEN,1,MIN,5,1,0,1,0,0,15.86666667,0,1,2,5,1,4,0,0,2,1,1,5,6,6,9.2
2023-24,202403290BRK,3/29/2024,BRK vs CHI,Javonte Green,greenja02,2,CHI,0,BRK,7,1,0,2,0,0,15.98333333,0,1,3,4,1,2,0,0,1,2,1,7,8,8,14.2
2023-24,202403290ORL,3/29/2024,ORL vs LAC,Jonathan Isaac,isaacjo01,51,ORL,1,LAC,3,5,1,1,2,0,16.31666667,1,4,1,3,1,2,0,0,1,3,6,4,8,9,19.5
2023-24,202403290CLE,3/29/2024,CLE vs PHI,Marcus Morris,morrima03,43,CLE,1,PHI,3,5,1,0,0,1,16.56666667,2,3,1,2,1,2,0,0,0,0,6,4,8,9,9.5
2023-24,202403290DEN,3/29/2024,DEN vs MIN,Nickeil Alexander-Walker,alexani01,73,MIN,0,DEN,6,1,0,0,1,1,16.7,1,0,2,6,2,4,0,0,1,1,1,6,7,7,9.2
2023-24,202403290SAS,3/29/2024,SAS vs NYK,Jeremy Sochan,sochaje01,74,SAS,1,NYK,4,0,1,0,0,0,16.75,0,0,2,3,0,0,0,0,1,0,1,5,4,5,5.5
2023-24,202403290IND,3/29/2024,IND vs LAL,Obi Toppin,toppiob01,76,IND,1,LAL,7,2,0,0,1,1,16.83333333,0,2,3,3,1,1,0,0,1,1,2,7,9,9,11.4
2023-24,202403290MIA,3/29/2024,MIA vs POR,Nikola Jovic,jovicni01,37,MIA,1,POR,5,2,3,3,0,0,17.28333333,0,2,2,3,1,2,0,0,1,3,5,8,7,10,20.9
2023-24,202403290BRK,3/29/2024,BRK vs CHI,Andre Drummond,drumman01,74,CHI,0,BRK,6,11,0,0,2,1,17.35,1,10,1,2,0,0,4,6,1,2,11,6,17,17,24.2
2023-24,202403290IND,3/29/2024,IND vs LAL,Jalen Smith,smithja04,54,IND,1,LAL,4,7,0,2,1,0,17.48333333,2,5,2,5,0,1,0,0,3,3,7,4,11,11,21.4
2023-24,202403290UTA,3/29/2024,UTA vs HOU,Walker Kessler,kesslwa01,62,UTA,1,HOU,4,6,1,1,0,3,17.75,2,4,1,2,0,0,2,2,2,1,7,5,10,11,12.7
2023-24,202403290WAS,3/29/2024,WAS vs DET,Anthony Gill,gillan01,43,WAS,1,DET,6,3,0,0,0,0,17.85,2,1,3,8,0,1,0,0,4,0,3,6,9,9,9.6
2023-24,202403290ORL,3/29/2024,ORL vs LAC,Russell Westbrook,westbru01,61,LAC,0,ORL,5,3,5,1,0,2,17.98333333,2,1,2,6,0,1,1,2,1,1,8,10,8,13,17.1
2023-24,202403290CLE,3/29/2024,CLE vs PHI,Buddy Hield,hieldbu01,77,PHI,0,CLE,10,4,2,1,0,0,18.13333333,4,0,4,6,1,2,1,1,3,1,6,12,14,16,20.8
2023-24,202403290ORL,3/29/2024,ORL vs LAC,Moritz Wagner,wagnemo01,71,ORL,1,LAC,12,9,2,1,0,1,18.26666667,6,3,6,10,0,0,0,2,0,1,11,14,21,23,27.8
2023-24,202403290ORL,3/29/2024,ORL vs LAC,Cole Anthony,anthoco01,72,ORL,1,LAC,8,3,0,0,2,1,18.58333333,0,3,3,10,2,5,0,0,1,2,3,8,11,11,16.6
2023-24,202403290CHO,3/29/2024,CHO vs GSW,Aleksej Pokusevski,pokusal01,20,CHO,1,GSW,6,3,0,1,0,1,18.6,2,1,2,8,1,6,1,2,0,1,3,6,9,9,11.6
2023-24,202403290SAC,3/29/2024,SAC vs DAL,Davion Mitchell,mitchda01,63,SAC,1,DAL,8,1,2,1,0,0,18.65,0,1,4,6,0,0,0,0,1,1,3,10,9,11,15.2
2023-24,202403290ORL,3/29/2024,ORL vs LAC,Joe Ingles,inglejo01,59,ORL,1,LAC,5,1,4,0,0,0,18.68333333,0,1,2,5,1,2,0,0,1,0,5,9,6,10,12.2
2023-24,202403290OKC,3/29/2024,OKC vs PHO,Kenrich Williams,willike04,60,OKC,1,PHO,6,4,1,0,0,0,18.68333333,2,2,3,7,0,2,0,0,3,0,5,7,10,11,12.3
2023-24,202403290SAS,3/29/2024,SAS vs NYK,Malaki Branham,branhma01,69,SAS,1,NYK,10,2,2,0,0,1,18.71666667,0,2,3,4,2,2,2,4,0,0,4,12,12,14,14.4
2023-24,202403290IND,3/29/2024,IND vs LAL,T.J. McConnell,mccontj01,65,IND,1,LAL,16,3,3,0,0,2,18.85,0,3,7,11,1,1,1,1,0,0,6,19,19,22,22.1
2023-24,202403290WAS,3/29/2024,WAS vs DET,Troy Brown Jr.,browntr01,51,DET,0,WAS,4,2,0,1,0,1,18.88333333,0,2,1,4,1,2,1,2,1,1,2,4,6,6,8.4
2023-24,202403290BRK,3/29/2024,BRK vs CHI,Dalen Terry,terryda01,51,CHI,0,BRK,4,4,0,0,0,0,19.15,2,2,2,4,0,2,0,0,2,0,4,4,8,8,8.8
2023-24,202403290ORL,3/29/2024,ORL vs LAC,Amir Coffey,coffeam01,61,LAC,0,ORL,6,2,0,1,0,1,19.16666667,1,1,2,4,2,3,0,0,0,1,2,6,8,8,10.4
2023-24,202403290CHO,3/29/2024,CHO vs GSW,Davis Bertans,bertada01,35,CHO,1,GSW,14,3,1,1,0,0,19.31666667,0,3,4,8,4,7,2,2,1,1,4,15,17,18,22.1
2023-24,202403290SAS,3/29/2024,SAS vs NYK,Mitchell Robinson,robinmi01,23,NYK,0,SAS,7,12,0,0,0,1,19.65,7,5,3,9,0,0,1,2,1,0,12,7,19,19,20.4
2023-24,202403290IND,3/29/2024,IND vs LAL,Ben Sheppard,sheppbe01,51,IND,1,LAL,7,2,3,0,0,0,19.65,0,2,3,7,1,3,0,0,2,0,5,10,9,12,13.9
2023-24,202403290ORL,3/29/2024,ORL vs LAC,Terance Mann,mannte01,66,LAC,0,ORL,5,0,1,0,0,1,20.13333333,0,0,2,4,1,1,0,0,2,0,1,6,5,6,5.5
2023-24,202403290WAS,3/29/2024,WAS vs DET,Jared Butler,butleja02,32,WAS,1,DET,6,1,2,1,0,2,20.28333333,0,1,3,4,0,0,0,0,1,1,3,8,7,9,11.2
2023-24,202403290UTA,3/29/2024,UTA vs HOU,Jeff Green,greenje02,69,HOU,0,UTA,5,4,0,0,0,0,20.36666667,2,2,2,5,1,3,0,0,0,0,4,5,9,9,9.8
2023-24,202403290SAC,3/29/2024,SAC vs DAL,Tim Hardaway Jr.,hardati02,70,DAL,0,SAC,5,2,1,0,0,0,20.45,0,2,1,7,1,4,2,2,0,0,3,6,7,8,8.9
2023-24,202403290SAS,3/29/2024,SAS vs NYK,Cedi Osman,osmande01,70,SAS,1,NYK,4,0,2,0,0,0,20.45,0,0,2,4,0,1,0,0,2,0,2,6,4,6,7
2023-24,202403290IND,3/29/2024,IND vs LAL,Spencer Dinwiddie,dinwisp01,68,LAL,0,IND,5,1,0,1,0,2,20.5,0,1,1,6,1,5,2,4,4,1,1,5,6,6,7.2
2023-24,202403290MIA,3/29/2024,MIA vs POR,Delon Wright,wrighde01,43,MIA,1,POR,5,0,1,2,0,0,20.56666667,0,0,2,7,1,2,0,0,1,2,1,6,5,6,12.5
2023-24,202403290CLE,3/29/2024,CLE vs PHI,Kelly Oubre Jr.,oubreke01,60,PHI,0,CLE,4,4,0,0,1,1,20.75,1,3,2,11,0,2,0,0,5,1,4,4,8,8,10.8
2023-24,202403290CLE,3/29/2024,CLE vs PHI,Sam Merrill,merrisa01,56,CLE,1,PHI,13,2,3,0,0,1,20.76666667,1,1,4,8,4,8,1,1,3,0,5,16,15,18,18.9
2023-24,202403290UTA,3/29/2024,UTA vs HOU,Dillon Brooks,brookdi01,64,HOU,0,UTA,5,4,0,0,0,1,21.41666667,2,2,2,7,1,2,0,0,4,0,4,5,9,9,8.8
2023-24,202403290OKC,3/29/2024,OKC vs PHO,Eric Gordon,gordoer01,61,PHO,0,OKC,6,2,2,2,0,1,21.58333333,0,2,2,10,1,8,1,1,1,2,4,8,8,10,16.4
2023-24,202403290UTA,3/29/2024,UTA vs HOU,Kris Dunn,dunnkr01,63,UTA,1,HOU,11,8,1,1,3,2,21.65,0,8,5,7,1,2,0,0,6,4,9,12,19,20,32.1
2023-24,202403290CLE,3/29/2024,CLE vs PHI,Mo Bamba,bambamo01,52,PHI,0,CLE,14,7,1,0,2,0,21.7,2,5,6,7,1,2,1,2,2,2,8,15,21,22,29.9
2023-24,202403290OKC,3/29/2024,OKC vs PHO,Royce O'Neale,onealro01,71,PHO,0,OKC,5,2,3,1,0,0,21.73333333,1,1,2,5,1,3,0,0,0,1,5,8,7,10,14.9
2023-24,202403290MIA,3/29/2024,MIA vs POR,Thomas Bryant,bryanth01,36,MIA,1,POR,26,12,1,2,2,0,21.78333333,6,6,11,17,1,3,3,4,0,4,13,27,38,39,53.9
2023-24,202403290OKC,3/29/2024,OKC vs PHO,Isaiah Joe,joeis01,69,OKC,1,PHO,14,3,1,0,0,1,21.86666667,0,3,5,11,4,7,0,0,2,0,4,15,17,18,18.1
2023-24,202403290SAC,3/29/2024,SAC vs DAL,Derrick Jones Jr.,jonesde02,68,DAL,0,SAC,7,1,1,0,0,1,22.05,0,1,3,7,1,3,0,1,1,0,2,8,8,9,8.7
2023-24,202403290SAC,3/29/2024,SAC vs DAL,Dante Exum,exumda01,47,DAL,0,SAC,8,3,2,0,0,0,22.68333333,0,3,2,6,2,5,2,2,4,0,5,10,11,13,14.6
2023-24,202403290OKC,3/29/2024,OKC vs PHO,Jusuf Nurkic,nurkiju01,69,PHO,0,OKC,5,3,3,0,1,2,23,2,1,2,4,0,0,1,2,2,1,6,8,8,11,14.1
2023-24,202403290ORL,3/29/2024,ORL vs LAC,Gary Harris,harriga01,47,ORL,1,LAC,8,2,0,1,0,1,23.55,1,1,3,6,1,3,1,1,2,1,2,8,10,10,12.4
2023-24,202403290ORL,3/29/2024,ORL vs LAC,Wendell Carter Jr.,cartewe01,46,ORL,1,LAC,2,5,2,0,1,1,23.58333333,2,3,1,3,0,1,0,0,0,1,7,4,7,9,13
2023-24,202403290BRK,3/29/2024,BRK vs CHI,Trendon Watford,watfotr01,55,BRK,1,CHI,11,5,4,2,0,0,23.58333333,1,4,3,7,1,3,4,5,2,2,9,15,16,20,29
2023-24,202403290SAC,3/29/2024,SAC vs DAL,Dereck Lively II,livelde01,54,DAL,0,SAC,12,9,2,0,1,0,23.76666667,3,6,5,7,0,0,2,4,1,1,11,14,21,23,28.8
2023-24,202403290SAC,3/29/2024,SAC vs DAL,Daniel Gafford,gaffoda01,66,DAL,0,SAC,6,7,0,1,3,2,23.78333333,2,5,3,5,0,0,0,2,1,4,7,6,13,13,24.4
2023-24,202403290OKC,3/29/2024,OKC vs PHO,Josh Giddey,giddejo01,72,OKC,1,PHO,23,7,9,0,1,3,24,1,6,10,15,1,3,2,2,0,1,16,32,30,39,44.9
2023-24,202403290UTA,3/29/2024,UTA vs HOU,Johnny Juzang,juzanjo01,13,UTA,1,HOU,12,2,3,0,0,2,24.36666667,1,1,5,7,1,3,1,1,2,0,5,15,14,17,16.9
2023-24,202403290MIA,3/29/2024,MIA vs POR,Deandre Ayton,aytonde01,48,POR,0,MIA,18,8,1,1,0,1,24.71666667,1,7,9,15,0,1,0,0,1,1,9,19,26,27,31.1
2023-24,202403290UTA,3/29/2024,UTA vs HOU,Brice Sensabaugh,sensabr01,24,UTA,1,HOU,0,4,5,1,0,2,24.73333333,1,3,0,8,0,7,0,0,1,1,9,5,4,9,13.3
2023-24,202403290MIA,3/29/2024,MIA vs POR,Jimmy Butler,butleji01,51,MIA,1,POR,8,4,8,1,0,0,24.83333333,0,4,2,4,1,3,3,3,1,1,12,16,12,20,27.8
2023-24,202403290CHO,3/29/2024,CHO vs GSW,Moses Moody,moodymo01,57,GSW,0,CHO,15,4,3,1,0,1,24.86666667,2,2,5,8,4,5,1,1,2,1,7,18,19,22,26.3
2023-24,202403290MIA,3/29/2024,MIA vs POR,Jaime Jaquez Jr.,jaqueja01,66,MIA,1,POR,12,3,5,1,0,0,25.43333333,0,3,6,9,0,1,0,0,3,1,8,17,15,20,26.1
2023-24,202403290WAS,3/29/2024,WAS vs DET,Evan Fournier,fournev01,25,DET,0,WAS,10,2,0,0,0,0,25.56666667,0,2,4,6,2,4,0,2,1,0,2,10,12,12,12.4
2023-24,202403290CHO,3/29/2024,CHO vs GSW,Grant Williams,willigr01,69,CHO,1,GSW,12,8,4,0,0,1,25.6,2,6,3,10,2,7,4,6,3,0,12,16,20,24,26.6
2023-24,202403290CHO,3/29/2024,CHO vs GSW,Brandin Podziemski,podzibr01,65,GSW,0,CHO,4,5,3,0,0,0,25.71666667,1,4,2,5,0,2,0,0,3,0,8,7,9,12,14.5
2023-24,202403290CLE,3/29/2024,CLE vs PHI,Paul Reed,reedpa01,74,PHI,0,CLE,12,7,0,1,3,3,25.95,5,2,3,7,1,1,5,5,2,4,7,12,19,19,29.4
2023-24,202403290UTA,3/29/2024,UTA vs HOU,Jock Landale,landajo01,47,HOU,0,UTA,2,5,0,0,1,1,25.98333333,1,4,1,4,0,1,0,0,4,1,5,2,7,7,10
2023-24,202403290WAS,3/29/2024,WAS vs DET,Chimezie Metu,metuch01,43,DET,0,WAS,5,3,1,1,1,1,26.08333333,0,3,2,9,0,4,1,1,0,2,4,6,8,9,15.1
2023-24,202403290CLE,3/29/2024,CLE vs PHI,Jarrett Allen,allenja01,69,CLE,1,PHI,13,11,2,0,0,2,26.16666667,1,10,6,9,0,0,1,1,1,0,13,15,24,26,27.2
2023-24,202403290OKC,3/29/2024,OKC vs PHO,Aaron Wiggins,wiggiaa01,69,OKC,1,PHO,15,4,2,1,0,1,26.2,1,3,6,8,3,4,0,0,1,1,6,17,19,21,24.8
2023-24,202403290MIA,3/29/2024,MIA vs POR,Bam Adebayo,adebaba01,62,MIA,1,POR,21,12,9,2,1,4,26.21666667,0,12,9,12,2,3,1,3,3,3,21,30,33,42,53.9
2023-24,202403290DEN,3/29/2024,DEN vs MIN,Christian Braun,braunch01,74,DEN,1,MIN,8,5,2,0,0,0,26.36666667,4,1,2,10,1,3,3,4,5,0,7,10,13,15,17
2023-24,202403290ORL,3/29/2024,ORL vs LAC,Norman Powell,powelno01,69,LAC,0,ORL,10,0,1,0,1,1,26.36666667,0,0,5,8,0,1,0,0,2,1,1,11,10,11,13.5
2023-24,202403290MIA,3/29/2024,MIA vs POR,Rayan Rupert,ruperra01,31,POR,0,MIA,6,4,3,1,0,3,26.41666667,2,2,3,6,0,1,0,0,5,1,7,9,10,13,15.3
2023-24,202403290DEN,3/29/2024,DEN vs MIN,Kyle Anderson,anderky01,70,MIN,0,DEN,5,3,7,0,2,1,26.51666667,0,3,1,3,0,0,3,4,3,2,10,12,8,15,24.1
2023-24,202403290OKC,3/29/2024,OKC vs PHO,Luguentz Dort,dortlu01,71,OKC,1,PHO,11,1,3,3,0,1,27.06666667,0,1,4,8,3,6,0,0,0,3,4,14,12,15,24.7
2023-24,202403290WAS,3/29/2024,WAS vs DET,Marvin Bagley III,baglema01,48,WAS,1,DET,15,11,1,0,2,0,27.15,3,8,7,9,1,1,0,0,1,2,12,16,26,27,35.7
2023-24,202403290OKC,3/29/2024,OKC vs PHO,Devin Booker,bookede01,60,PHO,0,OKC,14,3,5,0,0,3,27.21666667,0,3,4,9,0,2,6,7,5,0,8,19,17,22,22.1
2023-24,202403290MIA,3/29/2024,MIA vs POR,Terry Rozier,roziete01,56,MIA,1,POR,22,3,6,1,0,1,27.3,0,3,8,17,6,10,0,0,0,1,9,28,25,31,36.6
2023-24,202403290CLE,3/29/2024,CLE vs PHI,Max Strus,strusma01,62,CLE,1,PHI,15,1,3,1,0,2,27.36666667,0,1,6,9,2,4,1,1,3,1,4,18,16,19,21.7
2023-24,202403290MIA,3/29/2024,MIA vs POR,Patty Mills,millspa02,30,MIA,1,POR,17,0,1,3,0,1,27.5,0,0,5,8,2,5,5,5,0,3,1,18,17,18,26.5
2023-24,202403290DEN,3/29/2024,DEN vs MIN,Kentavious Caldwell-Pope,caldwke01,68,DEN,1,MIN,0,3,2,0,0,0,27.51666667,1,2,0,3,0,2,0,1,1,0,5,2,3,5,6.6
2023-24,202403290MIA,3/29/2024,MIA vs POR,Haywood Highsmith,highsha01,57,MIA,1,POR,20,6,1,1,0,1,27.68333333,0,6,7,9,5,6,1,3,1,1,7,21,26,27,30.7
2023-24,202403290OKC,3/29/2024,OKC vs PHO,Chet Holmgren,holmgch01,73,OKC,1,PHO,20,6,2,0,1,1,27.68333333,1,5,6,10,0,0,8,8,1,1,8,22,26,28,32.2
2023-24,202403290CHO,3/29/2024,CHO vs GSW,Draymond Green,greendr01,48,GSW,0,CHO,8,8,4,1,0,3,28.03333333,2,6,4,7,0,2,0,0,4,1,12,12,16,20,23.6
2023-24,202403290SAS,3/29/2024,SAS vs NYK,Isaiah Hartenstein,harteis01,67,NYK,0,SAS,7,4,4,1,0,3,28.28333333,1,3,3,7,0,0,1,2,6,1,8,11,11,15,17.8
2023-24,202403290SAS,3/29/2024,SAS vs NYK,Julian Champagnie,champju02,66,SAS,1,NYK,12,5,2,0,0,2,28.38333333,1,4,4,8,2,4,2,2,1,0,7,14,17,19,19
2023-24,202403290IND,3/29/2024,IND vs LAL,Myles Turner,turnemy01,72,IND,1,LAL,10,5,3,1,2,1,28.38333333,1,4,4,12,0,5,2,2,4,3,8,13,15,18,28.5
2023-24,202403290OKC,3/29/2024,OKC vs PHO,Grayson Allen,allengr01,68,PHO,0,OKC,13,9,5,1,0,2,28.4,4,5,6,16,1,9,0,0,0,1,14,18,22,27,32.3
2023-24,202403290UTA,3/29/2024,UTA vs HOU,Keyonte George,georgke01,67,UTA,1,HOU,6,1,6,0,0,6,29.13333333,0,1,3,12,0,4,0,0,3,0,7,12,7,13,10.2
2023-24,202403290BRK,3/29/2024,BRK vs CHI,Nikola Vucevic,vucevni01,69,CHI,0,BRK,13,10,4,0,1,1,29.56666667,2,8,5,10,2,5,1,2,2,1,14,17,23,27,33
2023-24,202403290IND,3/29/2024,IND vs LAL,Andrew Nembhard,nembhan01,61,IND,1,LAL,10,2,2,1,0,0,29.63333333,0,2,4,9,2,5,0,0,1,1,4,12,12,14,18.4
2023-24,202403290OKC,3/29/2024,OKC vs PHO,Jalen Williams,willija06,66,OKC,1,PHO,16,4,3,2,1,2,29.78333333,1,3,6,12,0,1,4,4,1,3,7,19,20,23,32.3
2023-24,202403290MIA,3/29/2024,MIA vs POR,Dalano Banton,bantoda01,47,POR,0,MIA,12,9,2,0,0,5,30.16666667,2,7,5,19,1,7,1,1,2,0,11,14,21,23,20.8
2023-24,202403290BRK,3/29/2024,BRK vs CHI,Dorian Finney-Smith,finnedo01,64,BRK,1,CHI,12,3,3,1,1,1,30.16666667,1,2,4,7,2,5,2,2,2,2,6,15,15,18,25.1
2023-24,202403290UTA,3/29/2024,UTA vs HOU,John Collins,collijo01,68,UTA,1,HOU,30,11,0,1,2,0,30.25,2,9,10,14,4,5,6,6,3,3,11,30,41,41,52.2
2023-24,202403290OKC,3/29/2024,OKC vs PHO,Bradley Beal,bealbr01,45,PHO,0,OKC,15,3,2,1,1,1,30.5,2,1,6,13,3,5,0,0,1,2,5,17,18,20,26.6
2023-24,202403290CLE,3/29/2024,CLE vs PHI,Evan Mobley,mobleev01,42,CLE,1,PHI,20,11,3,1,2,2,30.6,1,10,7,10,2,2,4,6,4,3,14,23,31,34,44.7
2023-24,202403290CLE,3/29/2024,CLE vs PHI,Georges Niang,niangge01,74,CLE,1,PHI,25,0,0,0,1,0,30.6,0,0,10,14,5,8,0,0,1,1,0,25,25,25,28
2023-24,202403290CHO,3/29/2024,CHO vs GSW,Trayce Jackson-Davis,jackstr02,59,GSW,0,CHO,18,8,1,2,3,0,30.8,4,4,9,13,0,0,0,0,2,5,9,19,26,27,44.1
2023-24,202403290CLE,3/29/2024,CLE vs PHI,Nicolas Batum,batumni01,52,PHI,0,CLE,8,8,3,0,0,0,30.83333333,4,4,3,5,2,3,0,0,2,0,11,11,16,19,22.1
2023-24,202403290OKC,3/29/2024,OKC vs PHO,Kevin Durant,duranke01,67,PHO,0,OKC,26,6,1,1,1,3,30.88333333,0,6,10,17,4,7,2,3,2,2,7,27,32,33,37.7
2023-24,202403290DEN,3/29/2024,DEN vs MIN,Jaden McDaniels,mcdanja02,63,MIN,0,DEN,17,3,3,1,0,0,30.95,0,3,7,10,1,3,2,2,2,1,6,20,20,23,28.1
2023-24,202403290DEN,3/29/2024,DEN vs MIN,Aaron Gordon,gordoaa01,67,DEN,1,MIN,14,7,4,0,0,4,30.98333333,1,6,5,9,2,4,2,4,4,0,11,18,21,25,24.4
2023-24,202403290IND,3/29/2024,IND vs LAL,Pascal Siakam,siakapa01,73,IND,1,LAL,22,11,6,1,1,1,31.16666667,1,10,8,16,0,0,6,7,0,2,17,28,33,39,49.2
2023-24,202403290IND,3/29/2024,IND vs LAL,Rui Hachimura,hachiru01,61,LAL,0,IND,14,0,0,0,0,0,31.28333333,0,0,5,10,2,4,2,2,2,0,0,14,14,14,14
2023-24,202403290CHO,3/29/2024,CHO vs GSW,Nick Richards,richani01,63,CHO,1,GSW,12,8,0,0,0,0,31.41666667,2,6,6,7,0,0,0,1,0,0,8,12,20,20,21.6
2023-24,202403290OKC,3/29/2024,OKC vs PHO,Cason Wallace,wallaca01,73,OKC,1,PHO,16,4,3,0,1,1,31.5,0,4,6,9,4,4,0,0,2,1,7,19,20,23,27.3
2023-24,202403290CLE,3/29/2024,CLE vs PHI,Kyle Lowry,lowryky01,54,PHI,0,CLE,23,3,6,0,0,2,31.73333333,0,3,7,12,4,8,5,5,5,0,9,29,26,32,33.6
2023-24,202403290BRK,3/29/2024,BRK vs CHI,Ayo Dosunmu,dosunay01,72,CHI,0,BRK,16,3,3,0,0,0,31.75,0,3,6,9,0,2,4,4,2,0,6,19,19,22,24.1
2023-24,202403290DEN,3/29/2024,DEN vs MIN,Mike Conley,conlemi01,68,MIN,0,DEN,23,3,8,0,0,2,31.91666667,0,3,8,12,5,6,2,2,3,0,11,31,26,34,36.6
2023-24,202403290CHO,3/29/2024,CHO vs GSW,Stephen Curry,curryst01,67,GSW,0,CHO,23,1,4,1,0,0,32.13333333,0,1,9,18,4,11,1,1,1,1,5,27,24,28,33.2
2023-24,202403290CLE,3/29/2024,CLE vs PHI,Donovan Mitchell,mitchdo01,50,CLE,1,PHI,12,3,8,2,0,1,32.28333333,0,3,4,13,1,7,3,3,1,2,11,20,15,23,32.6
2023-24,202403290CHO,3/29/2024,CHO vs GSW,Tre Mann,manntr01,32,CHO,1,GSW,7,3,4,0,1,4,32.63333333,1,2,3,9,1,6,0,0,0,1,7,11,10,14,15.6
2023-24,202403290UTA,3/29/2024,UTA vs HOU,Jabari Smith Jr.,smithja05,67,HOU,0,UTA,14,5,1,2,1,0,32.68333333,0,5,4,12,3,8,3,4,2,3,6,15,19,20,30.5
2023-24,202403290BRK,3/29/2024,BRK vs CHI,Alex Caruso,carusal01,65,CHI,0,BRK,6,3,5,0,1,4,32.7,0,3,2,5,2,4,0,0,2,1,8,11,9,14,16.1
2023-24,202403290CHO,3/29/2024,CHO vs GSW,Vasilije Micic,micicva01,52,CHO,1,GSW,10,2,8,2,0,2,32.75,0,2,3,7,1,4,3,4,2,2,10,18,12,20,28.4
2023-24,202403290CHO,3/29/2024,CHO vs GSW,Chris Paul,paulch01,49,GSW,0,CHO,11,7,9,0,0,4,32.88333333,0,7,5,6,1,2,0,0,2,0,16,20,18,27,28.9
2023-24,202403290ORL,3/29/2024,ORL vs LAC,Jalen Suggs,suggsja01,66,ORL,1,LAC,15,1,5,3,2,2,32.88333333,1,0,6,14,2,4,1,1,0,5,6,20,16,21,36.7
2023-24,202403290CHO,3/29/2024,CHO vs GSW,Brandon Miller,millebr02,66,CHO,1,GSW,12,3,3,0,1,1,32.93333333,3,0,5,15,2,8,0,0,2,1,6,15,15,18,22.1
2023-24,202403290IND,3/29/2024,IND vs LAL,Tyrese Haliburton,halibty01,63,IND,1,LAL,21,8,8,2,0,2,33,0,8,7,15,3,8,4,4,2,2,16,29,29,37,46.6
2023-24,202403290WAS,3/29/2024,WAS vs DET,Tosan Evbuomwan,evbuoto01,14,DET,0,WAS,8,4,2,1,0,1,33.05,1,3,2,3,0,1,4,4,2,1,6,10,12,14,17.8
2023-24,202403290DEN,3/29/2024,DEN vs MIN,Naz Reid,reidna01,72,MIN,0,DEN,7,6,2,2,0,1,33.15,0,6,2,12,0,5,3,4,3,2,8,9,13,15,22.2
2023-24,202403290SAC,3/29/2024,SAC vs DAL,P.J. Washington,washipj01,65,DAL,0,SAC,7,6,2,1,2,0,33.38333333,0,6,2,10,2,8,1,2,2,3,8,9,13,15,26.2
2023-24,202403290BRK,3/29/2024,BRK vs CHI,Dennis Schroder,schrode01,74,BRK,1,CHI,27,5,7,1,0,2,34.35,1,4,10,21,7,11,0,0,2,1,12,34,32,39,44.5
2023-24,202403290MIA,3/29/2024,MIA vs POR,Jabari Walker,walkeja01,65,POR,0,MIA,4,3,2,0,0,1,34.5,1,2,1,6,0,2,2,3,2,0,5,6,7,9,9.6
2023-24,202403290CHO,3/29/2024,CHO vs GSW,Andrew Wiggins,wiggian01,64,GSW,0,CHO,20,8,8,2,1,2,34.53333333,1,7,7,17,2,6,4,5,1,3,16,28,28,36,48.6
2023-24,202403290ORL,3/29/2024,ORL vs LAC,Paul George,georgpa01,67,LAC,0,ORL,12,4,1,1,0,2,34.56666667,0,4,4,14,1,5,3,3,4,1,5,13,16,17,19.3
2023-24,202403290UTA,3/29/2024,UTA vs HOU,Taylor Hendricks,hendrita0,32,UTA,1,HOU,8,9,2,0,2,1,34.66666667,2,7,3,7,2,5,0,0,2,2,11,10,17,19,26.8
2023-24,202403290WAS,3/29/2024,WAS vs DET,Jalen Duren,durenja01,56,DET,0,WAS,20,17,1,3,3,3,34.68333333,5,12,9,11,0,0,2,2,4,6,18,21,37,38,56.9
2023-24,202403290IND,3/29/2024,IND vs LAL,LeBron James,jamesle01,65,LAL,0,IND,16,10,8,0,0,5,34.68333333,1,9,6,12,0,3,4,4,1,0,18,24,26,34,35
2023-24,202403290DEN,3/29/2024,DEN vs MIN,Rudy Gobert,goberru01,67,MIN,0,DEN,21,12,2,0,3,0,34.8,3,9,7,8,0,0,7,15,5,3,14,23,33,35,47.4
2023-24,202403290CLE,3/29/2024,CLE vs PHI,Tobias Harris,harrito02,65,PHI,0,CLE,21,7,2,1,1,0,34.81666667,0,7,8,17,4,9,1,1,0,2,9,23,28,30,38.4
2023-24,202403290SAS,3/29/2024,SAS vs NYK,Keldon Johnson,johnske04,68,SAS,1,NYK,17,5,4,0,0,2,34.83333333,1,4,4,8,2,6,7,8,2,0,9,21,22,26,27
2023-24,202403290ORL,3/29/2024,ORL vs LAC,Ivica Zubac,zubaciv01,61,LAC,0,ORL,14,9,2,0,1,1,34.83333333,4,5,7,10,0,0,0,0,2,1,11,16,23,25,29.8
2023-24,202403290IND,3/29/2024,IND vs LAL,D'Angelo Russell,russeda01,69,LAL,0,IND,6,3,5,1,1,0,35.05,0,3,3,14,0,6,0,0,3,2,8,11,9,14,23.1
2023-24,202403290CLE,3/29/2024,CLE vs PHI,Darius Garland,garlada01,50,CLE,1,PHI,14,3,12,0,0,3,35.23333333,0,3,6,12,1,4,1,1,0,0,15,26,17,29,32.6
2023-24,202403290SAC,3/29/2024,SAC vs DAL,Keegan Murray,murrake02,68,SAC,1,DAL,12,7,1,0,1,0,35.43333333,1,6,4,11,4,7,0,0,5,1,8,13,19,20,24.9
2023-24,202403290SAS,3/29/2024,SAS vs NYK,Tre Jones,jonestr01,69,SAS,1,NYK,13,4,4,0,0,2,35.48333333,0,4,4,6,3,5,2,2,2,0,8,17,17,21,21.8
2023-24,202403290ORL,3/29/2024,ORL vs LAC,Franz Wagner,wagnefr01,65,ORL,1,LAC,13,3,3,2,1,1,35.51666667,1,2,5,13,0,3,3,4,2,3,6,16,16,19,29.1
2023-24,202403290DEN,3/29/2024,DEN vs MIN,Michael Porter Jr.,portemi01,73,DEN,1,MIN,14,6,4,1,0,0,35.73333333,1,5,5,10,2,5,2,2,2,1,10,18,20,24,30.2
2023-24,202403290IND,3/29/2024,IND vs LAL,Austin Reaves,reaveau01,75,LAL,0,IND,16,13,6,1,0,5,36.18333333,1,12,7,16,1,7,1,1,2,1,19,22,29,35,38.6
2023-24,202403290SAC,3/29/2024,SAC vs DAL,Domantas Sabonis,sabondo01,73,SAC,1,DAL,13,12,10,1,0,4,36.36666667,1,11,6,12,0,0,1,4,4,1,22,23,25,35,41.4
2023-24,202403290DEN,3/29/2024,DEN vs MIN,Reggie Jackson,jacksre01,74,DEN,1,MIN,12,4,10,2,0,3,36.5,2,2,4,15,2,5,2,2,6,2,14,22,16,26,34.8
2023-24,202403290ORL,3/29/2024,ORL vs LAC,James Harden,hardeja01,66,LAC,0,ORL,11,8,4,4,0,4,36.56666667,2,6,3,12,1,7,4,5,1,4,12,15,19,23,34.6
2023-24,202403290WAS,3/29/2024,WAS vs DET,Kyle Kuzma,kuzmaky01,69,WAS,1,DET,12,8,3,0,1,5,36.61666667,0,8,5,22,0,6,2,4,1,1,11,15,20,23,24.1
2023-24,202403290BRK,3/29/2024,BRK vs CHI,Nic Claxton,claxtni01,64,BRK,1,CHI,11,13,4,0,2,1,36.75,6,7,4,12,0,0,3,10,1,2,17,15,24,28,37.6
2023-24,202403290BRK,3/29/2024,BRK vs CHI,DeMar DeRozan,derozde01,72,CHI,0,BRK,31,8,2,1,1,3,36.8,0,8,11,20,0,2,9,10,2,2,10,33,39,41,46.6
2023-24,202403290WAS,3/29/2024,WAS vs DET,Cade Cunningham,cunnica01,61,DET,0,WAS,33,8,7,2,0,3,36.93333333,1,7,13,33,2,5,5,5,3,2,15,40,41,48,56.1
2023-24,202403290DEN,3/29/2024,DEN vs MIN,Nikola Jokic,jokicni01,71,DEN,1,MIN,32,10,5,2,1,4,36.96666667,1,9,11,24,0,3,10,13,2,3,15,37,42,47,56.5
2023-24,202403290WAS,3/29/2024,WAS vs DET,Jordan Poole,poolejo01,72,WAS,1,DET,7,3,6,0,1,5,37.23333333,0,3,3,15,1,8,0,0,3,1,9,13,10,16,17.6
2023-24,202403290WAS,3/29/2024,WAS vs DET,Jaden Ivey,iveyja01,69,DET,0,WAS,13,7,5,0,1,1,37.45,1,6,5,17,1,6,2,2,3,1,12,18,20,25,30.9
2023-24,202403290IND,3/29/2024,IND vs LAL,Anthony Davis,davisan02,70,LAL,0,IND,24,15,3,0,0,3,37.5,4,11,9,17,0,1,6,7,0,0,18,27,39,42,43.5
2023-24,202403290CHO,3/29/2024,CHO vs GSW,Miles Bridges,bridgmi02,62,CHO,1,GSW,22,9,3,0,0,2,37.61666667,2,7,8,17,1,7,5,7,2,0,12,25,31,34,35.3
2023-24,202403290SAS,3/29/2024,SAS vs NYK,Victor Wembanyama,wembavi01,65,SAS,1,NYK,40,20,7,2,1,4,37.7,5,15,13,22,4,9,10,12,2,3,27,47,60,67,79.5
2023-24,202403290ORL,3/29/2024,ORL vs LAC,Kawhi Leonard,leonaka01,67,LAC,0,ORL,29,11,5,4,2,3,37.76666667,1,10,12,21,3,6,2,2,4,6,16,34,40,45,64.7
2023-24,202403290BRK,3/29/2024,BRK vs CHI,Mikal Bridges,bridgmi01,74,BRK,1,CHI,25,3,3,4,0,0,37.93333333,1,2,8,15,7,11,2,2,2,4,6,28,28,31,45.1
2023-24,202403290SAC,3/29/2024,SAC vs DAL,Kyrie Irving,irvinky01,51,DAL,0,SAC,30,3,2,0,0,2,37.95,0,3,11,16,3,5,5,6,1,0,5,32,33,35,34.6
2023-24,202403290WAS,3/29/2024,WAS vs DET,Corey Kispert,kispeco01,72,WAS,1,DET,23,6,0,0,0,1,37.96666667,1,5,9,12,5,7,0,0,4,0,6,23,29,29,29.2
2023-24,202403290SAC,3/29/2024,SAC vs DAL,Keon Ellis,elliske01,48,SAC,1,DAL,16,6,1,3,0,2,38.08333333,1,5,5,12,4,9,2,2,4,3,7,17,22,23,31.7
2023-24,202403290ORL,3/29/2024,ORL vs LAC,Paolo Banchero,banchpa01,71,ORL,1,LAC,23,8,2,2,0,7,38.48333333,0,8,8,18,1,6,6,7,3,2,10,25,31,33,34.6
2023-24,202403290UTA,3/29/2024,UTA vs HOU,Jalen Green,greenja05,73,HOU,0,UTA,34,9,6,2,0,4,38.58333333,2,7,11,24,4,11,8,14,2,2,15,40,43,49,55.8
2023-24,202403290WAS,3/29/2024,WAS vs DET,Deni Avdija,avdijde01,67,WAS,1,DET,18,11,9,0,0,5,38.75,2,9,6,14,2,6,4,4,2,0,20,27,29,38,39.7
2023-24,202403290DEN,3/29/2024,DEN vs MIN,Anthony Edwards,edwaran01,70,MIN,0,DEN,25,4,5,3,0,2,39.33333333,1,3,8,19,0,8,9,10,2,3,9,30,29,34,44.3
2023-24,202403290IND,3/29/2024,IND vs LAL,Aaron Nesmith,nesmiaa01,66,IND,1,LAL,12,4,2,1,1,1,39.33333333,1,3,5,11,2,7,0,0,1,2,6,14,16,18,24.8
2023-24,202403290BRK,3/29/2024,BRK vs CHI,Coby White,whiteco01,71,CHI,0,BRK,18,2,9,0,0,2,39.46666667,0,2,6,16,3,9,3,5,5,0,11,27,20,29,31.9
2023-24,202403290SAC,3/29/2024,SAC vs DAL,Harrison Barnes,barneha02,73,SAC,1,DAL,20,6,2,0,0,3,39.73333333,2,4,8,19,1,4,3,3,1,0,8,22,26,28,27.2
2023-24,202403290SAC,3/29/2024,SAC vs DAL,De'Aaron Fox,foxde01,65,SAC,1,DAL,23,6,5,3,0,1,40.25,1,5,9,22,3,7,2,2,3,3,11,28,29,34,45.7
2023-24,202403290BRK,3/29/2024,BRK vs CHI,Cam Thomas,thomaca02,58,BRK,1,CHI,28,8,4,1,0,1,40.38333333,1,7,10,22,5,9,3,3,4,1,12,32,36,40,45.6
2023-24,202403290UTA,3/29/2024,UTA vs HOU,Amen Thompson,thompam01,54,HOU,0,UTA,18,14,5,2,1,3,40.38333333,8,6,6,12,0,0,6,8,1,3,19,23,32,37,48.3
2023-24,202403290SAC,3/29/2024,SAC vs DAL,Luka Doncic,doncilu01,64,DAL,0,SAC,26,9,12,2,0,5,40.86666667,0,9,6,14,4,8,10,14,2,2,21,38,35,47,55.8
2023-24,202403290MIA,3/29/2024,MIA vs POR,Scoot Henderson,hendesc01,55,POR,0,MIA,20,6,6,2,1,7,41.11666667,1,5,8,18,1,5,3,5,1,3,12,26,26,32,38.2
2023-24,202403290SAS,3/29/2024,SAS vs NYK,Josh Hart,hartjo01,72,NYK,0,SAS,12,12,8,1,0,2,41.85,4,8,4,13,2,5,2,2,3,1,20,20,24,32,39.4
2023-24,202403290UTA,3/29/2024,UTA vs HOU,Fred VanVleet,vanvlfr01,66,HOU,0,UTA,22,2,6,4,3,0,42.1,0,2,9,24,4,14,0,0,4,7,8,28,24,30,54.4
2023-24,202403290MIA,3/29/2024,MIA vs POR,Kris Murray,murrakr01,54,POR,0,MIA,11,5,4,0,0,4,42.18333333,1,4,4,10,3,8,0,0,2,0,9,15,16,20,19
2023-24,202403290CLE,3/29/2024,CLE vs PHI,Tyrese Maxey,maxeyty01,65,PHI,0,CLE,16,2,11,2,0,3,42.56666667,0,2,7,26,2,12,0,1,0,2,13,27,18,29,37.9
2023-24,202403290SAS,3/29/2024,SAS vs NYK,Jalen Brunson,brunsja01,68,NYK,0,SAS,61,4,6,1,0,1,43.31666667,1,3,25,47,5,13,6,6,2,1,10,67,65,71,76.8
2023-24,202403290UTA,3/29/2024,UTA vs HOU,Collin Sexton,sextoco01,74,UTA,1,HOU,29,6,5,0,2,4,44.11666667,2,4,10,21,0,4,9,10,3,2,11,34,35,40,45.7
2023-24,202403290SAS,3/29/2024,SAS vs NYK,Devin Vassell,vassede01,68,SAS,1,NYK,23,2,7,1,0,2,44.68333333,0,2,10,22,3,10,0,0,0,1,9,30,25,32,36.9
2023-24,202403290SAS,3/29/2024,SAS vs NYK,Miles McBride,mcbrimi01,60,NYK,0,SAS,7,2,3,4,0,1,45.86666667,2,0,3,9,1,4,0,0,3,4,5,10,9,12,24.9
2023-24,202403290SAS,3/29/2024,SAS vs NYK,Donte DiVincenzo,divindo01,72,NYK,0,SAS,20,6,2,2,0,0,49,0,6,7,13,6,12,0,0,2,2,8,22,26,28,36.2
2023-24,202403280ATL,3/28/2024,ATL vs BOS,Luke Kornet,kornelu01,55,BOS,0,ATL,4,3,0,1,0,0,13.01666667,1,2,1,1,0,0,2,2,0,1,3,4,7,7,10.6
2023-24,202403280NOP,3/28/2024,NOP vs MIL,Jordan Hawkins,hawkijo01,62,NOP,1,MIL,2,1,0,0,0,0,15,0,1,0,3,0,2,2,3,1,0,1,2,3,3,3.2
2023-24,202403280NOP,3/28/2024,NOP vs MIL,Jae Crowder,crowdja01,42,MIL,0,NOP,3,2,2,0,0,0,15.21666667,0,2,1,3,1,2,0,0,0,0,4,5,5,7,8.4
2023-24,202403280NOP,3/28/2024,NOP vs MIL,Bobby Portis,portibo01,73,MIL,0,NOP,5,7,0,0,0,3,15.91666667,1,6,2,6,1,2,0,0,5,0,7,5,12,12,10.4
2023-24,202403280ATL,3/28/2024,ATL vs BOS,Garrison Mathews,mathega01,57,ATL,1,BOS,7,1,1,0,0,1,16.83333333,0,1,3,5,1,3,0,0,0,0,2,8,8,9,8.7
2023-24,202403280ATL,3/28/2024,ATL vs BOS,Payton Pritchard,pritcpa01,73,BOS,0,ATL,4,1,2,1,0,1,18.73333333,0,1,1,3,0,1,2,2,1,1,3,6,5,7,10.2
2023-24,202403280ATL,3/28/2024,ATL vs BOS,Bruno Fernando,fernabr01,36,ATL,1,BOS,6,4,2,1,1,0,19.71666667,1,3,3,3,0,0,0,1,3,2,6,8,10,12,19.8
2023-24,202403280NOP,3/28/2024,NOP vs MIL,Pat Connaughton,connapa01,67,MIL,0,NOP,3,1,1,0,0,0,22,0,1,1,1,1,1,0,0,1,0,2,4,4,5,5.7
2023-24,202403280ATL,3/28/2024,ATL vs BOS,Sam Hauser,hausesa01,70,BOS,0,ATL,8,2,3,0,0,0,22.51666667,0,2,3,6,2,4,0,0,1,0,5,11,10,13,14.9
2023-24,202403280NOP,3/28/2024,NOP vs MIL,Naji Marshall,marshna01,61,NOP,1,MIL,0,3,0,0,0,0,23.13333333,1,2,0,4,0,2,0,0,1,0,3,0,3,3,3.6
2023-24,202403280NOP,3/28/2024,NOP vs MIL,Jonas Valanciunas,valanjo01,73,NOP,1,MIL,17,10,1,1,1,2,23.25,3,7,7,13,1,3,2,2,3,2,11,18,27,28,34.5
2023-24,202403280ATL,3/28/2024,ATL vs BOS,Wesley Matthews,matthwe02,32,ATL,1,BOS,3,5,3,1,1,1,23.66666667,3,2,1,6,1,5,0,0,3,2,8,6,8,11,18.5
2023-24,202403280NOP,3/28/2024,NOP vs MIL,Larry Nance Jr.,nancela02,54,NOP,1,MIL,9,7,3,3,0,0,24.75,3,4,4,8,1,2,0,0,3,3,10,12,16,19,30.9
2023-24,202403280NOP,3/28/2024,NOP vs MIL,Khris Middleton,middlkh01,48,MIL,0,NOP,7,8,6,1,0,4,32.76666667,0,8,3,12,1,7,0,0,3,1,14,13,15,21,24.6
2023-24,202403280NOP,3/28/2024,NOP vs MIL,Malik Beasley,beaslma01,70,MIL,0,NOP,20,2,0,0,1,1,33.05,0,2,6,12,6,11,2,2,3,1,2,20,22,22,24.4
2023-24,202403280NOP,3/28/2024,NOP vs MIL,Zion Williamson,willizi01,62,NOP,1,MIL,28,5,2,0,1,3,33.16666667,0,5,9,15,0,0,10,16,3,1,7,30,33,35,37
2023-24,202403280ATL,3/28/2024,ATL vs BOS,Clint Capela,capelca01,65,ATL,1,BOS,12,13,3,0,2,2,33.28333333,7,6,6,8,0,0,0,0,2,2,16,15,25,28,36.1
2023-24,202403280ATL,3/28/2024,ATL vs BOS,Vit Krejci,krejcvi01,13,ATL,1,BOS,2,3,1,0,0,0,35.2,1,2,1,1,0,0,0,0,6,0,4,3,5,6,7.1
2023-24,202403280NOP,3/28/2024,NOP vs MIL,Damian Lillard,lillada01,68,MIL,0,NOP,20,5,7,0,0,2,35.98333333,0,5,8,16,3,6,1,3,2,0,12,27,25,32,34.5
2023-24,202403280ATL,3/28/2024,ATL vs BOS,Jrue Holiday,holidjr01,62,BOS,0,ATL,13,7,5,1,1,0,36.53333333,1,6,5,11,3,6,0,0,1,2,12,18,20,25,34.9
2023-24,202403280NOP,3/28/2024,NOP vs MIL,Brook Lopez,lopezbr01,70,MIL,0,NOP,7,5,1,0,3,2,36.68333333,0,5,2,5,1,4,2,3,5,3,6,8,12,13,21.5
2023-24,202403280NOP,3/28/2024,NOP vs MIL,Herbert Jones,joneshe01,67,NOP,1,MIL,11,4,4,4,3,0,36.71666667,1,3,3,9,1,4,4,4,5,7,8,15,15,19,42.8
2023-24,202403280ATL,3/28/2024,ATL vs BOS,Jaylen Brown,brownja02,65,BOS,0,ATL,18,1,4,2,2,3,38.81666667,0,1,9,17,0,3,0,0,3,4,5,22,19,23,34.2
2023-24,202403280NOP,3/28/2024,NOP vs MIL,Trey Murphy III,murphtr02,48,NOP,1,MIL,15,11,5,2,0,0,39.11666667,2,9,4,13,2,9,5,5,1,2,16,20,26,31,41.7
2023-24,202403280NOP,3/28/2024,NOP vs MIL,Giannis Antetokounmpo,antetgi01,68,MIL,0,NOP,35,14,4,0,0,2,39.18333333,3,11,15,22,0,2,5,11,5,0,18,39,49,53,55.8
2023-24,202403280NOP,3/28/2024,NOP vs MIL,CJ McCollum,mccolcj01,57,NOP,1,MIL,25,7,7,1,0,1,39.46666667,1,6,9,24,3,9,4,4,1,1,14,32,32,39,45.9
2023-24,202403280ATL,3/28/2024,ATL vs BOS,De'Andre Hunter,huntede01,49,ATL,1,BOS,21,13,1,0,0,1,39.85,2,11,8,16,5,9,0,3,0,0,14,22,34,35,37.1
2023-24,202403280ATL,3/28/2024,ATL vs BOS,Kristaps Porzingis,porzikr01,51,BOS,0,ATL,20,7,2,1,3,3,40.61666667,2,5,8,20,2,7,2,3,3,4,9,22,27,29,40.4
2023-24,202403280ATL,3/28/2024,ATL vs BOS,Derrick White,whitede01,67,BOS,0,ATL,22,7,5,1,0,3,41,2,5,8,11,5,6,1,1,3,1,12,27,29,34,37.9
2023-24,202403280ATL,3/28/2024,ATL vs BOS,Bogdan Bogdanovic,bogdabo01,70,ATL,1,BOS,24,7,5,1,0,2,43.45,3,4,9,19,2,8,4,4,1,1,12,29,31,36,40.9
2023-24,202403280ATL,3/28/2024,ATL vs BOS,Jayson Tatum,tatumja01,68,BOS,0,ATL,31,13,6,0,0,2,45.23333333,3,10,9,22,2,7,11,13,3,0,19,37,44,50,53.6
2023-24,202403280ATL,3/28/2024,ATL vs BOS,Dejounte Murray,murrade01,70,ATL,1,BOS,44,7,7,2,1,3,46.8,0,7,18,44,6,19,2,2,2,3,14,51,51,58,68.9
2023-24,202403270MEM,3/27/2024,MEM vs LAL,Cam Reddish,reddica01,45,LAL,0,MEM,0,0,0,0,0,0,10.18333333,0,0,0,2,0,1,0,0,0,0,0,0,0,0,0
2023-24,202403270CHI,3/27/2024,CHI vs IND,Doug McDermott,mcderdo01,57,IND,0,CHI,3,0,1,0,0,0,10.41666667,0,0,1,3,1,3,0,0,1,0,1,4,3,4,4.5
2023-24,202403270TOR,3/27/2024,TOR vs NYK,Shake Milton,miltosh01,46,NYK,0,TOR,7,3,2,0,0,0,10.45,0,3,3,5,1,1,0,0,3,0,5,9,10,12,13.6
2023-24,202403270WAS,3/27/2024,WAS vs BRK,Noah Clowney,clownno01,14,BRK,0,WAS,1,4,0,0,1,0,10.58333333,2,2,0,4,0,2,1,2,2,1,4,1,5,5,8.8
2023-24,202403270OKC,3/27/2024,OKC vs HOU,Aaron Holiday,holidaa01,69,HOU,0,OKC,4,2,2,0,0,0,10.73333333,2,0,2,5,0,1,0,0,0,0,4,6,6,8,9.4
2023-24,202403270CHI,3/27/2024,CHI vs IND,Jarace Walker,walkeja02,30,IND,0,CHI,0,1,2,0,0,2,10.76666667,0,1,0,2,0,1,0,0,0,0,3,2,1,3,2.2
2023-24,202403270CHI,3/27/2024,CHI vs IND,Obi Toppin,toppiob01,75,IND,0,CHI,5,1,2,1,1,1,11.1,0,1,2,2,0,0,1,1,1,2,3,7,6,8,14.2
2023-24,202403270CHI,3/27/2024,CHI vs IND,Ben Sheppard,sheppbe01,50,IND,0,CHI,0,0,0,0,0,0,11.2,0,0,0,2,0,2,0,0,1,0,0,0,0,0,0
2023-24,202403270TOR,3/27/2024,TOR vs NYK,Mouhamadou Gueye,gueyemo01,7,TOR,1,NYK,2,2,1,0,1,2,11.31666667,2,0,1,4,0,0,0,0,1,1,3,3,4,5,6.9
2023-24,202403270DEN,3/27/2024,DEN vs PHO,Bol Bol,bolbo01,35,PHO,0,DEN,8,5,1,0,0,0,12.03333333,2,3,3,5,2,2,0,0,1,0,6,9,13,14,15.5
2023-24,202403270CHI,3/27/2024,CHI vs IND,Jalen Smith,smithja04,53,IND,0,CHI,5,4,0,0,0,1,12.18333333,2,2,2,5,1,3,0,0,4,0,4,5,9,9,8.8
2023-24,202403270WAS,3/27/2024,WAS vs BRK,Richaun Holmes,holmeri01,40,WAS,1,BRK,0,3,0,0,0,1,12.28333333,0,3,0,1,0,0,0,0,0,0,3,0,3,3,2.6
2023-24,202403270ATL,3/27/2024,ATL vs POR,Moses Brown,brownmo01,19,POR,0,ATL,7,1,0,1,1,0,12.31666667,1,0,3,5,0,0,1,5,1,2,1,7,8,8,14.2
2023-24,202403270TOR,3/27/2024,TOR vs NYK,Mitchell Robinson,robinmi01,22,NYK,0,TOR,8,2,0,0,2,3,12.43333333,1,1,3,3,0,0,2,4,2,2,2,8,10,10,13.4
2023-24,202403270OKC,3/27/2024,OKC vs HOU,Jeff Green,greenje02,68,HOU,0,OKC,7,2,1,0,0,0,13.36666667,0,2,3,8,1,5,0,0,1,0,3,8,9,10,10.9
2023-24,202403270CHI,3/27/2024,CHI vs IND,Dalen Terry,terryda01,50,CHI,1,IND,0,2,4,0,1,2,13.41666667,0,2,0,1,0,0,0,0,2,1,6,4,2,6,9.4
2023-24,202403270UTA,3/27/2024,UTA vs SAS,Brice Sensabaugh,sensabr01,23,UTA,1,SAS,9,1,1,1,0,2,13.46666667,0,1,3,5,1,2,2,2,2,1,2,10,10,11,12.7
2023-24,202403270WAS,3/27/2024,WAS vs BRK,Day'Ron Sharpe,sharpda01,55,BRK,0,WAS,8,5,0,0,0,3,14.15,1,4,2,3,0,1,4,6,3,0,5,8,13,13,11
2023-24,202403270MIN,3/27/2024,MIN vs DET,Monte Morris,morrimo01,23,MIN,1,DET,1,2,1,1,0,1,14.41666667,0,2,0,2,0,1,1,2,2,1,3,2,3,4,6.9
2023-24,202403270MIN,3/27/2024,MIN vs DET,Jordan McLaughlin,mclaujo01,46,MIN,1,DET,8,1,0,0,0,0,14.43333333,1,0,3,4,2,3,0,0,1,0,1,8,9,9,9.2
2023-24,202403270OKC,3/27/2024,OKC vs HOU,Jaylin Williams,willija07,59,OKC,1,HOU,5,5,0,1,0,3,14.48333333,0,5,2,4,1,3,0,0,2,1,5,5,10,10,11
2023-24,202403270DEN,3/27/2024,DEN vs PHO,Christian Braun,braunch01,73,DEN,1,PHO,0,3,0,0,1,0,14.68333333,1,2,0,3,0,1,0,0,0,1,3,0,3,3,6.6
2023-24,202403270ORL,3/27/2024,ORL vs GSW,Kevon Looney,looneke01,65,GSW,0,ORL,4,7,0,0,1,0,14.76666667,1,6,2,2,0,0,0,0,2,1,7,4,11,11,15.4
2023-24,202403270ORL,3/27/2024,ORL vs GSW,Anthony Black,blackan01,64,ORL,1,GSW,6,1,1,0,0,0,14.98333333,1,0,2,5,1,2,1,3,1,0,2,7,7,8,8.7
2023-24,202403270MIN,3/27/2024,MIN vs DET,Evan Fournier,fournev01,24,DET,0,MIN,0,0,0,3,0,1,15.01666667,0,0,0,6,0,4,0,0,1,3,0,0,0,0,8
2023-24,202403270UTA,3/27/2024,UTA vs SAS,Zach Collins,colliza01,60,SAS,0,UTA,4,0,6,0,1,1,15.1,0,0,1,3,0,0,2,2,5,1,6,10,4,10,15
2023-24,202403270UTA,3/27/2024,UTA vs SAS,Blake Wesley,weslebl01,52,SAS,0,UTA,1,2,4,0,0,1,15.18333333,0,2,0,0,0,0,1,2,0,0,6,5,3,7,8.4
2023-24,202403270ATL,3/27/2024,ATL vs POR,Ashton Hagans,haganas01,16,POR,0,ATL,10,2,3,0,0,3,15.83333333,0,2,3,5,2,2,2,2,1,0,5,13,12,15,13.9
2023-24,202403270ATL,3/27/2024,ATL vs POR,Trent Forrest,forretr01,34,ATL,1,POR,2,2,4,0,0,0,15.86666667,0,2,0,4,0,1,2,2,0,0,6,6,4,8,10.4
2023-24,202403270WAS,3/27/2024,WAS vs BRK,Anthony Gill,gillan01,42,WAS,1,BRK,5,3,2,1,0,1,15.96666667,2,1,2,4,1,3,0,0,3,1,5,7,8,10,13.6
2023-24,202403270DEN,3/27/2024,DEN vs PHO,Collin Gillespie,gilleco01,22,DEN,1,PHO,8,1,3,1,0,0,16.43333333,0,1,2,7,2,6,2,2,1,1,4,11,9,12,16.7
2023-24,202403270TOR,3/27/2024,TOR vs NYK,Jalen McDaniels,mcdanja01,42,TOR,1,NYK,4,0,0,0,1,3,16.45,0,0,2,7,0,2,0,0,3,1,0,4,4,4,4
2023-24,202403270ORL,3/27/2024,ORL vs GSW,Markelle Fultz,fultzma01,34,ORL,1,GSW,4,1,0,1,1,1,16.46666667,0,1,2,5,0,0,0,0,1,2,1,4,5,5,10.2
2023-24,202403270TOR,3/27/2024,TOR vs NYK,Bojan Bogdanovic,bogdabo02,47,NYK,0,TOR,18,1,2,0,0,0,16.48333333,0,1,7,11,4,5,0,0,0,0,3,20,19,21,22.2
2023-24,202403270ORL,3/27/2024,ORL vs GSW,Chris Paul,paulch01,48,GSW,0,ORL,3,3,4,0,0,1,16.66666667,0,3,1,5,0,2,1,2,0,0,7,7,6,10,11.6
2023-24,202403270WAS,3/27/2024,WAS vs BRK,Johnny Davis,davisjo06,42,WAS,1,BRK,2,1,1,0,2,0,16.7,0,1,1,3,0,0,0,0,1,2,2,3,3,4,10.7
2023-24,202403270CHI,3/27/2024,CHI vs IND,Torrey Craig,craigto01,44,CHI,1,IND,7,2,1,0,0,0,16.95,0,2,3,5,1,2,0,0,3,0,3,8,9,10,10.9
2023-24,202403270PHI,3/27/2024,PHI vs LAC,Russell Westbrook,westbru01,60,LAC,0,PHI,6,2,2,0,0,1,17,2,0,2,8,0,1,2,2,0,0,4,8,8,10,10.4
2023-24,202403270ATL,3/27/2024,ATL vs POR,Dylan Windler,windldy01,15,ATL,1,POR,11,2,0,1,0,0,17.15,0,2,4,6,3,5,0,0,0,1,2,11,13,13,16.4
2023-24,202403270CHI,3/27/2024,CHI vs IND,Andre Drummond,drumman01,73,CHI,1,IND,14,11,3,3,0,1,17.5,4,7,5,8,0,0,4,5,2,3,14,17,25,28,39.7
2023-24,202403270DEN,3/27/2024,DEN vs PHO,Royce O'Neale,onealro01,70,PHO,0,DEN,5,7,2,0,0,1,17.8,2,5,2,4,1,2,0,0,4,0,9,7,12,14,15.4
2023-24,202403270DEN,3/27/2024,DEN vs PHO,Thaddeus Young,youngth01,29,PHO,0,DEN,6,9,2,1,0,0,17.85,4,5,3,4,0,0,0,0,1,1,11,8,15,17,22.8
2023-24,202403270CHI,3/27/2024,CHI vs IND,T.J. McConnell,mccontj01,64,IND,0,CHI,12,1,4,0,0,1,17.93333333,0,1,5,9,0,1,2,2,1,0,5,16,13,17,18.2
2023-24,202403270OKC,3/27/2024,OKC vs HOU,Chet Holmgren,holmgch01,72,OKC,1,HOU,2,7,0,0,3,5,18.33333333,0,7,0,2,0,2,2,2,6,3,7,2,9,9,14.4
2023-24,202403270TOR,3/27/2024,TOR vs NYK,Jordan Nwora,nworajo01,44,TOR,1,NYK,7,3,3,2,1,2,18.53333333,0,3,3,6,1,2,0,0,0,3,6,10,10,13,22.1
2023-24,202403270TOR,3/27/2024,TOR vs NYK,Isaiah Hartenstein,harteis01,66,NYK,0,TOR,15,4,1,1,1,1,18.63333333,1,3,5,6,0,0,5,5,2,2,5,16,19,20,26.3
2023-24,202403270ORL,3/27/2024,ORL vs GSW,Gary Payton II,paytoga02,37,GSW,0,ORL,10,1,1,3,1,1,18.66666667,0,1,5,5,0,0,0,0,1,4,2,11,11,12,23.7
2023-24,202403270ATL,3/27/2024,ATL vs POR,Jabari Walker,walkeja01,64,POR,0,ATL,4,4,1,0,0,0,18.73333333,1,3,2,5,0,0,0,0,3,0,5,5,8,9,10.3
2023-24,202403270ORL,3/27/2024,ORL vs GSW,Wendell Carter Jr.,cartewe01,45,ORL,1,GSW,7,6,0,2,0,1,18.75,2,4,3,7,0,2,1,3,1,2,6,7,13,13,19.2
2023-24,202403270PHI,3/27/2024,PHI vs LAC,Mo Bamba,bambamo01,51,PHI,1,LAC,12,11,0,0,2,1,18.81666667,3,8,5,8,0,1,2,2,3,2,11,12,23,23,30.2
2023-24,202403270UTA,3/27/2024,UTA vs SAS,Cedi Osman,osmande01,69,SAS,0,UTA,9,7,6,1,0,1,19.2,1,6,3,5,3,3,0,0,4,1,13,15,16,22,28.4
2023-24,202403270DEN,3/27/2024,DEN vs PHO,Peyton Watson,watsope01,71,DEN,1,PHO,5,4,0,0,1,0,19.2,2,2,2,4,0,1,1,2,2,1,4,5,9,9,12.8
2023-24,202403270MIN,3/27/2024,MIN vs DET,Malachi Flynn,flynnma01,60,DET,0,MIN,14,5,0,0,0,2,19.31666667,2,3,6,9,2,3,0,0,2,0,5,14,19,19,18
2023-24,202403270CHI,3/27/2024,CHI vs IND,Javonte Green,greenja02,1,CHI,1,IND,5,4,1,0,1,2,19.31666667,0,4,2,3,1,1,0,0,2,1,5,6,9,10,12.3
2023-24,202403270WAS,3/27/2024,WAS vs BRK,Trendon Watford,watfotr01,54,BRK,0,WAS,12,3,2,1,1,0,19.38333333,0,3,5,7,2,3,0,0,2,2,5,14,15,17,24.6
2023-24,202403270OKC,3/27/2024,OKC vs HOU,Kenrich Williams,willike04,59,OKC,1,HOU,5,9,1,1,0,0,19.53333333,5,4,2,5,1,3,0,0,4,1,10,6,14,15,20.3
2023-24,202403270OKC,3/27/2024,OKC vs HOU,Jock Landale,landajo01,46,HOU,0,OKC,7,6,1,1,0,1,19.61666667,3,3,3,6,0,0,1,3,1,1,7,8,13,14,17.7
2023-24,202403270TOR,3/27/2024,TOR vs NYK,Bruce Brown,brownbr01,62,TOR,1,NYK,3,0,1,0,0,2,20.21666667,0,0,1,3,1,2,0,0,1,0,1,4,3,4,2.5
2023-24,202403270DEN,3/27/2024,DEN vs PHO,Eric Gordon,gordoer01,60,PHO,0,DEN,10,1,0,0,1,0,20.21666667,0,1,4,9,2,5,0,0,0,1,1,10,11,11,14.2
2023-24,202403270UTA,3/27/2024,UTA vs SAS,Malaki Branham,branhma01,68,SAS,0,UTA,17,0,0,1,0,1,20.38333333,0,0,7,11,3,5,0,0,1,1,0,17,17,17,19
2023-24,202403270ORL,3/27/2024,ORL vs GSW,Moritz Wagner,wagnemo01,70,ORL,1,GSW,6,3,7,2,0,2,20.48333333,1,2,3,5,0,1,0,0,2,2,10,13,9,16,24.1
2023-24,202403270MEM,3/27/2024,MEM vs LAL,Lamar Stevens,stevela01,33,MEM,1,LAL,11,4,2,1,0,0,20.5,0,4,5,13,0,4,1,1,0,1,6,13,15,17,21.8
2023-24,202403270MEM,3/27/2024,MEM vs LAL,Brandon Clarke,clarkbr01,1,MEM,1,LAL,6,5,1,1,0,0,20.85,3,2,3,7,0,1,0,1,1,1,6,7,11,12,16.5
2023-24,202403270ATL,3/27/2024,ATL vs POR,Bruno Fernando,fernabr01,35,ATL,1,POR,7,9,1,2,2,5,20.98333333,3,6,2,4,0,0,3,4,5,4,10,8,16,17,26.3
2023-24,202403270PHI,3/27/2024,PHI vs LAC,Paul Reed,reedpa01,73,PHI,1,LAC,5,7,0,0,3,0,21.05,3,4,2,4,0,0,1,2,2,3,7,5,12,12,22.4
2023-24,202403270WAS,3/27/2024,WAS vs BRK,Jared Butler,butleja02,31,WAS,1,BRK,0,3,2,1,0,2,21.45,0,3,0,2,0,1,0,0,2,1,5,2,3,5,7.6
2023-24,202403270ORL,3/27/2024,ORL vs GSW,Brandin Podziemski,podzibr01,64,GSW,0,ORL,6,9,1,1,0,0,21.48333333,4,5,3,10,0,2,0,0,2,1,10,7,15,16,21.3
2023-24,202403270OKC,3/27/2024,OKC vs HOU,Gordon Hayward,haywago01,43,OKC,1,HOU,13,2,1,1,0,0,21.58333333,0,2,4,7,3,3,2,4,0,1,3,14,15,16,19.9
2023-24,202403270ATL,3/27/2024,ATL vs POR,Kris Murray,murrakr01,53,POR,0,ATL,0,3,4,1,0,1,21.8,1,2,0,3,0,1,0,0,0,1,7,4,3,7,11.6
2023-24,202403270UTA,3/27/2024,UTA vs SAS,Walker Kessler,kesslwa01,61,UTA,1,SAS,4,6,1,0,2,2,21.88333333,2,4,1,3,0,0,2,2,0,2,7,5,10,11,16.7
2023-24,202403270ATL,3/27/2024,ATL vs POR,Garrison Mathews,mathega01,56,ATL,1,POR,21,2,1,0,0,1,21.91666667,0,2,5,11,5,9,6,6,6,0,3,22,23,24,23.9
2023-24,202403270PHI,3/27/2024,PHI vs LAC,Kyle Lowry,lowryky01,53,PHI,1,LAC,7,0,1,1,0,2,22.21666667,0,0,2,4,2,4,1,2,1,1,1,8,7,8,9.5
2023-24,202403270PHI,3/27/2024,PHI vs LAC,Amir Coffey,coffeam01,60,LAC,0,PHI,10,0,3,1,0,0,22.28333333,0,0,3,5,3,5,1,2,2,1,3,13,10,13,17.5
2023-24,202403270CHO,3/27/2024,CHO vs CLE,Nick Richards,richani01,62,CHO,1,CLE,11,10,0,0,0,1,22.4,3,7,4,4,0,0,3,4,2,0,10,11,21,21,22
2023-24,202403270MIN,3/27/2024,MIN vs DET,Kyle Anderson,anderky01,69,MIN,1,DET,14,4,5,2,0,2,22.53333333,0,4,5,8,0,0,4,5,1,2,9,19,18,23,30.3
2023-24,202403270CHO,3/27/2024,CHO vs CLE,Davis Bertans,bertada01,34,CHO,1,CLE,5,1,0,1,0,1,22.71666667,0,1,1,6,1,6,2,2,0,1,1,5,6,6,8.2
2023-24,202403270MIN,3/27/2024,MIN vs DET,James Wiseman,wisemja01,54,DET,0,MIN,11,4,0,0,0,1,22.71666667,0,4,2,4,0,0,7,8,1,0,4,11,15,15,14.8
2023-24,202403270CHO,3/27/2024,CHO vs CLE,Aleksej Pokusevski,pokusal01,19,CHO,1,CLE,10,7,1,0,0,0,22.73333333,0,7,4,4,0,0,2,4,0,0,8,11,17,18,19.9
2023-24,202403270UTA,3/27/2024,UTA vs SAS,John Collins,collijo01,67,UTA,1,SAS,18,5,1,2,0,4,22.75,1,4,5,10,2,4,6,6,3,2,6,19,23,24,27.5
2023-24,202403270MEM,3/27/2024,MEM vs LAL,Taurean Prince,princta02,70,LAL,0,MEM,15,1,1,0,0,2,23.43333333,0,1,4,5,3,4,4,6,4,0,2,16,16,17,15.7
2023-24,202403270ORL,3/27/2024,ORL vs GSW,Moses Moody,moodymo01,56,GSW,0,ORL,12,5,3,0,0,1,23.58333333,2,3,4,9,0,4,4,4,4,0,8,15,17,20,21.5
2023-24,202403270CHO,3/27/2024,CHO vs CLE,Sam Merrill,merrisa01,55,CLE,0,CHO,17,3,2,1,0,0,23.91666667,0,3,5,11,5,11,2,3,3,1,5,19,20,22,26.6
2023-24,202403270ORL,3/27/2024,ORL vs GSW,Joe Ingles,inglejo01,58,ORL,1,GSW,2,2,4,0,0,0,24.1,0,2,1,3,0,2,0,0,1,0,6,6,4,8,10.4
2023-24,202403270CHO,3/27/2024,CHO vs CLE,Georges Niang,niangge01,73,CLE,0,CHO,14,1,0,0,0,0,24.16666667,0,1,5,7,4,5,0,0,4,0,1,14,15,15,15.2
2023-24,202403270TOR,3/27/2024,TOR vs NYK,Kobi Simmons,simmoko01,2,TOR,1,NYK,2,1,6,3,1,0,24.36666667,0,1,1,6,0,3,0,0,3,4,7,8,3,9,24.2
2023-24,202403270CHO,3/27/2024,CHO vs CLE,Max Strus,strusma01,61,CLE,0,CHO,19,4,0,2,0,3,24.41666667,3,1,7,13,5,10,0,0,3,2,4,19,23,23,26.8
2023-24,202403270ORL,3/27/2024,ORL vs GSW,Jonathan Isaac,isaacjo01,50,ORL,1,GSW,9,5,1,1,2,0,24.45,1,4,3,5,2,3,1,2,2,3,6,10,14,15,25.5
2023-24,202403270OKC,3/27/2024,OKC vs HOU,Cason Wallace,wallaca01,72,OKC,1,HOU,4,2,1,0,0,1,24.51666667,0,2,2,5,0,1,0,0,2,0,3,5,6,7,6.9
2023-24,202403270CHI,3/27/2024,CHI vs IND,Myles Turner,turnemy01,71,IND,0,CHI,12,4,0,0,1,1,24.7,1,3,4,10,2,5,2,2,0,1,4,12,16,16,18.8
2023-24,202403270WAS,3/27/2024,WAS vs BRK,Marvin Bagley III,baglema01,47,WAS,1,BRK,18,6,0,0,1,0,24.83333333,1,5,7,10,2,2,2,2,0,1,6,18,24,24,28.2
2023-24,202403270MIN,3/27/2024,MIN vs DET,Mike Conley,conlemi01,67,MIN,1,DET,9,0,7,2,1,2,24.83333333,0,0,3,8,1,5,2,2,2,3,7,16,9,16,26.5
2023-24,202403270CHO,3/27/2024,CHO vs CLE,Isaac Okoro,okorois01,64,CLE,0,CHO,7,2,0,0,0,0,24.98333333,1,1,3,6,1,1,0,0,2,0,2,7,9,9,9.4
2023-24,202403270OKC,3/27/2024,OKC vs HOU,Aaron Wiggins,wiggiaa01,68,OKC,1,HOU,16,4,1,0,1,1,25.08333333,2,2,7,9,2,3,0,0,0,1,5,17,20,21,24.3
2023-24,202403270ORL,3/27/2024,ORL vs GSW,Jalen Suggs,suggsja01,65,ORL,1,GSW,4,1,2,2,0,1,25.21666667,0,1,1,7,1,5,1,2,3,2,3,6,5,7,13.2
2023-24,202403270MIN,3/27/2024,MIN vs DET,Jalen Duren,durenja01,55,DET,0,MIN,11,11,4,0,0,3,25.28333333,3,8,4,6,0,0,3,4,1,0,15,15,22,26,27.2
2023-24,202403270MEM,3/27/2024,MEM vs LAL,Spencer Dinwiddie,dinwisp01,67,LAL,0,MEM,14,7,1,1,1,2,25.36666667,1,6,4,7,3,4,3,3,2,2,8,15,21,22,27.9
2023-24,202403270MIN,3/27/2024,MIN vs DET,Nickeil Alexander-Walker,alexani01,72,MIN,1,DET,11,1,2,1,0,1,25.43333333,0,1,4,9,3,7,0,1,0,1,3,13,12,14,17.2
2023-24,202403270MEM,3/27/2024,MEM vs LAL,Scotty Pippen Jr.,pippesc02,12,MEM,1,LAL,11,2,2,2,1,2,25.61666667,0,2,4,9,2,4,1,2,4,3,4,13,13,15,23.4
2023-24,202403270PHI,3/27/2024,PHI vs LAC,Terance Mann,mannte01,65,LAC,0,PHI,14,7,0,0,0,1,25.81666667,2,5,5,10,2,7,2,2,2,0,7,14,21,21,21.4
2023-24,202403270PHI,3/27/2024,PHI vs LAC,Buddy Hield,hieldbu01,76,PHI,1,LAC,17,3,1,0,1,1,25.83333333,1,2,7,11,3,7,0,0,3,1,4,18,20,21,24.1
2023-24,202403270TOR,3/27/2024,TOR vs NYK,Garrett Temple,templga01,20,TOR,1,NYK,15,6,2,2,0,1,26.9,3,3,5,10,3,6,2,2,2,2,8,17,21,23,30.2
2023-24,202403270ATL,3/27/2024,ATL vs POR,Clint Capela,capelca01,64,ATL,1,POR,13,10,1,4,3,4,27.01666667,1,9,5,5,0,0,3,6,2,7,11,14,23,24,43.5
2023-24,202403270DEN,3/27/2024,DEN vs PHO,Drew Eubanks,eubandr01,67,PHO,0,DEN,5,4,1,0,0,0,27.1,1,3,2,3,0,0,1,1,1,0,5,6,9,10,11.3
2023-24,202403270MEM,3/27/2024,MEM vs LAL,Santi Aldama,aldamsa01,60,MEM,1,LAL,6,3,1,1,0,0,27.28333333,1,2,2,6,2,6,0,0,2,1,4,7,9,10,14.1
2023-24,202403270PHI,3/27/2024,PHI vs LAC,Ivica Zubac,zubaciv01,60,LAC,0,PHI,11,4,0,1,1,0,27.4,1,3,5,7,0,0,1,1,3,2,4,11,15,15,21.8
2023-24,202403270TOR,3/27/2024,TOR vs NYK,Kelly Olynyk,olynyke01,71,TOR,1,NYK,13,7,8,0,0,3,27.41666667,2,5,5,9,1,4,2,2,4,0,15,21,20,28,30.4
2023-24,202403270TOR,3/27/2024,TOR vs NYK,Precious Achiuwa,achiupr01,65,NYK,0,TOR,19,12,3,1,2,3,27.46666667,6,6,8,13,0,1,3,3,2,3,15,22,31,34,43.9
2023-24,202403270CHI,3/27/2024,CHI vs IND,Aaron Nesmith,nesmiaa01,65,IND,0,CHI,6,5,3,0,0,1,27.48333333,0,5,2,11,2,9,0,0,4,0,8,9,11,14,15.5
2023-24,202403270PHI,3/27/2024,PHI vs LAC,Nicolas Batum,batumni01,51,PHI,1,LAC,9,4,3,0,1,1,27.93333333,0,4,3,6,3,6,0,0,1,1,7,12,13,16,20.3
2023-24,202403270MIN,3/27/2024,MIN vs DET,Jaden McDaniels,mcdanja02,62,MIN,1,DET,20,4,0,0,0,0,28.28333333,1,3,8,14,3,7,1,1,3,0,4,20,24,24,24.8
2023-24,202403270TOR,3/27/2024,TOR vs NYK,Javon Freeman-Liberty,freemja01,13,TOR,1,NYK,14,5,3,0,0,3,28.45,2,3,5,9,1,4,3,3,2,0,8,17,19,22,21.5
2023-24,202403270TOR,3/27/2024,TOR vs NYK,Jalen Brunson,brunsja01,67,NYK,0,TOR,26,4,7,0,0,0,28.51666667,1,3,11,19,2,6,2,2,0,0,11,33,30,37,41.3
2023-24,202403270CHI,3/27/2024,CHI vs IND,Nikola Vucevic,vucevni01,68,CHI,1,IND,22,12,2,0,1,0,28.55,3,9,9,20,1,4,3,3,1,1,14,24,34,36,42.4
2023-24,202403270MIN,3/27/2024,MIN vs DET,Cade Cunningham,cunnica01,60,DET,0,MIN,32,1,2,1,0,1,28.68333333,0,1,11,23,3,8,7,8,0,1,3,34,33,35,38.2
2023-24,202403270MEM,3/27/2024,MEM vs LAL,GG Jackson II,jacksgg01,39,MEM,1,LAL,10,4,0,0,0,3,28.73333333,0,4,3,9,2,6,2,2,3,0,4,10,14,14,11.8
2023-24,202403270CHO,3/27/2024,CHO vs CLE,Tre Mann,manntr01,31,CHO,1,CLE,17,1,8,1,0,2,28.95,0,1,6,10,1,4,4,4,3,1,9,25,18,26,31.2
2023-24,202403270CHI,3/27/2024,CHI vs IND,Alex Caruso,carusal01,64,CHI,1,IND,12,7,7,2,0,0,28.98333333,2,5,5,10,2,5,0,0,1,2,14,19,19,26,36.9
2023-24,202403270MEM,3/27/2024,MEM vs LAL,D'Angelo Russell,russeda01,68,LAL,0,MEM,23,2,4,1,0,4,29.15,1,1,7,16,5,9,4,4,5,1,6,27,25,29,30.4
2023-24,202403270MIN,3/27/2024,MIN vs DET,Anthony Edwards,edwaran01,69,MIN,1,DET,9,3,5,1,0,3,29.18333333,1,2,4,11,1,4,0,2,0,1,8,14,12,17,20.1
2023-24,202403270MIN,3/27/2024,MIN vs DET,Tosan Evbuomwan,evbuoto01,13,DET,0,MIN,3,4,0,0,0,0,29.18333333,1,3,1,3,1,3,0,2,1,0,4,3,7,7,7.8
2023-24,202403270PHI,3/27/2024,PHI vs LAC,Norman Powell,powelno01,68,LAC,0,PHI,11,3,2,1,0,0,29.4,0,3,5,7,1,2,0,2,0,1,5,13,14,16,20.6
2023-24,202403270DEN,3/27/2024,DEN vs PHO,Reggie Jackson,jacksre01,73,DEN,1,PHO,11,1,3,1,0,1,29.43333333,1,0,5,14,1,7,0,0,2,1,4,14,12,15,18.7
2023-24,202403270CHO,3/27/2024,CHO vs CLE,Caris LeVert,leverca01,61,CLE,0,CHO,4,3,8,0,1,4,29.65,0,3,2,9,0,5,0,0,2,1,11,12,7,15,18.6
2023-24,202403270ATL,3/27/2024,ATL vs POR,Duop Reath,reathdu01,59,POR,0,ATL,13,5,5,1,0,1,30.21666667,1,4,6,12,1,5,0,0,3,1,10,18,18,23,28.5
2023-24,202403270CHI,3/27/2024,CHI vs IND,Pascal Siakam,siakapa01,72,IND,0,CHI,14,8,5,0,0,1,30.26666667,2,6,2,7,1,1,9,11,3,0,13,19,22,27,30.1
2023-24,202403270ATL,3/27/2024,ATL vs POR,Toumani Camara,camarto01,70,POR,0,ATL,17,4,2,1,0,2,30.28333333,1,3,7,9,3,4,0,0,2,1,6,19,21,23,25.8
2023-24,202403270MIN,3/27/2024,MIN vs DET,Troy Brown Jr.,browntr01,50,DET,0,MIN,5,3,2,2,0,1,30.35,1,2,2,8,1,4,0,0,0,2,5,7,8,10,16.6
2023-24,202403270TOR,3/27/2024,TOR vs NYK,Gradey Dick,dickgr01,52,TOR,1,NYK,23,1,0,0,0,0,30.35,1,0,10,18,3,6,0,0,1,0,1,23,24,24,24.2
2023-24,202403270UTA,3/27/2024,UTA vs SAS,Victor Wembanyama,wembavi01,64,SAS,0,UTA,19,8,6,0,5,6,30.48333333,2,6,7,15,1,4,4,7,4,5,14,25,27,33,46.6
2023-24,202403270MEM,3/27/2024,MEM vs LAL,Jaxson Hayes,hayesja02,63,LAL,0,MEM,14,7,1,1,1,1,30.5,1,6,6,7,0,0,2,2,5,2,8,15,21,22,28.9
2023-24,202403270TOR,3/27/2024,TOR vs NYK,Gary Trent Jr.,trentga02,65,TOR,1,NYK,18,2,6,0,0,1,30.6,0,2,6,11,1,2,5,6,0,0,8,24,20,26,28.4
2023-24,202403270MIN,3/27/2024,MIN vs DET,Naz Reid,reidna01,71,MIN,1,DET,21,10,4,0,0,0,30.68333333,1,9,9,18,1,8,2,2,2,0,14,25,31,35,39
2023-24,202403270CHO,3/27/2024,CHO vs CLE,Evan Mobley,mobleev01,41,CLE,0,CHO,10,6,6,1,0,0,30.8,1,5,3,7,1,2,3,4,2,1,12,16,16,22,29.2
2023-24,202403270ATL,3/27/2024,ATL vs POR,De'Andre Hunter,huntede01,48,ATL,1,POR,13,5,1,0,0,3,30.85,1,4,5,12,1,6,2,2,2,0,6,14,18,19,17.5
2023-24,202403270ORL,3/27/2024,ORL vs GSW,Franz Wagner,wagnefr01,64,ORL,1,GSW,14,5,1,1,0,1,30.98333333,2,3,6,14,0,2,2,2,1,1,6,15,19,20,23.5
2023-24,202403270CHI,3/27/2024,CHI vs IND,Tyrese Haliburton,halibty01,62,IND,0,CHI,13,4,5,0,0,2,31.06666667,2,2,4,15,3,11,2,3,2,0,9,18,17,22,23.3
2023-24,202403270UTA,3/27/2024,UTA vs SAS,Julian Champagnie,champju02,65,SAS,0,UTA,17,5,0,1,0,0,31.18333333,2,3,7,13,3,6,0,0,2,1,5,17,22,22,26
2023-24,202403270CHO,3/27/2024,CHO vs CLE,Grant Williams,willigr01,68,CHO,1,CLE,16,7,5,1,1,2,31.45,3,4,6,8,2,2,2,4,3,2,12,21,23,28,35.9
2023-24,202403270UTA,3/27/2024,UTA vs SAS,Tre Jones,jonestr01,68,SAS,0,UTA,3,4,10,0,0,4,31.75,0,4,0,2,0,0,3,4,2,0,14,13,7,17,18.8
2023-24,202403270OKC,3/27/2024,OKC vs HOU,Josh Giddey,giddejo01,71,OKC,1,HOU,31,7,4,1,1,1,31.88333333,5,2,12,20,0,3,7,11,2,2,11,35,38,42,50.4
2023-24,202403270MEM,3/27/2024,MEM vs LAL,Jake LaRavia,laravja01,28,MEM,1,LAL,25,6,4,1,0,4,31.98333333,4,2,9,14,7,9,0,1,2,1,10,29,31,35,37.2
2023-24,202403270ATL,3/27/2024,ATL vs POR,Scoot Henderson,hendesc01,54,POR,0,ATL,15,2,6,2,0,6,32.16666667,0,2,6,16,2,5,1,1,4,2,8,21,17,23,26.4
2023-24,202403270ORL,3/27/2024,ORL vs GSW,Cole Anthony,anthoco01,71,ORL,1,GSW,26,7,4,1,1,0,32.23333333,1,6,10,17,5,8,1,2,1,2,11,30,33,37,46.4
2023-24,202403270ORL,3/27/2024,ORL vs GSW,Klay Thompson,thompkl01,69,GSW,0,ORL,15,0,2,0,0,3,32.26666667,0,0,6,13,3,8,0,0,2,0,2,17,15,17,15
2023-24,202403270ORL,3/27/2024,ORL vs GSW,Paolo Banchero,banchpa01,70,ORL,1,GSW,15,8,5,0,1,4,32.3,2,6,5,17,1,7,4,7,0,1,13,20,23,28,31.1
2023-24,202403270MIN,3/27/2024,MIN vs DET,Chimezie Metu,metuch01,42,DET,0,MIN,8,7,2,2,1,2,32.36666667,2,5,3,8,1,3,1,1,4,3,9,10,15,17,26.4
2023-24,202403270DEN,3/27/2024,DEN vs PHO,Grayson Allen,allengr01,67,PHO,0,DEN,13,3,4,1,0,1,32.66666667,0,3,5,10,3,7,0,0,2,1,7,17,16,20,24.6
2023-24,202403270DEN,3/27/2024,DEN vs PHO,Michael Porter Jr.,portemi01,72,DEN,1,PHO,18,8,0,2,0,2,32.66666667,1,7,7,16,2,7,2,2,0,2,8,18,26,26,31.6
2023-24,202403270MIN,3/27/2024,MIN vs DET,Marcus Sasser,sassema01,64,DET,0,MIN,7,4,5,1,0,1,32.98333333,0,4,2,11,1,6,2,2,4,1,9,12,11,16,21.3
2023-24,202403270UTA,3/27/2024,UTA vs SAS,Taylor Hendricks,hendrita0,31,UTA,1,SAS,8,8,1,2,1,0,33.06666667,0,8,3,8,2,6,0,0,3,3,9,9,16,17,28.1
2023-24,202403270TOR,3/27/2024,TOR vs NYK,Donte DiVincenzo,divindo01,71,NYK,0,TOR,16,5,2,2,2,0,33.23333333,1,4,5,12,5,12,1,2,1,4,7,18,21,23,37
2023-24,202403270ORL,3/27/2024,ORL vs GSW,Trayce Jackson-Davis,jackstr02,58,GSW,0,ORL,8,14,3,1,1,0,33.23333333,5,9,4,8,0,1,0,0,1,2,17,11,22,25,35.3
2023-24,202403270ATL,3/27/2024,ATL vs POR,Vit Krejci,krejcvi01,12,ATL,1,POR,7,4,3,0,2,2,33.43333333,1,3,3,7,1,5,0,0,1,2,7,10,11,14,20.3
2023-24,202403270OKC,3/27/2024,OKC vs HOU,Isaiah Joe,joeis01,68,OKC,1,HOU,17,3,6,0,0,1,33.46666667,0,3,6,10,4,6,1,1,1,0,9,23,20,26,28.6
2023-24,202403270PHI,3/27/2024,PHI vs LAC,Paul George,georgpa01,66,LAC,0,PHI,22,10,4,1,1,2,33.7,2,8,7,18,5,8,3,3,4,2,14,26,32,36,44
2023-24,202403270CHI,3/27/2024,CHI vs IND,Andrew Nembhard,nembhan01,60,IND,0,CHI,18,5,2,2,0,1,33.81666667,1,4,7,12,3,5,1,2,3,2,7,20,23,25,32
2023-24,202403270CHI,3/27/2024,CHI vs IND,Ayo Dosunmu,dosunay01,71,CHI,1,IND,17,3,4,0,2,2,33.95,0,3,7,11,3,5,0,0,3,2,7,21,20,24,30.6
2023-24,202403270CHO,3/27/2024,CHO vs CLE,Vasilije Micic,micicva01,51,CHO,1,CLE,11,1,12,2,0,5,34.11666667,0,1,5,11,1,3,0,0,3,2,13,23,12,24,31.2
2023-24,202403270OKC,3/27/2024,OKC vs HOU,Luguentz Dort,dortlu01,70,OKC,1,HOU,8,4,2,1,1,1,34.13333333,0,4,2,10,0,4,4,4,2,2,6,10,12,14,20.8
2023-24,202403270MIN,3/27/2024,MIN vs DET,Rudy Gobert,goberru01,66,MIN,1,DET,11,14,4,0,2,3,34.31666667,5,9,5,5,0,0,1,1,4,2,18,15,25,29,36.8
2023-24,202403270TOR,3/27/2024,TOR vs NYK,Josh Hart,hartjo01,71,NYK,0,TOR,7,6,10,1,0,2,34.38333333,3,3,3,5,1,3,0,0,1,1,16,17,13,23,30.2
2023-24,202403270CHO,3/27/2024,CHO vs CLE,Jarrett Allen,allenja01,68,CLE,0,CHO,24,8,3,1,0,1,34.43333333,3,5,11,14,0,0,2,4,2,1,11,27,32,35,40.1
2023-24,202403270MEM,3/27/2024,MEM vs LAL,Jaren Jackson Jr.,jacksja02,63,MEM,1,LAL,17,9,3,3,1,1,34.63333333,4,5,6,16,0,4,5,6,5,4,12,20,26,29,43.3
2023-24,202403270MEM,3/27/2024,MEM vs LAL,LeBron James,jamesle01,64,LAL,0,MEM,23,14,12,1,0,4,34.75,0,14,8,14,0,1,7,11,1,1,26,35,37,49,56.8
2023-24,202403270OKC,3/27/2024,OKC vs HOU,Jabari Smith Jr.,smithja05,66,HOU,0,OKC,16,3,0,0,0,3,34.95,1,2,4,10,2,5,6,8,5,0,3,16,19,19,16.6
2023-24,202403270ORL,3/27/2024,ORL vs GSW,Stephen Curry,curryst01,66,GSW,0,ORL,17,4,10,0,0,2,35.01666667,0,4,6,18,3,8,2,2,2,0,14,27,21,31,34.8
2023-24,202403270MEM,3/27/2024,MEM vs LAL,Austin Reaves,reaveau01,74,LAL,0,MEM,13,2,11,0,0,2,35.05,1,1,4,12,0,4,5,5,1,0,13,24,15,26,29.9
2023-24,202403270CHI,3/27/2024,CHI vs IND,Coby White,whiteco01,70,CHI,1,IND,18,7,2,1,0,0,35.11666667,3,4,8,21,2,5,0,0,1,1,9,20,25,27,32.4
2023-24,202403270ORL,3/27/2024,ORL vs GSW,Andrew Wiggins,wiggian01,63,GSW,0,ORL,23,6,1,0,2,3,35.15,0,6,8,17,3,6,4,5,2,2,7,24,29,30,34.7
2023-24,202403270CHO,3/27/2024,CHO vs CLE,Brandon Miller,millebr02,65,CHO,1,CLE,31,6,1,0,1,1,35.48333333,0,6,11,19,7,13,2,2,3,1,7,32,37,38,41.7
2023-24,202403270ATL,3/27/2024,ATL vs POR,Dejounte Murray,murrade01,69,ATL,1,POR,30,3,7,2,2,1,35.5,0,3,13,20,4,8,0,0,0,4,10,37,33,40,55.1
2023-24,202403270PHI,3/27/2024,PHI vs LAC,Kawhi Leonard,leonaka01,66,LAC,0,PHI,17,9,3,2,2,1,35.56666667,4,5,7,19,0,3,3,4,2,4,12,20,26,29,43.3
2023-24,202403270MEM,3/27/2024,MEM vs LAL,Rui Hachimura,hachiru01,60,LAL,0,MEM,32,10,1,0,2,0,35.61666667,0,10,11,14,7,8,3,4,1,2,11,33,42,43,51.5
2023-24,202403270UTA,3/27/2024,UTA vs SAS,Jeremy Sochan,sochaje01,73,SAS,0,UTA,17,9,2,5,1,3,35.63333333,3,6,7,16,2,7,1,2,0,6,11,19,26,28,45.8
2023-24,202403270DEN,3/27/2024,DEN vs PHO,Kentavious Caldwell-Pope,caldwke01,67,DEN,1,PHO,13,6,6,2,1,2,36.11666667,2,4,5,9,3,6,0,0,4,3,12,19,19,25,36.2
2023-24,202403270WAS,3/27/2024,WAS vs BRK,Dorian Finney-Smith,finnedo01,63,BRK,0,WAS,4,8,1,1,0,1,36.15,1,7,2,9,0,5,0,2,0,1,9,5,12,13,17.1
2023-24,202403270DEN,3/27/2024,DEN vs PHO,Aaron Gordon,gordoaa01,66,DEN,1,PHO,18,6,2,0,0,2,36.3,2,4,7,14,1,3,3,3,2,0,8,20,24,26,26.2
2023-24,202403270ATL,3/27/2024,ATL vs POR,Dalano Banton,bantoda01,46,POR,0,ATL,31,5,9,2,0,4,36.76666667,1,4,13,23,5,11,0,0,0,2,14,40,36,45,52.5
2023-24,202403270DEN,3/27/2024,DEN vs PHO,Bradley Beal,bealbr01,44,PHO,0,DEN,10,4,7,1,1,4,36.8,1,3,3,11,3,7,1,2,1,2,11,17,14,21,27.3
2023-24,202403270CHO,3/27/2024,CHO vs CLE,Darius Garland,garlada01,49,CLE,0,CHO,14,5,12,1,0,5,37.21666667,1,4,5,15,3,10,1,1,3,1,17,26,19,31,36
2023-24,202403270ATL,3/27/2024,ATL vs POR,Bogdan Bogdanovic,bogdabo01,69,ATL,1,POR,16,4,5,3,0,0,37.28333333,2,2,7,16,2,7,0,0,1,3,9,21,20,25,37.3
2023-24,202403270DEN,3/27/2024,DEN vs PHO,Devin Booker,bookede01,59,PHO,0,DEN,17,5,9,0,0,2,37.3,0,5,5,17,2,6,5,5,2,0,14,26,22,31,34.5
2023-24,202403270WAS,3/27/2024,WAS vs BRK,Nic Claxton,claxtni01,63,BRK,0,WAS,17,13,1,2,3,1,37.48333333,4,9,8,11,0,0,1,1,3,5,14,18,30,31,48.1
2023-24,202403270OKC,3/27/2024,OKC vs HOU,Jalen Williams,willija06,65,OKC,1,HOU,23,5,10,2,1,5,37.65,1,4,9,23,3,10,2,2,5,3,15,33,28,38,48
2023-24,202403270CHI,3/27/2024,CHI vs IND,DeMar DeRozan,derozde01,71,CHI,1,IND,27,6,2,1,0,0,37.68333333,1,5,9,18,1,4,8,10,3,1,8,29,33,35,40.2
2023-24,202403270WAS,3/27/2024,WAS vs BRK,Deni Avdija,avdijde01,66,WAS,1,BRK,17,12,3,1,0,2,37.81666667,2,10,5,10,1,3,6,8,2,1,15,20,29,32,36.9
2023-24,202403270PHI,3/27/2024,PHI vs LAC,Kelly Oubre Jr.,oubreke01,59,PHI,1,LAC,17,11,2,1,0,3,38,2,9,6,17,0,3,5,5,4,1,13,19,28,30,33.2
2023-24,202403270PHI,3/27/2024,PHI vs LAC,Tobias Harris,harrito02,64,PHI,1,LAC,14,7,2,0,2,2,38.15,0,7,5,9,2,3,2,2,3,2,9,16,21,23,29.4
2023-24,202403270DEN,3/27/2024,DEN vs PHO,Kevin Durant,duranke01,66,PHO,0,DEN,30,13,3,0,5,8,38.23333333,2,11,12,20,3,4,3,3,1,5,16,33,43,46,57.1
2023-24,202403270UTA,3/27/2024,UTA vs SAS,Collin Sexton,sextoco01,73,UTA,1,SAS,26,2,9,2,1,3,38.31666667,1,1,11,20,2,6,2,2,3,3,11,35,28,37,47.9
2023-24,202403270PHI,3/27/2024,PHI vs LAC,James Harden,hardeja01,65,LAC,0,PHI,16,5,14,2,1,1,38.55,0,5,6,15,3,9,1,2,1,3,19,30,21,35,51
2023-24,202403270UTA,3/27/2024,UTA vs SAS,Devin Vassell,vassede01,67,SAS,0,UTA,31,4,6,1,0,4,38.66666667,0,4,12,20,4,8,3,4,3,1,10,37,35,41,43.8
2023-24,202403270OKC,3/27/2024,OKC vs HOU,Amen Thompson,thompam01,53,HOU,0,OKC,25,15,4,1,0,1,38.7,6,9,10,18,0,1,5,6,5,1,19,29,40,44,51
2023-24,202403270ATL,3/27/2024,ATL vs POR,Rayan Rupert,ruperra01,30,POR,0,ATL,7,6,5,0,1,1,38.78333333,0,6,2,6,1,3,2,2,4,1,11,12,13,18,23.7
2023-24,202403270MEM,3/27/2024,MEM vs LAL,Desmond Bane,banede01,42,MEM,1,LAL,26,4,16,1,0,4,39.58333333,0,4,8,17,4,9,6,6,5,1,20,42,30,46,53.8
2023-24,202403270UTA,3/27/2024,UTA vs SAS,Keyonte George,georgke01,66,UTA,1,SAS,14,1,8,0,0,5,39.58333333,0,1,5,12,2,6,2,2,2,0,9,22,15,23,22.2
2023-24,202403270TOR,3/27/2024,TOR vs NYK,Miles McBride,mcbrimi01,59,NYK,0,TOR,29,3,7,1,0,1,39.58333333,1,2,10,17,9,14,0,0,4,1,10,36,32,39,45.1
2023-24,202403270WAS,3/27/2024,WAS vs BRK,Corey Kispert,kispeco01,71,WAS,1,BRK,15,2,0,0,0,2,40.1,0,2,6,15,2,8,1,2,2,0,2,15,17,17,15.4
2023-24,202403270CHO,3/27/2024,CHO vs CLE,Miles Bridges,bridgmi02,61,CHO,1,CLE,17,5,3,3,0,3,41.08333333,2,3,7,14,1,5,2,2,0,3,8,20,22,25,33.5
2023-24,202403270DEN,3/27/2024,DEN vs PHO,Nikola Jokic,jokicni01,70,DEN,1,PHO,22,9,10,2,1,1,41.53333333,0,9,9,16,1,5,3,3,2,3,19,32,31,41,55.8
2023-24,202403270UTA,3/27/2024,UTA vs SAS,Lauri Markkanen,markkla01,55,UTA,1,SAS,25,6,2,1,0,3,42.15,1,5,8,17,3,7,6,6,1,1,8,27,31,33,35.2
2023-24,202403270OKC,3/27/2024,OKC vs HOU,Dillon Brooks,brookdi01,63,HOU,0,OKC,20,4,4,1,2,3,42.58333333,0,4,8,18,3,11,1,2,2,3,8,24,24,28,36.8
2023-24,202403270WAS,3/27/2024,WAS vs BRK,Dennis Schroder,schrode01,73,BRK,0,WAS,21,4,8,1,1,1,42.71666667,1,3,8,19,3,6,2,2,1,2,12,29,25,33,42.8
2023-24,202403270OKC,3/27/2024,OKC vs HOU,Fred VanVleet,vanvlfr01,65,HOU,0,OKC,13,4,6,3,0,1,43.03333333,1,3,5,12,1,7,2,2,4,3,10,19,17,23,34.8
2023-24,202403270WAS,3/27/2024,WAS vs BRK,Kyle Kuzma,kuzmaky01,68,WAS,1,BRK,24,6,10,0,0,0,43.55,0,6,10,19,3,4,1,2,6,0,16,34,30,40,46.2
2023-24,202403270PHI,3/27/2024,PHI vs LAC,Tyrese Maxey,maxeyty01,64,PHI,1,LAC,26,7,8,1,2,2,43.9,0,7,9,20,3,8,5,6,1,3,15,34,33,41,53.4
2023-24,202403270WAS,3/27/2024,WAS vs BRK,Jordan Poole,poolejo01,71,WAS,1,BRK,38,7,8,0,0,4,44.5,0,7,15,24,5,12,3,3,4,0,15,46,45,53,54.4
2023-24,202403270WAS,3/27/2024,WAS vs BRK,Cam Thomas,thomaca02,57,BRK,0,WAS,38,2,7,1,1,2,45.13333333,0,2,14,27,2,6,8,8,3,2,9,45,40,47,54.9
2023-24,202403270OKC,3/27/2024,OKC vs HOU,Jalen Green,greenja05,72,HOU,0,OKC,37,10,7,2,1,5,46.36666667,2,8,14,24,7,11,2,2,3,3,17,44,47,54,63.5
2023-24,202403270WAS,3/27/2024,WAS vs BRK,Mikal Bridges,bridgmi01,73,BRK,0,WAS,19,6,4,2,2,0,47.38333333,1,5,7,16,3,9,2,2,1,4,10,23,25,29,44.2
2023-24,202403260NOP,3/26/2024,NOP vs OKC,Gordon Hayward,haywago01,42,OKC,0,NOP,0,0,0,0,0,0,10,0,0,0,2,0,0,0,0,0,0,0,0,0,0,0
2023-24,202403260NOP,3/26/2024,NOP vs OKC,Jonas Valanciunas,valanjo01,72,NOP,1,OKC,6,6,1,0,0,0,10.5,2,4,2,4,0,1,2,3,0,0,7,7,12,13,14.7
2023-24,202403260SAC,3/26/2024,SAC vs DAL,Maxi Kleber,klebima01,35,DAL,0,SAC,0,0,0,1,0,1,10.96666667,0,0,0,0,0,0,0,0,0,1,0,0,0,0,2
2023-24,202403260SAC,3/26/2024,SAC vs DAL,Alex Len,lenal01,38,SAC,1,DAL,5,3,1,0,1,0,11.23333333,2,1,2,3,0,0,1,2,3,1,4,6,8,9,13.1
2023-24,202403260MIL,3/26/2024,MIL vs LAL,A.J. Green,greenaj01,48,MIL,1,LAL,0,2,0,1,0,0,12.06666667,0,2,0,2,0,2,0,0,1,1,2,0,2,2,5.4
2023-24,202403260SAC,3/26/2024,SAC vs DAL,Chris Duarte,duartch01,52,SAC,1,DAL,3,1,0,1,1,1,12.76666667,0,1,1,5,1,4,0,0,1,2,1,3,4,4,9.2
2023-24,202403260NOP,3/26/2024,NOP vs OKC,Cason Wallace,wallaca01,71,OKC,0,NOP,7,1,0,0,0,0,13.2,0,1,3,4,1,1,0,0,1,0,1,7,8,8,8.2
2023-24,202403260MIA,3/26/2024,MIA vs GSW,Gary Payton II,paytoga02,36,GSW,0,MIA,2,0,0,1,1,0,13.5,0,0,1,3,0,0,0,0,1,2,0,2,2,2,8
2023-24,202403260NOP,3/26/2024,NOP vs OKC,Jaylin Williams,willija07,58,OKC,0,NOP,3,7,2,0,0,3,13.51666667,0,7,1,1,1,1,0,0,2,0,9,5,10,12,11.4
2023-24,202403260SAC,3/26/2024,SAC vs DAL,Davion Mitchell,mitchda01,62,SAC,1,DAL,6,0,2,0,0,0,15.93333333,0,0,2,5,2,3,0,0,0,0,2,8,6,8,9
2023-24,202403260MIA,3/26/2024,MIA vs GSW,Delon Wright,wrighde01,42,MIA,1,GSW,0,3,3,0,0,0,16.01666667,1,2,0,3,0,1,0,0,0,0,6,3,3,6,8.1
2023-24,202403260NOP,3/26/2024,NOP vs OKC,Jose Alvarado,alvarjo01,51,NOP,1,OKC,8,3,3,1,0,0,16.11666667,1,2,3,7,2,6,0,0,2,1,6,11,11,14,19.1
2023-24,202403260NOP,3/26/2024,NOP vs OKC,Isaiah Joe,joeis01,67,OKC,0,NOP,6,3,2,1,0,0,16.21666667,0,3,2,4,2,4,0,0,1,1,5,8,9,11,15.6
2023-24,202403260MIL,3/26/2024,MIL vs LAL,Jaxson Hayes,hayesja02,62,LAL,0,MIL,2,4,0,0,0,3,16.93333333,1,3,1,1,0,0,0,1,3,0,4,2,6,6,3.8
2023-24,202403260MIA,3/26/2024,MIA vs GSW,Patty Mills,millspa02,29,MIA,1,GSW,2,0,1,0,0,1,17.63333333,0,0,1,5,0,2,0,0,1,0,1,3,2,3,2.5
2023-24,202403260NOP,3/26/2024,NOP vs OKC,Kenrich Williams,willike04,58,OKC,0,NOP,6,3,2,1,0,0,18.08333333,1,2,3,4,0,1,0,0,1,1,5,8,9,11,15.6
2023-24,202403260MIL,3/26/2024,MIL vs LAL,Jae Crowder,crowdja01,41,MIL,1,LAL,5,2,0,1,0,0,18.25,0,2,2,4,1,2,0,0,2,1,2,5,7,7,10.4
2023-24,202403260MIA,3/26/2024,MIA vs GSW,Kevon Looney,looneke01,64,GSW,0,MIA,7,6,1,0,0,0,18.71666667,1,5,3,5,0,0,1,2,3,0,7,8,13,14,15.7
2023-24,202403260SAC,3/26/2024,SAC vs DAL,Derrick Jones Jr.,jonesde02,67,DAL,0,SAC,8,3,3,1,1,0,21.23333333,0,3,2,5,2,4,2,2,0,2,6,11,11,14,22.1
2023-24,202403260MIL,3/26/2024,MIL vs LAL,Pat Connaughton,connapa01,66,MIL,1,LAL,3,3,9,0,0,2,21.76666667,0,3,1,4,1,4,0,0,1,0,12,12,6,15,18.1
2023-24,202403260SAC,3/26/2024,SAC vs DAL,Daniel Gafford,gaffoda01,65,DAL,0,SAC,10,4,3,1,0,1,21.85,2,2,5,7,0,0,0,0,4,1,7,13,14,17,21.3
2023-24,202403260SAC,3/26/2024,SAC vs DAL,Dante Exum,exumda01,46,DAL,0,SAC,6,2,4,1,0,1,21.96666667,0,2,2,4,2,3,0,0,1,1,6,10,8,12,16.4
2023-24,202403260SAC,3/26/2024,SAC vs DAL,Dereck Lively II,livelde01,53,DAL,0,SAC,4,7,1,1,2,0,21.96666667,0,7,2,5,0,0,0,0,1,3,8,5,11,12,22.9
2023-24,202403260MIA,3/26/2024,MIA vs GSW,Brandin Podziemski,podzibr01,63,GSW,0,MIA,6,5,1,1,0,1,22.03333333,1,4,3,5,0,2,0,1,1,1,6,7,11,12,15.5
2023-24,202403260MIA,3/26/2024,MIA vs GSW,Chris Paul,paulch01,47,GSW,0,MIA,0,2,7,2,0,3,23.01666667,0,2,0,2,0,1,0,0,2,2,9,7,2,9,15.9
2023-24,202403260NOP,3/26/2024,NOP vs OKC,Naji Marshall,marshna01,60,NOP,1,OKC,7,4,1,1,0,1,23.36666667,0,4,3,6,1,4,0,0,3,1,5,8,11,12,15.3
2023-24,202403260SAC,3/26/2024,SAC vs DAL,Harrison Barnes,barneha02,72,SAC,1,DAL,7,5,3,1,0,0,24.36666667,2,3,3,10,1,4,0,0,0,1,8,10,12,15,20.5
2023-24,202403260MIA,3/26/2024,MIA vs GSW,Jaime Jaquez Jr.,jaqueja01,65,MIA,1,GSW,12,2,1,0,0,2,25.93333333,1,1,4,10,1,4,3,4,2,0,3,13,14,15,13.9
2023-24,202403260SAC,3/26/2024,SAC vs DAL,Tim Hardaway Jr.,hardati02,69,DAL,0,SAC,22,3,6,1,1,0,26.25,1,2,8,14,4,6,2,3,2,2,9,28,25,31,40.6
2023-24,202403260SAC,3/26/2024,SAC vs DAL,Malik Monk,monkma01,71,SAC,1,DAL,10,4,3,1,1,3,27.3,0,4,5,13,0,2,0,0,4,2,7,13,14,17,22.3
2023-24,202403260MIA,3/26/2024,MIA vs GSW,Draymond Green,greendr01,46,GSW,0,MIA,4,9,8,2,0,1,27.71666667,0,9,2,5,0,1,0,0,5,2,17,12,13,21,31.8
2023-24,202403260MIL,3/26/2024,MIL vs LAL,Taurean Prince,princta02,69,LAL,0,MIL,9,4,1,0,0,3,28,0,4,3,10,1,5,2,2,0,0,5,10,13,14,12.3
2023-24,202403260SAC,3/26/2024,SAC vs DAL,Keon Ellis,elliske01,47,SAC,1,DAL,10,4,2,0,0,0,28.3,0,4,4,5,1,2,1,1,1,0,6,12,14,16,17.8
2023-24,202403260MIA,3/26/2024,MIA vs GSW,Haywood Highsmith,highsha01,56,MIA,1,GSW,15,6,2,2,0,0,29.96666667,2,4,6,7,3,3,0,0,1,2,8,17,21,23,31.2
2023-24,202403260MIL,3/26/2024,MIL vs LAL,Bobby Portis,portibo01,72,MIL,1,LAL,18,13,0,1,1,1,30.33333333,3,10,7,15,2,3,2,2,3,2,13,18,31,31,38.6
2023-24,202403260MIA,3/26/2024,MIA vs GSW,Andrew Wiggins,wiggian01,62,GSW,0,MIA,17,7,1,0,2,1,30.6,0,7,7,12,1,5,2,2,1,2,8,18,24,25,31.9
2023-24,202403260NOP,3/26/2024,NOP vs OKC,Josh Giddey,giddejo01,70,OKC,0,NOP,25,9,4,0,0,3,30.71666667,1,8,10,14,5,8,0,0,1,0,13,29,34,38,38.8
2023-24,202403260MIA,3/26/2024,MIA vs GSW,Nikola Jovic,jovicni01,36,MIA,1,GSW,11,6,4,0,0,0,30.91666667,2,4,4,11,2,7,1,2,0,0,10,15,17,21,24.2
2023-24,202403260NOP,3/26/2024,NOP vs OKC,Herbert Jones,joneshe01,66,NOP,1,OKC,16,2,4,1,1,2,30.95,0,2,4,12,2,8,6,6,5,2,6,20,18,22,28.4
2023-24,202403260MIA,3/26/2024,MIA vs GSW,Klay Thompson,thompkl01,68,GSW,0,MIA,28,5,2,0,1,1,30.96666667,1,4,11,20,6,14,0,0,1,1,7,30,33,35,39
2023-24,202403260MIA,3/26/2024,MIA vs GSW,Stephen Curry,curryst01,65,GSW,0,MIA,17,2,6,0,0,1,31.01666667,1,1,7,15,3,10,0,0,1,0,8,23,19,25,27.4
2023-24,202403260SAC,3/26/2024,SAC vs DAL,Domantas Sabonis,sabondo01,72,SAC,1,DAL,12,11,9,0,2,4,31.28333333,1,10,3,10,0,1,6,8,1,2,20,21,23,32,40.7
2023-24,202403260SAC,3/26/2024,SAC vs DAL,Luka Doncic,doncilu01,63,DAL,0,SAC,28,11,6,2,0,4,31.68333333,1,10,10,18,4,8,4,5,4,2,17,34,39,45,52.2
2023-24,202403260MIA,3/26/2024,MIA vs GSW,Jonathan Kuminga,kuminjo01,70,GSW,0,MIA,18,7,3,0,1,1,31.68333333,3,4,8,13,0,2,2,3,3,1,10,21,25,28,32.9
2023-24,202403260SAC,3/26/2024,SAC vs DAL,De'Aaron Fox,foxde01,64,SAC,1,DAL,18,5,3,1,0,3,31.86666667,2,3,6,18,2,4,4,4,3,1,8,21,23,26,28.5
2023-24,202403260SAC,3/26/2024,SAC vs DAL,P.J. Washington,washipj01,64,DAL,0,SAC,14,13,2,0,0,0,32.33333333,1,12,5,11,4,6,0,2,2,0,15,16,27,29,32.6
2023-24,202403260NOP,3/26/2024,NOP vs OKC,Luguentz Dort,dortlu01,69,OKC,0,NOP,6,6,1,1,0,3,32.41666667,2,4,2,6,1,4,1,1,3,1,7,7,12,13,14.7
2023-24,202403260NOP,3/26/2024,NOP vs OKC,Larry Nance Jr.,nancela02,53,NOP,1,OKC,4,2,0,1,0,0,32.55,1,1,2,4,0,0,0,0,0,1,2,4,6,6,9.4
2023-24,202403260MIA,3/26/2024,MIA vs GSW,Terry Rozier,roziete01,55,MIA,1,GSW,15,4,2,0,1,1,32.55,0,4,7,18,1,6,0,0,3,1,6,17,19,21,24.8
2023-24,202403260MIL,3/26/2024,MIL vs LAL,Brook Lopez,lopezbr01,69,MIL,1,LAL,9,6,1,1,0,0,33.16666667,1,5,4,7,1,4,0,0,2,1,7,10,15,16,20.7
2023-24,202403260SAC,3/26/2024,SAC vs DAL,Keegan Murray,murrake02,67,SAC,1,DAL,17,3,1,1,0,1,33.43333333,1,2,6,11,2,6,3,4,1,1,4,18,20,21,24.1
2023-24,202403260NOP,3/26/2024,NOP vs OKC,Chet Holmgren,holmgch01,71,OKC,0,NOP,16,9,4,0,2,1,33.48333333,0,9,7,13,1,6,1,2,3,2,13,20,25,29,37.8
2023-24,202403260NOP,3/26/2024,NOP vs OKC,Jalen Williams,willija06,64,OKC,0,NOP,26,2,5,0,1,2,34.11666667,1,1,9,18,3,6,5,5,4,1,7,31,28,33,36.9
2023-24,202403260MIA,3/26/2024,MIA vs GSW,Caleb Martin,martica02,55,MIA,1,GSW,10,5,6,0,0,0,34.28333333,1,4,4,12,0,4,2,2,0,0,11,16,15,21,25
2023-24,202403260SAC,3/26/2024,SAC vs DAL,Kyrie Irving,irvinky01,50,DAL,0,SAC,24,3,8,2,0,1,34.5,0,3,10,19,4,9,0,1,4,2,11,32,27,35,44.6
2023-24,202403260NOP,3/26/2024,NOP vs OKC,Shai Gilgeous-Alexander,gilgesh01,70,OKC,0,NOP,24,5,8,2,0,0,38.25,2,3,9,20,1,3,5,6,1,2,13,32,29,37,48
2023-24,202403260NOP,3/26/2024,NOP vs OKC,Zion Williamson,willizi01,61,NOP,1,OKC,29,5,10,3,0,5,38.5,1,4,10,17,0,0,9,10,4,3,15,39,34,44,54
2023-24,202403260MIL,3/26/2024,MIL vs LAL,Khris Middleton,middlkh01,47,MIL,1,LAL,12,6,7,1,0,1,38.56666667,2,4,4,15,2,7,2,2,5,1,13,19,18,25,31.7
2023-24,202403260MIA,3/26/2024,MIA vs GSW,Bam Adebayo,adebaba01,61,MIA,1,GSW,24,9,5,1,1,1,38.61666667,3,6,10,21,1,3,3,4,1,2,14,29,33,38,47.3
2023-24,202403260MIL,3/26/2024,MIL vs LAL,Rui Hachimura,hachiru01,59,LAL,0,MIL,16,14,1,0,0,1,38.66666667,4,10,7,14,0,2,2,2,2,0,15,17,30,31,33.3
2023-24,202403260NOP,3/26/2024,NOP vs OKC,Trey Murphy III,murphtr02,47,NOP,1,OKC,16,6,2,0,1,0,38.88333333,0,6,6,10,4,6,0,1,2,1,8,18,22,24,29.2
2023-24,202403260MIL,3/26/2024,MIL vs LAL,Malik Beasley,beaslma01,69,MIL,1,LAL,21,3,1,1,1,1,40.2,0,3,8,18,5,14,0,0,3,2,4,22,24,25,31.1
2023-24,202403260NOP,3/26/2024,NOP vs OKC,CJ McCollum,mccolcj01,56,NOP,1,OKC,23,6,5,0,0,0,41.38333333,0,6,8,24,4,11,3,3,2,0,11,28,29,34,37.7
2023-24,202403260MIL,3/26/2024,MIL vs LAL,Spencer Dinwiddie,dinwisp01,66,LAL,0,MIL,7,2,4,0,1,1,42.23333333,0,2,1,8,1,5,4,4,4,1,6,11,9,13,17.4
2023-24,202403260MIL,3/26/2024,MIL vs LAL,Giannis Antetokounmpo,antetgi01,67,MIL,1,LAL,29,21,11,2,3,7,46.41666667,8,13,14,25,0,1,1,6,3,5,32,40,50,61,78.7
2023-24,202403260MIL,3/26/2024,MIL vs LAL,Austin Reaves,reaveau01,73,LAL,0,MIL,29,14,10,0,2,1,47.58333333,2,12,10,20,4,11,5,6,3,2,24,39,43,53,65.8
2023-24,202403260MIL,3/26/2024,MIL vs LAL,Damian Lillard,lillada01,67,MIL,1,LAL,27,5,8,1,0,2,49.23333333,1,4,9,29,3,14,6,7,6,1,13,35,32,40,46
2023-24,202403260MIL,3/26/2024,MIL vs LAL,D'Angelo Russell,russeda01,67,LAL,0,MIL,29,7,12,2,1,4,50.38333333,1,6,7,22,5,12,10,10,0,3,19,41,36,48,60.4
2023-24,202403260MIL,3/26/2024,MIL vs LAL,Anthony Davis,davisan02,69,LAL,0,MIL,34,23,2,2,4,4,51.86666667,7,16,12,31,3,8,7,7,1,6,25,36,57,59,78.6
2023-24,202403250SAC,3/25/2024,SAC vs PHI,Alex Len,lenal01,37,SAC,1,PHI,7,5,0,0,2,1,10.53333333,1,4,3,3,0,0,1,1,0,2,5,7,12,12,18
2023-24,202403250ATL,3/25/2024,ATL vs BOS,Oshae Brissett,brissos01,48,BOS,0,ATL,0,1,2,0,0,0,10.85,0,1,0,0,0,0,0,0,1,0,3,2,1,3,4.2
2023-24,202403250ATL,3/25/2024,ATL vs BOS,Svi Mykhailiuk,mykhasv01,33,BOS,0,ATL,6,0,3,0,0,0,10.98333333,0,0,2,2,2,2,0,0,0,0,3,9,6,9,10.5
2023-24,202403250LAC,3/25/2024,LAC vs IND,Doug McDermott,mcderdo01,56,IND,0,LAC,0,1,0,0,0,0,11.26666667,0,1,0,2,0,2,0,0,2,0,1,0,1,1,1.2
2023-24,202403250TOR,3/25/2024,TOR vs BRK,Jacob Gilyard,gilyaja01,38,BRK,0,TOR,0,0,1,1,0,0,11.38333333,0,0,0,2,0,2,0,0,2,1,1,1,0,1,4.5
2023-24,202403250CHI,3/25/2024,CHI vs WAS,Dalen Terry,terryda01,49,CHI,1,WAS,0,1,1,0,0,0,11.46666667,1,0,0,0,0,0,0,0,0,0,2,1,1,2,2.7
2023-24,202403250LAC,3/25/2024,LAC vs IND,P.J. Tucker,tuckepj01,24,LAC,1,IND,0,2,0,1,0,1,11.83333333,0,2,0,1,0,1,0,0,3,1,2,0,2,2,4.4
2023-24,202403250SAC,3/25/2024,SAC vs PHI,Mo Bamba,bambamo01,50,PHI,0,SAC,5,6,0,0,0,0,12.15,5,1,1,3,0,1,3,3,4,0,6,5,11,11,12.2
2023-24,202403250TOR,3/25/2024,TOR vs BRK,Mouhamadou Gueye,gueyemo01,6,TOR,1,BRK,2,1,0,0,0,0,12.15,1,0,1,3,0,1,0,0,0,0,1,2,3,3,3.2
2023-24,202403250SAC,3/25/2024,SAC vs PHI,Chris Duarte,duartch01,51,SAC,1,PHI,4,0,0,1,0,0,12.81666667,0,0,1,5,0,4,2,2,1,1,0,4,4,4,7
2023-24,202403250UTA,3/25/2024,UTA vs DAL,Johnny Juzang,juzanjo01,12,UTA,1,DAL,0,3,2,0,0,0,13.25,2,1,0,4,0,4,0,0,1,0,5,2,3,5,6.6
2023-24,202403250CHI,3/25/2024,CHI vs WAS,Jules Bernard,bernaju01,13,WAS,0,CHI,3,2,1,1,0,0,13.35,0,2,1,5,1,2,0,0,3,1,3,4,5,6,9.9
2023-24,202403250LAC,3/25/2024,LAC vs IND,Jalen Smith,smithja04,52,IND,0,LAC,9,5,1,0,2,0,13.78333333,2,3,3,6,0,0,3,4,1,2,6,10,14,15,22.5
2023-24,202403250DEN,3/25/2024,DEN vs MEM,DeAndre Jordan,jordade01,32,DEN,1,MEM,0,6,1,0,2,0,13.91666667,1,5,0,2,0,0,0,0,1,2,7,1,6,7,14.7
2023-24,202403250SAC,3/25/2024,SAC vs PHI,D.J. Wilson,wilsodj01,2,PHI,0,SAC,10,2,2,0,2,0,13.95,1,1,4,6,2,2,0,0,1,2,4,12,12,14,21.4
2023-24,202403250CLE,3/25/2024,CLE vs CHO,Craig Porter Jr.,portecr01,47,CLE,1,CHO,9,1,4,0,1,0,14.43333333,0,1,4,6,1,2,0,1,0,1,5,13,10,14,19.2
2023-24,202403250HOU,3/25/2024,HOU vs POR,Reggie Bullock,bullore01,33,HOU,1,POR,3,5,0,0,1,0,15,1,4,1,1,1,1,0,0,0,1,5,3,8,8,12
2023-24,202403250SAS,3/25/2024,SAS vs PHO,Cedi Osman,osmande01,68,SAS,1,PHO,7,2,0,1,0,0,15.01666667,0,2,2,4,2,4,1,2,2,1,2,7,9,9,12.4
2023-24,202403250UTA,3/25/2024,UTA vs DAL,Maxi Kleber,klebima01,34,DAL,0,UTA,2,3,0,0,1,0,15.48333333,1,2,1,4,0,3,0,0,1,1,3,2,5,5,8.6
2023-24,202403250UTA,3/25/2024,UTA vs DAL,Dante Exum,exumda01,45,DAL,0,UTA,3,1,3,0,0,0,15.5,0,1,1,2,1,2,0,0,2,0,4,6,4,7,8.7
2023-24,202403250NYK,3/25/2024,NYK vs DET,Tosan Evbuomwan,evbuoto01,12,DET,0,NYK,3,2,0,0,0,0,15.56666667,1,1,1,3,1,1,0,0,3,0,2,3,5,5,5.4
2023-24,202403250CHI,3/25/2024,CHI vs WAS,Jevon Carter,carteje01,66,CHI,1,WAS,8,0,1,0,0,0,15.95,0,0,3,5,2,4,0,0,1,0,1,9,8,9,9.5
2023-24,202403250TOR,3/25/2024,TOR vs BRK,Garrett Temple,templga01,19,TOR,1,BRK,2,3,4,1,0,0,16.05,0,3,1,2,0,1,0,0,1,1,7,6,5,9,14.6
2023-24,202403250UTA,3/25/2024,UTA vs DAL,Brice Sensabaugh,sensabr01,22,UTA,1,DAL,3,3,1,0,0,2,16.35,0,3,1,3,1,2,0,0,2,0,4,4,6,7,6.1
2023-24,202403250UTA,3/25/2024,UTA vs DAL,Walker Kessler,kesslwa01,60,UTA,1,DAL,9,4,0,1,0,0,16.6,1,3,4,4,0,0,1,2,2,1,4,9,13,13,16.8
2023-24,202403250NYK,3/25/2024,NYK vs DET,Chimezie Metu,metuch01,41,DET,0,NYK,6,2,4,2,1,0,16.76666667,0,2,3,4,0,0,0,0,3,3,6,10,8,12,23.4
2023-24,202403250CLE,3/25/2024,CLE vs CHO,Davis Bertans,bertada01,33,CHO,0,CLE,3,0,1,0,0,0,17.11666667,0,0,1,4,1,2,0,0,0,0,1,4,3,4,4.5
2023-24,202403250ATL,3/25/2024,ATL vs BOS,Wesley Matthews,matthwe02,31,ATL,1,BOS,6,4,0,0,0,1,17.21666667,1,3,2,4,2,3,0,0,0,0,4,6,10,10,9.8
2023-24,202403250LAC,3/25/2024,LAC vs IND,Terance Mann,mannte01,64,LAC,1,IND,6,3,0,0,0,0,17.28333333,1,2,2,5,1,2,1,2,1,0,3,6,9,9,9.6
2023-24,202403250TOR,3/25/2024,TOR vs BRK,Kobi Simmons,simmoko01,1,TOR,1,BRK,7,2,0,2,0,1,17.28333333,1,1,3,6,1,2,0,0,1,2,2,7,9,9,14.4
2023-24,202403250CHI,3/25/2024,CHI vs WAS,Marvin Bagley III,baglema01,46,WAS,0,CHI,16,2,0,0,0,1,17.33333333,1,1,7,8,0,0,2,2,0,0,2,16,18,18,17.4
2023-24,202403250SAS,3/25/2024,SAS vs PHO,Dominick Barlow,barlodo01,32,SAS,1,PHO,0,3,0,0,0,2,17.83333333,0,3,0,1,0,0,0,0,2,0,3,0,3,3,1.6
2023-24,202403250UTA,3/25/2024,UTA vs DAL,Derrick Jones Jr.,jonesde02,66,DAL,0,UTA,6,1,0,1,0,0,17.91666667,0,1,2,3,0,1,2,3,1,1,1,6,7,7,10.2
2023-24,202403250NYK,3/25/2024,NYK vs DET,Bojan Bogdanovic,bogdabo02,46,NYK,1,DET,13,0,1,0,0,2,18.28333333,0,0,5,11,2,7,1,2,2,0,1,14,13,14,12.5
2023-24,202403250LAC,3/25/2024,LAC vs IND,Russell Westbrook,westbru01,59,LAC,1,IND,14,4,7,0,0,1,18.3,2,2,5,10,0,2,4,6,1,0,11,21,18,25,28.3
2023-24,202403250UTA,3/25/2024,UTA vs DAL,Dereck Lively II,livelde01,52,DAL,0,UTA,6,9,0,1,0,0,18.33333333,0,9,3,3,0,0,0,0,1,1,9,6,15,15,19.8
2023-24,202403250NYK,3/25/2024,NYK vs DET,Buddy Boeheim,boehebu01,4,DET,0,NYK,6,3,0,0,1,0,18.45,0,3,2,6,2,6,0,0,2,1,3,6,9,9,12.6
2023-24,202403250CHI,3/25/2024,CHI vs WAS,Andre Drummond,drumman01,72,CHI,1,WAS,10,12,1,0,2,0,18.55,3,9,5,9,0,0,0,0,0,2,13,11,22,23,31.9
2023-24,202403250ATL,3/25/2024,ATL vs BOS,Garrison Mathews,mathega01,55,ATL,1,BOS,6,1,0,0,0,0,18.75,0,1,2,2,2,2,0,0,3,0,1,6,7,7,7.2
2023-24,202403250ATL,3/25/2024,ATL vs BOS,Bruno Fernando,fernabr01,34,ATL,1,BOS,13,3,3,0,0,2,18.86666667,2,1,6,7,0,0,1,2,3,0,6,16,16,19,19.1
2023-24,202403250SAC,3/25/2024,SAC vs PHI,KJ Martin,martike04,55,PHI,0,SAC,4,5,1,0,1,2,18.98333333,2,3,2,6,0,2,0,0,5,1,6,5,9,10,12.5
2023-24,202403250CHI,3/25/2024,CHI vs WAS,Torrey Craig,craigto01,43,CHI,1,WAS,5,2,2,2,0,0,19.01666667,0,2,2,7,1,6,0,0,1,2,4,7,7,9,16.4
2023-24,202403250SAS,3/25/2024,SAS vs PHO,Jusuf Nurkic,nurkiju01,68,PHO,0,SAS,6,9,4,1,2,1,19.33333333,1,8,3,9,0,0,0,2,1,3,13,10,15,19,30.8
2023-24,202403250CLE,3/25/2024,CLE vs CHO,Aleksej Pokusevski,pokusal01,18,CHO,0,CLE,11,5,3,2,1,1,19.35,2,3,4,7,1,2,2,3,2,3,8,14,16,19,29.5
2023-24,202403250NYK,3/25/2024,NYK vs DET,Evan Fournier,fournev01,23,DET,0,NYK,15,2,2,1,0,1,19.71666667,0,2,5,11,1,4,4,4,1,1,4,17,17,19,22.4
2023-24,202403250SAS,3/25/2024,SAS vs PHO,Julian Champagnie,champju02,64,SAS,1,PHO,6,0,0,1,0,1,20.08333333,0,0,2,5,0,2,2,2,2,1,0,6,6,6,8
2023-24,202403250DEN,3/25/2024,DEN vs MEM,DeJon Jarreau,jarrede01,8,MEM,0,DEN,5,4,3,0,0,1,20.21666667,2,2,2,6,1,4,0,3,1,0,7,8,9,12,13.3
2023-24,202403250CHI,3/25/2024,CHI vs WAS,Johnny Davis,davisjo06,41,WAS,0,CHI,8,2,3,0,0,0,20.26666667,1,1,3,6,2,4,0,0,0,0,5,11,10,13,14.9
2023-24,202403250TOR,3/25/2024,TOR vs BRK,Jordan Nwora,nworajo01,43,TOR,1,BRK,5,4,2,2,0,1,20.31666667,0,4,2,7,0,3,1,2,1,2,6,7,9,11,17.8
2023-24,202403250HOU,3/25/2024,HOU vs POR,Jae'Sean Tate,tateja01,61,HOU,1,POR,8,4,2,0,1,1,20.58333333,3,1,4,7,0,2,0,0,0,1,6,10,12,14,17.8
2023-24,202403250TOR,3/25/2024,TOR vs BRK,Noah Clowney,clownno01,13,BRK,0,TOR,7,6,0,1,1,1,20.86666667,1,5,3,7,1,3,0,2,0,2,6,7,13,13,19.2
2023-24,202403250TOR,3/25/2024,TOR vs BRK,Trendon Watford,watfotr01,53,BRK,0,TOR,19,7,0,0,0,4,20.95,2,5,7,10,2,4,3,5,5,0,7,19,26,26,23.4
2023-24,202403250SAS,3/25/2024,SAS vs PHO,Blake Wesley,weslebl01,51,SAS,1,PHO,5,2,3,1,0,1,20.95,0,2,2,7,1,2,0,0,0,1,5,8,7,10,13.9
2023-24,202403250SAC,3/25/2024,SAC vs PHI,Nicolas Batum,batumni01,50,PHI,0,SAC,0,3,0,0,0,1,20.98333333,2,1,0,3,0,2,0,0,0,0,3,0,3,3,2.6
2023-24,202403250DEN,3/25/2024,DEN vs MEM,Collin Gillespie,gilleco01,21,DEN,1,MEM,4,4,7,1,0,2,21,0,4,2,5,0,3,0,0,1,1,11,11,8,15,20.3
2023-24,202403250LAC,3/25/2024,LAC vs IND,Ben Sheppard,sheppbe01,49,IND,0,LAC,7,5,0,2,0,0,21.15,0,5,2,3,1,2,2,2,3,2,5,7,12,12,19
2023-24,202403250SAS,3/25/2024,SAS vs PHO,Drew Eubanks,eubandr01,66,PHO,0,SAS,2,6,4,0,0,2,21.26666667,3,3,1,3,0,0,0,0,4,0,10,6,8,12,13.2
2023-24,202403250DEN,3/25/2024,DEN vs MEM,Trey Jemison,jemistr01,18,MEM,0,DEN,8,5,1,1,1,2,21.66666667,3,2,3,5,0,0,2,2,1,2,6,9,13,14,19.5
2023-24,202403250DEN,3/25/2024,DEN vs MEM,Justin Holiday,holidju01,48,DEN,1,MEM,11,3,2,2,0,0,21.68333333,1,2,4,6,3,4,0,0,1,2,5,13,14,16,23.6
2023-24,202403250DEN,3/25/2024,DEN vs MEM,Peyton Watson,watsope01,70,DEN,1,MEM,10,9,2,1,3,1,21.68333333,2,7,4,9,0,1,2,2,5,4,11,12,19,21,34.8
2023-24,202403250TOR,3/25/2024,TOR vs BRK,Bruce Brown,brownbr01,61,TOR,1,BRK,10,2,1,1,0,2,21.78333333,0,2,4,7,1,1,1,2,2,1,3,11,12,13,14.9
2023-24,202403250DEN,3/25/2024,DEN vs MEM,Julian Strawther,strawju01,42,DEN,1,MEM,14,2,1,0,0,2,21.95,1,1,5,11,2,7,2,2,3,0,3,15,16,17,15.9
2023-24,202403250DEN,3/25/2024,DEN vs MEM,Christian Braun,braunch01,72,DEN,1,MEM,17,5,2,0,0,1,22.05,3,2,8,10,1,2,0,0,2,0,7,19,22,24,25
2023-24,202403250DEN,3/25/2024,DEN vs MEM,Michael Porter Jr.,portemi01,71,DEN,1,MEM,11,4,2,1,0,1,22.05,1,3,4,7,3,4,0,0,0,1,6,13,15,17,20.8
2023-24,202403250SAC,3/25/2024,SAC vs PHI,Paul Reed,reedpa01,72,PHI,0,SAC,8,8,2,1,1,4,22.55,1,7,3,5,0,0,2,2,2,2,10,10,16,18,22.6
2023-24,202403250DEN,3/25/2024,DEN vs MEM,Jake LaRavia,laravja01,27,MEM,0,DEN,3,2,2,1,0,0,22.9,0,2,1,9,0,7,1,4,2,1,4,5,5,7,11.4
2023-24,202403250DEN,3/25/2024,DEN vs MEM,Lamar Stevens,stevela01,32,MEM,0,DEN,19,3,2,1,0,0,22.93333333,1,2,6,10,0,1,7,7,1,1,5,21,22,24,28.6
2023-24,202403250HOU,3/25/2024,HOU vs POR,Rayan Rupert,ruperra01,29,POR,0,HOU,9,4,1,0,0,1,23.16666667,0,4,3,8,3,4,0,0,3,0,5,10,13,14,14.3
2023-24,202403250CLE,3/25/2024,CLE vs CHO,Nick Richards,richani01,61,CHO,0,CLE,11,3,1,0,2,1,23.3,1,2,3,6,0,0,5,5,0,2,4,12,14,15,21.1
2023-24,202403250LAC,3/25/2024,LAC vs IND,T.J. McConnell,mccontj01,63,IND,0,LAC,15,2,6,0,0,1,23.51666667,0,2,7,14,1,2,0,0,1,0,8,21,17,23,25.4
2023-24,202403250HOU,3/25/2024,HOU vs POR,Ashton Hagans,haganas01,15,POR,0,HOU,8,4,3,0,0,2,23.56666667,2,2,4,8,0,3,0,0,2,0,7,11,12,15,15.3
2023-24,202403250HOU,3/25/2024,HOU vs POR,Aaron Holiday,holidaa01,68,HOU,1,POR,11,3,4,1,0,0,23.75,1,2,2,6,1,1,6,6,2,1,7,15,14,18,23.6
2023-24,202403250HOU,3/25/2024,HOU vs POR,Jeff Green,greenje02,67,HOU,1,POR,6,4,1,0,1,1,23.76666667,0,4,2,4,2,4,0,0,2,1,5,7,10,11,14.3
2023-24,202403250SAC,3/25/2024,SAC vs PHI,Keon Ellis,elliske01,46,SAC,1,PHI,5,2,1,0,1,0,23.93333333,1,1,2,5,1,3,0,0,4,1,3,6,7,8,11.9
2023-24,202403250HOU,3/25/2024,HOU vs POR,Duop Reath,reathdu01,58,POR,0,HOU,8,4,0,0,1,0,23.98333333,1,3,3,8,0,2,2,2,5,1,4,8,12,12,15.8
2023-24,202403250NYK,3/25/2024,NYK vs DET,Jaden Ivey,iveyja01,68,DET,0,NYK,9,4,3,2,1,2,24,2,2,2,14,1,6,4,4,2,3,7,12,13,16,25.3
2023-24,202403250LAC,3/25/2024,LAC vs IND,Ivica Zubac,zubaciv01,59,LAC,1,IND,9,11,2,0,0,0,24.03333333,4,7,4,8,0,0,1,2,2,0,13,11,20,22,25.2
2023-24,202403250DEN,3/25/2024,DEN vs MEM,Reggie Jackson,jacksre01,72,DEN,1,MEM,15,1,8,1,0,2,24.05,1,0,4,9,2,3,5,5,1,1,9,23,16,24,29.2
2023-24,202403250NYK,3/25/2024,NYK vs DET,Isaiah Hartenstein,harteis01,65,NYK,1,DET,6,10,5,1,3,0,24.23333333,2,8,3,6,0,0,0,0,3,4,15,11,16,21,37.5
2023-24,202403250SAS,3/25/2024,SAS vs PHO,Eric Gordon,gordoer01,59,PHO,0,SAS,2,2,0,0,0,1,24.4,0,2,1,4,0,3,0,0,1,0,2,2,4,4,3.4
2023-24,202403250LAC,3/25/2024,LAC vs IND,Andrew Nembhard,nembhan01,59,IND,0,LAC,9,0,2,1,0,0,24.48333333,0,0,4,9,1,2,0,0,3,1,2,11,9,11,15
2023-24,202403250HOU,3/25/2024,HOU vs POR,Scoot Henderson,hendesc01,53,POR,0,HOU,15,3,4,0,0,5,24.53333333,0,3,6,14,1,5,2,2,5,0,7,19,18,22,19.6
2023-24,202403250LAC,3/25/2024,LAC vs IND,Obi Toppin,toppiob01,74,IND,0,LAC,7,4,1,1,0,0,24.65,2,2,3,4,1,1,0,0,0,1,5,8,11,12,16.3
2023-24,202403250SAC,3/25/2024,SAC vs PHI,Cameron Payne,payneca01,68,PHI,0,SAC,8,3,6,0,0,2,24.71666667,1,2,3,10,2,5,0,0,4,0,9,14,11,17,18.6
2023-24,202403250CLE,3/25/2024,CLE vs CHO,Georges Niang,niangge01,72,CLE,1,CHO,17,3,2,0,0,1,24.73333333,0,3,6,11,5,10,0,0,4,0,5,19,20,22,22.6
2023-24,202403250SAC,3/25/2024,SAC vs PHI,Davion Mitchell,mitchda01,61,SAC,1,PHI,18,2,0,0,0,0,24.78333333,1,1,6,9,3,4,3,4,2,0,2,18,20,20,20.4
2023-24,202403250NYK,3/25/2024,NYK vs DET,Troy Brown Jr.,browntr01,49,DET,0,NYK,5,6,0,0,0,1,24.85,1,5,1,6,1,3,2,2,1,0,6,5,11,11,11.2
2023-24,202403250CLE,3/25/2024,CLE vs CHO,Evan Mobley,mobleev01,40,CLE,1,CHO,17,7,8,1,0,1,24.93333333,1,6,8,12,0,2,1,3,2,1,15,25,24,32,39.4
2023-24,202403250CLE,3/25/2024,CLE vs CHO,Sam Merrill,merrisa01,54,CLE,1,CHO,12,4,2,0,0,0,25.16666667,1,3,4,8,4,8,0,0,0,0,6,14,16,18,19.8
2023-24,202403250NYK,3/25/2024,NYK vs DET,Jared Rhoden,rhodeja01,9,DET,0,NYK,3,2,3,0,0,1,25.16666667,0,2,1,3,1,2,0,0,3,0,5,6,5,8,8.9
2023-24,202403250SAC,3/25/2024,SAC vs PHI,Kyle Lowry,lowryky01,52,PHI,0,SAC,3,2,1,1,0,2,25.38333333,1,1,1,4,1,4,0,0,3,1,3,4,5,6,7.9
2023-24,202403250SAC,3/25/2024,SAC vs PHI,Tobias Harris,harrito02,63,PHI,0,SAC,12,8,0,0,0,2,25.7,0,8,5,15,0,2,2,2,2,0,8,12,20,20,19.6
2023-24,202403250SAS,3/25/2024,SAS vs PHO,Royce O'Neale,onealro01,69,PHO,0,SAS,12,5,2,0,1,1,25.75,0,5,5,6,2,3,0,0,0,1,7,14,17,19,23
2023-24,202403250DEN,3/25/2024,DEN vs MEM,Kentavious Caldwell-Pope,caldwke01,66,DEN,1,MEM,9,2,2,1,0,2,25.76666667,0,2,3,6,1,2,2,2,1,1,4,11,11,13,15.4
2023-24,202403250NYK,3/25/2024,NYK vs DET,Precious Achiuwa,achiupr01,64,NYK,1,DET,9,16,1,1,1,2,25.83333333,5,11,3,5,0,0,3,6,2,2,17,10,25,26,33.7
2023-24,202403250HOU,3/25/2024,HOU vs POR,Jabari Walker,walkeja01,63,POR,0,HOU,7,5,0,0,0,0,25.88333333,1,4,3,6,0,1,1,2,3,0,5,7,12,12,13
2023-24,202403250LAC,3/25/2024,LAC vs IND,Myles Turner,turnemy01,70,IND,0,LAC,24,7,0,0,1,1,26.18333333,1,6,8,12,4,6,4,6,4,1,7,24,31,31,34.4
2023-24,202403250DEN,3/25/2024,DEN vs MEM,Scotty Pippen Jr.,pippesc02,11,MEM,0,DEN,17,2,4,0,0,5,26.21666667,1,1,5,9,3,6,4,4,3,0,6,21,19,23,20.4
2023-24,202403250HOU,3/25/2024,HOU vs POR,Fred VanVleet,vanvlfr01,64,HOU,1,POR,15,3,4,2,1,2,26.28333333,0,3,5,18,2,8,3,3,5,3,7,19,18,22,31.6
2023-24,202403250DEN,3/25/2024,DEN vs MEM,Jaren Jackson Jr.,jacksja02,62,MEM,0,DEN,11,4,5,2,4,1,26.33333333,3,1,4,18,1,7,2,4,4,6,9,16,15,20,40.3
2023-24,202403250SAC,3/25/2024,SAC vs PHI,Harrison Barnes,barneha02,71,SAC,1,PHI,6,3,1,0,0,1,26.35,0,3,2,8,1,4,1,1,1,0,4,7,9,10,10.1
2023-24,202403250CHI,3/25/2024,CHI vs WAS,Patrick Baldwin Jr.,baldwpa01,29,WAS,0,CHI,2,6,2,2,1,1,26.4,0,6,1,5,0,2,0,0,0,3,8,4,8,10,20.2
2023-24,202403250SAC,3/25/2024,SAC vs PHI,Malik Monk,monkma01,70,SAC,1,PHI,11,4,4,1,0,1,26.48333333,1,3,4,11,0,5,3,3,1,1,8,15,15,19,23.8
2023-24,202403250ATL,3/25/2024,ATL vs BOS,Sam Hauser,hausesa01,69,BOS,0,ATL,6,5,0,2,2,0,26.73333333,1,4,2,10,2,10,0,0,2,4,5,6,11,11,24
2023-24,202403250SAS,3/25/2024,SAS vs PHO,Tre Jones,jonestr01,67,SAS,1,PHO,2,3,4,1,0,0,27.05,1,2,1,4,0,0,0,0,0,1,7,6,5,9,14.6
2023-24,202403250LAC,3/25/2024,LAC vs IND,Amir Coffey,coffeam01,59,LAC,1,IND,2,5,2,0,1,0,27.06666667,2,3,1,3,0,2,0,0,3,1,7,4,7,9,14
2023-24,202403250CLE,3/25/2024,CLE vs CHO,Grant Williams,willigr01,67,CHO,0,CLE,12,2,1,2,1,0,27.06666667,1,1,5,12,1,6,1,1,4,3,3,13,14,15,24.9
2023-24,202403250UTA,3/25/2024,UTA vs DAL,Daniel Gafford,gaffoda01,64,DAL,0,UTA,13,11,5,2,5,0,27.28333333,4,7,6,7,0,0,1,2,2,7,16,18,24,29,54.7
2023-24,202403250CHI,3/25/2024,CHI vs WAS,Jared Butler,butleja02,30,WAS,0,CHI,8,4,13,2,2,4,27.36666667,2,2,3,12,0,6,2,2,3,4,17,21,12,25,40.3
2023-24,202403250ATL,3/25/2024,ATL vs BOS,Payton Pritchard,pritcpa01,72,BOS,0,ATL,15,5,6,0,0,0,27.56666667,1,4,7,12,1,5,0,2,3,0,11,21,20,26,30
2023-24,202403250CHI,3/25/2024,CHI vs WAS,Justin Champagnie,champju01,10,WAS,0,CHI,8,3,3,0,1,0,27.73333333,0,3,2,8,2,8,2,4,4,1,6,11,11,14,19.1
2023-24,202403250HOU,3/25/2024,HOU vs POR,Amen Thompson,thompam01,52,HOU,1,POR,12,9,2,1,1,1,28,6,3,6,12,0,1,0,0,0,2,11,14,21,23,30.8
2023-24,202403250UTA,3/25/2024,UTA vs DAL,Tim Hardaway Jr.,hardati02,68,DAL,0,UTA,13,2,4,3,0,0,28.63333333,0,2,5,14,3,9,0,0,2,3,6,17,15,19,30.4
2023-24,202403250UTA,3/25/2024,UTA vs DAL,Taylor Hendricks,hendrita0,30,UTA,1,DAL,8,6,1,0,1,0,28.9,1,5,3,8,1,5,1,1,3,1,7,9,14,15,19.7
2023-24,202403250ATL,3/25/2024,ATL vs BOS,Clint Capela,capelca01,63,ATL,1,BOS,14,12,3,0,2,1,29.1,5,7,6,10,0,0,2,4,3,2,15,17,26,29,37.9
2023-24,202403250UTA,3/25/2024,UTA vs DAL,Collin Sexton,sextoco01,72,UTA,1,DAL,20,2,6,0,0,1,29.15,1,1,8,15,3,6,1,1,2,0,8,26,22,28,30.4
2023-24,202403250TOR,3/25/2024,TOR vs BRK,Javon Freeman-Liberty,freemja01,12,TOR,1,BRK,15,4,2,1,0,0,29.3,1,3,7,12,0,2,1,2,2,1,6,17,19,21,25.8
2023-24,202403250CHI,3/25/2024,CHI vs WAS,Jordan Poole,poolejo01,70,WAS,0,CHI,23,3,5,0,0,2,29.31666667,1,2,8,20,4,12,3,3,4,0,8,28,26,31,32.1
2023-24,202403250LAC,3/25/2024,LAC vs IND,Jarace Walker,walkeja02,29,IND,0,LAC,8,4,7,1,0,0,29.38333333,0,4,3,3,2,2,0,0,2,1,11,15,12,19,26.3
2023-24,202403250HOU,3/25/2024,HOU vs POR,Dillon Brooks,brookdi01,62,HOU,1,POR,11,2,1,0,0,0,29.45,0,2,2,13,0,8,7,7,4,0,3,12,13,14,14.9
2023-24,202403250TOR,3/25/2024,TOR vs BRK,Kelly Olynyk,olynyke01,70,TOR,1,BRK,10,4,9,1,1,4,29.61666667,2,2,4,9,0,3,2,2,3,2,13,19,14,23,30.3
2023-24,202403250NYK,3/25/2024,NYK vs DET,Malachi Flynn,flynnma01,59,DET,0,NYK,14,4,3,2,1,2,29.65,1,3,5,12,2,6,2,2,2,3,7,17,18,21,30.3
2023-24,202403250CHI,3/25/2024,CHI vs WAS,Nikola Vucevic,vucevni01,67,CHI,1,WAS,9,16,3,0,3,3,29.65,3,13,3,5,0,1,3,4,2,3,19,12,25,28,38.7
2023-24,202403250NYK,3/25/2024,NYK vs DET,Jalen Brunson,brunsja01,66,NYK,1,DET,28,2,6,0,0,0,30.06666667,0,2,10,20,3,7,5,5,3,0,8,34,30,36,39.4
2023-24,202403250SAS,3/25/2024,SAS vs PHO,Zach Collins,colliza01,59,SAS,1,PHO,18,5,3,1,0,3,30.08333333,2,3,7,14,0,3,4,6,3,1,8,21,23,26,28.5
2023-24,202403250TOR,3/25/2024,TOR vs BRK,Gary Trent Jr.,trentga02,64,TOR,1,BRK,18,2,2,0,0,0,30.31666667,0,2,7,17,2,7,2,2,2,0,4,20,20,22,23.4
2023-24,202403250TOR,3/25/2024,TOR vs BRK,Dorian Finney-Smith,finnedo01,62,BRK,0,TOR,11,5,3,1,1,0,30.33333333,3,2,4,6,1,3,2,2,0,2,8,14,16,19,27.5
2023-24,202403250TOR,3/25/2024,TOR vs BRK,Jalen Wilson,wilsoja03,33,BRK,0,TOR,12,5,2,0,0,0,30.36666667,1,4,4,10,1,4,3,3,0,0,7,14,17,19,21
2023-24,202403250DEN,3/25/2024,DEN vs MEM,GG Jackson II,jacksgg01,38,MEM,0,DEN,15,3,2,1,0,1,30.43333333,1,2,6,15,2,8,1,1,0,1,5,17,18,20,23.6
2023-24,202403250SAS,3/25/2024,SAS vs PHO,Bradley Beal,bealbr01,43,PHO,0,SAS,9,5,6,2,0,1,30.45,0,5,4,11,1,4,0,0,0,2,11,15,14,20,29
2023-24,202403250UTA,3/25/2024,UTA vs DAL,John Collins,collijo01,66,UTA,1,DAL,21,11,2,2,0,0,30.6,3,8,9,16,2,5,1,3,0,2,13,23,32,34,43.2
2023-24,202403250CLE,3/25/2024,CLE vs CHO,Isaac Okoro,okorois01,63,CLE,1,CHO,14,5,3,0,0,1,30.61666667,3,2,5,11,3,7,1,2,1,0,8,17,19,22,23.5
2023-24,202403250TOR,3/25/2024,TOR vs BRK,Ochai Agbaji,agbajoc01,71,TOR,1,BRK,11,5,1,1,1,0,30.63333333,3,2,5,11,1,2,0,0,1,2,6,12,16,17,24.5
2023-24,202403250CHI,3/25/2024,CHI vs WAS,Richaun Holmes,holmeri01,39,WAS,0,CHI,14,15,2,1,1,2,30.63333333,6,9,6,10,0,1,2,3,4,2,17,16,29,31,39
2023-24,202403250CLE,3/25/2024,CLE vs CHO,Vasilije Micic,micicva01,50,CHO,0,CLE,2,2,4,0,0,2,30.73333333,0,2,1,4,0,1,0,0,1,0,6,6,4,8,8.4
2023-24,202403250SAS,3/25/2024,SAS vs PHO,Keldon Johnson,johnske04,67,SAS,1,PHO,14,3,5,1,0,0,30.83333333,0,3,5,9,2,2,2,2,2,1,8,19,17,22,28.1
2023-24,202403250DEN,3/25/2024,DEN vs MEM,Nikola Jokic,jokicni01,69,DEN,1,MEM,29,11,8,3,1,4,30.85,5,6,11,18,1,2,6,7,4,4,19,37,40,48,62.2
2023-24,202403250LAC,3/25/2024,LAC vs IND,Pascal Siakam,siakapa01,71,IND,0,LAC,31,4,2,0,0,2,30.85,2,2,12,20,1,2,6,8,2,0,6,33,35,37,36.8
2023-24,202403250LAC,3/25/2024,LAC vs IND,Norman Powell,powelno01,67,LAC,1,IND,22,3,0,0,0,1,30.86666667,0,3,8,13,2,5,4,4,2,0,3,22,25,25,24.6
2023-24,202403250LAC,3/25/2024,LAC vs IND,Tyrese Haliburton,halibty01,61,IND,0,LAC,21,1,9,2,0,3,31,0,1,7,12,6,9,1,1,2,2,10,30,22,31,38.7
2023-24,202403250DEN,3/25/2024,DEN vs MEM,Santi Aldama,aldamsa01,59,MEM,0,DEN,5,9,3,1,4,1,31.06666667,2,7,2,4,1,3,0,0,1,5,12,8,14,17,34.3
2023-24,202403250NYK,3/25/2024,NYK vs DET,James Wiseman,wisemja01,53,DET,0,NYK,14,11,1,0,1,4,31.23333333,2,9,7,11,0,0,0,0,3,1,12,15,25,26,27.7
2023-24,202403250HOU,3/25/2024,HOU vs POR,Kris Murray,murrakr01,52,POR,0,HOU,4,6,1,2,1,0,31.41666667,2,4,2,11,0,6,0,0,1,3,7,5,10,11,21.7
2023-24,202403250HOU,3/25/2024,HOU vs POR,Jock Landale,landajo01,45,HOU,1,POR,17,9,2,0,1,0,32,2,7,6,6,2,2,3,3,1,1,11,19,26,28,33.8
2023-24,202403250SAC,3/25/2024,SAC vs PHI,Buddy Hield,hieldbu01,75,PHI,0,SAC,7,5,3,0,0,0,32.08333333,1,4,3,9,0,6,1,1,0,0,8,10,12,15,17.5
2023-24,202403250DEN,3/25/2024,DEN vs MEM,Desmond Bane,banede01,41,MEM,0,DEN,15,3,3,1,0,3,32.31666667,1,2,6,14,2,6,1,1,2,1,6,18,18,21,23.1
2023-24,202403250TOR,3/25/2024,TOR vs BRK,Gradey Dick,dickgr01,51,TOR,1,BRK,8,3,2,1,0,2,32.55,0,3,3,11,0,5,2,2,2,1,5,10,11,13,15.6
2023-24,202403250CLE,3/25/2024,CLE vs CHO,Darius Garland,garlada01,48,CLE,1,CHO,15,4,10,1,0,3,32.88333333,1,3,6,12,2,6,1,1,1,1,14,25,19,29,34.8
2023-24,202403250ATL,3/25/2024,ATL vs BOS,Vit Krejci,krejcvi01,11,ATL,1,BOS,16,6,2,1,0,3,32.96666667,2,4,6,11,4,7,0,0,3,1,8,18,22,24,26.2
2023-24,202403250UTA,3/25/2024,UTA vs DAL,Jordan Clarkson,clarkjo01,55,UTA,1,DAL,4,4,8,0,0,5,33.08333333,0,4,0,7,0,2,4,5,1,0,12,12,8,16,15.8
2023-24,202403250CHI,3/25/2024,CHI vs WAS,Alex Caruso,carusal01,63,CHI,1,WAS,12,6,5,2,1,1,33.21666667,1,5,4,8,2,4,2,2,4,3,11,17,18,23,34.7
2023-24,202403250LAC,3/25/2024,LAC vs IND,Paul George,georgpa01,65,LAC,1,IND,26,1,3,2,1,1,33.25,0,1,12,18,2,4,0,0,2,3,4,29,27,30,39.7
2023-24,202403250CLE,3/25/2024,CLE vs CHO,Caris LeVert,leverca01,60,CLE,1,CHO,7,7,7,1,2,4,33.28333333,1,6,3,13,1,5,0,0,3,3,14,14,14,21,30.9
2023-24,202403250CLE,3/25/2024,CLE vs CHO,Jarrett Allen,allenja01,67,CLE,1,CHO,17,13,4,1,0,0,33.3,2,11,7,9,0,0,3,3,1,1,17,21,30,34,41.6
2023-24,202403250SAC,3/25/2024,SAC vs PHI,Domantas Sabonis,sabondo01,71,SAC,1,PHI,11,13,10,0,1,3,33.36666667,5,8,3,5,0,0,5,8,4,1,23,21,24,34,41.6
2023-24,202403250CLE,3/25/2024,CLE vs CHO,Tre Mann,manntr01,30,CHO,0,CLE,12,7,5,0,0,3,33.63333333,1,6,5,11,2,3,0,0,2,0,12,17,19,24,24.9
2023-24,202403250LAC,3/25/2024,LAC vs IND,James Harden,hardeja01,64,LAC,1,IND,11,3,7,1,0,1,33.7,0,3,3,7,0,1,5,5,3,1,10,18,14,21,27.1
2023-24,202403250ATL,3/25/2024,ATL vs BOS,De'Andre Hunter,huntede01,47,ATL,1,BOS,24,7,3,0,0,2,33.73333333,3,4,8,14,4,8,4,4,3,0,10,27,31,34,34.9
2023-24,202403250CHI,3/25/2024,CHI vs WAS,Ayo Dosunmu,dosunay01,70,CHI,1,WAS,12,2,3,0,0,2,33.75,1,1,4,9,2,4,2,3,3,0,5,15,14,17,16.9
2023-24,202403250UTA,3/25/2024,UTA vs DAL,Lauri Markkanen,markkla01,54,UTA,1,DAL,34,7,2,1,1,1,33.76666667,3,4,10,19,6,9,8,8,2,2,9,36,41,43,50.4
2023-24,202403250ATL,3/25/2024,ATL vs BOS,Kristaps Porzingis,porzikr01,50,BOS,0,ATL,17,5,2,0,3,3,34.13333333,5,0,7,14,1,4,2,2,3,3,7,19,22,24,32
2023-24,202403250SAC,3/25/2024,SAC vs PHI,Tyrese Maxey,maxeyty01,63,PHI,0,SAC,29,3,2,0,0,2,34.5,0,3,10,16,5,7,4,6,3,0,5,31,32,34,33.6
2023-24,202403250SAS,3/25/2024,SAS vs PHO,Grayson Allen,allengr01,66,PHO,0,SAS,6,4,2,0,0,0,34.6,0,4,2,5,0,2,2,3,2,0,6,8,10,12,13.8
2023-24,202403250NYK,3/25/2024,NYK vs DET,Marcus Sasser,sassema01,63,DET,0,NYK,24,1,6,1,0,1,34.6,0,1,7,18,1,6,9,10,2,1,7,30,25,31,36.2
2023-24,202403250SAS,3/25/2024,SAS vs PHO,Devin Vassell,vassede01,66,SAS,1,PHO,26,4,7,3,0,0,35.05,0,4,11,24,2,9,2,2,2,3,11,33,30,37,50.3
2023-24,202403250UTA,3/25/2024,UTA vs DAL,Keyonte George,georgke01,65,UTA,1,DAL,6,5,6,2,0,3,35.1,0,5,2,11,0,6,2,2,2,2,11,12,11,17,24
2023-24,202403250UTA,3/25/2024,UTA vs DAL,P.J. Washington,washipj01,63,DAL,0,UTA,16,4,1,1,0,0,35.11666667,3,1,6,12,2,6,2,2,2,1,5,17,20,21,25.3
2023-24,202403250HOU,3/25/2024,HOU vs POR,Toumani Camara,camarto01,69,POR,0,HOU,12,5,0,2,2,4,35.23333333,3,2,4,9,1,3,3,3,4,4,5,12,17,17,26
2023-24,202403250TOR,3/25/2024,TOR vs BRK,Nic Claxton,claxtni01,62,BRK,0,TOR,9,16,2,0,1,3,35.25,5,11,4,5,0,0,1,2,4,1,18,11,25,27,31.2
2023-24,202403250ATL,3/25/2024,ATL vs BOS,Al Horford,horfoal01,59,BOS,0,ATL,7,9,2,1,1,1,35.53333333,1,8,3,5,1,2,0,0,1,2,11,9,16,18,25.8
2023-24,202403250SAS,3/25/2024,SAS vs PHO,Jeremy Sochan,sochaje01,72,SAS,1,PHO,26,18,1,1,1,0,35.61666667,2,16,10,19,1,7,5,5,2,2,19,27,44,45,55.1
2023-24,202403250UTA,3/25/2024,UTA vs DAL,Kyrie Irving,irvinky01,49,DAL,0,UTA,27,3,5,0,0,2,35.88333333,0,3,10,21,4,9,3,3,2,0,8,32,30,35,36.1
2023-24,202403250SAS,3/25/2024,SAS vs PHO,Kevin Durant,duranke01,65,PHO,0,SAS,29,8,6,1,0,3,36.13333333,0,8,12,17,4,6,1,2,2,1,14,35,37,43,47.6
2023-24,202403250CHI,3/25/2024,CHI vs WAS,Coby White,whiteco01,69,CHI,1,WAS,22,4,5,0,1,1,36.28333333,0,4,6,20,2,11,8,8,1,1,9,27,26,31,36.3
2023-24,202403250TOR,3/25/2024,TOR vs BRK,Dennis Schroder,schrode01,72,BRK,0,TOR,19,5,7,0,0,3,36.61666667,2,3,7,15,1,7,4,4,2,0,12,26,24,31,32.5
2023-24,202403250SAC,3/25/2024,SAC vs PHI,De'Aaron Fox,foxde01,63,SAC,1,PHI,23,8,5,2,1,0,36.8,2,6,8,18,2,6,5,6,2,3,13,28,31,36,49.1
2023-24,202403250CLE,3/25/2024,CLE vs CHO,Brandon Miller,millebr02,64,CHO,0,CLE,24,8,3,0,0,3,36.96666667,0,8,8,18,3,8,5,5,1,0,11,27,32,35,35.1
2023-24,202403250TOR,3/25/2024,TOR vs BRK,Mikal Bridges,bridgmi01,72,BRK,0,TOR,13,3,4,0,0,7,37,1,2,5,15,3,12,0,0,0,0,7,17,16,20,15.6
2023-24,202403250ATL,3/25/2024,ATL vs BOS,Jaylen Brown,brownja02,64,BOS,0,ATL,24,4,1,2,0,1,37.01666667,2,2,10,22,2,7,2,4,3,2,5,25,28,29,35.3
2023-24,202403250SAC,3/25/2024,SAC vs PHI,Keegan Murray,murrake02,66,SAC,1,PHI,23,3,4,1,1,0,37.58333333,0,3,9,20,3,11,2,3,2,2,7,27,26,30,38.6
2023-24,202403250CLE,3/25/2024,CLE vs CHO,Miles Bridges,bridgmi02,60,CHO,0,CLE,13,6,2,1,0,1,37.6,1,5,5,14,1,5,2,4,3,1,8,15,19,21,25.2
2023-24,202403250CHI,3/25/2024,CHI vs WAS,DeMar DeRozan,derozde01,70,CHI,1,WAS,27,2,6,5,1,3,37.76666667,0,2,9,22,1,4,8,11,1,6,8,33,29,35,53.4
2023-24,202403250LAC,3/25/2024,LAC vs IND,Kawhi Leonard,leonaka01,65,LAC,1,IND,26,4,3,0,2,3,38.06666667,2,2,11,18,1,2,3,3,2,2,7,29,30,33,38.3
2023-24,202403250CHI,3/25/2024,CHI vs WAS,Corey Kispert,kispeco01,70,WAS,0,CHI,19,12,3,2,0,2,38.56666667,3,9,6,18,3,10,4,4,1,2,15,22,31,34,41.9
2023-24,202403250HOU,3/25/2024,HOU vs POR,Dalano Banton,bantoda01,45,POR,0,HOU,28,11,5,1,2,3,38.85,1,10,11,21,2,9,4,4,1,3,16,33,39,44,54.7
2023-24,202403250ATL,3/25/2024,ATL vs BOS,Jayson Tatum,tatumja01,67,BOS,0,ATL,37,8,5,2,1,2,39.38333333,2,6,13,26,2,7,9,11,1,3,13,42,45,50,61.1
2023-24,202403250ATL,3/25/2024,ATL vs BOS,Bogdan Bogdanovic,bogdabo01,68,ATL,1,BOS,22,4,3,1,0,2,39.55,0,4,8,15,4,7,2,3,3,1,7,25,26,29,32.3
2023-24,202403250NYK,3/25/2024,NYK vs DET,Josh Hart,hartjo01,70,NYK,1,DET,11,14,10,1,0,3,39.8,3,11,4,10,1,3,2,2,0,1,24,21,25,35,42.8
2023-24,202403250SAS,3/25/2024,SAS vs PHO,Devin Booker,bookede01,58,PHO,0,SAS,36,6,4,1,3,5,39.98333333,1,5,14,28,3,10,5,7,4,4,10,40,42,46,56.2
2023-24,202403250HOU,3/25/2024,HOU vs POR,Jalen Green,greenja05,71,HOU,1,POR,27,6,3,3,1,3,40.15,0,6,9,26,4,12,5,6,2,4,9,30,33,36,47.7
2023-24,202403250ATL,3/25/2024,ATL vs BOS,Dejounte Murray,murrade01,68,ATL,1,BOS,19,5,15,3,0,1,40.61666667,1,4,8,22,2,9,1,4,0,3,20,34,24,39,55.5
2023-24,202403250NYK,3/25/2024,NYK vs DET,Donte DiVincenzo,divindo01,70,NYK,1,DET,40,5,2,2,1,4,40.83333333,1,4,14,23,11,20,1,3,2,3,7,42,45,47,54
2023-24,202403250UTA,3/25/2024,UTA vs DAL,Luka Doncic,doncilu01,62,DAL,0,UTA,29,12,13,1,1,4,41.18333333,2,10,10,24,2,11,7,8,3,2,25,42,41,54,64.9
2023-24,202403250NYK,3/25/2024,NYK vs DET,Miles McBride,mcbrimi01,58,NYK,1,DET,13,5,4,1,0,0,43.3,1,4,5,12,1,7,2,2,4,1,9,17,18,22,28
2023-24,202403240MIA,3/24/2024,MIA vs CLE,Tristan Thompson,thomptr01,41,CLE,0,MIA,6,3,1,0,1,2,10.03333333,2,1,3,4,0,0,0,0,0,1,4,7,9,10,12.1
2023-24,202403240MIA,3/24/2024,MIA vs CLE,Emoni Bates,batesem01,12,CLE,0,MIA,9,0,1,0,0,0,10.53333333,0,0,3,5,3,4,0,0,0,0,1,10,9,10,10.5
2023-24,202403240MIA,3/24/2024,MIA vs CLE,Damian Jones,jonesda03,32,CLE,0,MIA,9,0,0,0,0,1,10.53333333,0,0,3,3,0,0,3,3,3,0,0,9,9,9,8
2023-24,202403240MIN,3/24/2024,MIN vs GSW,Jordan McLaughlin,mclaujo01,45,MIN,1,GSW,3,1,2,0,0,0,11.8,1,0,1,3,1,2,0,0,0,0,3,5,4,6,7.2
2023-24,202403240LAC,3/24/2024,LAC vs PHI,Brandon Boston Jr.,bostobr01,26,LAC,1,PHI,4,2,0,0,0,0,11.83333333,0,2,2,4,0,0,0,0,1,0,2,4,6,6,6.4
2023-24,202403240LAC,3/24/2024,LAC vs PHI,Jeff Dowtin,dowtije01,6,PHI,0,LAC,3,4,3,0,0,0,12.03333333,0,4,1,3,1,3,0,0,0,0,7,6,7,10,12.3
2023-24,202403240DET,3/24/2024,DET vs NOP,Jared Rhoden,rhodeja01,8,DET,1,NOP,5,3,0,0,2,0,12.03333333,0,3,2,5,1,3,0,0,3,2,3,5,8,8,14.6
2023-24,202403240LAC,3/24/2024,LAC vs PHI,Mason Plumlee,plumlma01,36,LAC,1,PHI,8,5,1,0,1,2,12.48333333,2,3,2,2,0,0,4,4,1,1,6,9,13,14,16.5
2023-24,202403240LAL,3/24/2024,LAL vs IND,Isaiah Jackson,jacksis01,53,IND,0,LAL,5,4,1,1,0,1,13.46666667,2,2,2,4,0,0,1,1,3,1,5,6,9,10,13.3
2023-24,202403240MIL,3/24/2024,MIL vs OKC,Gordon Hayward,haywago01,41,OKC,0,MIL,0,2,3,0,0,1,14.4,1,1,0,3,0,1,0,0,0,0,5,3,2,5,5.9
2023-24,202403240MIL,3/24/2024,MIL vs OKC,Patrick Beverley,beverpa01,66,MIL,1,OKC,1,4,4,0,2,0,14.95,1,3,0,2,0,1,1,2,1,2,8,5,5,9,17.8
2023-24,202403240LAL,3/24/2024,LAL vs IND,Ben Sheppard,sheppbe01,48,IND,0,LAL,2,0,3,0,0,1,15.81666667,0,0,1,2,0,1,0,0,4,0,3,5,2,5,5.5
2023-24,202403240MIN,3/24/2024,MIN vs GSW,Monte Morris,morrimo01,22,MIN,1,GSW,8,2,3,2,1,0,17.16666667,0,2,3,6,2,4,0,0,1,3,5,11,10,13,23.9
2023-24,202403240LAL,3/24/2024,LAL vs IND,T.J. McConnell,mccontj01,62,IND,0,LAL,17,3,7,1,0,2,17.78333333,1,2,8,15,1,1,0,1,0,1,10,24,20,27,32.1
2023-24,202403240MIL,3/24/2024,MIL vs OKC,Jae Crowder,crowdja01,40,MIL,1,OKC,10,2,2,1,0,0,17.93333333,0,2,4,4,2,2,0,0,1,1,4,12,12,14,18.4
2023-24,202403240MIL,3/24/2024,MIL vs OKC,Aaron Wiggins,wiggiaa01,67,OKC,0,MIL,8,3,0,1,0,2,18.03333333,2,1,2,3,0,0,4,5,1,1,3,8,11,11,12.6
2023-24,202403240MIA,3/24/2024,MIA vs CLE,Nikola Jovic,jovicni01,35,MIA,1,CLE,8,0,1,1,0,2,18.48333333,0,0,3,6,2,4,0,0,3,1,1,9,8,9,10.5
2023-24,202403240MIN,3/24/2024,MIN vs GSW,Brandin Podziemski,podzibr01,62,GSW,0,MIN,7,2,0,0,0,0,18.61666667,0,2,2,4,1,3,2,2,2,0,2,7,9,9,9.4
2023-24,202403240MIL,3/24/2024,MIL vs OKC,Kenrich Williams,willike04,57,OKC,0,MIL,6,4,2,1,0,0,18.93333333,1,3,2,7,0,3,2,2,3,1,6,8,10,12,16.8
2023-24,202403240MIA,3/24/2024,MIA vs CLE,Isaac Okoro,okorois01,62,CLE,0,MIA,3,1,0,0,0,3,19.1,0,1,1,5,1,3,0,0,0,0,1,3,4,4,1.2
2023-24,202403240MIL,3/24/2024,MIL vs OKC,Pat Connaughton,connapa01,65,MIL,1,OKC,11,1,1,0,0,1,19.11666667,0,1,5,9,1,5,0,0,2,0,2,12,12,13,12.7
2023-24,202403240LAL,3/24/2024,LAL vs IND,Taurean Prince,princta02,68,LAL,1,IND,14,2,0,0,1,0,19.31666667,0,2,6,8,2,3,0,1,3,1,2,14,16,16,19.4
2023-24,202403240LAL,3/24/2024,LAL vs IND,Obi Toppin,toppiob01,73,IND,0,LAL,11,3,1,0,0,1,19.33333333,1,2,4,6,3,5,0,0,4,0,4,12,14,15,15.1
2023-24,202403240MIA,3/24/2024,MIA vs CLE,Caleb Martin,martica02,54,MIA,1,CLE,11,2,2,1,0,0,19.73333333,1,1,3,7,2,3,3,4,0,1,4,13,13,15,19.4
2023-24,202403240DET,3/24/2024,DET vs NOP,Jonas Valanciunas,valanjo01,71,NOP,0,DET,13,6,0,0,1,1,19.85,1,5,6,10,0,1,1,3,5,1,6,13,19,19,22.2
2023-24,202403240DET,3/24/2024,DET vs NOP,Troy Brown Jr.,browntr01,48,DET,1,NOP,6,6,2,0,0,2,20.01666667,0,6,1,8,0,4,4,5,1,0,8,8,12,14,14.2
2023-24,202403240MIA,3/24/2024,MIA vs CLE,Caris LeVert,leverca01,59,CLE,0,MIA,2,3,1,1,0,0,20.26666667,1,2,1,5,0,3,0,2,2,1,4,3,5,6,10.1
2023-24,202403240MIA,3/24/2024,MIA vs CLE,Thomas Bryant,bryanth01,34,MIA,1,CLE,14,5,3,1,0,1,20.3,1,4,4,6,0,2,6,6,5,1,8,17,19,22,26.5
2023-24,202403240MIN,3/24/2024,MIN vs GSW,Chris Paul,paulch01,46,GSW,0,MIN,7,4,6,0,0,1,20.33333333,1,3,3,8,1,3,0,0,2,0,10,13,11,17,19.8
2023-24,202403240MIA,3/24/2024,MIA vs CLE,Evan Mobley,mobleev01,39,CLE,0,MIA,15,4,1,0,0,2,21.03333333,0,4,4,6,2,2,5,6,3,0,5,16,19,20,19.3
2023-24,202403240MIA,3/24/2024,MIA vs CLE,Marcus Morris,morrima03,41,CLE,0,MIA,7,2,2,1,1,0,21.41666667,0,2,3,10,0,3,1,2,0,2,4,9,9,11,18.4
2023-24,202403240DET,3/24/2024,DET vs NOP,Jose Alvarado,alvarjo01,50,NOP,0,DET,4,5,3,0,1,0,21.45,2,3,1,6,0,3,2,2,2,1,8,7,9,12,17.5
2023-24,202403240MIA,3/24/2024,MIA vs CLE,Patty Mills,millspa02,28,MIA,1,CLE,10,2,3,2,0,1,21.68333333,0,2,4,8,2,5,0,0,3,2,5,13,12,15,21.9
2023-24,202403240LAL,3/24/2024,LAL vs IND,Doug McDermott,mcderdo01,55,IND,0,LAL,14,0,3,1,0,2,21.7,0,0,5,8,4,7,0,0,4,1,3,17,14,17,19.5
2023-24,202403240LAC,3/24/2024,LAC vs PHI,Mo Bamba,bambamo01,49,PHI,0,LAC,5,7,1,0,2,0,21.75,2,5,2,5,1,2,0,0,1,2,8,6,12,13,20.9
2023-24,202403240MIN,3/24/2024,MIN vs GSW,Nickeil Alexander-Walker,alexani01,71,MIN,1,GSW,11,0,2,0,0,0,21.95,0,0,4,7,3,5,0,0,1,0,2,13,11,13,14
2023-24,202403240MIA,3/24/2024,MIA vs CLE,Jarrett Allen,allenja01,66,CLE,0,MIA,9,4,3,0,0,2,22.15,0,4,3,7,0,0,3,4,1,0,7,12,13,16,16.3
2023-24,202403240MIL,3/24/2024,MIL vs OKC,Luguentz Dort,dortlu01,68,OKC,0,MIL,7,3,0,0,0,0,22.31666667,0,3,2,8,1,6,2,2,2,0,3,7,10,10,10.6
2023-24,202403240DET,3/24/2024,DET vs NOP,Buddy Boeheim,boehebu01,3,DET,1,NOP,13,3,3,0,0,0,22.33333333,0,3,4,8,3,7,2,2,1,0,6,16,16,19,21.1
2023-24,202403240MIA,3/24/2024,MIA vs CLE,Darius Garland,garlada01,47,CLE,0,MIA,9,3,3,0,0,1,22.36666667,0,3,4,9,1,4,0,0,4,0,6,12,12,15,16.1
2023-24,202403240MIL,3/24/2024,MIL vs OKC,Brook Lopez,lopezbr01,68,MIL,1,OKC,14,3,2,1,1,0,22.58333333,1,2,5,11,2,5,2,3,1,2,5,16,17,19,26.6
2023-24,202403240LAL,3/24/2024,LAL vs IND,Cam Reddish,reddica01,43,LAL,1,IND,7,0,0,2,0,0,22.71666667,0,0,1,5,1,3,4,6,0,2,0,7,7,7,13
2023-24,202403240LAC,3/24/2024,LAC vs PHI,Buddy Hield,hieldbu01,74,PHI,0,LAC,9,4,2,0,0,1,23.01666667,1,3,3,7,3,6,0,0,2,0,6,11,13,15,15.8
2023-24,202403240LAC,3/24/2024,LAC vs PHI,Terance Mann,mannte01,63,LAC,1,PHI,6,1,1,0,0,0,23.13333333,1,0,2,5,2,2,0,0,2,0,2,7,7,8,8.7
2023-24,202403240MIN,3/24/2024,MIN vs GSW,Gary Payton II,paytoga02,35,GSW,0,MIN,2,8,7,1,0,1,23.58333333,3,5,1,3,0,0,0,0,1,1,15,9,10,17,24.1
2023-24,202403240LAC,3/24/2024,LAC vs PHI,Amir Coffey,coffeam01,58,LAC,1,PHI,2,1,1,0,1,0,23.96666667,0,1,1,3,0,0,0,0,2,1,2,3,3,4,7.7
2023-24,202403240LAC,3/24/2024,LAC vs PHI,Cameron Payne,payneca01,67,PHI,0,LAC,23,5,3,1,2,4,23.96666667,1,4,8,15,5,10,2,2,2,3,8,26,28,31,38.5
2023-24,202403240DET,3/24/2024,DET vs NOP,Naji Marshall,marshna01,59,NOP,0,DET,14,8,3,0,0,1,24.1,2,6,5,10,4,7,0,0,2,0,11,17,22,25,27.1
2023-24,202403240LAC,3/24/2024,LAC vs PHI,KJ Martin,martike04,54,PHI,0,LAC,8,2,4,1,1,0,24.11666667,1,1,4,6,0,1,0,1,3,2,6,12,10,14,22.4
2023-24,202403240MIL,3/24/2024,MIL vs OKC,Cason Wallace,wallaca01,70,OKC,0,MIL,5,2,0,2,0,1,24.36666667,1,1,2,9,1,7,0,0,3,2,2,5,7,7,12.4
2023-24,202403240MIA,3/24/2024,MIA vs CLE,Georges Niang,niangge01,71,CLE,0,MIA,6,4,2,1,0,3,24.4,0,4,2,6,2,4,0,0,1,1,6,8,10,12,13.8
2023-24,202403240MIA,3/24/2024,MIA vs CLE,Jimmy Butler,butleji01,50,MIA,1,CLE,15,3,6,1,0,2,24.41666667,0,3,3,6,1,2,8,9,3,1,9,21,18,24,28.6
2023-24,202403240LAC,3/24/2024,LAC vs PHI,Paul Reed,reedpa01,71,PHI,0,LAC,10,8,3,3,2,0,24.41666667,3,5,4,6,0,0,2,2,4,5,11,13,18,21,39.1
2023-24,202403240LAC,3/24/2024,LAC vs PHI,Kelly Oubre Jr.,oubreke01,58,PHI,0,LAC,12,2,6,0,1,0,24.56666667,2,0,5,11,2,5,0,0,2,1,8,18,14,20,26.4
2023-24,202403240LAC,3/24/2024,LAC vs PHI,Norman Powell,powelno01,66,LAC,1,PHI,20,1,1,0,0,1,24.56666667,1,0,7,11,3,5,3,3,1,0,2,21,21,22,21.7
2023-24,202403240MIA,3/24/2024,MIA vs CLE,Haywood Highsmith,highsha01,55,MIA,1,CLE,18,5,2,1,0,0,24.68333333,2,3,7,10,4,4,0,0,1,1,7,20,23,25,30
2023-24,202403240MIN,3/24/2024,MIN vs GSW,Andrew Wiggins,wiggian01,61,GSW,0,MIN,15,4,0,2,0,2,24.68333333,1,3,4,8,2,3,5,7,4,2,4,15,19,19,23.8
2023-24,202403240DET,3/24/2024,DET vs NOP,Malachi Flynn,flynnma01,58,DET,1,NOP,17,4,4,1,0,0,24.86666667,3,1,6,12,3,7,2,3,0,1,8,21,21,25,30.8
2023-24,202403240MIL,3/24/2024,MIL vs OKC,Malik Beasley,beaslma01,68,MIL,1,OKC,8,2,0,1,0,1,25.36666667,0,2,3,6,2,5,0,0,2,1,2,8,10,10,12.4
2023-24,202403240MIL,3/24/2024,MIL vs OKC,Chet Holmgren,holmgch01,70,OKC,0,MIL,6,4,0,0,0,1,25.46666667,1,3,1,10,0,5,4,4,1,0,4,6,10,10,9.8
2023-24,202403240MIN,3/24/2024,MIN vs GSW,Kyle Anderson,anderky01,68,MIN,1,GSW,10,6,5,2,1,0,25.78333333,2,4,3,9,0,0,4,5,0,3,11,15,16,21,33.7
2023-24,202403240LAL,3/24/2024,LAL vs IND,Andrew Nembhard,nembhan01,58,IND,0,LAL,15,3,5,1,0,0,26.01666667,0,3,7,9,1,2,0,0,4,1,8,20,18,23,29.1
2023-24,202403240LAL,3/24/2024,LAL vs IND,Aaron Nesmith,nesmiaa01,64,IND,0,LAL,13,3,4,0,2,1,26.7,1,2,4,8,3,5,2,2,5,2,7,17,16,20,27.6
2023-24,202403240DET,3/24/2024,DET vs NOP,James Wiseman,wisemja01,52,DET,1,NOP,15,11,0,0,0,4,26.73333333,3,8,5,8,0,0,5,6,5,0,11,15,26,26,24.2
2023-24,202403240DET,3/24/2024,DET vs NOP,Larry Nance Jr.,nancela02,52,NOP,0,DET,9,3,2,0,0,0,26.75,0,3,4,4,0,0,1,2,3,0,5,11,12,14,15.6
2023-24,202403240MIA,3/24/2024,MIA vs CLE,Craig Porter Jr.,portecr01,46,CLE,0,MIA,8,4,4,0,1,2,26.96666667,1,3,3,6,0,0,2,2,0,1,8,12,12,16,19.8
2023-24,202403240DET,3/24/2024,DET vs NOP,Marcus Sasser,sassema01,62,DET,1,NOP,3,1,3,1,1,2,27.13333333,0,1,1,5,1,3,0,0,3,2,4,6,4,7,12.7
2023-24,202403240MIL,3/24/2024,MIL vs OKC,Khris Middleton,middlkh01,46,MIL,1,OKC,11,10,10,0,1,5,27.3,2,8,5,11,1,5,0,0,3,1,20,21,21,31,36
2023-24,202403240MIL,3/24/2024,MIL vs OKC,Bobby Portis,portibo01,71,MIL,1,OKC,15,6,2,3,0,3,27.61666667,1,5,7,13,0,2,1,2,3,3,8,17,21,23,31.2
2023-24,202403240MIA,3/24/2024,MIA vs CLE,Bam Adebayo,adebaba01,60,MIA,1,CLE,15,16,3,5,0,1,27.7,3,13,7,11,0,1,1,2,0,5,19,18,31,34,52.7
2023-24,202403240LAL,3/24/2024,LAL vs IND,Myles Turner,turnemy01,69,IND,0,LAL,20,5,3,0,2,1,28.36666667,0,5,7,12,4,6,2,4,3,2,8,23,25,28,35.5
2023-24,202403240MIN,3/24/2024,MIN vs GSW,Trayce Jackson-Davis,jackstr02,57,GSW,0,MIN,6,5,0,3,2,1,28.41666667,2,3,2,6,0,0,2,4,1,5,5,6,11,11,26
2023-24,202403240MIL,3/24/2024,MIL vs OKC,Josh Giddey,giddejo01,69,OKC,0,MIL,19,9,8,0,0,1,28.7,0,9,7,12,4,6,1,1,2,0,17,27,28,36,40.8
2023-24,202403240MIN,3/24/2024,MIN vs GSW,Naz Reid,reidna01,70,MIN,1,GSW,20,12,0,1,2,6,28.81666667,2,10,7,11,6,8,0,0,3,3,12,20,32,32,37.4
2023-24,202403240DET,3/24/2024,DET vs NOP,Tosan Evbuomwan,evbuoto01,11,DET,1,NOP,7,7,1,0,1,2,28.86666667,1,6,3,8,0,4,1,2,4,1,8,8,14,15,17.9
2023-24,202403240MIL,3/24/2024,MIL vs OKC,Jalen Williams,willija06,63,OKC,0,MIL,18,3,4,1,0,0,29.06666667,3,0,8,15,1,4,1,2,3,1,7,22,21,25,30.6
2023-24,202403240LAC,3/24/2024,LAC vs PHI,Ivica Zubac,zubaciv01,58,LAC,1,PHI,13,10,2,0,4,0,29.2,3,7,5,9,0,0,3,4,0,4,12,15,23,25,40
2023-24,202403240DET,3/24/2024,DET vs NOP,Jaden Ivey,iveyja01,67,DET,1,NOP,16,2,4,1,0,4,29.26666667,1,1,5,12,3,7,3,4,3,1,6,20,18,22,23.4
2023-24,202403240MIN,3/24/2024,MIN vs GSW,Jaden McDaniels,mcdanja02,61,MIN,1,GSW,8,4,1,0,0,1,29.5,1,3,3,8,2,6,0,0,4,0,5,9,12,13,13.3
2023-24,202403240MIN,3/24/2024,MIN vs GSW,Stephen Curry,curryst01,64,GSW,0,MIN,31,4,3,0,0,2,29.85,0,4,9,21,5,11,8,8,1,0,7,34,35,38,38.3
2023-24,202403240MIL,3/24/2024,MIL vs OKC,Shai Gilgeous-Alexander,gilgesh01,69,OKC,0,MIL,12,3,2,3,1,4,29.96666667,0,3,5,12,0,3,2,3,0,4,5,14,15,17,26.6
2023-24,202403240MIN,3/24/2024,MIN vs GSW,Jonathan Kuminga,kuminjo01,69,GSW,0,MIN,14,3,2,1,1,2,30.05,0,3,6,11,0,0,2,4,3,2,5,16,17,19,24.6
2023-24,202403240MIA,3/24/2024,MIA vs CLE,Delon Wright,wrighde01,41,MIA,1,CLE,8,4,1,0,0,0,30.11666667,0,4,3,9,2,8,0,0,0,0,5,9,12,13,14.3
2023-24,202403240MIN,3/24/2024,MIN vs GSW,Mike Conley,conlemi01,66,MIN,1,GSW,14,1,7,4,0,2,30.26666667,0,1,5,12,3,7,1,2,2,4,8,21,15,22,35.7
2023-24,202403240LAL,3/24/2024,LAL vs IND,Rui Hachimura,hachiru01,58,LAL,1,IND,9,5,1,0,1,0,30.38333333,0,5,4,8,1,4,0,0,1,1,6,10,14,15,19.5
2023-24,202403240MIA,3/24/2024,MIA vs CLE,Terry Rozier,roziete01,54,MIA,1,CLE,14,3,5,1,0,0,30.71666667,0,3,6,14,0,6,2,2,1,1,8,19,17,22,28.1
2023-24,202403240MIA,3/24/2024,MIA vs CLE,Sam Merrill,merrisa01,53,CLE,0,MIA,1,2,6,0,0,1,31.18333333,0,2,0,6,0,6,1,1,2,0,8,7,3,9,11.4
2023-24,202403240LAC,3/24/2024,LAC vs PHI,Kawhi Leonard,leonaka01,64,LAC,1,PHI,20,6,3,1,0,2,31.23333333,1,5,7,16,1,6,5,5,1,1,9,23,26,29,32.7
2023-24,202403240MIN,3/24/2024,MIN vs GSW,Draymond Green,greendr01,45,GSW,0,MIN,12,8,3,1,0,0,31.55,0,8,5,9,2,5,0,0,2,1,11,15,20,23,29.1
2023-24,202403240DET,3/24/2024,DET vs NOP,Trey Murphy III,murphtr02,46,NOP,0,DET,8,8,2,1,4,1,31.75,0,8,1,12,0,9,6,8,1,5,10,10,16,18,34.6
2023-24,202403240LAL,3/24/2024,LAL vs IND,Pascal Siakam,siakapa01,70,IND,0,LAL,36,12,2,0,0,1,32.58333333,4,8,16,29,0,2,4,8,3,0,14,38,48,50,52.4
2023-24,202403240LAL,3/24/2024,LAL vs IND,Tyrese Haliburton,halibty01,60,IND,0,LAL,12,6,10,2,0,1,32.78333333,1,5,5,13,2,6,0,0,1,2,16,22,18,28,39.2
2023-24,202403240MIN,3/24/2024,MIN vs GSW,Klay Thompson,thompkl01,67,GSW,0,MIN,16,3,2,0,0,3,32.91666667,0,3,6,15,3,11,1,1,3,0,5,18,19,21,19.6
2023-24,202403240MIL,3/24/2024,MIL vs OKC,Damian Lillard,lillada01,66,MIL,1,OKC,11,6,5,0,0,1,33.1,0,6,4,12,2,5,1,1,2,0,11,16,17,22,24.7
2023-24,202403240MIL,3/24/2024,MIL vs OKC,Giannis Antetokounmpo,antetgi01,66,MIL,1,OKC,30,19,4,0,1,3,33.65,8,11,13,18,0,0,4,6,3,1,23,34,49,53,58.8
2023-24,202403240LAC,3/24/2024,LAC vs PHI,Paul George,georgpa01,64,LAC,1,PHI,18,3,1,0,1,5,33.95,1,2,7,15,4,8,0,0,2,1,4,19,21,22,21.1
2023-24,202403240LAC,3/24/2024,LAC vs PHI,James Harden,hardeja01,63,LAC,1,PHI,12,4,14,1,1,2,34.36666667,1,3,5,13,0,6,2,2,0,2,18,26,16,30,41.8
2023-24,202403240LAL,3/24/2024,LAL vs IND,Spencer Dinwiddie,dinwisp01,65,LAL,1,IND,26,2,5,1,2,3,35.28333333,0,2,8,11,2,3,8,9,4,3,7,31,28,33,41.9
2023-24,202403240DET,3/24/2024,DET vs NOP,Herbert Jones,joneshe01,65,NOP,0,DET,7,1,2,4,1,1,35.41666667,0,1,2,4,2,3,1,2,3,5,3,9,8,10,25.2
2023-24,202403240DET,3/24/2024,DET vs NOP,Zion Williamson,willizi01,60,NOP,0,DET,36,7,6,2,0,4,36.48333333,1,6,13,14,0,0,10,14,2,2,13,42,43,49,55.4
2023-24,202403240DET,3/24/2024,DET vs NOP,CJ McCollum,mccolcj01,55,NOP,0,DET,23,2,7,1,0,2,36.66666667,0,2,9,18,5,9,0,0,2,1,9,30,25,32,36.9
2023-24,202403240MIN,3/24/2024,MIN vs GSW,Rudy Gobert,goberru01,65,MIN,1,GSW,17,12,2,0,1,4,37.16666667,1,11,7,10,0,0,3,3,5,1,14,19,29,31,33.4
2023-24,202403240LAL,3/24/2024,LAL vs IND,Austin Reaves,reaveau01,72,LAL,1,IND,25,5,8,0,1,2,37.48333333,1,4,6,13,2,5,11,12,1,1,13,33,30,38,44
2023-24,202403240MIN,3/24/2024,MIN vs GSW,Anthony Edwards,edwaran01,68,MIN,1,GSW,23,6,8,0,0,2,37.55,0,6,7,18,4,8,5,8,1,0,14,31,29,37,40.2
2023-24,202403240LAC,3/24/2024,LAC vs PHI,Tobias Harris,harrito02,62,PHI,0,LAC,24,4,4,1,1,3,37.81666667,1,3,11,19,2,4,0,0,2,2,8,28,28,32,37.8
2023-24,202403240LAL,3/24/2024,LAL vs IND,LeBron James,jamesle01,63,LAL,1,IND,26,5,10,1,1,3,38.13333333,1,4,8,19,2,4,8,8,1,2,15,36,31,41,50
2023-24,202403240DET,3/24/2024,DET vs NOP,Chimezie Metu,metuch01,40,DET,1,NOP,17,8,3,1,1,2,39,2,6,5,8,0,2,7,8,5,2,11,20,25,28,35.1
2023-24,202403240LAL,3/24/2024,LAL vs IND,Anthony Davis,davisan02,68,LAL,1,IND,36,16,3,2,1,2,40,3,13,15,21,1,2,5,5,4,3,19,39,52,55,66.7
2023-24,202403240LAC,3/24/2024,LAC vs PHI,Tyrese Maxey,maxeyty01,62,PHI,0,LAC,24,1,6,1,1,0,44.4,1,0,9,17,3,5,3,4,2,2,7,30,25,31,40.2
2023-24,202403230ORL,3/23/2024,ORL vs SAC,Chris Duarte,duartch01,50,SAC,0,ORL,5,0,0,0,0,0,10,0,0,2,3,1,2,0,0,2,0,0,5,5,5,5
2023-24,202403230NYK,3/23/2024,NYK vs BRK,Day'Ron Sharpe,sharpda01,53,BRK,0,NYK,5,4,2,0,1,0,10.4,3,1,2,4,0,0,1,1,3,1,6,7,9,11,15.8
2023-24,202403230WAS,3/23/2024,WAS vs TOR,Garrett Temple,templga01,18,TOR,0,WAS,3,5,2,0,1,0,10.85,0,5,1,2,1,2,0,0,3,1,7,5,8,10,15
2023-24,202403230CHI,3/23/2024,CHI vs BOS,Xavier Tillman Sr.,tillmxa01,45,BOS,0,CHI,2,2,2,0,0,0,10.85,0,2,1,2,0,1,0,0,1,0,4,4,4,6,7.4
2023-24,202403230POR,3/23/2024,POR vs DEN,Moses Brown,brownmo01,17,POR,1,DEN,4,3,0,0,2,1,11.05,2,1,2,4,0,0,0,1,1,2,3,4,7,7,12.6
2023-24,202403230WAS,3/23/2024,WAS vs TOR,Patrick Baldwin Jr.,baldwpa01,28,WAS,1,TOR,2,1,0,0,3,1,11.06666667,1,0,1,3,0,2,0,0,1,3,1,2,3,3,11.2
2023-24,202403230ORL,3/23/2024,ORL vs SAC,Caleb Houstan,houstca01,54,ORL,1,SAC,6,2,0,1,0,0,11.28333333,2,0,2,5,2,5,0,0,0,1,2,6,8,8,11.4
2023-24,202403230NYK,3/23/2024,NYK vs BRK,Lonnie Walker IV,walkelo01,50,BRK,0,NYK,9,2,1,0,0,1,12.03333333,0,2,4,6,1,3,0,0,0,0,3,10,11,12,11.9
2023-24,202403230ORL,3/23/2024,ORL vs SAC,Joe Ingles,inglejo01,57,ORL,1,SAC,0,3,3,0,0,2,12.18333333,1,2,0,0,0,0,0,0,1,0,6,3,3,6,6.1
2023-24,202403230ORL,3/23/2024,ORL vs SAC,Davion Mitchell,mitchda01,60,SAC,0,ORL,2,2,3,0,0,0,12.3,0,2,1,3,0,1,0,0,0,0,5,5,4,7,8.9
2023-24,202403230ATL,3/23/2024,ATL vs CHO,Wesley Matthews,matthwe02,30,ATL,1,CHO,6,4,0,1,2,0,12.68333333,0,4,2,5,2,4,0,0,1,3,4,6,10,10,19.8
2023-24,202403230ORL,3/23/2024,ORL vs SAC,Moritz Wagner,wagnemo01,69,ORL,1,SAC,4,5,2,0,0,2,13.1,0,5,1,2,0,1,2,2,3,0,7,6,9,11,11
2023-24,202403230NYK,3/23/2024,NYK vs BRK,Dennis Smith Jr.,smithde03,55,BRK,0,NYK,8,0,1,2,0,2,14.13333333,0,0,3,4,1,2,1,2,1,2,1,9,8,9,13.5
2023-24,202403230POR,3/23/2024,POR vs DEN,Justin Holiday,holidju01,47,DEN,0,POR,2,1,0,0,0,0,14.26666667,0,1,1,2,0,0,0,0,0,0,1,2,3,3,3.2
2023-24,202403230NYK,3/23/2024,NYK vs BRK,Alec Burks,burksal01,61,NYK,1,BRK,5,2,1,0,0,0,15.18333333,1,1,2,9,1,5,0,1,0,0,3,6,7,8,8.9
2023-24,202403230POR,3/23/2024,POR vs DEN,Peyton Watson,watsope01,69,DEN,0,POR,3,5,1,0,2,0,15.21666667,2,3,1,6,0,1,1,1,2,2,6,4,8,9,16.5
2023-24,202403230CHI,3/23/2024,CHI vs BOS,Andre Drummond,drumman01,71,CHI,1,BOS,7,6,0,0,0,1,15.63333333,1,5,3,3,0,0,1,1,0,0,6,7,13,13,13.2
2023-24,202403230WAS,3/23/2024,WAS vs TOR,Jordan Nwora,nworajo01,42,TOR,0,WAS,7,2,1,0,1,2,15.7,0,2,3,6,1,3,0,0,2,1,3,8,9,10,11.9
2023-24,202403230SAS,3/23/2024,SAS vs PHO,Royce O'Neale,onealro01,68,PHO,0,SAS,4,4,0,0,1,2,15.71666667,0,4,2,6,0,4,0,0,0,1,4,4,8,8,9.8
2023-24,202403230POR,3/23/2024,POR vs DEN,Rayan Rupert,ruperra01,28,POR,1,DEN,3,1,5,0,0,2,15.76666667,0,1,1,2,0,0,1,1,1,0,6,8,4,9,9.7
2023-24,202403230WAS,3/23/2024,WAS vs TOR,Marvin Bagley III,baglema01,45,WAS,1,TOR,10,8,0,0,2,1,16.4,3,5,4,7,1,2,1,1,0,2,8,10,18,18,24.6
2023-24,202403230CHI,3/23/2024,CHI vs BOS,Oshae Brissett,brissos01,47,BOS,0,CHI,7,4,0,0,0,1,16.76666667,3,1,3,3,1,1,0,0,1,0,4,7,11,11,10.8
2023-24,202403230ATL,3/23/2024,ATL vs CHO,Trent Forrest,forretr01,32,ATL,1,CHO,4,1,9,2,0,1,17.13333333,0,1,2,5,0,1,0,0,0,2,10,13,5,14,23.7
2023-24,202403230WAS,3/23/2024,WAS vs TOR,Johnny Davis,davisjo06,40,WAS,1,TOR,4,1,1,1,1,0,17.2,0,1,2,3,0,1,0,0,0,2,2,5,5,6,12.7
2023-24,202403230HOU,3/23/2024,HOU vs UTA,Jock Landale,landajo01,44,HOU,1,UTA,6,2,3,0,0,2,17.66666667,2,0,3,4,0,1,0,0,4,0,5,9,8,11,10.9
2023-24,202403230HOU,3/23/2024,HOU vs UTA,Micah Potter,pottemi01,8,UTA,0,HOU,0,3,0,0,0,0,17.66666667,2,1,0,2,0,2,0,0,0,0,3,0,3,3,3.6
2023-24,202403230WAS,3/23/2024,WAS vs TOR,Jahmi'us Ramsey,ramseja01,7,TOR,0,WAS,8,4,1,0,0,0,18.08333333,0,4,3,5,2,4,0,0,2,0,5,9,12,13,14.3
2023-24,202403230NYK,3/23/2024,NYK vs BRK,Jericho Sims,simsje01,41,NYK,1,BRK,0,7,0,1,0,2,18.23333333,2,5,0,2,0,0,0,0,3,1,7,0,7,7,9.4
2023-24,202403230SAS,3/23/2024,SAS vs PHO,Drew Eubanks,eubandr01,65,PHO,0,SAS,10,3,1,1,3,0,18.35,0,3,3,4,0,0,4,5,1,4,4,11,13,14,27.1
2023-24,202403230SAS,3/23/2024,SAS vs PHO,Cedi Osman,osmande01,67,SAS,1,PHO,5,4,1,0,0,0,18.6,0,4,2,5,1,3,0,0,1,0,5,6,9,10,11.3
2023-24,202403230SAS,3/23/2024,SAS vs PHO,Blake Wesley,weslebl01,50,SAS,1,PHO,12,1,3,2,1,0,18.65,1,0,4,5,2,2,2,2,2,3,4,15,13,16,26.7
2023-24,202403230ORL,3/23/2024,ORL vs SAC,Markelle Fultz,fultzma01,33,ORL,1,SAC,4,1,2,2,0,1,18.95,0,1,2,5,0,0,0,0,2,2,3,6,5,7,13.2
2023-24,202403230SAS,3/23/2024,SAS vs PHO,Bol Bol,bolbo01,33,PHO,0,SAS,13,4,1,0,1,0,19.01666667,0,4,4,5,2,2,3,4,3,1,5,14,17,18,22.3
2023-24,202403230HOU,3/23/2024,HOU vs UTA,Jae'Sean Tate,tateja01,60,HOU,1,UTA,7,3,1,0,1,0,19.03333333,0,3,3,4,1,1,0,0,3,1,4,8,10,11,15.1
2023-24,202403230SAS,3/23/2024,SAS vs PHO,Zach Collins,colliza01,58,SAS,1,PHO,11,3,1,1,1,2,19.08333333,2,1,4,9,2,2,1,2,3,2,4,12,14,15,20.1
2023-24,202403230POR,3/23/2024,POR vs DEN,Collin Gillespie,gilleco01,20,DEN,0,POR,11,3,1,0,0,2,19.08333333,0,3,4,10,2,4,1,2,3,0,4,12,14,15,14.1
2023-24,202403230ATL,3/23/2024,ATL vs CHO,Dylan Windler,windldy01,13,ATL,1,CHO,5,4,2,1,0,1,19.15,1,3,2,5,1,4,0,0,1,1,6,7,9,11,14.8
2023-24,202403230CHI,3/23/2024,CHI vs BOS,Torrey Craig,craigto01,42,CHI,1,BOS,11,2,3,2,0,0,19.26666667,0,2,4,4,3,3,0,0,3,2,5,14,13,16,23.9
2023-24,202403230CHI,3/23/2024,CHI vs BOS,Dalen Terry,terryda01,48,CHI,1,BOS,12,3,1,1,0,0,19.7,2,1,5,8,1,3,1,2,1,1,4,13,15,16,20.1
2023-24,202403230WAS,3/23/2024,WAS vs TOR,Jared Butler,butleja02,29,WAS,1,TOR,7,2,2,1,0,2,19.85,1,1,3,7,1,5,0,0,3,1,4,9,9,11,13.4
2023-24,202403230HOU,3/23/2024,HOU vs UTA,John Collins,collijo01,65,UTA,0,HOU,25,6,1,0,0,2,19.95,3,3,7,9,2,2,9,10,4,0,7,26,31,32,31.7
2023-24,202403230POR,3/23/2024,POR vs DEN,DeAndre Jordan,jordade01,31,DEN,0,POR,11,8,3,1,1,2,19.98333333,2,6,4,7,0,0,3,3,3,2,11,14,19,22,29.1
2023-24,202403230HOU,3/23/2024,HOU vs UTA,Aaron Holiday,holidaa01,67,HOU,1,UTA,7,1,3,0,0,0,20.05,0,1,3,7,1,3,0,0,1,0,4,10,8,11,12.7
2023-24,202403230HOU,3/23/2024,HOU vs UTA,Johnny Juzang,juzanjo01,11,UTA,0,HOU,8,0,1,0,0,0,20.75,0,0,3,5,2,4,0,0,2,0,1,9,8,9,9.5
2023-24,202403230SAS,3/23/2024,SAS vs PHO,Victor Wembanyama,wembavi01,63,SAS,1,PHO,13,5,4,0,1,5,20.88333333,1,4,5,7,1,2,2,2,0,1,9,17,18,22,23
2023-24,202403230HOU,3/23/2024,HOU vs UTA,Reggie Bullock,bullore01,32,HOU,1,UTA,6,7,0,1,0,0,20.96666667,1,6,2,6,2,6,0,0,2,1,7,6,13,13,17.4
2023-24,202403230NYK,3/23/2024,NYK vs BRK,Dorian Finney-Smith,finnedo01,61,BRK,0,NYK,2,4,2,0,0,0,21.25,0,4,1,5,0,4,0,0,4,0,6,4,6,8,9.8
2023-24,202403230SAS,3/23/2024,SAS vs PHO,Tre Jones,jonestr01,66,SAS,1,PHO,10,1,5,0,0,1,21.36666667,0,1,4,5,0,1,2,2,0,0,6,15,11,16,17.7
2023-24,202403230SAS,3/23/2024,SAS vs PHO,Jeremy Sochan,sochaje01,71,SAS,1,PHO,7,3,2,0,1,2,21.36666667,0,3,3,7,0,4,1,2,0,1,5,9,10,12,14.6
2023-24,202403230POR,3/23/2024,POR vs DEN,Ashton Hagans,haganas01,14,POR,1,DEN,2,3,6,2,2,2,21.41666667,1,2,0,3,0,1,2,2,4,4,9,8,5,11,24.6
2023-24,202403230SAS,3/23/2024,SAS vs PHO,Malaki Branham,branhma01,66,SAS,1,PHO,7,0,3,0,0,0,21.6,0,0,3,8,1,3,0,0,1,0,3,10,7,10,11.5
2023-24,202403230SAS,3/23/2024,SAS vs PHO,Jusuf Nurkic,nurkiju01,67,PHO,0,SAS,6,10,3,3,0,0,21.81666667,3,7,3,7,0,0,0,0,4,3,13,9,16,19,31.5
2023-24,202403230ATL,3/23/2024,ATL vs CHO,Clint Capela,capelca01,62,ATL,1,CHO,12,10,1,0,1,0,22.21666667,5,5,5,11,0,1,2,2,0,1,11,13,22,23,28.5
2023-24,202403230ORL,3/23/2024,ORL vs SAC,Malik Monk,monkma01,69,SAC,0,ORL,0,1,5,0,0,1,22.23333333,0,1,0,11,0,2,0,0,3,0,6,5,1,6,7.7
2023-24,202403230ORL,3/23/2024,ORL vs SAC,Wendell Carter Jr.,cartewe01,44,ORL,1,SAC,3,11,1,0,0,1,22.53333333,3,8,1,6,0,3,1,2,1,0,12,4,14,15,16.7
2023-24,202403230ORL,3/23/2024,ORL vs SAC,Jonathan Isaac,isaacjo01,49,ORL,1,SAC,25,7,0,1,2,0,22.78333333,2,5,10,13,3,4,2,3,3,3,7,25,32,32,42.4
2023-24,202403230SAS,3/23/2024,SAS vs PHO,Eric Gordon,gordoer01,58,PHO,0,SAS,12,0,1,1,0,0,22.85,0,0,4,6,4,5,0,0,3,1,1,13,12,13,16.5
2023-24,202403230WAS,3/23/2024,WAS vs TOR,Javon Freeman-Liberty,freemja01,11,TOR,0,WAS,4,4,4,2,0,3,23,1,3,1,5,0,2,2,2,1,2,8,8,8,12,17.8
2023-24,202403230SAS,3/23/2024,SAS vs PHO,Devin Vassell,vassede01,65,SAS,1,PHO,2,3,3,0,0,1,23.5,0,3,1,8,0,2,0,0,0,0,6,5,5,8,9.1
2023-24,202403230ATL,3/23/2024,ATL vs CHO,Davis Bertans,bertada01,32,CHO,0,ATL,6,1,0,0,1,2,23.98333333,0,1,2,8,2,7,0,0,0,1,1,6,7,7,8.2
2023-24,202403230ATL,3/23/2024,ATL vs CHO,Aleksej Pokusevski,pokusal01,17,CHO,0,ATL,9,5,4,2,0,0,24.15,2,3,2,4,1,3,4,4,1,2,9,13,14,18,27
2023-24,202403230SAS,3/23/2024,SAS vs PHO,Keldon Johnson,johnske04,66,SAS,1,PHO,14,4,1,1,0,1,24.4,1,3,5,11,0,5,4,5,1,1,5,15,18,19,22.3
2023-24,202403230SAS,3/23/2024,SAS vs PHO,Julian Champagnie,champju02,63,SAS,1,PHO,4,2,2,1,2,1,24.61666667,0,2,1,4,0,2,2,3,1,3,4,6,6,8,17.4
2023-24,202403230ATL,3/23/2024,ATL vs CHO,Grant Williams,willigr01,66,CHO,0,ATL,7,4,4,0,0,2,24.81666667,1,3,3,10,1,6,0,0,3,0,8,11,11,15,15.8
2023-24,202403230HOU,3/23/2024,HOU vs UTA,Jeff Green,greenje02,66,HOU,1,UTA,21,4,1,0,2,0,24.93333333,0,4,7,14,4,8,3,3,3,2,5,22,25,26,33.3
2023-24,202403230HOU,3/23/2024,HOU vs UTA,Kira Lewis Jr.,lewiski01,23,UTA,0,HOU,12,5,4,0,0,2,25.3,1,4,4,9,1,3,3,4,0,0,9,16,17,21,22
2023-24,202403230SAS,3/23/2024,SAS vs PHO,Grayson Allen,allengr01,65,PHO,0,SAS,8,2,1,1,0,1,25.61666667,0,2,4,6,0,0,0,0,1,1,3,9,10,11,13.9
2023-24,202403230HOU,3/23/2024,HOU vs UTA,Dillon Brooks,brookdi01,61,HOU,1,UTA,12,4,4,1,0,0,25.75,0,4,4,8,2,3,2,2,3,1,8,16,16,20,25.8
2023-24,202403230ATL,3/23/2024,ATL vs CHO,Bruno Fernando,fernabr01,33,ATL,1,CHO,25,6,1,1,1,0,25.78333333,4,2,11,14,0,1,3,4,4,2,7,26,31,32,39.7
2023-24,202403230POR,3/23/2024,POR vs DEN,Jabari Walker,walkeja01,62,POR,1,DEN,15,9,0,1,0,1,25.85,1,8,6,7,1,1,2,2,1,1,9,15,24,24,27.8
2023-24,202403230NYK,3/23/2024,NYK vs BRK,Isaiah Hartenstein,harteis01,64,NYK,1,BRK,17,9,2,4,2,3,26.18333333,4,5,8,10,0,0,1,2,1,6,11,19,26,28,45.8
2023-24,202403230POR,3/23/2024,POR vs DEN,Duop Reath,reathdu01,57,POR,1,DEN,24,8,2,1,2,2,26.33333333,2,6,9,14,3,6,3,3,5,3,10,26,32,34,43.6
2023-24,202403230ATL,3/23/2024,ATL vs CHO,Bogdan Bogdanovic,bogdabo01,67,ATL,1,CHO,12,3,6,0,0,0,26.46666667,1,2,5,10,2,4,0,0,0,0,9,18,15,21,24.6
2023-24,202403230ATL,3/23/2024,ATL vs CHO,Garrison Mathews,mathega01,54,ATL,1,CHO,20,3,2,0,1,0,27.13333333,0,3,6,8,4,6,4,5,3,1,5,22,23,25,29.6
2023-24,202403230HOU,3/23/2024,HOU vs UTA,Taylor Hendricks,hendrita0,29,UTA,0,HOU,9,6,0,0,1,1,27.25,1,5,4,9,1,4,0,0,3,1,6,9,15,15,18.2
2023-24,202403230HOU,3/23/2024,HOU vs UTA,Brice Sensabaugh,sensabr01,21,UTA,0,HOU,16,4,4,0,0,2,27.28333333,0,4,5,14,2,10,4,5,0,0,8,20,20,24,24.8
2023-24,202403230ATL,3/23/2024,ATL vs CHO,De'Andre Hunter,huntede01,46,ATL,1,CHO,11,1,3,0,0,0,27.73333333,0,1,4,14,1,8,2,2,1,0,4,14,12,15,16.7
2023-24,202403230HOU,3/23/2024,HOU vs UTA,Fred VanVleet,vanvlfr01,63,HOU,1,UTA,34,3,7,2,0,2,27.95,0,3,11,16,10,15,2,2,3,2,10,41,37,44,52.1
2023-24,202403230CHI,3/23/2024,CHI vs BOS,Alex Caruso,carusal01,62,CHI,1,BOS,14,3,3,1,0,0,28.05,0,3,5,8,4,6,0,0,1,1,6,17,17,20,25.1
2023-24,202403230HOU,3/23/2024,HOU vs UTA,Walker Kessler,kesslwa01,59,UTA,0,HOU,12,9,1,0,3,1,28.05,3,6,5,8,0,0,2,2,1,3,10,13,21,22,32.3
2023-24,202403230WAS,3/23/2024,WAS vs TOR,Richaun Holmes,holmeri01,38,WAS,1,TOR,15,14,0,0,2,2,28.21666667,7,7,6,9,0,0,3,4,3,2,14,15,29,29,35.8
2023-24,202403230POR,3/23/2024,POR vs DEN,Scoot Henderson,hendesc01,52,POR,1,DEN,22,4,6,2,0,4,28.33333333,1,3,9,20,2,4,2,2,5,2,10,28,26,32,37.8
2023-24,202403230SAS,3/23/2024,SAS vs PHO,Bradley Beal,bealbr01,42,PHO,0,SAS,13,1,12,0,0,1,28.38333333,0,1,6,10,1,3,0,0,1,0,13,25,14,26,31.2
2023-24,202403230ATL,3/23/2024,ATL vs CHO,Tre Mann,manntr01,29,CHO,0,ATL,9,3,9,1,0,1,28.81666667,1,2,4,11,1,5,0,0,0,1,12,18,12,21,28.1
2023-24,202403230POR,3/23/2024,POR vs DEN,Reggie Jackson,jacksre01,71,DEN,0,POR,23,0,5,2,0,3,28.91666667,0,0,7,12,1,4,8,11,2,2,5,28,23,28,33.5
2023-24,202403230ATL,3/23/2024,ATL vs CHO,Vasilije Micic,micicva01,49,CHO,0,ATL,8,3,6,0,1,1,29.51666667,1,2,3,10,0,3,2,2,1,1,9,14,11,17,22.6
2023-24,202403230HOU,3/23/2024,HOU vs UTA,Amen Thompson,thompam01,51,HOU,1,UTA,4,10,6,1,0,2,30.1,7,3,2,9,0,1,0,2,3,1,16,10,14,20,26
2023-24,202403230SAS,3/23/2024,SAS vs PHO,Devin Booker,bookede01,57,PHO,0,SAS,32,7,9,0,0,2,30.5,2,5,14,24,3,7,1,1,3,0,16,41,39,48,51.9
2023-24,202403230CHI,3/23/2024,CHI vs BOS,Luke Kornet,kornelu01,53,BOS,0,CHI,8,13,4,0,2,1,30.63333333,5,8,4,5,0,0,0,0,2,2,17,12,21,25,34.6
2023-24,202403230ORL,3/23/2024,ORL vs SAC,Cole Anthony,anthoco01,70,ORL,1,SAC,16,7,6,1,0,1,30.65,3,4,7,15,2,7,0,0,1,1,13,22,23,29,35.4
2023-24,202403230ATL,3/23/2024,ATL vs CHO,Vit Krejci,krejcvi01,10,ATL,1,CHO,9,4,4,0,0,2,30.83333333,0,4,3,4,3,4,0,0,3,0,8,13,13,17,17.8
2023-24,202403230ATL,3/23/2024,ATL vs CHO,Dejounte Murray,murrade01,67,ATL,1,CHO,28,7,12,4,0,4,30.86666667,0,7,10,14,7,9,1,1,1,4,19,40,35,47,62.4
2023-24,202403230NYK,3/23/2024,NYK vs BRK,Nic Claxton,claxtni01,61,BRK,0,NYK,5,9,2,1,2,1,30.93333333,3,6,2,5,0,0,1,2,0,3,11,7,14,16,26.8
2023-24,202403230SAS,3/23/2024,SAS vs PHO,Kevin Durant,duranke01,64,PHO,0,SAS,25,4,4,3,0,0,31.03333333,0,4,12,16,1,2,0,0,0,3,8,29,29,33,44.8
2023-24,202403230CHI,3/23/2024,CHI vs BOS,Al Horford,horfoal01,58,BOS,0,CHI,23,8,1,0,0,2,31.21666667,2,6,8,16,5,10,2,2,1,0,9,24,31,32,32.1
2023-24,202403230ATL,3/23/2024,ATL vs CHO,Nick Richards,richani01,60,CHO,0,ATL,12,16,1,0,0,1,31.4,3,13,5,7,0,0,2,2,2,0,17,13,28,29,31.7
2023-24,202403230HOU,3/23/2024,HOU vs UTA,Keyonte George,georgke01,64,UTA,0,HOU,15,4,5,0,0,2,31.43333333,0,4,4,13,2,9,5,6,0,0,9,20,19,24,25.3
2023-24,202403230NYK,3/23/2024,NYK vs BRK,Cameron Johnson,johnsca02,55,BRK,0,NYK,13,2,2,1,0,0,31.55,0,2,3,7,3,6,4,4,3,1,4,15,15,17,21.4
2023-24,202403230CHI,3/23/2024,CHI vs BOS,Nikola Vucevic,vucevni01,66,CHI,1,BOS,14,2,5,1,2,1,31.6,0,2,7,10,0,3,0,0,3,3,7,19,16,21,31.9
2023-24,202403230WAS,3/23/2024,WAS vs TOR,Ochai Agbaji,agbajoc01,70,TOR,0,WAS,12,9,2,1,2,1,32.03333333,5,4,6,12,0,5,0,3,0,3,11,14,21,23,33.8
2023-24,202403230CHI,3/23/2024,CHI vs BOS,Sam Hauser,hausesa01,68,BOS,0,CHI,23,5,1,2,0,2,32.1,1,4,8,9,7,8,0,0,0,2,6,24,28,29,34.5
2023-24,202403230WAS,3/23/2024,WAS vs TOR,Kelly Olynyk,olynyke01,69,TOR,0,WAS,14,6,10,2,1,3,32.36666667,1,5,4,11,0,1,6,6,5,3,16,24,20,30,42.2
2023-24,202403230WAS,3/23/2024,WAS vs TOR,Bruce Brown,brownbr01,60,TOR,0,WAS,11,6,3,1,0,3,32.5,5,1,5,13,0,1,1,3,1,1,9,14,17,20,22.7
2023-24,202403230POR,3/23/2024,POR vs DEN,Dalano Banton,bantoda01,44,POR,1,DEN,14,3,1,0,0,1,32.73333333,0,3,5,19,1,6,3,4,4,0,4,15,17,18,18.1
2023-24,202403230NYK,3/23/2024,NYK vs BRK,Jalen Brunson,brunsja01,65,NYK,1,BRK,17,4,8,1,0,1,32.81666667,1,3,7,24,3,4,0,0,1,1,12,25,21,29,35.8
2023-24,202403230HOU,3/23/2024,HOU vs UTA,Jalen Green,greenja05,70,HOU,1,UTA,41,4,4,1,0,3,32.91666667,1,3,15,22,7,11,4,4,3,1,8,45,45,49,51.8
2023-24,202403230WAS,3/23/2024,WAS vs TOR,Corey Kispert,kispeco01,69,WAS,1,TOR,18,1,2,1,0,2,33.13333333,0,1,7,12,4,6,0,0,2,1,3,20,19,21,23.2
2023-24,202403230WAS,3/23/2024,WAS vs TOR,Gradey Dick,dickgr01,50,TOR,0,WAS,17,2,2,0,1,0,33.65,0,2,6,13,3,8,2,2,3,1,4,19,19,21,25.4
2023-24,202403230CHI,3/23/2024,CHI vs BOS,Payton Pritchard,pritcpa01,71,BOS,0,CHI,15,3,8,1,0,0,33.73333333,0,3,5,13,2,6,3,3,1,1,11,23,18,26,33.6
2023-24,202403230NYK,3/23/2024,NYK vs BRK,Dennis Schroder,schrode01,71,BRK,0,NYK,9,7,3,0,3,2,33.78333333,2,5,4,14,1,4,0,0,1,3,10,12,16,19,28.9
2023-24,202403230WAS,3/23/2024,WAS vs TOR,Kyle Kuzma,kuzmaky01,67,WAS,1,TOR,16,9,5,0,0,4,34.28333333,0,9,7,18,0,3,2,4,4,0,14,21,25,30,30.3
2023-24,202403230WAS,3/23/2024,WAS vs TOR,Gary Trent Jr.,trentga02,63,TOR,0,WAS,31,4,2,3,0,0,34.43333333,1,3,10,26,1,7,10,10,2,3,6,33,35,37,47.8
2023-24,202403230ATL,3/23/2024,ATL vs CHO,Brandon Miller,millebr02,63,CHO,0,ATL,13,2,1,0,0,1,34.45,0,2,5,12,2,6,1,3,1,0,3,14,15,16,15.9
2023-24,202403230POR,3/23/2024,POR vs DEN,Kentavious Caldwell-Pope,caldwke01,65,DEN,0,POR,13,3,1,2,2,2,34.55,0,3,4,6,3,5,2,2,3,4,4,14,16,17,28.1
2023-24,202403230ORL,3/23/2024,ORL vs SAC,Franz Wagner,wagnefr01,63,ORL,1,SAC,18,3,4,0,0,0,35.08333333,1,2,8,14,1,4,1,2,4,0,7,22,21,25,27.6
2023-24,202403230POR,3/23/2024,POR vs DEN,Michael Porter Jr.,portemi01,70,DEN,0,POR,12,9,3,0,0,2,35.15,3,6,5,12,1,5,1,2,2,0,12,15,21,24,25.3
2023-24,202403230WAS,3/23/2024,WAS vs TOR,Deni Avdija,avdijde01,65,WAS,1,TOR,22,13,5,1,0,1,35.81666667,3,10,8,19,3,8,3,6,2,1,18,27,35,40,47.1
2023-24,202403230ORL,3/23/2024,ORL vs SAC,De'Aaron Fox,foxde01,62,SAC,0,ORL,31,8,2,3,0,2,35.83333333,2,6,10,22,3,12,8,9,3,3,10,33,39,41,50.6
2023-24,202403230CHI,3/23/2024,CHI vs BOS,Coby White,whiteco01,68,CHI,1,BOS,11,5,10,0,0,2,35.83333333,0,5,3,11,1,4,4,4,3,0,15,21,16,26,30
2023-24,202403230HOU,3/23/2024,HOU vs UTA,Collin Sexton,sextoco01,71,UTA,0,HOU,20,2,8,2,0,0,35.85,1,1,7,17,1,2,5,6,1,2,10,28,22,30,40.4
2023-24,202403230ORL,3/23/2024,ORL vs SAC,Jalen Suggs,suggsja01,64,ORL,1,SAC,9,3,4,0,0,2,35.85,0,3,3,10,1,5,2,4,3,0,7,13,12,16,16.6
2023-24,202403230POR,3/23/2024,POR vs DEN,Christian Braun,braunch01,71,DEN,0,POR,17,8,6,3,1,1,35.91666667,4,4,7,15,1,3,2,4,2,4,14,23,25,31,46.6
2023-24,202403230NYK,3/23/2024,NYK vs BRK,Cam Thomas,thomaca02,56,BRK,0,NYK,19,5,6,0,0,5,36.01666667,0,5,6,14,1,5,6,6,0,0,11,25,24,30,29
2023-24,202403230NYK,3/23/2024,NYK vs BRK,Mikal Bridges,bridgmi01,71,BRK,0,NYK,18,4,5,1,0,3,36.63333333,0,4,7,14,4,9,0,0,1,1,9,23,22,27,30.3
2023-24,202403230ATL,3/23/2024,ATL vs CHO,Miles Bridges,bridgmi02,59,CHO,0,ATL,27,5,0,0,2,4,36.7,3,2,11,19,4,7,1,3,1,2,5,27,32,32,35
2023-24,202403230ORL,3/23/2024,ORL vs SAC,Keon Ellis,elliske01,45,SAC,0,ORL,19,5,6,2,1,0,36.85,1,4,7,12,4,9,1,2,1,3,11,25,24,30,43
2023-24,202403230ORL,3/23/2024,ORL vs SAC,Harrison Barnes,barneha02,70,SAC,0,ORL,9,4,0,0,0,1,36.91666667,1,3,3,10,0,4,3,4,1,0,4,9,13,13,12.8
2023-24,202403230POR,3/23/2024,POR vs DEN,Aaron Gordon,gordoaa01,65,DEN,0,POR,22,12,5,0,3,1,36.91666667,8,4,8,21,0,2,6,8,0,3,17,27,34,39,51.9
2023-24,202403230CHI,3/23/2024,CHI vs BOS,Jayson Tatum,tatumja01,66,BOS,0,CHI,26,2,6,1,1,5,37.4,1,1,8,20,2,7,8,9,1,2,8,32,28,34,38.4
2023-24,202403230ORL,3/23/2024,ORL vs SAC,Paolo Banchero,banchpa01,69,ORL,1,SAC,22,7,5,0,1,4,37.58333333,0,7,8,18,1,6,5,5,2,1,12,27,29,34,36.9
2023-24,202403230ORL,3/23/2024,ORL vs SAC,Keegan Murray,murrake02,65,SAC,0,ORL,22,7,2,0,2,0,37.83333333,1,6,8,12,6,7,0,0,5,2,9,24,29,31,39.4
2023-24,202403230WAS,3/23/2024,WAS vs TOR,Jordan Poole,poolejo01,69,WAS,1,TOR,18,4,12,3,0,3,38.11666667,1,3,6,14,2,8,4,4,3,3,16,30,22,34,46.8
2023-24,202403230CHI,3/23/2024,CHI vs BOS,Derrick White,whitede01,66,BOS,0,CHI,17,3,6,1,0,1,38.26666667,0,3,6,14,3,11,2,3,1,1,9,23,20,26,31.6
2023-24,202403230POR,3/23/2024,POR vs DEN,Kris Murray,murrakr01,51,POR,1,DEN,11,7,1,1,1,1,39.18333333,3,4,5,13,1,6,0,0,1,2,8,12,18,19,25.9
2023-24,202403230POR,3/23/2024,POR vs DEN,Toumani Camara,camarto01,68,POR,1,DEN,16,7,6,1,1,1,39.33333333,4,3,6,11,2,4,2,2,2,2,13,22,23,29,38.4
2023-24,202403230ORL,3/23/2024,ORL vs SAC,Domantas Sabonis,sabondo01,70,SAC,0,ORL,21,14,8,1,0,2,39.51666667,1,13,7,14,1,3,6,6,3,1,22,29,35,43,50.8
2023-24,202403230CHI,3/23/2024,CHI vs BOS,Ayo Dosunmu,dosunay01,69,CHI,1,BOS,14,2,4,2,0,1,39.96666667,0,2,7,16,0,4,0,0,4,2,6,18,16,20,27.4
2023-24,202403230NYK,3/23/2024,NYK vs BRK,Donte DiVincenzo,divindo01,69,NYK,1,BRK,31,6,5,2,1,2,40.86666667,2,4,12,24,4,13,3,4,3,3,11,36,37,42,52.7
2023-24,202403230CHI,3/23/2024,CHI vs BOS,DeMar DeRozan,derozde01,69,CHI,1,BOS,28,6,9,0,1,2,42.4,0,6,12,19,0,1,4,4,1,1,15,37,34,43,49.7
2023-24,202403230NYK,3/23/2024,NYK vs BRK,Josh Hart,hartjo01,69,NYK,1,BRK,6,13,5,1,1,0,44.1,3,10,3,8,0,3,0,1,2,2,18,11,19,24,35.1
2023-24,202403230NYK,3/23/2024,NYK vs BRK,Miles McBride,mcbrimi01,57,NYK,1,BRK,26,2,3,1,0,0,48,1,1,9,16,6,12,2,2,4,1,5,29,28,31,35.9
2023-24,202403220MIA,3/22/2024,MIA vs NOP,Thomas Bryant,bryanth01,33,MIA,1,NOP,8,3,0,0,1,0,10.5,0,3,2,2,2,2,2,2,1,1,3,8,11,11,14.6
2023-24,202403220SAS,3/22/2024,SAS vs MEM,DeJon Jarreau,jarrede01,7,MEM,0,SAS,1,2,0,1,1,1,11.73333333,0,2,0,4,0,0,1,2,3,2,2,1,3,3,8.4
2023-24,202403220MIA,3/22/2024,MIA vs NOP,Patty Mills,millspa02,27,MIA,1,NOP,4,1,1,0,0,0,12.08333333,1,0,2,7,0,4,0,0,1,0,2,5,5,6,6.7
2023-24,202403220TOR,3/22/2024,TOR vs OKC,Aaron Wiggins,wiggiaa01,66,OKC,0,TOR,3,1,2,3,0,1,12.28333333,0,1,1,2,0,0,1,2,0,3,3,5,4,6,15.2
2023-24,202403220LAL,3/22/2024,LAL vs PHI,Cameron Payne,payneca01,66,PHI,0,LAL,7,0,2,1,0,0,12.31666667,0,0,3,9,1,3,0,0,1,1,2,9,7,9,13
2023-24,202403220LAL,3/22/2024,LAL vs PHI,Buddy Hield,hieldbu01,73,PHI,0,LAL,5,0,1,2,1,1,12.98333333,0,0,2,6,1,3,0,0,3,3,1,6,5,6,14.5
2023-24,202403220LAL,3/22/2024,LAL vs PHI,Paul Reed,reedpa01,70,PHI,0,LAL,4,5,0,1,0,0,13.08333333,4,1,2,3,0,0,0,0,4,1,5,4,9,9,13
2023-24,202403220SAS,3/22/2024,SAS vs MEM,Maozinha Pereira,pereima01,2,MEM,0,SAS,0,3,0,1,0,1,13.35,0,3,0,3,0,1,0,0,1,1,3,0,3,3,5.6
2023-24,202403220POR,3/22/2024,POR vs LAC,Moses Brown,brownmo01,16,POR,1,LAC,9,6,2,0,0,0,13.75,4,2,3,6,0,0,3,8,3,0,8,11,15,17,19.2
2023-24,202403220MIA,3/22/2024,MIA vs NOP,Jaime Jaquez Jr.,jaqueja01,64,MIA,1,NOP,3,0,3,0,0,0,13.96666667,0,0,1,7,1,5,0,0,1,0,3,6,3,6,7.5
2023-24,202403220GSW,3/22/2024,GSW vs IND,Ben Sheppard,sheppbe01,47,IND,0,GSW,3,1,1,1,0,0,14.23333333,1,0,1,4,1,3,0,0,1,1,2,4,4,5,8.7
2023-24,202403220MIN,3/22/2024,MIN vs CLE,Nickeil Alexander-Walker,alexani01,70,MIN,1,CLE,0,1,0,0,0,1,14.45,0,1,0,2,0,2,0,0,4,0,1,0,1,1,0.2
2023-24,202403220SAS,3/22/2024,SAS vs MEM,Zach Collins,colliza01,57,SAS,1,MEM,4,4,2,0,1,1,14.55,0,4,2,3,0,0,0,0,6,1,6,6,8,10,13.8
2023-24,202403220GSW,3/22/2024,GSW vs IND,Obi Toppin,toppiob01,72,IND,0,GSW,8,3,0,0,0,1,14.88333333,0,3,3,6,2,4,0,0,1,0,3,8,11,11,10.6
2023-24,202403220MIN,3/22/2024,MIN vs CLE,Tristan Thompson,thomptr01,40,CLE,0,MIN,5,7,1,1,1,0,15.1,2,5,2,3,0,0,1,2,2,2,8,6,12,13,20.9
2023-24,202403220DET,3/22/2024,DET vs BOS,Svi Mykhailiuk,mykhasv01,31,BOS,0,DET,3,2,1,0,0,0,15.71666667,0,2,1,1,0,0,1,1,0,0,3,4,5,6,6.9
2023-24,202403220LAL,3/22/2024,LAL vs PHI,Max Christie,chrisma02,57,LAL,1,PHI,0,2,0,0,0,1,16.16666667,0,2,0,0,0,0,0,0,1,0,2,0,2,2,1.4
2023-24,202403220GSW,3/22/2024,GSW vs IND,T.J. McConnell,mccontj01,61,IND,0,GSW,11,2,6,0,0,3,16.71666667,1,1,5,11,0,1,1,1,0,0,8,17,13,19,19.4
2023-24,202403220SAS,3/22/2024,SAS vs MEM,Julian Champagnie,champju02,62,SAS,1,MEM,1,1,1,2,2,1,16.75,0,1,0,2,0,2,1,2,1,4,2,2,2,3,14.7
2023-24,202403220MIA,3/22/2024,MIA vs NOP,Caleb Martin,martica02,53,MIA,1,NOP,0,3,0,0,0,1,16.88333333,1,2,0,8,0,7,0,0,0,0,3,0,3,3,2.6
2023-24,202403220SAS,3/22/2024,SAS vs MEM,Cedi Osman,osmande01,66,SAS,1,MEM,0,2,0,0,0,0,17.13333333,0,2,0,3,0,2,0,0,1,0,2,0,2,2,2.4
2023-24,202403220DET,3/22/2024,DET vs BOS,Luke Kornet,kornelu01,52,BOS,0,DET,3,3,4,0,1,0,17.18333333,1,2,1,2,0,0,1,2,2,1,7,7,6,10,15.6
2023-24,202403220DET,3/22/2024,DET vs BOS,Jared Rhoden,rhodeja01,7,DET,1,BOS,9,5,0,1,0,2,17.28333333,0,5,4,5,1,2,0,0,2,1,5,9,14,14,16
2023-24,202403220TOR,3/22/2024,TOR vs OKC,Isaiah Joe,joeis01,65,OKC,0,TOR,8,1,2,0,0,0,17.3,0,1,2,5,1,4,3,3,3,0,3,10,9,11,12.2
2023-24,202403220SAS,3/22/2024,SAS vs MEM,Malaki Branham,branhma01,65,SAS,1,MEM,4,3,2,1,0,0,17.78333333,0,3,2,7,0,3,0,0,2,1,5,6,7,9,13.6
2023-24,202403220MIN,3/22/2024,MIN vs CLE,Monte Morris,morrimo01,21,MIN,1,CLE,3,0,3,0,0,0,17.85,0,0,1,5,1,2,0,0,0,0,3,6,3,6,7.5
2023-24,202403220POR,3/22/2024,POR vs LAC,Ivica Zubac,zubaciv01,57,LAC,0,POR,6,8,0,1,1,3,17.93333333,1,7,3,3,0,0,0,0,5,2,8,6,14,14,18.6
2023-24,202403220TOR,3/22/2024,TOR vs OKC,Garrett Temple,templga01,17,TOR,1,OKC,8,2,2,2,0,0,18.03333333,0,2,2,2,2,2,2,2,0,2,4,10,10,12,19.4
2023-24,202403220MIN,3/22/2024,MIN vs CLE,Jordan McLaughlin,mclaujo01,44,MIN,1,CLE,12,2,4,1,0,0,18.55,0,2,4,4,4,4,0,0,0,1,6,16,14,18,23.4
2023-24,202403220MIA,3/22/2024,MIA vs NOP,Cole Swider,swideco01,12,MIA,1,NOP,14,2,0,0,0,0,18.66666667,0,2,5,7,4,6,0,0,0,0,2,14,16,16,16.4
2023-24,202403220MIA,3/22/2024,MIA vs NOP,Nikola Jovic,jovicni01,34,MIA,1,NOP,10,1,1,1,0,1,18.86666667,0,1,4,9,2,5,0,0,1,1,2,11,11,12,14.7
2023-24,202403220POR,3/22/2024,POR vs LAC,Brandon Boston Jr.,bostobr01,25,LAC,0,POR,9,4,1,1,0,3,19.01666667,1,3,3,4,2,3,1,2,3,1,5,10,13,14,15.3
2023-24,202403220TOR,3/22/2024,TOR vs OKC,Jahmi'us Ramsey,ramseja01,6,TOR,1,OKC,7,0,2,2,0,2,19.26666667,0,0,3,7,1,4,0,0,4,2,2,9,7,9,14
2023-24,202403220DET,3/22/2024,DET vs BOS,Oshae Brissett,brissos01,46,BOS,0,DET,6,2,1,0,1,0,19.36666667,0,2,2,2,1,1,1,2,1,1,3,7,8,9,12.9
2023-24,202403220LAL,3/22/2024,LAL vs PHI,Cam Reddish,reddica01,42,LAL,1,PHI,0,2,0,0,0,0,19.43333333,1,1,0,2,0,2,0,0,2,0,2,0,2,2,2.4
2023-24,202403220DET,3/22/2024,DET vs BOS,Chimezie Metu,metuch01,39,DET,1,BOS,2,4,2,0,0,3,19.46666667,0,4,1,3,0,2,0,0,4,0,6,4,6,8,6.8
2023-24,202403220LAL,3/22/2024,LAL vs PHI,Nicolas Batum,batumni01,49,PHI,0,LAL,0,5,1,0,0,1,19.71666667,1,4,0,2,0,2,0,0,0,0,6,1,5,6,6.5
2023-24,202403220DET,3/22/2024,DET vs BOS,Xavier Tillman Sr.,tillmxa01,44,BOS,0,DET,2,4,0,0,0,1,19.91666667,2,2,1,2,0,1,0,0,1,0,4,2,6,6,5.8
2023-24,202403220TOR,3/22/2024,TOR vs OKC,Jontay Porter,portejo01,26,TOR,1,OKC,7,3,8,2,1,3,20.61666667,1,2,2,3,1,2,2,2,0,3,11,15,10,18,28.6
2023-24,202403220POR,3/22/2024,POR vs LAC,Daniel Theis,theisda01,54,LAC,0,POR,6,4,1,0,2,1,20.66666667,1,3,3,5,0,1,0,0,2,2,5,7,10,11,17.3
2023-24,202403220DET,3/22/2024,DET vs BOS,Troy Brown Jr.,browntr01,47,DET,1,BOS,8,3,2,0,0,0,20.78333333,0,3,3,7,2,6,0,0,1,0,5,10,11,13,14.6
2023-24,202403220GSW,3/22/2024,GSW vs IND,Jalen Smith,smithja04,50,IND,0,GSW,11,7,1,1,1,0,21.06666667,3,4,4,5,3,3,0,0,2,2,8,12,18,19,26.9
2023-24,202403220TOR,3/22/2024,TOR vs OKC,Jordan Nwora,nworajo01,41,TOR,1,OKC,12,4,2,1,0,3,21.35,0,4,6,10,0,3,0,0,3,1,6,14,16,18,19.8
2023-24,202403220MIA,3/22/2024,MIA vs NOP,Jonas Valanciunas,valanjo01,70,NOP,0,MIA,8,10,0,0,0,0,21.68333333,0,10,4,4,0,0,0,0,4,0,10,8,18,18,20
2023-24,202403220POR,3/22/2024,POR vs LAC,Anfernee Simons,simonan01,46,POR,1,LAC,3,0,6,1,0,0,21.83333333,0,0,1,6,1,4,0,0,0,1,6,9,3,9,15
2023-24,202403220TOR,3/22/2024,TOR vs OKC,Josh Giddey,giddejo01,68,OKC,0,TOR,10,2,5,0,1,2,21.95,0,2,4,6,1,2,1,1,3,1,7,15,12,17,20.9
2023-24,202403220MIA,3/22/2024,MIA vs NOP,Haywood Highsmith,highsha01,54,MIA,1,NOP,0,3,3,0,0,0,21.95,1,2,0,3,0,2,0,0,1,0,6,3,3,6,8.1
2023-24,202403220GSW,3/22/2024,GSW vs IND,Andrew Wiggins,wiggian01,60,GSW,1,IND,8,5,1,0,1,0,22,3,2,4,11,0,3,0,0,1,1,6,9,13,14,18.5
2023-24,202403220MIA,3/22/2024,MIA vs NOP,Delon Wright,wrighde01,40,MIA,1,NOP,5,1,3,1,0,0,22.41666667,0,1,2,7,0,4,1,2,1,1,4,8,6,9,13.7
2023-24,202403220TOR,3/22/2024,TOR vs OKC,Luguentz Dort,dortlu01,67,OKC,0,TOR,10,3,2,0,0,1,22.73333333,0,3,4,9,1,5,1,1,3,0,5,12,13,15,15.6
2023-24,202403220MIA,3/22/2024,MIA vs NOP,Naji Marshall,marshna01,58,NOP,0,MIA,13,7,1,1,0,0,22.83333333,0,7,6,11,1,2,0,0,1,1,8,14,20,21,25.9
2023-24,202403220TOR,3/22/2024,TOR vs OKC,Kenrich Williams,willike04,56,OKC,0,TOR,12,5,2,4,0,0,23.11666667,3,2,5,7,2,3,0,0,0,4,7,14,17,19,33
2023-24,202403220MIA,3/22/2024,MIA vs NOP,Larry Nance Jr.,nancela02,51,NOP,0,MIA,6,9,1,0,0,0,23.15,4,5,2,2,0,0,2,3,0,0,10,7,15,16,18.3
2023-24,202403220POR,3/22/2024,POR vs LAC,Rayan Rupert,ruperra01,27,POR,1,LAC,5,2,1,0,1,0,23.23333333,0,2,2,2,0,0,1,2,2,1,3,6,7,8,11.9
2023-24,202403220SAS,3/22/2024,SAS vs MEM,Scotty Pippen Jr.,pippesc02,10,MEM,0,SAS,18,3,2,4,0,3,23.46666667,1,2,6,9,2,2,4,8,2,4,5,20,21,23,33.6
2023-24,202403220MIN,3/22/2024,MIN vs CLE,Sam Merrill,merrisa01,52,CLE,0,MIN,10,3,1,0,0,0,23.51666667,0,3,3,7,3,7,1,1,0,0,4,11,13,14,15.1
2023-24,202403220TOR,3/22/2024,TOR vs OKC,Cason Wallace,wallaca01,69,OKC,0,TOR,12,4,1,2,0,0,23.65,3,1,4,10,3,5,1,2,0,2,5,13,16,17,24.3
2023-24,202403220LAL,3/22/2024,LAL vs PHI,Spencer Dinwiddie,dinwisp01,64,LAL,1,PHI,11,0,2,0,1,0,23.83333333,0,0,3,8,3,6,2,2,1,1,2,13,11,13,17
2023-24,202403220DET,3/22/2024,DET vs BOS,Sam Hauser,hausesa01,67,BOS,0,DET,14,4,1,1,0,0,23.83333333,0,4,5,14,4,11,0,0,1,1,5,15,18,19,23.3
2023-24,202403220TOR,3/22/2024,TOR vs OKC,Gordon Hayward,haywago01,40,OKC,0,TOR,5,6,1,0,0,2,23.83333333,0,6,1,4,1,3,2,2,4,0,7,6,11,12,11.7
2023-24,202403220POR,3/22/2024,POR vs LAC,Dalano Banton,bantoda01,43,POR,1,LAC,17,4,2,2,0,1,24.03333333,1,3,7,16,2,6,1,1,1,2,6,19,21,23,29.8
2023-24,202403220LAL,3/22/2024,LAL vs PHI,Rui Hachimura,hachiru01,57,LAL,1,PHI,14,7,1,0,0,1,24.41666667,1,6,4,10,1,3,5,6,3,0,8,15,21,22,22.9
2023-24,202403220SAS,3/22/2024,SAS vs MEM,Jordan Goodwin,goodwjo01,49,MEM,0,SAS,2,5,5,1,0,3,24.53333333,0,5,1,5,0,3,0,0,0,1,10,7,7,12,15.5
2023-24,202403220MIA,3/22/2024,MIA vs NOP,Zion Williamson,willizi01,59,NOP,0,MIA,4,5,4,0,1,5,24.83333333,3,2,2,7,0,0,0,0,2,1,9,8,9,13,14
2023-24,202403220GSW,3/22/2024,GSW vs IND,Chris Paul,paulch01,45,GSW,1,IND,12,6,4,0,0,2,24.86666667,2,4,5,10,2,5,0,0,4,0,10,16,18,22,23.2
2023-24,202403220GSW,3/22/2024,GSW vs IND,Trayce Jackson-Davis,jackstr02,56,GSW,1,IND,9,10,2,1,2,1,25.76666667,5,5,4,5,0,0,1,3,1,3,12,11,19,21,32
2023-24,202403220MIN,3/22/2024,MIN vs CLE,Naz Reid,reidna01,69,MIN,1,CLE,18,3,3,1,0,1,25.96666667,0,3,7,15,3,8,1,1,3,1,6,21,21,24,28.1
2023-24,202403220DET,3/22/2024,DET vs BOS,Kristaps Porzingis,porzikr01,49,BOS,0,DET,19,4,1,3,2,0,26.11666667,2,2,7,15,2,6,3,4,5,5,5,20,23,24,40.3
2023-24,202403220MIN,3/22/2024,MIN vs CLE,Marcus Morris,morrima03,40,CLE,0,MIN,11,7,1,0,0,4,26.48333333,0,7,4,10,1,5,2,2,0,0,8,12,18,19,16.9
2023-24,202403220TOR,3/22/2024,TOR vs OKC,Chet Holmgren,holmgch01,69,OKC,0,TOR,18,10,1,2,1,0,26.6,3,7,8,13,2,4,0,0,1,3,11,19,28,29,40.5
2023-24,202403220POR,3/22/2024,POR vs LAC,Duop Reath,reathdu01,56,POR,1,LAC,13,3,2,2,0,3,26.68333333,0,3,5,10,2,6,1,1,3,2,5,15,16,18,22.6
2023-24,202403220GSW,3/22/2024,GSW vs IND,Myles Turner,turnemy01,68,IND,0,GSW,14,10,0,0,5,0,26.93333333,2,8,5,15,1,5,3,4,2,5,10,14,24,24,41
2023-24,202403220MIN,3/22/2024,MIN vs CLE,Kyle Anderson,anderky01,67,MIN,1,CLE,10,6,5,3,0,0,26.95,3,3,5,9,0,0,0,0,0,3,11,15,16,21,33.7
2023-24,202403220DET,3/22/2024,DET vs BOS,Jaden Ivey,iveyja01,66,DET,1,BOS,16,4,0,0,0,2,27,0,4,7,13,1,4,1,1,3,0,4,16,20,20,18.8
2023-24,202403220TOR,3/22/2024,TOR vs OKC,Jalen Williams,willija06,62,OKC,0,TOR,20,3,3,3,2,3,27.1,0,3,9,13,0,0,2,2,1,5,6,23,23,26,40.1
2023-24,202403220GSW,3/22/2024,GSW vs IND,Brandin Podziemski,podzibr01,61,GSW,1,IND,13,10,2,1,0,2,27.15,5,5,5,8,3,5,0,0,2,1,12,15,23,25,29
2023-24,202403220TOR,3/22/2024,TOR vs OKC,Kelly Olynyk,olynyke01,68,TOR,1,OKC,16,6,5,1,0,7,27.38333333,1,5,7,9,1,2,1,2,3,1,11,21,22,27,26.7
2023-24,202403220POR,3/22/2024,POR vs LAC,Amir Coffey,coffeam01,57,LAC,0,POR,8,1,3,0,0,2,27.45,0,1,2,3,2,2,2,2,1,0,4,11,9,12,11.7
2023-24,202403220POR,3/22/2024,POR vs LAC,Paul George,georgpa01,63,LAC,0,POR,31,4,3,2,2,0,27.78333333,0,4,10,14,4,8,7,7,3,4,7,34,35,38,52.3
2023-24,202403220SAS,3/22/2024,SAS vs MEM,Jake LaRavia,laravja01,26,MEM,0,SAS,15,5,1,1,0,1,27.78333333,2,3,3,8,1,3,8,9,3,1,6,16,20,21,24.5
2023-24,202403220DET,3/22/2024,DET vs BOS,Evan Fournier,fournev01,21,DET,1,BOS,6,1,3,1,1,1,27.9,0,1,3,7,0,3,0,0,4,2,4,9,7,10,16.7
2023-24,202403220POR,3/22/2024,POR vs LAC,Jabari Walker,walkeja01,61,POR,1,LAC,14,8,3,1,0,0,27.93333333,1,7,6,9,0,1,2,5,3,1,11,17,22,25,31.1
2023-24,202403220TOR,3/22/2024,TOR vs OKC,Bruce Brown,brownbr01,59,TOR,1,OKC,10,3,5,0,0,2,28.1,0,3,4,8,1,2,1,2,2,0,8,15,13,18,19.1
2023-24,202403220GSW,3/22/2024,GSW vs IND,Klay Thompson,thompkl01,66,GSW,1,IND,17,4,2,1,0,3,28.4,0,4,6,15,3,10,2,2,2,1,6,19,21,23,24.8
2023-24,202403220DET,3/22/2024,DET vs BOS,Marcus Sasser,sassema01,61,DET,1,BOS,8,2,7,0,0,2,28.43333333,0,2,3,8,2,4,0,0,2,0,9,15,10,17,18.9
2023-24,202403220DET,3/22/2024,DET vs BOS,Cade Cunningham,cunnica01,59,DET,1,BOS,15,6,6,2,0,3,28.68333333,1,5,6,17,1,4,2,2,4,2,12,21,21,27,34.2
2023-24,202403220SAS,3/22/2024,SAS vs MEM,Keldon Johnson,johnske04,65,SAS,1,MEM,8,8,1,0,0,0,29.2,3,5,2,9,0,4,4,6,3,0,9,9,16,17,19.1
2023-24,202403220TOR,3/22/2024,TOR vs OKC,Javon Freeman-Liberty,freemja01,10,TOR,1,OKC,10,4,3,0,0,2,29.25,0,4,4,10,0,3,2,2,1,0,7,13,14,17,17.3
2023-24,202403220POR,3/22/2024,POR vs LAC,Kawhi Leonard,leonaka01,63,LAC,0,POR,22,6,3,0,1,3,29.26666667,1,5,9,15,2,4,2,3,0,1,9,25,28,31,33.7
2023-24,202403220MIA,3/22/2024,MIA vs NOP,Trey Murphy III,murphtr02,45,NOP,0,MIA,14,8,3,0,0,3,29.61666667,1,7,4,11,4,9,2,2,1,0,11,17,22,25,25.1
2023-24,202403220GSW,3/22/2024,GSW vs IND,Jonathan Kuminga,kuminjo01,68,GSW,1,IND,11,8,2,2,1,3,29.65,2,6,4,17,0,3,3,4,2,3,10,13,19,21,29.6
2023-24,202403220MIA,3/22/2024,MIA vs NOP,Bam Adebayo,adebaba01,59,MIA,1,NOP,12,10,1,0,2,0,29.8,1,9,4,7,1,2,3,4,1,2,11,13,22,23,31.5
2023-24,202403220DET,3/22/2024,DET vs BOS,Tosan Evbuomwan,evbuoto01,10,DET,1,BOS,14,8,1,0,0,2,30.68333333,2,6,4,9,2,5,4,6,1,0,9,15,22,23,23.1
2023-24,202403220SAS,3/22/2024,SAS vs MEM,Jeremy Sochan,sochaje01,70,SAS,1,MEM,6,10,4,4,1,4,30.91666667,3,7,3,13,0,4,0,0,3,5,14,10,16,20,35
2023-24,202403220MIA,3/22/2024,MIA vs NOP,Terry Rozier,roziete01,53,MIA,1,NOP,13,4,2,0,0,1,30.93333333,1,3,5,14,3,6,0,0,2,0,6,15,17,19,19.8
2023-24,202403220MIA,3/22/2024,MIA vs NOP,Jose Alvarado,alvarjo01,49,NOP,0,MIA,17,7,6,0,0,2,31.46666667,2,5,6,12,4,7,1,2,2,0,13,23,24,30,32.4
2023-24,202403220LAL,3/22/2024,LAL vs PHI,Mo Bamba,bambamo01,48,PHI,0,LAL,11,7,3,2,3,1,31.73333333,1,6,3,7,2,5,3,4,5,5,10,14,18,21,37.9
2023-24,202403220TOR,3/22/2024,TOR vs OKC,Ochai Agbaji,agbajoc01,69,TOR,1,OKC,12,7,6,3,0,2,31.75,2,5,4,10,1,5,3,4,3,3,13,18,19,25,36.4
2023-24,202403220POR,3/22/2024,POR vs LAC,Toumani Camara,camarto01,67,POR,1,LAC,11,7,1,0,0,1,31.81666667,5,2,5,11,1,4,0,0,3,0,8,12,18,19,19.9
2023-24,202403220LAL,3/22/2024,LAL vs PHI,Kyle Lowry,lowryky01,51,PHI,0,LAL,5,2,3,0,1,1,31.83333333,1,1,1,6,1,4,2,2,1,1,5,8,7,10,13.9
2023-24,202403220MIN,3/22/2024,MIN vs CLE,Mike Conley,conlemi01,65,MIN,1,CLE,21,2,6,1,1,0,32.13333333,0,2,8,15,3,6,2,3,1,2,8,27,23,29,38.4
2023-24,202403220MIN,3/22/2024,MIN vs CLE,Jaden McDaniels,mcdanja02,60,MIN,1,CLE,15,4,0,3,2,5,32.18333333,2,2,6,10,2,4,1,4,1,5,4,15,19,19,29.8
2023-24,202403220SAS,3/22/2024,SAS vs MEM,Tre Jones,jonestr01,65,SAS,1,MEM,16,7,5,2,0,1,32.41666667,3,4,7,13,2,4,0,0,3,2,12,21,23,28,36.9
2023-24,202403220TOR,3/22/2024,TOR vs OKC,Gradey Dick,dickgr01,49,TOR,1,OKC,21,5,1,1,0,4,32.68333333,0,5,8,15,4,7,1,3,1,1,6,22,26,27,27.5
2023-24,202403220MIN,3/22/2024,MIN vs CLE,Jarrett Allen,allenja01,65,CLE,0,MIN,15,13,5,0,1,0,32.88333333,5,8,5,10,0,0,5,6,1,1,18,20,28,33,41.1
2023-24,202403220LAL,3/22/2024,LAL vs PHI,Austin Reaves,reaveau01,71,LAL,1,PHI,14,6,5,0,1,3,33.1,1,5,3,8,2,5,6,8,2,1,11,19,20,25,28.7
2023-24,202403220SAS,3/22/2024,SAS vs MEM,John Konchar,konchjo01,55,MEM,0,SAS,6,5,2,1,0,1,33.11666667,0,5,2,5,2,5,0,0,1,1,7,8,11,13,17
2023-24,202403220GSW,3/22/2024,GSW vs IND,Pascal Siakam,siakapa01,69,IND,0,GSW,25,16,6,1,0,3,33.11666667,3,13,11,17,1,3,2,4,1,1,22,31,41,47,53.2
2023-24,202403220DET,3/22/2024,DET vs BOS,Jaylen Brown,brownja02,63,BOS,0,DET,33,4,0,4,0,4,33.13333333,0,4,13,19,3,8,4,7,1,4,4,33,37,37,45.8
2023-24,202403220GSW,3/22/2024,GSW vs IND,Andrew Nembhard,nembhan01,57,IND,0,GSW,17,5,5,0,0,3,33.26666667,1,4,7,11,1,2,2,2,3,0,10,22,22,27,27.5
2023-24,202403220GSW,3/22/2024,GSW vs IND,Draymond Green,greendr01,44,GSW,1,IND,11,8,6,0,2,1,33.31666667,2,6,4,10,0,1,3,4,2,2,14,17,19,25,34.6
2023-24,202403220TOR,3/22/2024,TOR vs OKC,Shai Gilgeous-Alexander,gilgesh01,68,OKC,0,TOR,23,7,8,3,1,6,33.35,1,6,9,20,1,5,4,6,4,4,15,31,30,38,49.4
2023-24,202403220SAS,3/22/2024,SAS vs MEM,Victor Wembanyama,wembavi01,62,SAS,1,MEM,31,16,5,2,3,7,33.45,5,11,11,24,3,12,6,10,2,5,21,36,47,52,65.7
2023-24,202403220MIN,3/22/2024,MIN vs CLE,Georges Niang,niangge01,70,CLE,0,MIN,10,3,0,2,1,2,33.68333333,1,2,4,8,1,3,1,1,4,3,3,10,13,13,20.6
2023-24,202403220SAS,3/22/2024,SAS vs MEM,Santi Aldama,aldamsa01,58,MEM,0,SAS,15,13,3,0,1,0,33.76666667,1,12,5,10,3,6,2,2,0,1,16,18,28,31,38.1
2023-24,202403220POR,3/22/2024,POR vs LAC,Scoot Henderson,hendesc01,51,POR,1,LAC,24,4,10,2,0,4,34.56666667,1,3,8,18,3,6,5,5,0,2,14,34,28,38,45.8
2023-24,202403220MIN,3/22/2024,MIN vs CLE,Anthony Edwards,edwaran01,67,MIN,1,CLE,16,13,5,0,0,3,34.71666667,2,11,6,17,1,1,3,4,1,0,18,21,29,34,36.1
2023-24,202403220GSW,3/22/2024,GSW vs IND,Stephen Curry,curryst01,63,GSW,1,IND,25,11,5,0,0,1,34.88333333,3,8,9,24,6,18,1,1,0,0,16,30,36,41,44.7
2023-24,202403220MIN,3/22/2024,MIN vs CLE,Darius Garland,garlada01,46,CLE,0,MIN,19,2,4,0,0,2,35.05,1,1,8,21,0,6,3,3,2,0,6,23,21,25,25.4
2023-24,202403220MIA,3/22/2024,MIA vs NOP,CJ McCollum,mccolcj01,54,NOP,0,MIA,30,5,7,1,0,2,35.08333333,1,4,12,21,6,12,0,0,0,1,12,37,35,42,47.5
2023-24,202403220LAL,3/22/2024,LAL vs PHI,Kelly Oubre Jr.,oubreke01,57,PHI,0,LAL,19,6,3,3,1,2,35.25,2,4,6,18,1,5,6,7,1,4,9,22,25,28,40.7
2023-24,202403220MIN,3/22/2024,MIN vs CLE,Isaac Okoro,okorois01,61,CLE,0,MIN,5,1,4,2,1,1,35.53333333,0,1,2,6,0,3,1,2,2,3,5,9,6,10,20.2
2023-24,202403220POR,3/22/2024,POR vs LAC,Terance Mann,mannte01,62,LAC,0,POR,20,1,4,2,1,1,35.55,0,1,7,12,1,4,5,5,3,3,5,24,21,25,35.2
2023-24,202403220POR,3/22/2024,POR vs LAC,James Harden,hardeja01,62,LAC,0,POR,15,5,10,1,1,2,35.56666667,1,4,5,13,2,9,3,4,1,2,15,25,20,30,40
2023-24,202403220SAS,3/22/2024,SAS vs MEM,Jaren Jackson Jr.,jacksja02,61,MEM,0,SAS,28,7,2,1,2,4,35.6,2,5,11,22,2,6,4,6,4,3,9,30,35,37,44.4
2023-24,202403220DET,3/22/2024,DET vs BOS,Derrick White,whitede01,65,BOS,0,DET,19,8,11,0,1,1,35.81666667,2,6,5,14,1,7,8,9,1,1,19,30,27,38,47.1
2023-24,202403220GSW,3/22/2024,GSW vs IND,Aaron Nesmith,nesmiaa01,63,IND,0,GSW,8,3,2,1,1,0,35.98333333,1,2,3,11,2,6,0,0,4,2,5,10,11,13,20.6
2023-24,202403220POR,3/22/2024,POR vs LAC,Kris Murray,murrakr01,50,POR,1,LAC,21,7,2,3,0,1,36.13333333,3,4,8,15,3,6,2,3,4,3,9,23,28,30,40.4
2023-24,202403220MIA,3/22/2024,MIA vs NOP,Jimmy Butler,butleji01,49,MIA,1,NOP,17,4,5,1,0,0,36.4,1,3,5,12,0,3,7,7,0,1,9,22,21,26,32.3
2023-24,202403220SAS,3/22/2024,SAS vs MEM,GG Jackson II,jacksgg01,37,MEM,0,SAS,14,8,3,0,0,3,36.65,3,5,5,16,2,8,2,4,3,0,11,17,22,25,25.1
2023-24,202403220DET,3/22/2024,DET vs BOS,James Wiseman,wisemja01,51,DET,1,BOS,24,9,4,0,0,3,36.96666667,5,4,11,13,0,0,2,4,2,0,13,28,33,37,37.8
2023-24,202403220MIN,3/22/2024,MIN vs CLE,Rudy Gobert,goberru01,64,MIN,1,CLE,9,15,1,0,2,1,37.18333333,6,9,4,8,0,0,1,4,2,2,16,10,24,25,33.5
2023-24,202403220LAL,3/22/2024,LAL vs PHI,D'Angelo Russell,russeda01,66,LAL,1,PHI,14,5,3,1,0,5,37.18333333,0,5,4,13,4,10,2,2,2,1,8,17,19,22,22.5
2023-24,202403220DET,3/22/2024,DET vs BOS,Payton Pritchard,pritcpa01,70,BOS,0,DET,20,2,9,0,0,1,37.71666667,0,2,8,15,4,9,0,0,2,0,11,29,22,31,34.9
2023-24,202403220MIN,3/22/2024,MIN vs CLE,Caris LeVert,leverca01,58,CLE,0,MIN,16,5,6,1,1,3,37.73333333,1,4,6,16,2,5,2,2,3,2,11,22,21,27,34
2023-24,202403220GSW,3/22/2024,GSW vs IND,Tyrese Haliburton,halibty01,59,IND,0,GSW,26,2,11,4,3,1,37.83333333,0,2,9,18,4,8,4,5,0,7,13,37,28,39,64.9
2023-24,202403220LAL,3/22/2024,LAL vs PHI,LeBron James,jamesle01,62,LAL,1,PHI,20,8,6,0,1,8,37.86666667,0,8,7,15,1,3,5,7,1,1,14,26,28,34,33.6
2023-24,202403220SAS,3/22/2024,SAS vs MEM,Devin Vassell,vassede01,64,SAS,1,MEM,27,4,4,1,0,1,37.86666667,0,4,10,17,2,6,5,5,2,1,8,31,31,35,39.8
2023-24,202403220MIA,3/22/2024,MIA vs NOP,Herbert Jones,joneshe01,64,NOP,0,MIA,10,3,2,0,1,0,38.66666667,0,3,3,8,1,4,3,3,3,1,5,12,13,15,19.6
2023-24,202403220LAL,3/22/2024,LAL vs PHI,Tyrese Maxey,maxeyty01,61,PHI,0,LAL,27,2,3,3,0,0,39.05,0,2,10,26,1,9,6,6,4,3,5,30,29,32,42.9
2023-24,202403220LAL,3/22/2024,LAL vs PHI,Anthony Davis,davisan02,67,LAL,1,PHI,23,19,4,0,4,3,39.66666667,7,12,10,16,1,2,2,4,4,4,23,27,42,46,60.8
2023-24,202403220LAL,3/22/2024,LAL vs PHI,Tobias Harris,harrito02,61,PHI,0,LAL,16,13,4,1,1,2,40.85,2,11,6,18,1,6,3,5,2,2,17,20,29,33,41.6
2023-24,202403210PHO,3/21/2024,PHO vs ATL,Bol Bol,bolbo01,32,PHO,1,ATL,5,3,2,0,1,1,10.96666667,0,3,1,2,1,2,2,2,1,1,5,7,8,10,13.6
2023-24,202403210HOU,3/21/2024,HOU vs CHI,Reggie Bullock,bullore01,31,HOU,1,CHI,3,3,0,1,0,0,11.01666667,1,2,1,2,1,1,0,0,1,1,3,3,6,6,9.6
2023-24,202403210MIL,3/21/2024,MIL vs BRK,Jalen Wilson,wilsoja03,31,BRK,0,MIL,4,5,2,0,0,2,11.35,2,3,1,3,0,1,2,2,0,0,7,6,9,11,11
2023-24,202403210MIL,3/21/2024,MIL vs BRK,Lonnie Walker IV,walkelo01,49,BRK,0,MIL,2,3,0,0,1,0,11.56666667,1,2,1,7,0,5,0,0,1,1,3,2,5,5,8.6
2023-24,202403210ORL,3/21/2024,ORL vs NOP,Jeremiah Robinson-Earl,robinje02,30,NOP,0,ORL,6,1,1,0,0,0,12,0,1,3,5,0,1,0,0,1,0,2,7,7,8,8.7
2023-24,202403210ORL,3/21/2024,ORL vs NOP,Gary Harris,harriga01,46,ORL,1,NOP,5,1,0,0,0,1,12.21666667,1,0,2,3,1,2,0,0,1,0,1,5,6,6,5.2
2023-24,202403210DEN,3/21/2024,DEN vs NYK,Peyton Watson,watsope01,68,DEN,1,NYK,4,1,0,0,0,1,12.76666667,1,0,1,3,0,2,2,2,1,0,1,4,5,5,4.2
2023-24,202403210DEN,3/21/2024,DEN vs NYK,Reggie Jackson,jacksre01,70,DEN,1,NYK,4,0,4,0,1,1,12.98333333,0,0,1,3,0,1,2,2,1,1,4,8,4,8,12
2023-24,202403210WAS,3/21/2024,WAS vs SAC,Johnny Davis,davisjo06,39,WAS,1,SAC,4,3,1,0,0,0,13.13333333,1,2,1,2,0,0,2,2,2,0,4,5,7,8,9.1
2023-24,202403210ORL,3/21/2024,ORL vs NOP,Caleb Houstan,houstca01,53,ORL,1,NOP,3,1,0,0,0,1,13.46666667,1,0,1,3,1,3,0,0,1,0,1,3,4,4,3.2
2023-24,202403210DEN,3/21/2024,DEN vs NYK,Christian Braun,braunch01,70,DEN,1,NYK,3,3,1,0,0,0,13.48333333,0,3,1,2,0,1,1,2,1,0,4,4,6,7,8.1
2023-24,202403210MIL,3/21/2024,MIL vs BRK,A.J. Green,greenaj01,47,MIL,1,BRK,15,2,0,0,0,1,13.75,1,1,5,7,5,7,0,0,1,0,2,15,17,17,16.4
2023-24,202403210MIL,3/21/2024,MIL vs BRK,Noah Clowney,clownno01,11,BRK,0,MIL,5,4,1,0,0,0,13.95,1,3,2,5,1,4,0,0,0,0,5,6,9,10,11.3
2023-24,202403210ORL,3/21/2024,ORL vs NOP,Moritz Wagner,wagnemo01,68,ORL,1,NOP,14,1,0,0,0,0,14.25,0,1,5,5,2,2,2,2,0,0,1,14,15,15,15.2
2023-24,202403210DEN,3/21/2024,DEN vs NYK,Bojan Bogdanovic,bogdabo02,44,NYK,0,DEN,3,1,2,0,0,2,14.36666667,0,1,1,5,1,2,0,0,0,0,3,5,4,6,5.2
2023-24,202403210PHO,3/21/2024,PHO vs ATL,Wesley Matthews,matthwe02,29,ATL,0,PHO,3,1,0,0,0,0,14.45,0,1,1,4,1,2,0,0,3,0,1,3,4,4,4.2
2023-24,202403210DAL,3/21/2024,DAL vs UTA,Dante Exum,exumda01,44,DAL,1,UTA,0,2,2,0,0,2,15.15,0,2,0,1,0,0,0,0,2,0,4,2,2,4,3.4
2023-24,202403210PHO,3/21/2024,PHO vs ATL,Royce O'Neale,onealro01,67,PHO,1,ATL,14,5,2,0,1,1,15.26666667,0,5,5,7,4,6,0,0,1,1,7,16,19,21,25
2023-24,202403210MIL,3/21/2024,MIL vs BRK,Pat Connaughton,connapa01,64,MIL,1,BRK,2,0,4,1,0,0,15.46666667,0,0,1,4,0,1,0,0,1,1,4,6,2,6,11
2023-24,202403210DAL,3/21/2024,DAL vs UTA,Dereck Lively II,livelde01,51,DAL,1,UTA,6,5,1,0,0,1,15.48333333,3,2,3,5,0,0,0,2,0,0,6,7,11,12,12.5
2023-24,202403210ORL,3/21/2024,ORL vs NOP,Joe Ingles,inglejo01,56,ORL,1,NOP,0,3,2,3,0,1,15.6,0,3,0,1,0,1,0,0,2,3,5,2,3,5,14.6
2023-24,202403210ORL,3/21/2024,ORL vs NOP,Jonathan Isaac,isaacjo01,48,ORL,1,NOP,9,5,2,2,1,1,15.93333333,3,2,4,6,1,3,0,0,1,3,7,11,14,16,26
2023-24,202403210PHO,3/21/2024,PHO vs ATL,Drew Eubanks,eubandr01,64,PHO,1,ATL,7,4,0,0,3,1,16.41666667,1,3,3,4,0,0,1,1,2,3,4,7,11,11,19.8
2023-24,202403210DAL,3/21/2024,DAL vs UTA,Tim Hardaway Jr.,hardati02,67,DAL,1,UTA,0,1,0,0,0,1,16.88333333,0,1,0,4,0,3,0,0,0,0,1,0,1,1,0.2
2023-24,202403210HOU,3/21/2024,HOU vs CHI,Dalen Terry,terryda01,47,CHI,0,HOU,6,7,5,0,0,0,17.11666667,3,4,3,5,0,1,0,0,0,0,12,11,13,18,21.9
2023-24,202403210DAL,3/21/2024,DAL vs UTA,Jaden Hardy,hardyja02,62,DAL,1,UTA,6,2,5,0,0,1,17.16666667,1,1,2,5,2,4,0,0,4,0,7,11,8,13,14.9
2023-24,202403210DAL,3/21/2024,DAL vs UTA,Maxi Kleber,klebima01,33,DAL,1,UTA,7,2,2,3,0,1,17.78333333,1,1,2,3,2,3,1,2,3,3,4,9,9,11,20.4
2023-24,202403210ORL,3/21/2024,ORL vs NOP,Jose Alvarado,alvarjo01,48,NOP,0,ORL,0,1,3,1,0,0,17.81666667,0,1,0,3,0,1,0,0,2,1,4,3,1,4,8.7
2023-24,202403210ORL,3/21/2024,ORL vs NOP,Naji Marshall,marshna01,57,NOP,0,ORL,4,0,2,1,0,1,17.9,0,0,2,6,0,2,0,0,0,1,2,6,4,6,9
2023-24,202403210ORL,3/21/2024,ORL vs NOP,Larry Nance Jr.,nancela02,50,NOP,0,ORL,0,2,3,2,0,1,18,0,2,0,1,0,0,0,0,0,2,5,3,2,5,11.9
2023-24,202403210ORL,3/21/2024,ORL vs NOP,Jonas Valanciunas,valanjo01,69,NOP,0,ORL,6,5,1,1,0,1,18,0,5,3,4,0,1,0,0,3,1,6,7,11,12,15.5
2023-24,202403210ORL,3/21/2024,ORL vs NOP,Cole Anthony,anthoco01,69,ORL,1,NOP,10,5,1,0,1,2,18.08333333,1,4,3,8,2,4,2,2,1,1,6,11,15,16,18.5
2023-24,202403210WAS,3/21/2024,WAS vs SAC,Anthony Gill,gillan01,40,WAS,1,SAC,8,2,1,1,0,1,18.26666667,1,1,2,4,0,1,4,4,2,1,3,9,10,11,13.9
2023-24,202403210HOU,3/21/2024,HOU vs CHI,Aaron Holiday,holidaa01,66,HOU,1,CHI,15,3,1,1,0,1,18.4,1,2,5,6,3,4,2,2,2,1,4,16,18,19,22.1
2023-24,202403210MIL,3/21/2024,MIL vs BRK,Dennis Smith Jr.,smithde03,54,BRK,0,MIL,5,3,6,3,0,3,18.56666667,0,3,2,2,1,1,0,0,2,3,9,11,8,14,23.6
2023-24,202403210WAS,3/21/2024,WAS vs SAC,Jared Butler,butleja02,28,WAS,1,SAC,8,1,1,2,0,4,19.08333333,0,1,3,5,2,3,0,0,1,2,2,9,9,10,12.7
2023-24,202403210PHO,3/21/2024,PHO vs ATL,Onyeka Okongwu,okongon01,55,ATL,0,PHO,8,3,1,1,1,0,19.25,1,2,4,7,0,1,0,0,4,2,4,9,11,12,19.1
2023-24,202403210WAS,3/21/2024,WAS vs SAC,Chris Duarte,duartch01,49,SAC,0,WAS,3,3,2,1,2,1,19.3,1,2,1,8,1,7,0,0,0,3,5,5,6,8,17.6
2023-24,202403210WAS,3/21/2024,WAS vs SAC,Davion Mitchell,mitchda01,59,SAC,0,WAS,5,2,1,1,0,1,19.36666667,1,1,2,3,1,1,0,0,0,1,3,6,7,8,10.9
2023-24,202403210MIL,3/21/2024,MIL vs BRK,Patrick Beverley,beverpa01,65,MIL,1,BRK,2,3,2,0,1,1,19.46666667,1,2,0,4,0,3,2,2,1,1,5,4,5,7,10.6
2023-24,202403210DAL,3/21/2024,DAL vs UTA,Brice Sensabaugh,sensabr01,20,UTA,0,DAL,3,8,5,1,2,2,19.51666667,1,7,1,7,0,4,1,2,1,3,13,8,11,16,27.1
2023-24,202403210DAL,3/21/2024,DAL vs UTA,Kris Dunn,dunnkr01,61,UTA,0,DAL,4,4,5,1,1,4,19.61666667,0,4,2,3,0,1,0,0,5,2,9,9,8,13,18.3
2023-24,202403210ORL,3/21/2024,ORL vs NOP,Markelle Fultz,fultzma01,32,ORL,1,NOP,6,1,6,1,0,0,20.16666667,1,0,3,4,0,0,0,0,3,1,7,12,7,13,19.2
2023-24,202403210DAL,3/21/2024,DAL vs UTA,Omer Yurtseven,yurtsom01,38,UTA,0,DAL,10,5,2,0,0,0,20.51666667,2,3,4,7,1,2,1,2,2,0,7,12,15,17,19
2023-24,202403210DEN,3/21/2024,DEN vs NYK,Alec Burks,burksal01,60,NYK,0,DEN,18,5,1,2,0,3,20.55,0,5,5,11,3,6,5,7,1,2,6,19,23,24,28.5
2023-24,202403210WAS,3/21/2024,WAS vs SAC,Keon Ellis,elliske01,44,SAC,0,WAS,2,1,0,1,0,0,20.83333333,0,1,1,3,0,2,0,0,4,1,1,2,3,3,6.2
2023-24,202403210PHO,3/21/2024,PHO vs ATL,Garrison Mathews,mathega01,53,ATL,0,PHO,9,2,2,1,0,0,21.05,0,2,2,5,0,2,5,6,3,1,4,11,11,13,17.4
2023-24,202403210ORL,3/21/2024,ORL vs NOP,Brandon Ingram,ingrabr01,63,NOP,0,ORL,14,4,3,1,0,2,21.48333333,0,4,7,12,0,1,0,0,2,1,7,17,18,21,24.3
2023-24,202403210HOU,3/21/2024,HOU vs CHI,Jabari Smith Jr.,smithja05,64,HOU,1,CHI,5,7,0,0,0,3,22.48333333,1,6,2,10,0,4,1,1,5,0,7,5,12,12,10.4
2023-24,202403210ORL,3/21/2024,ORL vs NOP,Wendell Carter Jr.,cartewe01,43,ORL,1,NOP,8,6,4,3,1,1,23.33333333,2,4,4,7,0,2,0,3,0,4,10,12,14,18,32.2
2023-24,202403210HOU,3/21/2024,HOU vs CHI,DeMar DeRozan,derozde01,68,CHI,0,HOU,16,2,2,2,0,0,23.61666667,0,2,4,15,0,1,8,9,1,2,4,18,18,20,27.4
2023-24,202403210HOU,3/21/2024,HOU vs CHI,Andre Drummond,drumman01,70,CHI,0,HOU,9,8,0,1,1,2,23.9,3,5,3,5,0,0,3,4,1,2,8,9,17,17,22.6
2023-24,202403210PHO,3/21/2024,PHO vs ATL,Eric Gordon,gordoer01,57,PHO,1,ATL,21,1,5,2,0,0,24.1,0,1,8,11,4,6,1,1,1,2,6,26,22,27,35.7
2023-24,202403210DAL,3/21/2024,DAL vs UTA,Derrick Jones Jr.,jonesde02,65,DAL,1,UTA,12,4,2,0,1,0,24.45,0,4,4,4,0,0,4,6,1,1,6,14,16,18,22.8
2023-24,202403210HOU,3/21/2024,HOU vs CHI,Torrey Craig,craigto01,41,CHI,0,HOU,10,4,1,0,1,2,24.7,1,3,4,9,2,4,0,0,3,1,5,11,14,15,17.3
2023-24,202403210PHO,3/21/2024,PHO vs ATL,Clint Capela,capelca01,61,ATL,0,PHO,13,10,2,0,2,0,24.76666667,5,5,5,10,0,0,3,5,2,2,12,15,23,25,34
2023-24,202403210HOU,3/21/2024,HOU vs CHI,Dillon Brooks,brookdi01,60,HOU,1,CHI,23,2,1,2,0,0,25.21666667,0,2,10,13,3,6,0,0,0,2,3,24,25,26,32.9
2023-24,202403210DEN,3/21/2024,DEN vs NYK,Precious Achiuwa,achiupr01,62,NYK,0,DEN,9,5,3,0,2,0,25.38333333,0,5,4,5,1,1,0,0,2,2,8,12,14,17,25.5
2023-24,202403210HOU,3/21/2024,HOU vs CHI,Amen Thompson,thompam01,50,HOU,1,CHI,15,8,3,1,0,1,26.31666667,1,7,5,9,0,1,5,6,3,1,11,18,23,26,31.1
2023-24,202403210DEN,3/21/2024,DEN vs NYK,Isaiah Hartenstein,harteis01,63,NYK,0,DEN,20,8,3,1,2,3,26.46666667,3,5,8,10,0,0,4,5,6,3,11,23,28,31,40.1
2023-24,202403210HOU,3/21/2024,HOU vs CHI,Jock Landale,landajo01,43,HOU,1,CHI,17,12,5,0,2,3,26.88333333,7,5,6,10,0,0,5,5,2,2,17,22,29,34,41.9
2023-24,202403210DAL,3/21/2024,DAL vs UTA,Daniel Gafford,gaffoda01,63,DAL,1,UTA,24,7,5,1,0,1,27.26666667,3,4,10,11,0,0,4,6,2,1,12,29,31,36,41.9
2023-24,202403210HOU,3/21/2024,HOU vs CHI,Jeff Green,greenje02,65,HOU,1,CHI,14,7,0,0,1,0,27.46666667,2,5,5,8,3,6,1,2,3,1,7,14,21,21,25.4
2023-24,202403210DAL,3/21/2024,DAL vs UTA,Walker Kessler,kesslwa01,58,UTA,0,DAL,14,9,2,0,0,2,27.48333333,1,8,7,7,0,0,0,0,3,0,11,16,23,25,25.8
2023-24,202403210ORL,3/21/2024,ORL vs NOP,Franz Wagner,wagnefr01,62,ORL,1,NOP,18,3,3,1,0,0,27.56666667,0,3,7,13,2,5,2,2,2,1,6,21,21,24,29.1
2023-24,202403210ORL,3/21/2024,ORL vs NOP,Jalen Suggs,suggsja01,63,ORL,1,NOP,22,1,2,1,0,1,27.68333333,0,1,7,14,3,8,5,6,3,1,3,24,23,25,28.2
2023-24,202403210WAS,3/21/2024,WAS vs SAC,Harrison Barnes,barneha02,69,SAC,0,WAS,12,2,1,1,1,1,28.2,0,2,3,7,0,2,6,8,2,2,3,13,14,15,20.9
2023-24,202403210DAL,3/21/2024,DAL vs UTA,Taylor Hendricks,hendrita0,28,UTA,0,DAL,5,2,0,1,0,1,28.4,0,2,2,4,1,3,0,0,5,1,2,5,7,7,9.4
2023-24,202403210MIL,3/21/2024,MIL vs BRK,Brook Lopez,lopezbr01,67,MIL,1,BRK,17,5,0,0,0,1,28.45,1,4,7,9,3,5,0,0,2,0,5,17,22,22,22
2023-24,202403210ORL,3/21/2024,ORL vs NOP,Zion Williamson,willizi01,58,NOP,0,ORL,20,7,2,2,1,8,28.8,0,7,8,15,0,0,4,6,5,3,9,22,27,29,32.4
2023-24,202403210ORL,3/21/2024,ORL vs NOP,Trey Murphy III,murphtr02,44,NOP,0,ORL,21,3,0,1,0,1,29.33333333,1,2,6,10,3,5,6,7,0,1,3,21,24,24,26.6
2023-24,202403210WAS,3/21/2024,WAS vs SAC,Richaun Holmes,holmeri01,37,WAS,1,SAC,6,16,2,0,1,1,29.46666667,6,10,2,9,0,0,2,2,5,1,18,8,22,24,30.2
2023-24,202403210HOU,3/21/2024,HOU vs CHI,Coby White,whiteco01,67,CHI,0,HOU,13,4,3,0,0,2,29.46666667,0,4,5,13,2,5,1,2,2,0,7,16,17,20,20.3
2023-24,202403210WAS,3/21/2024,WAS vs SAC,Malik Monk,monkma01,68,SAC,0,WAS,20,1,4,1,1,2,29.48333333,0,1,6,13,1,7,7,7,3,2,5,24,21,25,31.2
2023-24,202403210WAS,3/21/2024,WAS vs SAC,Keegan Murray,murrake02,64,SAC,0,WAS,16,2,1,0,2,1,29.55,1,1,7,11,2,4,0,0,3,2,3,17,18,19,24.9
2023-24,202403210MIL,3/21/2024,MIL vs BRK,Bobby Portis,portibo01,70,MIL,1,BRK,6,9,2,2,1,0,29.76666667,2,7,2,10,0,2,2,2,3,3,11,8,15,17,28.8
2023-24,202403210MIL,3/21/2024,MIL vs BRK,Jae Crowder,crowdja01,39,MIL,1,BRK,6,3,2,0,0,1,29.93333333,2,1,3,6,0,3,0,0,1,0,5,8,9,11,11.6
2023-24,202403210MIL,3/21/2024,MIL vs BRK,Malik Beasley,beaslma01,67,MIL,1,BRK,16,6,0,0,0,0,30.91666667,1,5,5,10,2,7,4,4,2,0,6,16,22,22,23.2
2023-24,202403210DEN,3/21/2024,DEN vs NYK,Donte DiVincenzo,divindo01,68,NYK,0,DEN,11,2,4,2,1,0,31.03333333,0,2,4,11,3,8,0,0,2,3,6,15,13,17,28.4
2023-24,202403210PHO,3/21/2024,PHO vs ATL,Jusuf Nurkic,nurkiju01,66,PHO,1,ATL,7,10,2,1,0,2,31.58333333,3,7,1,5,0,0,5,8,3,1,12,9,17,19,23
2023-24,202403210ORL,3/21/2024,ORL vs NOP,Herbert Jones,joneshe01,63,NOP,0,ORL,13,6,5,1,0,2,31.7,2,4,5,6,0,1,3,4,1,1,11,18,19,24,28.7
2023-24,202403210PHO,3/21/2024,PHO vs ATL,Devin Booker,bookede01,56,PHO,1,ATL,30,4,2,0,0,2,31.88333333,1,3,10,15,6,8,4,4,5,0,6,32,34,36,35.8
2023-24,202403210WAS,3/21/2024,WAS vs SAC,Deni Avdija,avdijde01,64,WAS,1,SAC,17,9,5,0,0,3,31.98333333,0,9,7,14,2,3,1,3,3,0,14,22,26,31,32.3
2023-24,202403210DAL,3/21/2024,DAL vs UTA,Keyonte George,georgke01,63,UTA,0,DAL,18,2,5,1,0,6,33.06666667,0,2,6,16,1,6,5,5,0,1,7,23,20,25,24.9
2023-24,202403210DAL,3/21/2024,DAL vs UTA,P.J. Washington,washipj01,62,DAL,1,UTA,6,5,1,2,2,1,33.33333333,1,4,3,9,0,4,0,0,5,4,6,7,11,12,24.5
2023-24,202403210ORL,3/21/2024,ORL vs NOP,Paolo Banchero,banchpa01,68,ORL,1,NOP,20,10,11,1,0,4,33.48333333,1,9,9,18,2,5,0,2,2,1,21,31,30,41,47.5
2023-24,202403210MIL,3/21/2024,MIL vs BRK,Mikal Bridges,bridgmi01,70,BRK,0,MIL,24,6,2,1,0,2,33.48333333,2,4,9,19,6,14,0,0,2,1,8,26,30,32,35.2
2023-24,202403210PHO,3/21/2024,PHO vs ATL,De'Andre Hunter,huntede01,45,ATL,0,PHO,22,4,1,2,0,1,33.55,0,4,5,13,3,7,9,10,2,2,5,23,26,27,33.3
2023-24,202403210ORL,3/21/2024,ORL vs NOP,CJ McCollum,mccolcj01,53,NOP,0,ORL,18,3,3,0,0,2,33.6,0,3,6,12,3,6,3,4,3,0,6,21,21,24,24.1
2023-24,202403210DAL,3/21/2024,DAL vs UTA,Collin Sexton,sextoco01,70,UTA,0,DAL,20,4,5,0,0,3,33.8,1,3,9,14,0,3,2,2,2,0,9,25,24,29,29.3
2023-24,202403210MIL,3/21/2024,MIL vs BRK,Nic Claxton,claxtni01,60,BRK,0,MIL,22,9,1,2,0,1,34.03333333,4,5,9,12,0,0,4,6,3,2,10,23,31,32,39.3
2023-24,202403210DEN,3/21/2024,DEN vs NYK,Jalen Brunson,brunsja01,64,NYK,0,DEN,26,2,9,0,0,0,34.06666667,0,2,11,23,2,7,2,3,1,0,11,35,28,37,41.9
2023-24,202403210DEN,3/21/2024,DEN vs NYK,Jamal Murray,murraja01,54,DEN,1,NYK,23,6,4,2,0,4,34.2,2,4,9,20,1,2,4,4,1,2,10,27,29,33,38.2
2023-24,202403210MIL,3/21/2024,MIL vs BRK,Dennis Schroder,schrode01,70,BRK,0,MIL,5,2,9,1,0,2,34.25,0,2,2,9,1,5,0,0,4,1,11,14,7,16,21.9
2023-24,202403210DAL,3/21/2024,DAL vs UTA,Kyrie Irving,irvinky01,48,DAL,1,UTA,16,5,7,2,0,1,34.61666667,1,4,7,19,2,8,0,0,1,2,12,23,21,28,37.5
2023-24,202403210DAL,3/21/2024,DAL vs UTA,Luka Doncic,doncilu01,61,DAL,1,UTA,34,9,8,4,0,4,34.66666667,1,8,11,23,4,10,8,12,2,4,17,42,43,51,64.8
2023-24,202403210HOU,3/21/2024,HOU vs CHI,Alex Caruso,carusal01,61,CHI,0,HOU,12,2,4,2,0,2,34.8,1,1,3,11,2,8,4,4,5,2,6,16,14,18,24.4
2023-24,202403210MIL,3/21/2024,MIL vs BRK,Giannis Antetokounmpo,antetgi01,65,MIL,1,BRK,21,9,5,0,2,2,34.91666667,3,6,9,19,1,2,2,4,3,2,14,26,30,35,43.3
2023-24,202403210MIL,3/21/2024,MIL vs BRK,Cameron Johnson,johnsca02,54,BRK,0,MIL,17,8,4,0,0,1,35.1,2,6,6,13,4,9,1,1,0,0,12,21,25,29,31.6
2023-24,202403210DEN,3/21/2024,DEN vs NYK,Aaron Gordon,gordoaa01,64,DEN,1,NYK,10,4,8,1,0,0,35.18333333,3,1,5,9,0,0,0,1,1,1,12,18,14,22,29.8
2023-24,202403210DEN,3/21/2024,DEN vs NYK,Josh Hart,hartjo01,68,NYK,0,DEN,2,3,1,0,0,1,35.61666667,1,2,1,5,0,2,0,0,4,0,4,3,5,6,6.1
2023-24,202403210PHO,3/21/2024,PHO vs ATL,Grayson Allen,allengr01,64,PHO,1,ATL,13,3,4,1,2,0,35.78333333,0,3,4,8,3,7,2,2,2,3,7,17,16,20,31.6
2023-24,202403210DAL,3/21/2024,DAL vs UTA,Lauri Markkanen,markkla01,53,UTA,0,DAL,21,3,2,2,0,0,35.78333333,0,3,6,20,1,9,8,8,1,2,5,23,24,26,33.6
2023-24,202403210WAS,3/21/2024,WAS vs SAC,Jordan Poole,poolejo01,68,WAS,1,SAC,14,2,2,3,0,3,35.96666667,1,1,5,11,1,4,3,3,2,3,4,16,16,18,25.4
2023-24,202403210PHO,3/21/2024,PHO vs ATL,Bogdan Bogdanovic,bogdabo01,66,ATL,0,PHO,16,2,3,1,0,0,36.15,1,1,6,13,4,7,0,1,3,1,5,19,18,21,25.9
2023-24,202403210WAS,3/21/2024,WAS vs SAC,Kyle Kuzma,kuzmaky01,66,WAS,1,SAC,31,6,5,1,1,5,36.56666667,0,6,13,22,3,6,2,2,2,2,11,36,37,42,46.7
2023-24,202403210WAS,3/21/2024,WAS vs SAC,De'Aaron Fox,foxde01,61,SAC,0,WAS,25,5,5,6,1,3,36.78333333,3,2,10,30,5,15,0,0,4,7,10,30,30,35,56.5
2023-24,202403210DEN,3/21/2024,DEN vs NYK,Michael Porter Jr.,portemi01,69,DEN,1,NYK,31,8,0,0,0,1,36.88333333,1,7,13,16,3,6,2,2,1,0,8,31,39,39,39.6
2023-24,202403210PHO,3/21/2024,PHO vs ATL,Kevin Durant,duranke01,63,PHO,1,ATL,19,4,2,0,3,5,36.93333333,1,3,5,15,2,8,7,7,1,3,6,21,23,25,30.8
2023-24,202403210DEN,3/21/2024,DEN vs NYK,Kentavious Caldwell-Pope,caldwke01,64,DEN,1,NYK,6,4,3,1,3,1,36.95,0,4,2,5,2,5,0,0,4,4,7,9,10,13,26.3
2023-24,202403210PHO,3/21/2024,PHO vs ATL,Bradley Beal,bealbr01,41,PHO,1,ATL,12,4,9,0,1,5,37.06666667,1,3,4,7,2,4,2,2,3,1,13,21,16,25,28.3
2023-24,202403210MIL,3/21/2024,MIL vs BRK,Damian Lillard,lillada01,65,MIL,1,BRK,30,3,12,2,0,4,37.3,0,3,11,22,5,11,3,3,3,2,15,42,33,45,53.6
2023-24,202403210WAS,3/21/2024,WAS vs SAC,Corey Kispert,kispeco01,68,WAS,1,SAC,15,3,2,1,0,1,37.45,0,3,6,9,1,4,2,6,1,1,5,17,18,20,23.6
2023-24,202403210PHO,3/21/2024,PHO vs ATL,Vit Krejci,krejcvi01,9,ATL,0,PHO,9,1,4,1,0,1,37.55,0,1,4,9,1,5,0,0,3,1,5,13,10,14,18.2
2023-24,202403210WAS,3/21/2024,WAS vs SAC,Domantas Sabonis,sabondo01,69,SAC,0,WAS,14,14,6,0,0,6,38.61666667,2,12,6,9,0,0,2,2,3,0,20,20,28,34,33.8
2023-24,202403210HOU,3/21/2024,HOU vs CHI,Nikola Vucevic,vucevni01,65,CHI,0,HOU,16,14,6,0,1,1,38.88333333,4,10,7,16,1,5,1,2,2,1,20,22,30,36,43.8
2023-24,202403210HOU,3/21/2024,HOU vs CHI,Fred VanVleet,vanvlfr01,62,HOU,1,CHI,9,3,12,1,2,3,38.95,0,3,3,11,3,9,0,0,4,3,15,21,12,24,36.6
2023-24,202403210MIL,3/21/2024,MIL vs BRK,Cam Thomas,thomaca02,55,BRK,0,MIL,21,6,4,0,0,3,39.16666667,0,6,8,17,0,5,5,6,0,0,10,25,27,31,31.2
2023-24,202403210DEN,3/21/2024,DEN vs NYK,Nikola Jokic,jokicni01,68,DEN,1,NYK,30,14,11,1,0,1,39.23333333,2,12,12,23,0,1,6,7,1,1,25,41,44,55,65.3
2023-24,202403210HOU,3/21/2024,HOU vs CHI,Ayo Dosunmu,dosunay01,68,CHI,0,HOU,35,2,2,3,0,2,39.41666667,0,2,13,18,5,6,4,4,2,3,4,37,37,39,47.4
2023-24,202403210PHO,3/21/2024,PHO vs ATL,Dejounte Murray,murrade01,66,ATL,0,PHO,29,9,10,4,0,5,39.71666667,2,7,11,26,3,10,4,5,2,4,19,39,38,48,61.8
2023-24,202403210HOU,3/21/2024,HOU vs CHI,Jalen Green,greenja05,69,HOU,1,CHI,26,4,3,1,1,2,40.01666667,0,4,10,22,4,12,2,4,0,2,7,29,30,33,39.3
2023-24,202403210DEN,3/21/2024,DEN vs NYK,Miles McBride,mcbrimi01,56,NYK,0,DEN,11,3,3,1,1,0,44.13333333,0,3,4,9,1,5,2,2,2,2,6,14,14,17,25.1
2023-24,202403200PHO,3/20/2024,PHO vs PHI,Royce O'Neale,onealro01,66,PHO,1,PHI,13,4,0,0,0,1,10.31666667,2,2,5,7,3,4,0,0,2,0,4,13,17,17,16.8
2023-24,202403200GSW,3/20/2024,GSW vs MEM,Gary Payton II,paytoga02,33,GSW,1,MEM,4,1,1,0,0,1,11.2,1,0,2,2,0,0,0,0,3,0,2,5,5,6,5.7
2023-24,202403200PHO,3/20/2024,PHO vs PHI,Ricky Council IV,councri01,23,PHI,0,PHO,10,0,2,0,0,0,12,0,0,4,5,2,2,0,0,0,0,2,12,10,12,13
2023-24,202403200PHO,3/20/2024,PHO vs PHI,Jeff Dowtin,dowtije01,5,PHI,0,PHO,12,2,5,1,0,0,12,1,1,4,5,2,3,2,2,0,1,7,17,14,19,24.9
2023-24,202403200TOR,3/20/2024,TOR vs SAC,Kessler Edwards,edwarke02,43,SAC,0,TOR,9,3,1,1,0,1,12,1,2,4,8,1,5,0,0,1,1,4,10,12,13,16.1
2023-24,202403200CLE,3/20/2024,CLE vs MIA,Orlando Robinson,robinor01,29,MIA,0,CLE,8,2,2,0,0,0,12.61666667,2,0,3,4,1,1,1,1,0,0,4,10,10,12,13.4
2023-24,202403200TOR,3/20/2024,TOR vs SAC,Mouhamadou Gueye,gueyemo01,3,TOR,1,SAC,3,2,0,1,1,3,13.38333333,1,1,1,6,0,0,1,4,1,2,2,3,5,5,8.4
2023-24,202403200TOR,3/20/2024,TOR vs SAC,Jalen McDaniels,mcdanja01,40,TOR,1,SAC,4,0,3,1,0,0,13.46666667,0,0,2,4,0,2,0,0,0,1,3,7,4,7,11.5
2023-24,202403200PHO,3/20/2024,PHO vs PHI,Bol Bol,bolbo01,31,PHO,1,PHI,10,3,0,0,1,2,14.06666667,0,3,4,6,2,4,0,0,1,1,3,10,13,13,14.6
2023-24,202403200OKC,3/20/2024,OKC vs UTA,Isaiah Joe,joeis01,64,OKC,1,UTA,0,1,0,0,0,0,14.15,0,1,0,4,0,3,0,0,1,0,1,0,1,1,1.2
2023-24,202403200PHO,3/20/2024,PHO vs PHI,Drew Eubanks,eubandr01,63,PHO,1,PHI,4,4,1,1,0,1,14.23333333,1,3,2,5,0,0,0,0,1,1,5,5,8,9,12.3
2023-24,202403200BOS,3/20/2024,BOS vs MIL,Xavier Tillman Sr.,tillmxa01,43,BOS,1,MIL,0,3,2,1,0,1,14.46666667,1,2,0,2,0,2,0,0,1,1,5,2,3,5,8.6
2023-24,202403200PHO,3/20/2024,PHO vs PHI,Buddy Hield,hieldbu01,72,PHI,0,PHO,7,2,0,0,0,0,14.66666667,1,1,3,8,1,5,0,0,0,0,2,7,9,9,9.4
2023-24,202403200DET,3/20/2024,DET vs IND,Troy Brown Jr.,browntr01,46,DET,1,IND,2,1,1,0,0,0,14.73333333,1,0,1,3,0,1,0,0,0,0,2,3,3,4,4.7
2023-24,202403200DET,3/20/2024,DET vs IND,Obi Toppin,toppiob01,71,IND,0,DET,5,3,1,1,0,0,14.83333333,1,2,1,3,1,3,2,2,1,1,4,6,8,9,13.1
2023-24,202403200CLE,3/20/2024,CLE vs MIA,Thomas Bryant,bryanth01,32,MIA,0,CLE,6,10,0,0,1,0,14.96666667,1,9,2,5,0,2,2,2,4,1,10,6,16,16,21
2023-24,202403200BOS,3/20/2024,BOS vs MIL,Jae Crowder,crowdja01,38,MIL,0,BOS,7,2,2,0,0,1,14.96666667,0,2,3,5,1,3,0,0,4,0,4,9,9,11,11.4
2023-24,202403200OKC,3/20/2024,OKC vs UTA,Micah Potter,pottemi01,6,UTA,0,OKC,3,3,1,0,1,2,15.1,0,3,1,2,1,2,0,0,2,1,4,4,6,7,9.1
2023-24,202403200PHO,3/20/2024,PHO vs PHI,Cameron Payne,payneca01,65,PHI,0,PHO,12,1,3,1,0,0,15.18333333,0,1,5,10,2,4,0,0,1,1,4,15,13,16,20.7
2023-24,202403200CLE,3/20/2024,CLE vs MIA,Delon Wright,wrighde01,39,MIA,0,CLE,2,2,1,0,0,1,15.36666667,0,2,1,3,0,0,0,0,1,0,3,3,4,5,4.9
2023-24,202403200OKC,3/20/2024,OKC vs UTA,Jaylin Williams,willija07,56,OKC,1,UTA,3,2,0,1,1,0,15.43333333,0,2,1,4,1,4,0,0,0,2,2,3,5,5,11.4
2023-24,202403200OKC,3/20/2024,OKC vs UTA,Talen Horton-Tucker,hortota01,45,UTA,0,OKC,8,2,2,0,0,1,15.9,0,2,3,10,1,5,1,1,2,0,4,10,10,12,12.4
2023-24,202403200DET,3/20/2024,DET vs IND,Doug McDermott,mcderdo01,53,IND,0,DET,9,3,2,2,0,1,15.95,0,3,4,6,1,3,0,0,1,2,5,11,12,14,20.6
2023-24,202403200TOR,3/20/2024,TOR vs SAC,Alex Len,lenal01,34,SAC,0,TOR,6,3,4,0,1,0,16.03333333,0,3,2,2,0,0,2,2,1,1,7,10,9,13,18.6
2023-24,202403200POR,3/20/2024,POR vs LAC,Duop Reath,reathdu01,55,POR,1,LAC,8,2,1,0,1,1,16.1,0,2,3,8,2,4,0,0,0,1,3,9,10,11,13.9
2023-24,202403200CLE,3/20/2024,CLE vs MIA,Marcus Morris,morrima03,39,CLE,1,MIA,4,2,3,0,0,1,16.25,1,1,1,3,1,2,1,2,2,0,5,7,6,9,9.9
2023-24,202403200OKC,3/20/2024,OKC vs UTA,Gordon Hayward,haywago01,39,OKC,1,UTA,7,2,3,0,0,0,16.55,1,1,2,3,2,3,1,2,0,0,5,10,9,12,13.9
2023-24,202403200DET,3/20/2024,DET vs IND,James Wiseman,wisemja01,50,DET,1,IND,8,9,1,0,0,1,17.26666667,4,5,3,7,0,0,2,2,2,0,10,9,17,18,19.3
2023-24,202403200TOR,3/20/2024,TOR vs SAC,Jordan Nwora,nworajo01,40,TOR,1,SAC,13,2,0,1,0,5,17.41666667,0,2,5,7,1,2,2,3,1,1,2,13,15,15,13.4
2023-24,202403200POR,3/20/2024,POR vs LAC,Toumani Camara,camarto01,66,POR,1,LAC,3,2,2,1,0,0,17.81666667,0,2,1,1,1,1,0,0,2,1,4,5,5,7,11.4
2023-24,202403200OKC,3/20/2024,OKC vs UTA,Aaron Wiggins,wiggiaa01,65,OKC,1,UTA,6,2,2,0,0,1,18.21666667,0,2,2,3,2,2,0,0,1,0,4,8,8,10,10.4
2023-24,202403200BOS,3/20/2024,BOS vs MIL,Danilo Gallinari,gallida01,44,MIL,0,BOS,4,1,1,1,1,0,18.6,0,1,2,3,0,1,0,0,1,2,2,5,5,6,12.7
2023-24,202403200TOR,3/20/2024,TOR vs SAC,Harrison Barnes,barneha02,68,SAC,0,TOR,16,2,1,0,0,0,19.03333333,0,2,6,9,3,5,1,2,1,0,3,17,18,19,19.9
2023-24,202403200TOR,3/20/2024,TOR vs SAC,Chris Duarte,duartch01,48,SAC,0,TOR,14,5,2,0,0,1,19.2,2,3,5,6,2,2,2,2,0,0,7,16,19,21,22
2023-24,202403200PHO,3/20/2024,PHO vs PHI,Eric Gordon,gordoer01,56,PHO,1,PHI,0,3,2,0,1,2,19.23333333,0,3,0,2,0,0,0,0,0,1,5,2,3,5,7.6
2023-24,202403200PHO,3/20/2024,PHO vs PHI,Mo Bamba,bambamo01,47,PHI,0,PHO,9,5,0,2,1,1,19.36666667,1,4,4,6,1,3,0,2,2,3,5,9,14,14,23
2023-24,202403200POR,3/20/2024,POR vs LAC,Daniel Theis,theisda01,53,LAC,0,POR,10,5,2,0,1,1,19.53333333,1,4,3,4,2,2,2,2,2,1,7,12,15,17,21
2023-24,202403200DET,3/20/2024,DET vs IND,Myles Turner,turnemy01,67,IND,0,DET,6,5,3,0,2,1,19.56666667,1,4,2,7,1,4,1,2,5,2,8,9,11,14,21.5
2023-24,202403200POR,3/20/2024,POR vs LAC,Rayan Rupert,ruperra01,26,POR,1,LAC,8,5,3,0,0,0,19.58333333,1,4,3,5,0,2,2,2,1,0,8,11,13,16,18.5
2023-24,202403200TOR,3/20/2024,TOR vs SAC,Malik Monk,monkma01,67,SAC,0,TOR,17,2,2,1,0,3,19.7,0,2,6,12,1,7,4,4,3,1,4,19,19,21,22.4
2023-24,202403200DET,3/20/2024,DET vs IND,Marcus Sasser,sassema01,60,DET,1,IND,6,2,1,1,0,1,19.71666667,0,2,2,5,2,4,0,0,0,1,3,7,8,9,11.9
2023-24,202403200OKC,3/20/2024,OKC vs UTA,Brice Sensabaugh,sensabr01,19,UTA,0,OKC,4,6,1,1,0,4,20.16666667,1,5,2,9,0,3,0,0,1,1,7,5,10,11,11.7
2023-24,202403200GSW,3/20/2024,GSW vs MEM,DeJon Jarreau,jarrede01,6,MEM,0,GSW,2,10,5,0,0,0,20.3,4,6,1,6,0,1,0,0,2,0,15,7,12,17,21.5
2023-24,202403200OKC,3/20/2024,OKC vs UTA,Johnny Juzang,juzanjo01,9,UTA,0,OKC,9,1,0,0,0,1,20.36666667,0,1,3,6,3,6,0,0,2,0,1,9,10,10,9.2
2023-24,202403200DET,3/20/2024,DET vs IND,T.J. McConnell,mccontj01,60,IND,0,DET,13,2,6,1,1,6,20.6,0,2,6,9,1,2,0,0,0,2,8,19,15,21,24.4
2023-24,202403200CLE,3/20/2024,CLE vs MIA,Sam Merrill,merrisa01,51,CLE,1,MIA,12,1,0,0,0,1,20.61666667,0,1,4,9,4,9,0,0,2,0,1,12,13,13,12.2
2023-24,202403200TOR,3/20/2024,TOR vs SAC,Javon Freeman-Liberty,freemja01,9,TOR,1,SAC,4,4,1,1,0,0,20.98333333,1,3,1,4,0,1,2,2,3,1,5,5,8,9,13.3
2023-24,202403200BOS,3/20/2024,BOS vs MIL,Brook Lopez,lopezbr01,66,MIL,0,BOS,8,2,4,0,2,2,21.25,0,2,2,5,2,4,2,2,4,2,6,12,10,14,20.4
2023-24,202403200TOR,3/20/2024,TOR vs SAC,Davion Mitchell,mitchda01,58,SAC,0,TOR,8,2,3,2,0,3,21.36666667,2,0,4,7,0,1,0,0,0,2,5,11,10,13,17.9
2023-24,202403200DET,3/20/2024,DET vs IND,Evan Fournier,fournev01,20,DET,1,IND,5,3,4,1,0,2,21.68333333,1,2,2,6,1,2,0,0,0,1,7,9,8,12,15.6
2023-24,202403200DET,3/20/2024,DET vs IND,Ben Sheppard,sheppbe01,46,IND,0,DET,9,2,3,0,0,1,21.81666667,0,2,4,8,1,4,0,0,1,0,5,12,11,14,14.9
2023-24,202403200DET,3/20/2024,DET vs IND,Stanley Umude,umudest01,24,DET,1,IND,8,1,0,0,0,1,21.96666667,0,1,3,6,0,3,2,3,3,0,1,8,9,9,8.2
2023-24,202403200DET,3/20/2024,DET vs IND,Chimezie Metu,metuch01,38,DET,1,IND,8,3,1,2,0,1,22.08333333,1,2,3,8,0,3,2,2,2,2,4,9,11,12,18.1
2023-24,202403200TOR,3/20/2024,TOR vs SAC,Jahmi'us Ramsey,ramseja01,5,TOR,1,SAC,11,3,1,1,0,2,22.18333333,0,3,5,8,1,3,0,0,0,1,4,12,14,15,17.1
2023-24,202403200BOS,3/20/2024,BOS vs MIL,Patrick Beverley,beverpa01,64,MIL,0,BOS,9,0,0,0,0,0,22.46666667,0,0,3,5,1,2,2,2,1,0,0,9,9,9,9
2023-24,202403200OKC,3/20/2024,OKC vs UTA,Cason Wallace,wallaca01,68,OKC,1,UTA,5,4,2,2,1,0,22.46666667,2,2,2,4,0,2,1,2,2,3,6,7,9,11,21.8
2023-24,202403200GSW,3/20/2024,GSW vs MEM,Brandin Podziemski,podzibr01,60,GSW,1,MEM,2,5,4,2,0,1,22.85,1,4,1,6,0,2,0,0,0,2,9,6,7,11,19
2023-24,202403200POR,3/20/2024,POR vs LAC,Jabari Walker,walkeja01,60,POR,1,LAC,12,3,0,2,0,3,23.06666667,2,1,4,6,2,2,2,2,5,2,3,12,15,15,18.6
2023-24,202403200POR,3/20/2024,POR vs LAC,Brandon Boston Jr.,bostobr01,24,LAC,0,POR,9,2,0,1,2,1,23.08333333,0,2,4,9,0,2,1,2,2,3,2,9,11,11,19.4
2023-24,202403200OKC,3/20/2024,OKC vs UTA,John Collins,collijo01,64,UTA,0,OKC,16,6,0,1,0,1,23.36666667,3,3,5,12,2,3,4,4,4,1,6,16,22,22,25.2
2023-24,202403200OKC,3/20/2024,OKC vs UTA,Kris Dunn,dunnkr01,60,UTA,0,OKC,5,1,3,1,0,0,23.36666667,0,1,2,5,1,2,0,0,3,1,4,8,6,9,13.7
2023-24,202403200OKC,3/20/2024,OKC vs UTA,Walker Kessler,kesslwa01,57,UTA,0,OKC,4,8,1,0,1,2,23.36666667,2,6,2,2,0,0,0,0,3,1,9,5,12,13,16.1
2023-24,202403200POR,3/20/2024,POR vs LAC,Ivica Zubac,zubaciv01,56,LAC,0,POR,14,9,2,4,2,1,23.95,4,5,7,9,0,0,0,0,2,6,11,16,23,25,44.8
2023-24,202403200PHO,3/20/2024,PHO vs PHI,Nicolas Batum,batumni01,48,PHI,0,PHO,8,3,0,1,1,1,24,1,2,3,4,1,2,1,2,2,2,3,8,11,11,16.6
2023-24,202403200GSW,3/20/2024,GSW vs MEM,Stephen Curry,curryst01,62,GSW,1,MEM,14,2,3,0,1,2,24.08333333,1,1,5,9,4,7,0,0,1,1,5,17,16,19,21.9
2023-24,202403200OKC,3/20/2024,OKC vs UTA,Taylor Hendricks,hendrita0,27,UTA,0,OKC,12,4,1,0,3,0,24.16666667,3,1,3,6,2,5,4,4,3,3,5,13,16,17,27.3
2023-24,202403200GSW,3/20/2024,GSW vs MEM,Chris Paul,paulch01,44,GSW,1,MEM,12,4,14,0,0,0,24.35,0,4,5,8,2,3,0,0,2,0,18,26,16,30,37.8
2023-24,202403200GSW,3/20/2024,GSW vs MEM,Desmond Bane,banede01,40,MEM,0,GSW,6,1,4,0,1,2,24.45,0,1,2,13,2,9,0,0,1,1,5,10,7,11,14.2
2023-24,202403200GSW,3/20/2024,GSW vs MEM,Draymond Green,greendr01,43,GSW,1,MEM,10,12,7,1,1,1,24.46666667,4,8,5,10,0,3,0,0,1,2,19,17,22,29,39.9
2023-24,202403200BOS,3/20/2024,BOS vs MIL,Pat Connaughton,connapa01,63,MIL,0,BOS,7,5,1,0,0,1,24.48333333,2,3,3,4,1,1,0,0,3,0,6,8,12,13,13.5
2023-24,202403200PHO,3/20/2024,PHO vs PHI,Kyle Lowry,lowryky01,50,PHI,0,PHO,5,3,7,0,0,1,24.73333333,0,3,2,6,1,4,0,2,1,0,10,12,8,15,18.1
2023-24,202403200GSW,3/20/2024,GSW vs MEM,Trey Jemison,jemistr01,17,MEM,0,GSW,4,4,2,0,0,1,25,1,3,2,5,0,0,0,0,2,0,6,6,8,10,10.8
2023-24,202403200TOR,3/20/2024,TOR vs SAC,Keon Ellis,elliske01,43,SAC,0,TOR,6,1,2,4,1,0,25.31666667,0,1,2,6,2,5,0,0,1,5,3,8,7,9,25.2
2023-24,202403200CLE,3/20/2024,CLE vs MIA,Patty Mills,millspa02,26,MIA,0,CLE,10,1,4,2,0,0,25.35,1,0,3,11,1,8,3,3,1,2,5,14,11,15,23.2
2023-24,202403200GSW,3/20/2024,GSW vs MEM,Klay Thompson,thompkl01,65,GSW,1,MEM,23,0,2,1,0,0,25.35,0,0,9,18,5,11,0,0,0,1,2,25,23,25,29
2023-24,202403200GSW,3/20/2024,GSW vs MEM,Trayce Jackson-Davis,jackstr02,55,GSW,1,MEM,13,5,2,0,2,0,25.51666667,0,5,6,8,0,0,1,4,3,2,7,15,18,20,28
2023-24,202403200OKC,3/20/2024,OKC vs UTA,Luguentz Dort,dortlu01,66,OKC,1,UTA,9,3,1,0,0,2,25.53333333,1,2,2,5,1,4,4,4,4,0,4,10,12,13,12.1
2023-24,202403200PHO,3/20/2024,PHO vs PHI,KJ Martin,martike04,52,PHI,0,PHO,11,13,2,0,0,0,25.55,3,10,4,9,1,2,2,4,1,0,15,13,24,26,29.6
2023-24,202403200POR,3/20/2024,POR vs LAC,P.J. Tucker,tuckepj01,22,LAC,0,POR,0,7,1,2,0,0,25.61666667,0,7,0,0,0,0,0,0,2,2,8,1,7,8,15.9
2023-24,202403200TOR,3/20/2024,TOR vs SAC,Bruce Brown,brownbr01,58,TOR,1,SAC,9,5,6,1,0,4,25.76666667,2,3,3,8,0,1,3,3,1,1,11,15,14,20,23
2023-24,202403200DET,3/20/2024,DET vs IND,Aaron Nesmith,nesmiaa01,62,IND,0,DET,14,1,0,0,1,0,25.8,0,1,5,10,2,5,2,2,2,1,1,14,15,15,18.2
2023-24,202403200DET,3/20/2024,DET vs IND,Tyrese Haliburton,halibty01,58,IND,0,DET,20,3,9,4,0,2,25.93333333,0,3,9,13,1,3,1,2,1,4,12,29,23,32,47.1
2023-24,202403200OKC,3/20/2024,OKC vs UTA,Josh Giddey,giddejo01,67,OKC,1,UTA,5,11,8,0,1,0,26.1,2,9,2,9,1,3,0,0,1,1,19,13,16,24,33.2
2023-24,202403200DET,3/20/2024,DET vs IND,Andrew Nembhard,nembhan01,56,IND,0,DET,7,0,3,0,0,0,26.18333333,0,0,3,6,1,2,0,0,2,0,3,10,7,10,11.5
2023-24,202403200POR,3/20/2024,POR vs LAC,Deandre Ayton,aytonde01,47,POR,1,LAC,8,7,1,0,1,4,26.41666667,1,6,4,10,0,0,0,1,0,1,8,9,15,16,16.9
2023-24,202403200DET,3/20/2024,DET vs IND,Pascal Siakam,siakapa01,68,IND,0,DET,25,8,4,1,1,0,26.93333333,0,8,10,15,2,3,3,6,0,2,12,29,33,37,46.6
2023-24,202403200DET,3/20/2024,DET vs IND,Jalen Duren,durenja01,54,DET,1,IND,11,12,1,1,1,2,27.38333333,3,9,3,8,0,0,5,6,3,2,13,12,23,24,30.9
2023-24,202403200TOR,3/20/2024,TOR vs SAC,Domantas Sabonis,sabondo01,68,SAC,0,TOR,13,17,10,0,1,1,27.56666667,6,11,4,7,0,0,5,6,2,1,27,23,30,40,50.4
2023-24,202403200BOS,3/20/2024,BOS vs MIL,Kristaps Porzingis,porzikr01,48,BOS,1,MIL,17,3,2,0,0,2,27.78333333,3,0,6,16,0,5,5,6,3,0,5,19,20,22,21.6
2023-24,202403200OKC,3/20/2024,OKC vs UTA,Keyonte George,georgke01,62,UTA,0,OKC,9,7,2,0,0,2,27.98333333,0,7,3,14,0,7,3,3,1,0,9,11,16,18,18.4
2023-24,202403200PHO,3/20/2024,PHO vs PHI,Paul Reed,reedpa01,69,PHI,0,PHO,4,6,3,3,2,3,27.98333333,3,3,2,9,0,2,0,2,2,5,9,7,10,13,27.7
2023-24,202403200GSW,3/20/2024,GSW vs MEM,Jonathan Kuminga,kuminjo01,67,GSW,1,MEM,26,5,4,2,0,0,28,0,5,12,17,2,3,0,0,3,2,9,30,31,35,44
2023-24,202403200POR,3/20/2024,POR vs LAC,Kawhi Leonard,leonaka01,62,LAC,0,POR,24,4,2,4,0,2,28.03333333,1,3,9,16,1,3,5,6,0,4,6,26,28,30,41.8
2023-24,202403200BOS,3/20/2024,BOS vs MIL,Malik Beasley,beaslma01,66,MIL,0,BOS,6,6,0,0,0,0,28.15,0,6,2,8,2,7,0,0,2,0,6,6,12,12,13.2
2023-24,202403200POR,3/20/2024,POR vs LAC,Dalano Banton,bantoda01,42,POR,1,LAC,12,3,6,0,0,2,28.25,1,2,4,12,2,7,2,2,0,0,9,18,15,21,22.6
2023-24,202403200POR,3/20/2024,POR vs LAC,Anfernee Simons,simonan01,45,POR,1,LAC,14,4,1,0,1,3,28.41666667,0,4,6,11,2,5,0,0,2,1,5,15,18,19,20.3
2023-24,202403200TOR,3/20/2024,TOR vs SAC,De'Aaron Fox,foxde01,60,SAC,0,TOR,20,4,5,2,0,3,28.43333333,0,4,8,15,3,7,1,2,0,2,9,25,24,29,35.3
2023-24,202403200DET,3/20/2024,DET vs IND,Isaiah Jackson,jacksis01,52,IND,0,DET,10,11,6,3,0,0,28.43333333,3,8,4,7,0,0,2,4,2,3,17,16,21,27,41.2
2023-24,202403200DET,3/20/2024,DET vs IND,Cade Cunningham,cunnica01,58,DET,1,IND,23,6,10,1,0,4,29.05,0,6,9,22,0,2,5,6,1,1,16,33,29,39,44.2
2023-24,202403200GSW,3/20/2024,GSW vs MEM,Andrew Wiggins,wiggian01,59,GSW,1,MEM,22,10,3,0,1,0,29.2,6,4,9,14,4,6,0,0,0,1,13,25,32,35,41.5
2023-24,202403200PHO,3/20/2024,PHO vs PHI,Tyrese Maxey,maxeyty01,60,PHI,0,PHO,6,0,7,1,0,1,29.45,0,0,3,13,0,4,0,0,2,1,7,13,6,13,18.5
2023-24,202403200TOR,3/20/2024,TOR vs SAC,Kelly Olynyk,olynyke01,67,TOR,1,SAC,9,3,4,0,2,3,29.6,0,3,4,7,1,3,0,0,4,2,7,13,12,16,21.6
2023-24,202403200DET,3/20/2024,DET vs IND,Tosan Evbuomwan,evbuoto01,9,DET,1,IND,11,4,0,0,0,0,29.61666667,0,4,4,7,0,1,3,4,2,0,4,11,15,15,15.8
2023-24,202403200OKC,3/20/2024,OKC vs UTA,Collin Sexton,sextoco01,69,UTA,0,OKC,25,5,7,2,0,2,29.75,1,4,12,19,0,2,1,2,0,2,12,32,30,37,45.5
2023-24,202403200DET,3/20/2024,DET vs IND,Jaden Ivey,iveyja01,65,DET,1,IND,15,2,3,2,0,2,29.8,0,2,6,13,1,3,2,4,1,2,5,18,17,20,25.9
2023-24,202403200TOR,3/20/2024,TOR vs SAC,Ochai Agbaji,agbajoc01,68,TOR,1,SAC,13,3,1,3,0,2,29.96666667,2,1,5,10,2,4,1,2,2,3,4,14,16,17,25.1
2023-24,202403200TOR,3/20/2024,TOR vs SAC,Keegan Murray,murrake02,63,SAC,0,TOR,10,8,1,1,2,2,30.7,3,5,5,12,0,5,0,0,3,3,9,11,18,19,28.1
2023-24,202403200POR,3/20/2024,POR vs LAC,Amir Coffey,coffeam01,56,LAC,0,POR,11,1,2,1,0,1,30.73333333,0,1,5,10,1,4,0,0,0,1,3,13,12,14,17.2
2023-24,202403200OKC,3/20/2024,OKC vs UTA,Chet Holmgren,holmgch01,68,OKC,1,UTA,35,14,1,2,3,2,30.81666667,3,11,12,18,1,5,10,12,1,5,15,36,49,50,66.3
2023-24,202403200CLE,3/20/2024,CLE vs MIA,Jaime Jaquez Jr.,jaqueja01,63,MIA,0,CLE,7,1,2,0,0,1,31.21666667,0,1,3,5,0,1,1,1,4,0,3,9,8,10,10.2
2023-24,202403200GSW,3/20/2024,GSW vs MEM,Jaren Jackson Jr.,jacksja02,60,MEM,0,GSW,28,4,3,1,0,2,31.26666667,1,3,13,21,1,4,1,2,4,1,7,31,32,35,38.3
2023-24,202403200PHO,3/20/2024,PHO vs PHI,Jusuf Nurkic,nurkiju01,65,PHO,1,PHI,10,14,3,0,2,4,31.31666667,4,10,5,10,0,0,0,0,4,2,17,13,24,27,33.3
2023-24,202403200BOS,3/20/2024,BOS vs MIL,Payton Pritchard,pritcpa01,69,BOS,1,MIL,19,6,3,0,0,1,31.48333333,2,4,7,11,5,8,0,0,2,0,9,22,25,28,29.7
2023-24,202403200OKC,3/20/2024,OKC vs UTA,Jalen Williams,willija06,61,OKC,1,UTA,18,2,4,1,0,3,31.51666667,0,2,8,14,0,2,2,3,1,1,6,22,20,24,26.4
2023-24,202403200GSW,3/20/2024,GSW vs MEM,Jake LaRavia,laravja01,25,MEM,0,GSW,12,5,3,0,1,1,31.58333333,4,1,3,10,2,6,4,5,0,1,8,15,17,20,24.5
2023-24,202403200CLE,3/20/2024,CLE vs MIA,Caleb Martin,martica02,52,MIA,0,CLE,4,6,2,0,0,0,32.11666667,1,5,1,7,0,4,2,2,4,0,8,6,10,12,14.2
2023-24,202403200TOR,3/20/2024,TOR vs SAC,Gradey Dick,dickgr01,48,TOR,1,SAC,5,1,3,1,0,2,32.16666667,0,1,1,8,1,6,2,2,1,1,4,8,6,9,11.7
2023-24,202403200TOR,3/20/2024,TOR vs SAC,Gary Trent Jr.,trentga02,62,TOR,1,SAC,18,6,2,1,0,0,32.35,3,3,6,17,4,9,2,2,2,1,8,20,24,26,31.2
2023-24,202403200BOS,3/20/2024,BOS vs MIL,Khris Middleton,middlkh01,45,MIL,0,BOS,22,6,6,1,1,4,32.61666667,2,4,8,11,2,3,4,5,5,2,12,28,28,34,40.2
2023-24,202403200POR,3/20/2024,POR vs LAC,Kris Murray,murrakr01,49,POR,1,LAC,17,5,2,1,0,2,32.68333333,1,4,7,11,3,6,0,0,1,1,7,19,22,24,27
2023-24,202403200GSW,3/20/2024,GSW vs MEM,John Konchar,konchjo01,54,MEM,0,GSW,0,7,5,1,0,1,32.78333333,2,5,0,2,0,2,0,0,3,1,12,5,7,12,17.9
2023-24,202403200BOS,3/20/2024,BOS vs MIL,Bobby Portis,portibo01,69,MIL,0,BOS,24,15,0,0,1,2,33.08333333,5,10,11,20,2,3,0,1,3,1,15,24,39,39,43
2023-24,202403200CLE,3/20/2024,CLE vs MIA,Terry Rozier,roziete01,52,MIA,0,CLE,24,3,2,1,0,2,33.11666667,0,3,8,16,5,6,3,3,3,1,5,26,27,29,31.6
2023-24,202403200OKC,3/20/2024,OKC vs UTA,Shai Gilgeous-Alexander,gilgesh01,67,OKC,1,UTA,31,3,7,4,0,1,33.16666667,1,2,12,22,2,4,5,6,3,4,10,38,34,41,56.1
2023-24,202403200CLE,3/20/2024,CLE vs MIA,Nikola Jovic,jovicni01,33,MIA,0,CLE,14,6,1,0,1,1,33.35,0,6,5,12,4,10,0,0,2,1,7,15,20,21,24.7
2023-24,202403200GSW,3/20/2024,GSW vs MEM,Santi Aldama,aldamsa01,57,MEM,0,GSW,27,9,4,2,1,2,34.01666667,3,6,9,18,6,12,3,4,0,3,13,31,36,40,50.8
2023-24,202403200PHO,3/20/2024,PHO vs PHI,Grayson Allen,allengr01,63,PHO,1,PHI,32,4,5,1,1,2,34.46666667,1,3,10,17,9,15,3,4,1,2,9,37,36,41,48.3
2023-24,202403200PHO,3/20/2024,PHO vs PHI,Devin Booker,bookede01,55,PHO,1,PHI,18,9,11,2,0,2,34.71666667,5,4,7,15,1,5,3,4,4,2,20,29,27,38,49.3
2023-24,202403200CLE,3/20/2024,CLE vs MIA,Georges Niang,niangge01,69,CLE,1,MIA,18,3,1,1,0,1,34.81666667,0,3,6,15,3,11,3,3,2,1,4,19,21,22,25.1
2023-24,202403200GSW,3/20/2024,GSW vs MEM,GG Jackson II,jacksgg01,36,MEM,0,GSW,35,5,3,0,0,1,34.88333333,1,4,11,19,7,14,6,7,2,0,8,38,40,43,44.5
2023-24,202403200PHO,3/20/2024,PHO vs PHI,Kelly Oubre Jr.,oubreke01,56,PHI,0,PHO,18,5,4,3,3,2,35.05,3,2,7,20,2,6,2,4,1,6,9,22,23,27,46
2023-24,202403200POR,3/20/2024,POR vs LAC,Scoot Henderson,hendesc01,50,POR,1,LAC,18,2,5,2,0,2,35.06666667,0,2,6,15,2,5,4,6,5,2,7,23,20,25,31.9
2023-24,202403200POR,3/20/2024,POR vs LAC,Paul George,georgpa01,62,LAC,0,POR,27,6,4,2,1,0,35.83333333,0,6,10,18,4,7,3,3,1,3,10,31,33,37,49.2
2023-24,202403200PHO,3/20/2024,PHO vs PHI,Kevin Durant,duranke01,62,PHO,1,PHI,22,8,4,0,3,4,35.88333333,0,8,10,18,2,6,0,0,1,3,12,26,30,34,42.6
2023-24,202403200POR,3/20/2024,POR vs LAC,James Harden,hardeja01,61,LAC,0,POR,19,4,14,0,1,3,36.03333333,0,4,6,11,5,9,2,2,1,1,18,33,23,37,44.8
2023-24,202403200BOS,3/20/2024,BOS vs MIL,Damian Lillard,lillada01,64,MIL,0,BOS,32,4,6,1,1,4,36.13333333,0,4,11,21,6,10,4,4,1,2,10,38,36,42,47.8
2023-24,202403200PHO,3/20/2024,PHO vs PHI,Bradley Beal,bealbr01,40,PHO,1,PHI,3,6,7,1,2,5,36.75,1,5,1,6,1,4,0,0,2,3,13,10,9,16,24.7
2023-24,202403200CLE,3/20/2024,CLE vs MIA,Caris LeVert,leverca01,57,CLE,1,MIA,16,5,12,2,1,5,36.93333333,1,4,4,9,1,4,7,8,3,3,17,28,21,33,44
2023-24,202403200CLE,3/20/2024,CLE vs MIA,Jimmy Butler,butleji01,48,MIA,0,CLE,30,4,5,4,0,2,37,1,3,11,19,2,4,6,7,1,4,9,35,34,39,52.3
2023-24,202403200BOS,3/20/2024,BOS vs MIL,Jaylen Brown,brownja02,62,BOS,1,MIL,21,8,2,1,0,1,37.08333333,4,4,6,15,2,4,7,10,3,1,10,23,29,31,35.6
2023-24,202403200BOS,3/20/2024,BOS vs MIL,Derrick White,whitede01,64,BOS,1,MIL,23,5,8,0,2,0,37.46666667,0,5,8,17,4,11,3,3,5,2,13,31,28,36,47
2023-24,202403200BOS,3/20/2024,BOS vs MIL,Al Horford,horfoal01,57,BOS,1,MIL,8,4,4,1,1,2,38.11666667,1,3,3,3,2,2,0,0,2,2,8,12,12,16,22.8
2023-24,202403200CLE,3/20/2024,CLE vs MIA,Isaac Okoro,okorois01,60,CLE,1,MIA,7,1,1,0,0,0,38.45,0,1,3,6,1,3,0,0,2,0,2,8,8,9,9.7
2023-24,202403200CLE,3/20/2024,CLE vs MIA,Jarrett Allen,allenja01,64,CLE,1,MIA,25,20,3,0,0,2,38.83333333,2,18,10,13,0,0,5,6,2,0,23,28,45,48,51.5
2023-24,202403200BOS,3/20/2024,BOS vs MIL,Jayson Tatum,tatumja01,65,BOS,1,MIL,31,8,4,3,2,2,39.33333333,0,8,9,19,4,7,9,10,2,5,12,35,39,43,59.6
2023-24,202403200CLE,3/20/2024,CLE vs MIA,Darius Garland,garlada01,45,CLE,1,MIA,20,1,9,0,0,1,40.76666667,1,0,7,18,5,12,1,1,2,0,10,29,21,30,33.7
2023-24,202403190SAS,3/19/2024,SAS vs DAL,Cedi Osman,osmande01,65,SAS,1,DAL,5,0,1,0,2,1,11.03333333,0,0,2,4,1,3,0,0,2,2,1,6,5,6,11.5
2023-24,202403190ORL,3/19/2024,ORL vs CHO,JT Thor,thorjt01,52,CHO,0,ORL,2,0,0,0,0,0,12.55,0,0,1,2,0,1,0,0,2,0,0,2,2,2,2
2023-24,202403190SAS,3/19/2024,SAS vs DAL,Blake Wesley,weslebl01,48,SAS,1,DAL,1,4,0,1,1,1,13.43333333,0,4,0,2,0,1,1,2,1,2,4,1,5,5,10.8
2023-24,202403190ORL,3/19/2024,ORL vs CHO,Moritz Wagner,wagnemo01,67,ORL,1,CHO,13,5,2,0,1,1,14.1,2,3,5,9,0,1,3,3,0,1,7,15,18,20,24
2023-24,202403190WAS,3/19/2024,WAS vs HOU,Jae'Sean Tate,tateja01,58,HOU,0,WAS,6,3,1,0,0,1,14.66666667,1,2,2,3,0,0,2,2,3,0,4,7,9,10,10.1
2023-24,202403190ORL,3/19/2024,ORL vs CHO,Caleb Houstan,houstca01,52,ORL,1,CHO,3,1,0,0,0,0,14.78333333,0,1,1,5,1,5,0,0,1,0,1,3,4,4,4.2
2023-24,202403190ORL,3/19/2024,ORL vs CHO,Joe Ingles,inglejo01,55,ORL,1,CHO,3,3,4,1,0,2,14.85,0,3,1,3,1,3,0,0,0,1,7,7,6,10,13.6
2023-24,202403190SAS,3/19/2024,SAS vs DAL,Derrick Jones Jr.,jonesde02,64,DAL,0,SAS,4,1,0,0,0,1,15.45,0,1,1,2,0,1,2,2,1,0,1,4,5,5,4.2
2023-24,202403190SAS,3/19/2024,SAS vs DAL,Dominick Barlow,barlodo01,30,SAS,1,DAL,4,1,5,1,0,0,15.88333333,0,1,2,4,0,0,0,0,0,1,6,9,5,10,15.7
2023-24,202403190SAS,3/19/2024,SAS vs DAL,Dereck Lively II,livelde01,50,DAL,0,SAS,12,5,1,0,1,0,16.05,1,4,5,7,0,0,2,2,3,1,6,13,17,18,22.5
2023-24,202403190BRK,3/19/2024,BRK vs NOP,Lonnie Walker IV,walkelo01,48,BRK,1,NOP,3,1,0,0,0,0,16.28333333,0,1,1,6,1,5,0,0,0,0,1,3,4,4,4.2
2023-24,202403190MIN,3/19/2024,MIN vs DEN,Peyton Watson,watsope01,67,DEN,0,MIN,2,3,0,0,0,1,16.43333333,0,3,1,4,0,1,0,1,4,0,3,2,5,5,4.6
2023-24,202403190MIN,3/19/2024,MIN vs DEN,Reggie Jackson,jacksre01,69,DEN,0,MIN,2,3,6,1,0,2,16.71666667,0,3,1,3,0,2,0,0,1,1,9,8,5,11,15.6
2023-24,202403190BRK,3/19/2024,BRK vs NOP,Jonas Valanciunas,valanjo01,68,NOP,0,BRK,8,7,2,0,1,1,16.86666667,2,5,4,7,0,1,0,0,2,1,9,10,15,17,21.4
2023-24,202403190ORL,3/19/2024,ORL vs CHO,Gary Harris,harriga01,45,ORL,1,CHO,3,1,0,0,0,2,16.88333333,0,1,1,2,1,2,0,0,0,0,1,3,4,4,2.2
2023-24,202403190BRK,3/19/2024,BRK vs NOP,Jose Alvarado,alvarjo01,47,NOP,0,BRK,3,3,1,1,0,1,16.91666667,1,2,1,3,1,2,0,2,2,1,4,4,6,7,10.1
2023-24,202403190SAS,3/19/2024,SAS vs DAL,Tim Hardaway Jr.,hardati02,66,DAL,0,SAS,5,1,1,2,0,0,17.18333333,0,1,2,5,1,2,0,0,0,2,2,6,6,7,13.7
2023-24,202403190WAS,3/19/2024,WAS vs HOU,Jeff Green,greenje02,64,HOU,0,WAS,12,2,1,0,0,0,17.56666667,0,2,4,7,2,4,2,2,0,0,3,13,14,15,15.9
2023-24,202403190MIN,3/19/2024,MIN vs DEN,Christian Braun,braunch01,69,DEN,0,MIN,3,4,0,0,0,1,17.63333333,0,4,1,4,1,3,0,0,1,0,4,3,7,7,6.8
2023-24,202403190MIN,3/19/2024,MIN vs DEN,Justin Holiday,holidju01,45,DEN,0,MIN,6,2,3,0,0,0,17.71666667,0,2,2,3,2,3,0,0,3,0,5,9,8,11,12.9
2023-24,202403190ORL,3/19/2024,ORL vs CHO,Markelle Fultz,fultzma01,31,ORL,1,CHO,0,3,1,0,0,1,17.95,2,1,0,4,0,0,0,0,3,0,4,1,3,4,4.1
2023-24,202403190MIN,3/19/2024,MIN vs DEN,Jordan McLaughlin,mclaujo01,43,MIN,1,DEN,2,3,3,0,0,1,18.63333333,1,2,1,4,0,1,0,0,0,0,6,5,5,8,9.1
2023-24,202403190BRK,3/19/2024,BRK vs NOP,Naji Marshall,marshna01,56,NOP,0,BRK,4,5,3,3,0,1,18.71666667,0,5,2,4,0,2,0,0,1,3,8,7,9,12,22.5
2023-24,202403190WAS,3/19/2024,WAS vs HOU,Jules Bernard,bernaju01,12,WAS,1,HOU,16,2,4,0,0,0,18.96666667,2,0,6,11,3,5,1,2,2,0,6,20,18,22,24.4
2023-24,202403190SAS,3/19/2024,SAS vs DAL,Julian Champagnie,champju02,61,SAS,1,DAL,6,3,1,0,1,0,19.63333333,0,3,2,5,2,5,0,0,2,1,4,7,9,10,14.1
2023-24,202403190WAS,3/19/2024,WAS vs HOU,Jock Landale,landajo01,42,HOU,0,WAS,10,3,0,0,7,0,19.75,2,1,4,7,0,0,2,2,2,7,3,10,13,13,34.6
2023-24,202403190SAS,3/19/2024,SAS vs DAL,Malaki Branham,branhma01,64,SAS,1,DAL,11,4,1,0,0,1,20.01666667,2,2,4,7,1,3,2,3,1,0,5,12,15,16,16.3
2023-24,202403190WAS,3/19/2024,WAS vs HOU,Patrick Baldwin Jr.,baldwpa01,26,WAS,1,HOU,12,7,3,1,0,0,20.76666667,2,5,4,9,1,5,3,5,5,1,10,15,19,22,27.9
2023-24,202403190WAS,3/19/2024,WAS vs HOU,Aaron Holiday,holidaa01,65,HOU,0,WAS,7,0,6,2,1,0,20.96666667,0,0,2,7,1,5,2,2,2,3,6,13,7,13,25
2023-24,202403190ORL,3/19/2024,ORL vs CHO,Cole Anthony,anthoco01,68,ORL,1,CHO,21,6,3,1,1,2,21.35,1,5,9,12,3,5,0,1,1,2,9,24,27,30,36.7
2023-24,202403190SAS,3/19/2024,SAS vs DAL,Maxi Kleber,klebima01,32,DAL,0,SAS,5,1,4,0,0,0,21.8,0,1,2,2,1,1,0,0,3,0,5,9,6,10,12.2
2023-24,202403190BRK,3/19/2024,BRK vs NOP,Cameron Johnson,johnsca02,53,BRK,1,NOP,10,4,1,0,0,2,21.91666667,0,4,4,9,2,6,0,1,1,0,5,11,14,15,14.3
2023-24,202403190BRK,3/19/2024,BRK vs NOP,Nic Claxton,claxtni01,59,BRK,1,NOP,8,6,2,0,1,1,21.95,2,4,3,3,0,0,2,2,3,1,8,10,14,16,20.2
2023-24,202403190WAS,3/19/2024,WAS vs HOU,Anthony Gill,gillan01,39,WAS,1,HOU,12,8,3,0,0,1,22.05,3,5,5,9,2,3,0,0,3,0,11,15,20,23,25.1
2023-24,202403190MIN,3/19/2024,MIN vs DEN,Luka Garza,garzalu01,18,MIN,1,DEN,11,6,0,2,1,0,22.4,3,3,4,11,2,8,1,2,1,3,6,11,17,17,27.2
2023-24,202403190MIN,3/19/2024,MIN vs DEN,Monte Morris,morrimo01,20,MIN,1,DEN,8,1,2,3,0,0,22.8,0,1,3,6,1,2,1,2,0,3,3,10,9,11,21.2
2023-24,202403190ORL,3/19/2024,ORL vs CHO,Grant Williams,willigr01,65,CHO,0,ORL,5,3,1,0,0,1,23.21666667,1,2,2,6,0,3,1,2,2,0,4,6,8,9,9.1
2023-24,202403190WAS,3/19/2024,WAS vs HOU,Dillon Brooks,brookdi01,59,HOU,0,WAS,2,1,0,0,0,2,23.46666667,0,1,1,7,0,5,0,0,1,0,1,2,3,3,1.2
2023-24,202403190BRK,3/19/2024,BRK vs NOP,Day'Ron Sharpe,sharpda01,52,BRK,1,NOP,8,17,3,0,2,2,23.6,9,8,4,11,0,0,0,0,2,2,20,11,25,28,36.9
2023-24,202403190ORL,3/19/2024,ORL vs CHO,Wendell Carter Jr.,cartewe01,42,ORL,1,CHO,8,8,3,1,0,4,23.83333333,1,7,3,6,1,2,1,1,1,1,11,11,16,19,21.1
2023-24,202403190ORL,3/19/2024,ORL vs CHO,Franz Wagner,wagnefr01,61,ORL,1,CHO,11,0,3,1,0,1,23.83333333,0,0,4,9,0,3,3,3,1,1,3,14,11,14,17.5
2023-24,202403190SAS,3/19/2024,SAS vs DAL,Daniel Gafford,gaffoda01,62,DAL,0,SAS,13,8,3,1,1,1,24.18333333,0,8,5,7,0,0,3,4,4,2,11,16,21,24,32.1
2023-24,202403190ORL,3/19/2024,ORL vs CHO,Jalen Suggs,suggsja01,62,ORL,1,CHO,16,4,6,3,2,0,24.88333333,0,4,6,9,2,5,2,2,1,5,10,22,20,26,44.8
2023-24,202403190MIN,3/19/2024,MIN vs DEN,Kyle Anderson,anderky01,66,MIN,1,DEN,12,3,4,1,2,0,25.6,0,3,5,9,0,0,2,2,3,3,7,16,15,19,30.6
2023-24,202403190WAS,3/19/2024,WAS vs HOU,Richaun Holmes,holmeri01,36,WAS,1,HOU,12,9,0,1,1,1,25.95,4,5,4,5,0,0,4,4,2,2,9,12,21,21,27.8
2023-24,202403190ORL,3/19/2024,ORL vs CHO,Paolo Banchero,banchpa01,67,ORL,1,CHO,13,1,5,0,0,1,26.43333333,0,1,6,7,1,2,0,0,1,0,6,18,14,19,20.7
2023-24,202403190ORL,3/19/2024,ORL vs CHO,Vasilije Micic,micicva01,48,CHO,0,ORL,20,1,1,1,0,3,26.91666667,0,1,8,10,2,3,2,2,1,1,2,21,21,22,22.7
2023-24,202403190WAS,3/19/2024,WAS vs HOU,Johnny Davis,davisjo06,38,WAS,1,HOU,2,1,0,1,0,0,27.28333333,0,1,1,7,0,1,0,0,2,1,1,2,3,3,6.2
2023-24,202403190WAS,3/19/2024,WAS vs HOU,Jordan Poole,poolejo01,67,WAS,1,HOU,13,5,2,0,0,2,27.55,0,5,5,18,2,6,1,1,4,0,7,15,18,20,20
2023-24,202403190ORL,3/19/2024,ORL vs CHO,Aleksej Pokusevski,pokusal01,16,CHO,0,ORL,3,5,1,1,0,3,27.56666667,0,5,1,5,0,1,1,1,1,1,6,4,8,9,10.5
2023-24,202403190BRK,3/19/2024,BRK vs NOP,Larry Nance Jr.,nancela02,49,NOP,0,BRK,13,10,2,1,0,0,27.66666667,3,7,6,8,1,3,0,0,2,1,12,15,23,25,31
2023-24,202403190BRK,3/19/2024,BRK vs NOP,Dorian Finney-Smith,finnedo01,60,BRK,1,NOP,2,3,1,1,1,0,27.7,0,3,0,6,0,4,2,2,0,2,4,3,5,6,13.1
2023-24,202403190SAS,3/19/2024,SAS vs DAL,Dante Exum,exumda01,43,DAL,0,SAS,16,1,2,0,0,2,27.96666667,0,1,5,8,4,4,2,2,1,0,3,18,17,19,18.2
2023-24,202403190SAS,3/19/2024,SAS vs DAL,Keldon Johnson,johnske04,64,SAS,1,DAL,14,6,2,0,0,1,28.28333333,1,5,5,10,3,6,1,2,1,0,8,16,20,22,23.2
2023-24,202403190ORL,3/19/2024,ORL vs CHO,Nick Richards,richani01,59,CHO,0,ORL,4,6,3,1,0,2,28.36666667,1,5,2,4,0,0,0,0,4,1,9,7,10,13,16.7
2023-24,202403190ORL,3/19/2024,ORL vs CHO,Tre Mann,manntr01,28,CHO,0,ORL,11,4,5,1,0,1,28.96666667,0,4,5,8,1,2,0,0,0,1,9,16,15,20,25.3
2023-24,202403190MIN,3/19/2024,MIN vs DEN,Mike Conley,conlemi01,64,MIN,1,DEN,13,6,5,1,0,2,29.35,2,4,3,7,1,4,6,6,5,1,11,18,19,24,28.7
2023-24,202403190SAS,3/19/2024,SAS vs DAL,Jeremy Sochan,sochaje01,69,SAS,1,DAL,13,10,6,0,0,2,29.81666667,3,7,4,15,3,9,2,4,2,0,16,19,23,29,32
2023-24,202403190BRK,3/19/2024,BRK vs NOP,Trey Murphy III,murphtr02,43,NOP,0,BRK,10,8,3,1,0,1,30.2,1,7,4,13,1,8,1,1,1,1,11,13,18,21,26.1
2023-24,202403190WAS,3/19/2024,WAS vs HOU,Jabari Smith Jr.,smithja05,63,HOU,0,WAS,18,14,0,1,0,0,30.66666667,4,10,7,13,2,7,2,3,2,1,14,18,32,32,37.8
2023-24,202403190WAS,3/19/2024,WAS vs HOU,Jared Butler,butleja02,27,WAS,1,HOU,15,3,9,1,1,1,30.83333333,0,3,7,19,1,6,0,0,3,2,12,24,18,27,37.1
2023-24,202403190WAS,3/19/2024,WAS vs HOU,Justin Champagnie,champju01,7,WAS,1,HOU,16,8,2,2,0,2,31.26666667,6,2,4,9,2,6,6,6,3,2,10,18,24,26,32.6
2023-24,202403190MIN,3/19/2024,MIN vs DEN,Michael Porter Jr.,portemi01,68,DEN,0,MIN,26,4,1,0,0,3,31.56666667,1,3,9,15,4,7,4,5,2,0,5,27,30,31,29.3
2023-24,202403190BRK,3/19/2024,BRK vs NOP,Brandon Ingram,ingrabr01,62,NOP,0,BRK,11,4,6,0,1,3,31.58333333,0,4,4,12,1,5,2,3,3,1,10,17,15,21,24.8
2023-24,202403190BRK,3/19/2024,BRK vs NOP,CJ McCollum,mccolcj01,52,NOP,0,BRK,16,1,5,0,0,2,31.73333333,0,1,6,12,4,8,0,0,2,0,6,21,17,22,22.7
2023-24,202403190WAS,3/19/2024,WAS vs HOU,Fred VanVleet,vanvlfr01,61,HOU,0,WAS,7,3,11,2,1,1,32.11666667,0,3,3,11,1,4,0,1,1,3,14,18,10,21,35.1
2023-24,202403190SAS,3/19/2024,SAS vs DAL,Victor Wembanyama,wembavi01,61,SAS,1,DAL,12,11,3,1,6,5,32.11666667,3,8,3,13,0,4,6,7,4,7,14,15,23,26,45.7
2023-24,202403190MIN,3/19/2024,MIN vs DEN,Jamal Murray,murraja01,53,DEN,0,MIN,18,4,11,2,0,2,32.23333333,1,3,6,14,2,3,4,4,3,2,15,29,22,33,43.3
2023-24,202403190WAS,3/19/2024,WAS vs HOU,Amen Thompson,thompam01,49,HOU,0,WAS,25,10,2,0,1,2,32.23333333,3,7,10,12,0,0,5,7,1,1,12,27,35,37,41
2023-24,202403190BRK,3/19/2024,BRK vs NOP,Mikal Bridges,bridgmi01,69,BRK,1,NOP,15,2,1,2,0,2,32.36666667,1,1,4,11,4,9,3,6,1,2,3,16,17,18,22.9
2023-24,202403190MIN,3/19/2024,MIN vs DEN,Aaron Gordon,gordoaa01,63,DEN,0,MIN,14,11,2,0,0,4,32.36666667,7,4,5,10,0,0,4,5,1,0,13,16,25,27,26.2
2023-24,202403190ORL,3/19/2024,ORL vs CHO,Brandon Miller,millebr02,62,CHO,0,ORL,21,7,1,1,0,2,32.41666667,1,6,7,20,4,9,3,4,2,1,8,22,28,29,31.9
2023-24,202403190BRK,3/19/2024,BRK vs NOP,Zion Williamson,willizi01,57,NOP,0,BRK,28,7,4,1,0,2,32.63333333,2,5,11,16,0,0,6,6,3,1,11,32,35,39,43.4
2023-24,202403190SAS,3/19/2024,SAS vs DAL,Tre Jones,jonestr01,64,SAS,1,DAL,22,3,9,0,0,1,33.38333333,0,3,8,11,4,5,2,2,0,0,12,31,25,34,38.1
2023-24,202403190BRK,3/19/2024,BRK vs NOP,Dennis Schroder,schrode01,69,BRK,1,NOP,12,2,5,1,0,4,33.63333333,0,2,4,12,2,6,2,2,1,1,7,17,14,19,20.9
2023-24,202403190BRK,3/19/2024,BRK vs NOP,Herbert Jones,joneshe01,62,NOP,0,BRK,11,3,3,0,3,2,33.68333333,2,1,4,8,2,5,1,1,3,3,6,14,14,17,26.1
2023-24,202403190BRK,3/19/2024,BRK vs NOP,Cam Thomas,thomaca02,54,BRK,1,NOP,25,3,2,0,0,1,33.68333333,1,2,8,19,3,10,6,7,2,0,5,27,28,30,30.6
2023-24,202403190SAS,3/19/2024,SAS vs DAL,P.J. Washington,washipj01,61,DAL,0,SAS,8,6,0,0,1,0,34.01666667,1,5,3,8,2,5,0,0,1,1,6,8,14,14,18.2
2023-24,202403190WAS,3/19/2024,WAS vs HOU,Corey Kispert,kispeco01,67,WAS,1,HOU,16,1,1,0,0,3,35.33333333,0,1,6,11,4,7,0,2,3,0,2,17,17,18,15.7
2023-24,202403190WAS,3/19/2024,WAS vs HOU,Jalen Green,greenja05,68,HOU,0,WAS,42,10,3,1,1,1,35.7,2,8,12,21,7,13,11,13,2,2,13,45,52,55,63.5
2023-24,202403190SAS,3/19/2024,SAS vs DAL,Devin Vassell,vassede01,63,SAS,1,DAL,19,6,3,3,0,3,36.4,0,6,9,18,0,3,1,1,1,3,9,22,25,28,36.7
2023-24,202403190MIN,3/19/2024,MIN vs DEN,Nickeil Alexander-Walker,alexani01,69,MIN,1,DEN,4,2,3,0,1,0,36.5,0,2,2,7,0,4,0,0,1,1,5,7,6,9,13.9
2023-24,202403190MIN,3/19/2024,MIN vs DEN,Jaden McDaniels,mcdanja02,59,MIN,1,DEN,26,6,0,1,2,1,37.63333333,0,6,9,13,4,6,4,7,5,3,6,26,32,32,41.2
2023-24,202403190MIN,3/19/2024,MIN vs DEN,Kentavious Caldwell-Pope,caldwke01,63,DEN,0,MIN,9,2,1,2,1,1,37.66666667,1,1,3,6,2,4,1,1,1,3,3,10,11,12,20.9
2023-24,202403190MIN,3/19/2024,MIN vs DEN,Anthony Edwards,edwaran01,66,MIN,1,DEN,30,8,8,2,0,3,37.66666667,1,7,13,26,3,8,1,2,1,2,16,38,38,46,54.6
2023-24,202403190MIN,3/19/2024,MIN vs DEN,Nikola Jokic,jokicni01,67,DEN,0,MIN,35,16,2,0,0,3,37.66666667,1,15,14,22,3,4,4,6,3,0,18,37,51,53,54.2
2023-24,202403190ORL,3/19/2024,ORL vs CHO,Miles Bridges,bridgmi02,58,CHO,0,ORL,16,4,5,1,0,3,38.2,1,3,8,15,0,4,0,0,0,1,9,21,20,25,28.3
2023-24,202403190SAS,3/19/2024,SAS vs DAL,Kyrie Irving,irvinky01,47,DAL,0,SAS,28,7,3,2,0,1,38.41666667,1,6,13,21,0,5,2,2,3,2,10,31,35,38,45.9
2023-24,202403190SAS,3/19/2024,SAS vs DAL,Luka Doncic,doncilu01,60,DAL,0,SAS,18,10,16,1,0,4,40.43333333,0,10,6,27,2,12,4,5,0,1,26,34,28,44,53
2023-24,202403180BOS,3/18/2024,BOS vs DET,Taj Gibson,gibsota01,17,DET,0,BOS,3,2,0,1,0,0,10.95,0,2,1,2,1,2,0,0,1,1,2,3,5,5,8.4
2023-24,202403180LAL,3/18/2024,LAL vs ATL,Wesley Matthews,matthwe02,28,ATL,0,LAL,3,0,3,1,0,0,11.01666667,0,0,1,2,1,2,0,0,1,1,3,6,3,6,10.5
2023-24,202403180UTA,3/18/2024,UTA vs MIN,Luka Garza,garzalu01,17,MIN,0,UTA,8,1,0,0,0,2,11.08333333,1,0,3,5,2,4,0,0,1,0,1,8,9,9,7.2
2023-24,202403180SAC,3/18/2024,SAC vs MEM,Trey Jemison,jemistr01,16,MEM,0,SAC,0,5,2,0,0,0,13.16666667,4,1,0,1,0,0,0,0,2,0,7,2,5,7,9
2023-24,202403180SAC,3/18/2024,SAC vs MEM,Alex Len,lenal01,33,SAC,1,MEM,6,3,1,0,2,0,13.2,0,3,2,2,0,0,2,2,4,2,4,7,9,10,17.1
2023-24,202403180CHI,3/18/2024,CHI vs POR,Andre Drummond,drumman01,69,CHI,1,POR,9,11,0,0,0,0,13.71666667,7,4,2,10,0,0,5,5,2,0,11,9,20,20,22.2
2023-24,202403180IND,3/18/2024,IND vs CLE,Tristan Thompson,thomptr01,38,CLE,0,IND,2,4,2,1,0,0,14.01666667,2,2,1,2,0,0,0,2,1,1,6,4,6,8,12.8
2023-24,202403180GSW,3/18/2024,GSW vs NYK,Alec Burks,burksal01,59,NYK,0,GSW,5,1,1,0,0,0,14.25,0,1,1,5,1,3,2,2,0,0,2,6,6,7,7.7
2023-24,202403180CHI,3/18/2024,CHI vs POR,Toumani Camara,camarto01,65,POR,0,CHI,0,1,1,0,0,1,14.5,0,1,0,0,0,0,0,0,3,0,2,1,1,2,1.7
2023-24,202403180UTA,3/18/2024,UTA vs MIN,Brice Sensabaugh,sensabr01,18,UTA,1,MIN,3,1,3,0,0,0,14.8,0,1,1,5,1,3,0,0,1,0,4,6,4,7,8.7
2023-24,202403180CHI,3/18/2024,CHI vs POR,Dalen Terry,terryda01,46,CHI,1,POR,5,3,2,2,1,0,15.03333333,0,3,2,7,1,4,0,0,4,3,5,7,8,10,20.6
2023-24,202403180PHI,3/18/2024,PHI vs MIA,Delon Wright,wrighde01,38,MIA,0,PHI,1,2,4,1,0,0,15.66666667,1,1,0,4,0,0,1,2,1,1,6,5,3,7,12.4
2023-24,202403180UTA,3/18/2024,UTA vs MIN,Monte Morris,morrimo01,19,MIN,0,UTA,8,1,4,0,0,0,15.68333333,0,1,3,5,2,3,0,0,0,0,5,12,9,13,15.2
2023-24,202403180PHI,3/18/2024,PHI vs MIA,Cameron Payne,payneca01,64,PHI,1,MIA,3,2,3,0,0,2,15.86666667,0,2,1,5,1,3,0,0,0,0,5,6,5,8,7.9
2023-24,202403180PHI,3/18/2024,PHI vs MIA,Thomas Bryant,bryanth01,31,MIA,0,PHI,11,2,1,1,1,0,16.11666667,1,1,4,9,1,1,2,2,1,2,3,12,13,14,20.9
2023-24,202403180GSW,3/18/2024,GSW vs NYK,Gary Payton II,paytoga02,32,GSW,1,NYK,6,0,1,0,0,2,16.66666667,0,0,2,2,1,1,1,2,2,0,1,7,6,7,5.5
2023-24,202403180GSW,3/18/2024,GSW vs NYK,Bojan Bogdanovic,bogdabo02,43,NYK,0,GSW,4,2,2,0,0,2,16.73333333,0,2,2,6,0,2,0,0,0,0,4,6,6,8,7.4
2023-24,202403180SAC,3/18/2024,SAC vs MEM,DeJon Jarreau,jarrede01,5,MEM,0,SAC,8,3,2,0,0,1,16.73333333,1,2,3,8,2,3,0,2,1,0,5,10,11,13,13.6
2023-24,202403180LAL,3/18/2024,LAL vs ATL,Jaxson Hayes,hayesja02,59,LAL,1,ATL,7,3,0,0,1,0,16.78333333,1,2,3,4,0,0,1,2,2,1,3,7,10,10,13.6
2023-24,202403180CHI,3/18/2024,CHI vs POR,Jevon Carter,carteje01,65,CHI,1,POR,3,1,1,0,0,0,16.8,0,1,1,4,1,4,0,0,1,0,2,4,4,5,5.7
2023-24,202403180CHI,3/18/2024,CHI vs POR,Duop Reath,reathdu01,54,POR,0,CHI,14,1,0,0,0,0,16.95,1,0,5,6,2,3,2,2,3,0,1,14,15,15,15.2
2023-24,202403180BOS,3/18/2024,BOS vs DET,Isaiah Stewart,stewais01,46,DET,0,BOS,5,5,1,0,0,0,17.25,1,4,2,3,1,2,0,0,0,0,6,6,10,11,12.5
2023-24,202403180UTA,3/18/2024,UTA vs MIN,Naz Reid,reidna01,68,MIN,0,UTA,17,4,0,0,1,1,17.3,2,2,7,12,2,4,1,2,1,1,4,17,21,21,23.8
2023-24,202403180BOS,3/18/2024,BOS vs DET,Xavier Tillman Sr.,tillmxa01,42,BOS,1,DET,2,4,1,0,1,0,17.45,0,4,1,2,0,1,0,0,0,1,5,3,6,7,11.3
2023-24,202403180BOS,3/18/2024,BOS vs DET,Tosan Evbuomwan,evbuoto01,8,DET,0,BOS,11,2,0,1,0,1,17.81666667,0,2,4,5,2,2,1,2,1,1,2,11,13,13,15.4
2023-24,202403180SAC,3/18/2024,SAC vs MEM,Chris Duarte,duartch01,47,SAC,1,MEM,8,2,1,0,0,0,17.95,1,1,3,6,2,4,0,0,2,0,3,9,10,11,11.9
2023-24,202403180GSW,3/18/2024,GSW vs NYK,Precious Achiuwa,achiupr01,61,NYK,0,GSW,6,9,1,0,0,1,18.23333333,5,4,2,4,0,0,2,2,0,0,10,7,15,16,17.3
2023-24,202403180BOS,3/18/2024,BOS vs DET,Malachi Flynn,flynnma01,56,DET,0,BOS,11,2,1,2,0,0,18.4,0,2,3,8,2,5,3,4,0,2,3,12,13,14,20.9
2023-24,202403180PHI,3/18/2024,PHI vs MIA,Mo Bamba,bambamo01,46,PHI,1,MIA,8,4,3,2,2,1,18.55,1,3,3,5,2,3,0,0,2,4,7,11,12,15,28.3
2023-24,202403180LAL,3/18/2024,LAL vs ATL,Onyeka Okongwu,okongon01,54,ATL,0,LAL,11,4,2,2,0,0,18.65,1,3,5,7,1,3,0,1,0,2,6,13,15,17,24.8
2023-24,202403180BOS,3/18/2024,BOS vs DET,Oshae Brissett,brissos01,45,BOS,1,DET,3,4,0,0,0,0,18.75,2,2,1,7,1,2,0,0,1,0,4,3,7,7,7.8
2023-24,202403180LAL,3/18/2024,LAL vs ATL,Garrison Mathews,mathega01,52,ATL,0,LAL,0,0,1,0,0,0,18.76666667,0,0,0,3,0,3,0,0,2,0,1,1,0,1,1.5
2023-24,202403180UTA,3/18/2024,UTA vs MIN,Talen Horton-Tucker,hortota01,44,UTA,1,MIN,7,1,3,2,0,0,18.95,0,1,2,7,1,3,2,3,1,2,4,10,8,11,18.7
2023-24,202403180IND,3/18/2024,IND vs CLE,Jalen Smith,smithja04,49,IND,1,CLE,11,8,1,0,1,0,19.23333333,4,4,3,9,2,7,3,6,2,1,9,12,19,20,25.1
2023-24,202403180IND,3/18/2024,IND vs CLE,Obi Toppin,toppiob01,70,IND,1,CLE,10,8,2,1,0,0,19.75,1,7,4,6,1,2,1,1,1,1,10,12,18,20,25.6
2023-24,202403180IND,3/18/2024,IND vs CLE,Ben Sheppard,sheppbe01,45,IND,1,CLE,5,1,1,1,0,0,19.83333333,0,1,2,6,1,5,0,0,2,1,2,6,6,7,10.7
2023-24,202403180UTA,3/18/2024,UTA vs MIN,John Collins,collijo01,63,UTA,1,MIN,11,6,0,0,0,0,19.85,2,4,5,9,0,0,1,2,4,0,6,11,17,17,18.2
2023-24,202403180IND,3/18/2024,IND vs CLE,Marcus Morris,morrima03,38,CLE,0,IND,14,4,0,0,0,0,19.86666667,0,4,5,7,4,5,0,0,3,0,4,14,18,18,18.8
2023-24,202403180LAL,3/18/2024,LAL vs ATL,Taurean Prince,princta02,67,LAL,1,ATL,8,5,1,0,1,1,19.95,0,5,3,8,2,7,0,0,2,1,6,9,13,14,17.5
2023-24,202403180LAL,3/18/2024,LAL vs ATL,Clint Capela,capelca01,60,ATL,0,LAL,10,9,0,1,1,1,20.08333333,4,5,5,10,0,0,0,0,1,2,9,10,19,19,25.8
2023-24,202403180GSW,3/18/2024,GSW vs NYK,Chris Paul,paulch01,43,GSW,1,NYK,14,4,4,1,0,1,20.16666667,0,4,6,9,2,2,0,0,3,1,8,18,18,22,26.8
2023-24,202403180LAL,3/18/2024,LAL vs ATL,Spencer Dinwiddie,dinwisp01,63,LAL,1,ATL,3,1,3,0,0,1,21.28333333,0,1,1,4,1,2,0,0,0,0,4,6,4,7,7.7
2023-24,202403180IND,3/18/2024,IND vs CLE,T.J. McConnell,mccontj01,59,IND,1,CLE,14,3,4,2,0,1,21.28333333,1,2,7,11,0,1,0,0,1,2,7,18,17,21,28.6
2023-24,202403180BOS,3/18/2024,BOS vs DET,Kristaps Porzingis,porzikr01,47,BOS,1,DET,20,8,1,1,1,0,21.48333333,1,7,7,14,5,9,1,1,2,2,9,21,28,29,37.1
2023-24,202403180PHI,3/18/2024,PHI vs MIA,Patty Mills,millspa02,25,MIA,0,PHI,3,2,3,0,0,1,21.66666667,2,0,1,6,1,5,0,0,2,0,5,6,5,8,8.9
2023-24,202403180UTA,3/18/2024,UTA vs MIN,Jordan McLaughlin,mclaujo01,42,MIN,0,UTA,11,1,0,1,0,0,21.75,0,1,3,3,3,3,2,2,0,1,1,11,12,12,15.2
2023-24,202403180PHI,3/18/2024,PHI vs MIA,Paul Reed,reedpa01,68,PHI,1,MIA,4,7,1,0,1,1,21.83333333,2,5,1,5,0,1,2,2,1,1,8,5,11,12,15.9
2023-24,202403180BOS,3/18/2024,BOS vs DET,Jaden Springer,sprinja01,42,BOS,1,DET,6,4,4,0,2,0,21.85,4,0,2,5,0,2,2,2,2,2,8,10,10,14,22.8
2023-24,202403180BOS,3/18/2024,BOS vs DET,Jalen Duren,durenja01,53,DET,0,BOS,8,9,0,0,0,2,21.91666667,0,9,3,7,0,0,2,2,2,0,9,8,17,17,16.8
2023-24,202403180LAL,3/18/2024,LAL vs ATL,Trent Forrest,forretr01,30,ATL,0,LAL,2,4,6,0,0,1,22.11666667,1,3,1,2,0,0,0,0,0,0,10,8,6,12,14.8
2023-24,202403180LAL,3/18/2024,LAL vs ATL,Max Christie,chrisma02,56,LAL,1,ATL,11,3,1,0,0,0,22.28333333,1,2,4,9,2,4,1,2,1,0,4,12,14,15,16.1
2023-24,202403180BOS,3/18/2024,BOS vs DET,Evan Fournier,fournev01,19,DET,0,BOS,3,1,4,0,0,1,22.3,0,1,1,9,1,7,0,0,2,0,5,7,4,8,9.2
2023-24,202403180BOS,3/18/2024,BOS vs DET,Svi Mykhailiuk,mykhasv01,29,BOS,1,DET,6,2,2,2,0,1,23.61666667,0,2,2,8,2,8,0,0,0,2,4,8,8,10,16.4
2023-24,202403180CHI,3/18/2024,CHI vs POR,Torrey Craig,craigto01,40,CHI,1,POR,6,2,2,1,1,0,23.9,1,1,2,7,2,5,0,0,2,2,4,8,8,10,17.4
2023-24,202403180PHI,3/18/2024,PHI vs MIA,Buddy Hield,hieldbu01,71,PHI,1,MIA,12,2,1,0,1,1,24.08333333,1,1,4,10,2,7,2,2,1,1,3,13,14,15,17.9
2023-24,202403180GSW,3/18/2024,GSW vs NYK,Andrew Wiggins,wiggian01,58,GSW,1,NYK,7,8,0,1,0,1,24.13333333,4,4,2,9,1,3,2,4,1,1,8,7,15,15,18.6
2023-24,202403180PHI,3/18/2024,PHI vs MIA,Duncan Robinson,robindu01,63,MIA,0,PHI,3,4,0,0,0,1,24.2,1,3,1,5,0,1,1,2,4,0,4,3,7,7,6.8
2023-24,202403180SAC,3/18/2024,SAC vs MEM,Harrison Barnes,barneha02,67,SAC,1,MEM,11,5,0,0,0,2,24.35,0,5,5,11,1,4,0,0,1,0,5,11,16,16,15
2023-24,202403180LAL,3/18/2024,LAL vs ATL,Vit Krejci,krejcvi01,8,ATL,0,LAL,11,1,1,0,1,1,24.58333333,0,1,5,8,1,3,0,0,3,1,2,12,12,13,15.7
2023-24,202403180IND,3/18/2024,IND vs CLE,Sam Merrill,merrisa01,50,CLE,0,IND,11,1,1,1,1,1,24.6,1,0,3,8,2,6,3,3,2,2,2,12,12,13,18.7
2023-24,202403180GSW,3/18/2024,GSW vs NYK,Brandin Podziemski,podzibr01,59,GSW,1,NYK,0,2,2,0,1,1,25.06666667,1,1,0,2,0,1,0,0,3,1,4,2,2,4,7.4
2023-24,202403180GSW,3/18/2024,GSW vs NYK,Isaiah Hartenstein,harteis01,62,NYK,0,GSW,13,10,4,2,1,0,25.11666667,5,5,6,7,0,0,1,2,2,3,14,17,23,27,40
2023-24,202403180GSW,3/18/2024,GSW vs NYK,Jonathan Kuminga,kuminjo01,66,GSW,1,NYK,16,1,1,1,0,2,25.58333333,0,1,7,13,0,2,2,2,2,1,2,17,17,18,19.7
2023-24,202403180CHI,3/18/2024,CHI vs POR,Onuralp Bitim,bitimon01,13,CHI,1,POR,9,4,1,0,0,1,25.71666667,1,3,4,9,1,3,0,0,2,0,5,10,13,14,14.3
2023-24,202403180GSW,3/18/2024,GSW vs NYK,Trayce Jackson-Davis,jackstr02,54,GSW,1,NYK,19,9,2,0,3,0,25.71666667,3,6,9,9,0,0,1,2,2,3,11,21,28,30,41.8
2023-24,202403180LAL,3/18/2024,LAL vs ATL,Bogdan Bogdanovic,bogdabo01,65,ATL,0,LAL,17,3,0,0,0,2,25.75,1,2,5,11,3,5,4,4,3,0,3,17,20,20,18.6
2023-24,202403180LAL,3/18/2024,LAL vs ATL,Rui Hachimura,hachiru01,56,LAL,1,ATL,17,3,1,0,0,0,25.91666667,0,3,7,10,1,2,2,2,3,0,4,18,20,21,22.1
2023-24,202403180BOS,3/18/2024,BOS vs DET,James Wiseman,wisemja01,49,DET,0,BOS,12,5,3,1,2,1,26.08333333,4,1,4,10,0,0,4,4,3,3,8,15,17,20,30.5
2023-24,202403180LAL,3/18/2024,LAL vs ATL,De'Andre Hunter,huntede01,44,ATL,0,LAL,8,1,3,1,1,0,26.3,0,1,4,14,0,5,0,0,1,2,4,11,9,12,19.7
2023-24,202403180PHI,3/18/2024,PHI vs MIA,Haywood Highsmith,highsha01,52,MIA,0,PHI,11,5,2,0,0,1,26.48333333,0,5,4,7,3,6,0,2,0,0,7,13,16,18,19
2023-24,202403180UTA,3/18/2024,UTA vs MIN,Kris Dunn,dunnkr01,59,UTA,1,MIN,8,3,5,0,0,0,26.61666667,3,0,3,9,2,6,0,0,3,0,8,13,11,16,19.1
2023-24,202403180CHI,3/18/2024,CHI vs POR,Kris Murray,murrakr01,48,POR,0,CHI,10,1,1,2,1,0,26.86666667,1,0,5,9,0,2,0,2,3,3,2,11,11,12,21.7
2023-24,202403180UTA,3/18/2024,UTA vs MIN,Mike Conley,conlemi01,63,MIN,0,UTA,4,1,2,2,1,1,27.08333333,0,1,2,8,0,5,0,0,2,3,3,6,5,7,16.2
2023-24,202403180UTA,3/18/2024,UTA vs MIN,Taylor Hendricks,hendrita0,26,UTA,1,MIN,8,6,1,1,1,0,27.61666667,0,6,3,6,2,4,0,0,1,2,7,9,14,15,22.7
2023-24,202403180BOS,3/18/2024,BOS vs DET,Luke Kornet,kornelu01,50,BOS,1,DET,4,10,0,2,3,0,27.76666667,6,4,2,4,0,0,0,0,1,5,10,4,14,14,31
2023-24,202403180UTA,3/18/2024,UTA vs MIN,Walker Kessler,kesslwa01,56,UTA,1,MIN,6,14,2,0,1,1,28.15,5,9,2,3,0,0,2,2,2,1,16,8,20,22,27.8
2023-24,202403180LAL,3/18/2024,LAL vs ATL,Austin Reaves,reaveau01,70,LAL,1,ATL,12,6,4,1,1,0,28.28333333,1,5,4,9,0,3,4,4,3,2,10,16,18,22,31.2
2023-24,202403180IND,3/18/2024,IND vs CLE,Myles Turner,turnemy01,66,IND,1,CLE,12,3,1,1,1,2,28.63333333,1,2,5,10,2,4,0,0,3,2,4,13,15,16,21.1
2023-24,202403180LAL,3/18/2024,LAL vs ATL,LeBron James,jamesle01,61,LAL,1,ATL,25,7,10,0,0,2,28.65,0,7,10,14,2,5,3,3,0,0,17,35,32,42,46.4
2023-24,202403180BOS,3/18/2024,BOS vs DET,Jaden Ivey,iveyja01,64,DET,0,BOS,21,5,5,0,1,3,29.11666667,1,4,10,19,1,4,0,0,3,1,10,26,26,31,34.5
2023-24,202403180UTA,3/18/2024,UTA vs MIN,Keyonte George,georgke01,61,UTA,1,MIN,15,3,8,1,0,6,29.8,0,3,6,12,2,3,1,1,0,1,11,23,18,26,27.6
2023-24,202403180CHI,3/18/2024,CHI vs POR,Scoot Henderson,hendesc01,49,POR,0,CHI,14,5,5,1,0,6,30.15,3,2,4,17,1,3,5,6,3,1,10,19,19,24,24.5
2023-24,202403180LAL,3/18/2024,LAL vs ATL,D'Angelo Russell,russeda01,65,LAL,1,ATL,27,4,10,1,0,1,30.38333333,0,4,8,14,6,10,5,5,1,1,14,37,31,41,48.8
2023-24,202403180BOS,3/18/2024,BOS vs DET,Jaylen Brown,brownja02,61,BOS,1,DET,31,7,3,1,0,3,30.4,0,7,11,20,3,6,6,8,2,1,10,34,38,41,43.9
2023-24,202403180GSW,3/18/2024,GSW vs NYK,Klay Thompson,thompkl01,64,GSW,1,NYK,18,2,8,2,1,0,30.7,1,1,6,15,5,10,1,1,0,3,10,26,20,28,41.4
2023-24,202403180GSW,3/18/2024,GSW vs NYK,Draymond Green,greendr01,42,GSW,1,NYK,2,8,5,1,0,4,30.88333333,3,5,1,7,0,2,0,0,2,1,13,7,10,15,18.1
2023-24,202403180UTA,3/18/2024,UTA vs MIN,Lauri Markkanen,markkla01,52,UTA,1,MIN,22,12,1,2,1,6,30.91666667,3,9,8,16,1,5,5,5,1,3,13,23,34,35,40.9
2023-24,202403180LAL,3/18/2024,LAL vs ATL,Dejounte Murray,murrade01,65,ATL,0,LAL,13,5,10,3,0,2,31.11666667,1,4,6,18,1,9,0,0,1,3,15,23,18,28,41
2023-24,202403180CHI,3/18/2024,CHI vs POR,Alex Caruso,carusal01,60,CHI,1,POR,5,4,4,3,1,1,31.15,0,4,1,5,1,5,2,4,5,4,8,9,9,13,26.8
2023-24,202403180LAL,3/18/2024,LAL vs ATL,Anthony Davis,davisan02,66,LAL,1,ATL,22,15,6,2,1,2,31.21666667,1,14,10,14,1,2,1,2,2,3,21,28,37,43,56
2023-24,202403180GSW,3/18/2024,GSW vs NYK,Donte DiVincenzo,divindo01,67,NYK,0,GSW,18,4,1,1,0,0,31.26666667,1,3,7,13,4,8,0,0,4,1,5,19,22,23,27.3
2023-24,202403180IND,3/18/2024,IND vs CLE,Andrew Nembhard,nembhan01,55,IND,1,CLE,9,0,4,1,0,0,31.75,0,0,4,8,1,4,0,0,2,1,4,13,9,13,18
2023-24,202403180PHI,3/18/2024,PHI vs MIA,Bam Adebayo,adebaba01,58,MIA,0,PHI,20,13,6,0,0,4,31.88333333,3,10,8,10,2,2,2,2,1,0,19,26,33,39,40.6
2023-24,202403180IND,3/18/2024,IND vs CLE,Pascal Siakam,siakapa01,67,IND,1,CLE,19,12,1,1,0,2,31.96666667,4,8,9,18,0,1,1,4,3,1,13,20,31,32,35.9
2023-24,202403180LAL,3/18/2024,LAL vs ATL,Jalen Johnson,johnsja05,51,ATL,0,LAL,25,9,4,0,1,1,32.35,2,7,9,20,2,11,5,6,1,1,13,29,34,38,43.8
2023-24,202403180IND,3/18/2024,IND vs CLE,Tyrese Haliburton,halibty01,57,IND,1,CLE,14,6,12,1,1,3,32.48333333,1,5,4,14,1,9,5,5,5,2,18,26,20,32,42.2
2023-24,202403180UTA,3/18/2024,UTA vs MIN,Jaden McDaniels,mcdanja02,58,MIN,0,UTA,9,8,1,1,2,0,32.6,3,5,4,13,1,5,0,0,4,3,9,10,17,18,29.1
2023-24,202403180IND,3/18/2024,IND vs CLE,Isaac Okoro,okorois01,59,CLE,0,IND,9,3,2,1,0,2,33.21666667,1,2,4,7,1,2,0,0,4,1,5,11,12,14,16.6
2023-24,202403180GSW,3/18/2024,GSW vs NYK,Stephen Curry,curryst01,61,GSW,1,NYK,27,5,5,0,0,2,33.31666667,0,5,8,20,4,13,7,7,1,0,10,32,32,37,38.5
2023-24,202403180IND,3/18/2024,IND vs CLE,Georges Niang,niangge01,68,CLE,0,IND,13,2,1,0,1,4,33.33333333,0,2,5,8,3,4,0,0,2,1,3,14,15,16,15.9
2023-24,202403180CHI,3/18/2024,CHI vs POR,Jabari Walker,walkeja01,59,POR,0,CHI,3,10,4,1,0,0,33.45,3,7,1,5,0,2,1,2,3,1,14,7,13,17,24
2023-24,202403180UTA,3/18/2024,UTA vs MIN,Kyle Anderson,anderky01,65,MIN,0,UTA,10,6,5,0,1,1,33.46666667,3,3,4,8,1,2,1,2,3,1,11,15,16,21,26.7
2023-24,202403180CHI,3/18/2024,CHI vs POR,Dalano Banton,bantoda01,41,POR,0,CHI,11,6,0,3,2,4,33.46666667,1,5,4,7,1,2,2,2,4,5,6,11,17,17,29.2
2023-24,202403180SAC,3/18/2024,SAC vs MEM,Keon Ellis,elliske01,42,SAC,1,MEM,5,7,3,1,5,2,33.73333333,2,5,2,4,1,2,0,0,4,6,10,8,12,15,33.9
2023-24,202403180PHI,3/18/2024,PHI vs MIA,Terry Rozier,roziete01,51,MIA,0,PHI,20,8,1,1,1,3,33.8,2,6,8,21,3,7,1,1,0,2,9,21,28,29,34.1
2023-24,202403180IND,3/18/2024,IND vs CLE,Jarrett Allen,allenja01,63,CLE,0,IND,23,9,1,1,1,1,33.98333333,0,9,8,12,0,0,7,8,0,2,10,24,32,33,40.3
2023-24,202403180BOS,3/18/2024,BOS vs DET,Stanley Umude,umudest01,23,DET,0,BOS,10,6,1,0,0,1,34.06666667,1,5,3,7,1,4,3,3,3,0,7,11,16,17,17.7
2023-24,202403180BOS,3/18/2024,BOS vs DET,Marcus Sasser,sassema01,59,DET,0,BOS,8,4,6,1,0,3,34.41666667,1,3,4,12,0,2,0,0,0,1,10,14,12,18,21.8
2023-24,202403180UTA,3/18/2024,UTA vs MIN,Nickeil Alexander-Walker,alexani01,68,MIN,0,UTA,13,4,5,3,2,0,34.46666667,1,3,4,11,3,6,2,2,2,5,9,18,17,22,40.3
2023-24,202403180PHI,3/18/2024,PHI vs MIA,Jaime Jaquez Jr.,jaqueja01,62,MIA,0,PHI,9,9,4,1,0,1,34.75,0,9,3,13,1,5,2,2,1,1,13,13,18,22,27.8
2023-24,202403180CHI,3/18/2024,CHI vs POR,Nikola Vucevic,vucevni01,64,CHI,1,POR,22,9,0,2,1,3,34.81666667,1,8,10,17,2,4,0,2,3,3,9,22,31,31,38.8
2023-24,202403180IND,3/18/2024,IND vs CLE,Aaron Nesmith,nesmiaa01,61,IND,1,CLE,9,4,2,0,0,3,35.06666667,2,2,4,9,1,5,0,0,5,0,6,11,13,15,13.8
2023-24,202403180SAC,3/18/2024,SAC vs MEM,John Konchar,konchjo01,53,MEM,0,SAC,6,10,3,4,2,1,35.18333333,4,6,2,6,0,2,2,2,5,6,13,9,16,19,39.5
2023-24,202403180GSW,3/18/2024,GSW vs NYK,Jalen Brunson,brunsja01,63,NYK,0,GSW,34,5,7,1,0,3,35.23333333,0,5,12,25,3,9,7,8,2,1,12,41,39,46,50.5
2023-24,202403180PHI,3/18/2024,PHI vs MIA,Kyle Lowry,lowryky01,49,PHI,1,MIA,16,4,1,2,1,0,35.23333333,0,4,6,12,3,5,1,1,2,3,5,17,20,21,31.3
2023-24,202403180PHI,3/18/2024,PHI vs MIA,Caleb Martin,martica02,51,MIA,0,PHI,13,4,2,4,1,4,35.4,1,3,6,14,1,6,0,1,3,5,6,15,17,19,31.8
2023-24,202403180IND,3/18/2024,IND vs CLE,Darius Garland,garlada01,44,CLE,0,IND,13,6,7,2,0,5,36.08333333,4,2,5,18,1,9,2,4,4,2,13,20,19,26,31.7
2023-24,202403180UTA,3/18/2024,UTA vs MIN,Collin Sexton,sextoco01,68,UTA,1,MIN,24,1,2,0,0,4,36.53333333,1,0,9,17,5,8,1,1,0,0,3,26,25,27,24.2
2023-24,202403180BOS,3/18/2024,BOS vs DET,Derrick White,whitede01,63,BOS,1,DET,22,10,10,2,1,3,36.55,0,10,8,20,6,12,0,0,0,3,20,32,32,42,55
2023-24,202403180CHI,3/18/2024,CHI vs POR,Deandre Ayton,aytonde01,46,POR,0,CHI,25,15,1,0,2,1,37.11666667,4,11,11,17,0,0,3,4,3,2,16,26,40,41,49.5
2023-24,202403180SAC,3/18/2024,SAC vs MEM,Desmond Bane,banede01,39,MEM,0,SAC,24,5,4,3,0,1,37.36666667,0,5,7,19,2,7,8,8,2,3,9,28,29,33,44
2023-24,202403180UTA,3/18/2024,UTA vs MIN,Anthony Edwards,edwaran01,65,MIN,0,UTA,32,7,8,1,2,3,37.85,1,6,13,23,2,8,4,4,2,3,15,40,39,47,58.4
2023-24,202403180PHI,3/18/2024,PHI vs MIA,Nicolas Batum,batumni01,47,PHI,1,MIA,2,8,1,2,1,1,37.93333333,1,7,1,4,0,1,0,0,4,3,9,3,10,11,21.1
2023-24,202403180BOS,3/18/2024,BOS vs DET,Payton Pritchard,pritcpa01,68,BOS,1,DET,23,2,7,0,0,2,37.95,1,1,8,14,5,9,2,2,1,0,9,30,25,32,33.9
2023-24,202403180IND,3/18/2024,IND vs CLE,Caris LeVert,leverca01,56,CLE,0,IND,23,8,11,1,1,1,37.98333333,1,7,7,15,1,5,8,11,2,2,19,34,31,42,54.1
2023-24,202403180PHI,3/18/2024,PHI vs MIA,Kelly Oubre Jr.,oubreke01,55,PHI,1,MIA,22,11,3,0,5,2,38.56666667,2,9,10,19,2,6,0,0,1,5,14,25,33,36,52.7
2023-24,202403180CHI,3/18/2024,CHI vs POR,Ayo Dosunmu,dosunay01,67,CHI,1,POR,23,1,10,1,0,2,38.75,1,0,9,17,2,6,3,3,2,1,11,33,24,34,40.2
2023-24,202403180SAC,3/18/2024,SAC vs MEM,Santi Aldama,aldamsa01,56,MEM,0,SAC,14,9,2,2,1,2,38.76666667,1,8,5,11,2,6,2,3,2,3,11,16,23,25,34.8
2023-24,202403180CHI,3/18/2024,CHI vs POR,Anfernee Simons,simonan01,44,POR,0,CHI,30,3,9,0,0,1,38.8,0,3,10,24,4,14,6,7,2,0,12,39,33,42,46.1
2023-24,202403180SAC,3/18/2024,SAC vs MEM,Jaren Jackson Jr.,jacksja02,59,MEM,0,SAC,25,2,4,1,4,4,39.4,1,1,8,27,1,6,8,9,6,5,6,29,27,31,44.4
2023-24,202403180SAC,3/18/2024,SAC vs MEM,Malik Monk,monkma01,66,SAC,1,MEM,28,6,6,0,0,3,39.45,1,5,10,19,1,6,7,7,3,0,12,34,34,40,41.2
2023-24,202403180CHI,3/18/2024,CHI vs POR,DeMar DeRozan,derozde01,67,CHI,1,POR,28,5,6,0,1,2,40.08333333,2,3,10,17,1,2,7,7,0,1,11,34,33,39,44
2023-24,202403180SAC,3/18/2024,SAC vs MEM,Domantas Sabonis,sabondo01,67,SAC,1,MEM,25,18,5,0,2,2,40.16666667,7,11,6,17,0,2,13,15,4,2,23,30,43,48,58.1
2023-24,202403180SAC,3/18/2024,SAC vs MEM,Jake LaRavia,laravja01,24,MEM,0,SAC,12,8,5,0,0,1,40.81666667,3,5,4,13,2,6,2,4,3,0,13,17,20,25,28.1
2023-24,202403180PHI,3/18/2024,PHI vs MIA,Tyrese Maxey,maxeyty01,59,PHI,1,MIA,30,8,10,1,1,3,41.15,0,8,11,24,3,10,5,5,3,2,18,40,38,48,57.6
2023-24,202403180SAC,3/18/2024,SAC vs MEM,Keegan Murray,murrake02,62,SAC,1,MEM,15,10,3,2,0,1,41.58333333,3,7,6,17,2,8,1,4,2,2,13,18,25,28,36.5
2023-24,202403180SAC,3/18/2024,SAC vs MEM,De'Aaron Fox,foxde01,59,SAC,1,MEM,23,7,10,3,1,6,42.91666667,1,6,8,16,4,7,3,4,4,4,17,33,30,40,52.4
2023-24,202403180SAC,3/18/2024,SAC vs MEM,GG Jackson II,jacksgg01,35,MEM,0,SAC,22,7,0,3,0,2,43.56666667,1,6,8,13,4,8,2,2,2,3,7,22,29,29,37.4
2023-24,202403180GSW,3/18/2024,GSW vs NYK,Miles McBride,mcbrimi01,55,NYK,0,GSW,29,1,2,1,0,1,46.51666667,1,0,9,13,6,9,5,6,4,1,3,31,30,32,35.2
2023-24,202403180GSW,3/18/2024,GSW vs NYK,Josh Hart,hartjo01,67,NYK,0,GSW,10,11,11,1,0,2,48,2,9,5,18,0,6,0,0,3,1,22,21,21,32,40.7
2023-24,202403170SAS,3/17/2024,SAS vs BRK,Blake Wesley,weslebl01,47,SAS,1,BRK,2,1,0,0,0,1,10.36666667,0,1,1,4,0,1,0,0,2,0,1,2,3,3,2.2
2023-24,202403170DET,3/17/2024,DET vs MIA,Thomas Bryant,bryanth01,30,MIA,0,DET,2,4,1,0,0,0,10.45,0,4,0,1,0,0,2,2,1,0,5,3,6,7,8.3
2023-24,202403170SAS,3/17/2024,SAS vs BRK,Lonnie Walker IV,walkelo01,47,BRK,0,SAS,0,3,1,0,1,0,10.9,0,3,0,2,0,2,0,0,1,1,4,1,3,4,8.1
2023-24,202403170LAC,3/17/2024,LAC vs ATL,Bones Hyland,hylanbo01,29,LAC,1,ATL,2,1,1,0,0,5,11.03333333,0,1,0,4,0,4,2,2,0,0,2,3,3,4,-0.3
2023-24,202403170DAL,3/17/2024,DAL vs DEN,Reggie Jackson,jacksre01,68,DEN,0,DAL,8,0,2,0,0,1,12.51666667,0,0,3,8,2,3,0,0,1,0,2,10,8,10,10
2023-24,202403170LAC,3/17/2024,LAC vs ATL,Garrison Mathews,mathega01,51,ATL,0,LAC,6,0,0,1,1,0,13.15,0,0,2,5,2,3,0,0,0,2,0,6,6,6,12
2023-24,202403170ORL,3/17/2024,ORL vs TOR,Joe Ingles,inglejo01,54,ORL,1,TOR,5,2,2,0,0,2,13.3,0,2,1,1,1,1,2,2,3,0,4,7,7,9,8.4
2023-24,202403170LAC,3/17/2024,LAC vs ATL,Wesley Matthews,matthwe02,27,ATL,0,LAC,6,1,0,1,0,0,13.61666667,0,1,2,2,2,2,0,0,0,1,1,6,7,7,10.2
2023-24,202403170DAL,3/17/2024,DAL vs DEN,Peyton Watson,watsope01,66,DEN,0,DAL,3,2,0,2,0,0,14.28333333,0,2,1,4,1,1,0,0,1,2,2,3,5,5,11.4
2023-24,202403170SAS,3/17/2024,SAS vs BRK,Cedi Osman,osmande01,64,SAS,1,BRK,10,3,0,0,0,1,14.45,0,3,4,7,2,4,0,0,1,0,3,10,13,13,12.6
2023-24,202403170ORL,3/17/2024,ORL vs TOR,Markelle Fultz,fultzma01,30,ORL,1,TOR,4,5,2,0,0,1,14.76666667,2,3,2,7,0,1,0,0,0,0,7,6,9,11,12
2023-24,202403170WAS,3/17/2024,WAS vs BOS,Xavier Tillman Sr.,tillmxa01,41,BOS,0,WAS,3,2,0,2,1,1,14.76666667,1,1,1,4,0,3,1,2,1,3,2,3,5,5,13.4
2023-24,202403170DAL,3/17/2024,DAL vs DEN,Tim Hardaway Jr.,hardati02,65,DAL,1,DEN,1,3,1,0,0,1,14.86666667,0,3,0,3,0,2,1,2,1,0,4,2,4,5,5.1
2023-24,202403170ORL,3/17/2024,ORL vs TOR,Caleb Houstan,houstca01,51,ORL,1,TOR,3,0,0,0,0,0,15.15,0,0,1,4,1,4,0,0,1,0,0,3,3,3,3
2023-24,202403170WAS,3/17/2024,WAS vs BOS,Eugene Omoruyi,omorueu01,36,WAS,1,BOS,0,2,2,0,0,1,15.33333333,1,1,0,1,0,1,0,0,2,0,4,2,2,4,4.4
2023-24,202403170MIL,3/17/2024,MIL vs PHO,A.J. Green,greenaj01,45,MIL,1,PHO,5,1,0,1,0,0,15.45,1,0,1,1,1,1,2,2,1,1,1,5,6,6,9.2
2023-24,202403170SAS,3/17/2024,SAS vs BRK,Julian Champagnie,champju02,60,SAS,1,BRK,0,1,0,0,0,1,15.51666667,0,1,0,3,0,3,0,0,1,0,1,0,1,1,0.2
2023-24,202403170SAS,3/17/2024,SAS vs BRK,Malaki Branham,branhma01,63,SAS,1,BRK,7,3,2,0,0,1,15.53333333,1,2,2,8,0,3,3,3,0,0,5,9,10,12,12.6
2023-24,202403170WAS,3/17/2024,WAS vs BOS,Jaden Springer,sprinja01,41,BOS,0,WAS,2,2,0,1,0,3,16,1,1,1,3,0,2,0,0,4,1,2,2,4,4,4.4
2023-24,202403170DET,3/17/2024,DET vs MIA,James Wiseman,wisemja01,48,DET,1,MIA,4,6,1,0,0,2,16.11666667,0,6,0,2,0,0,4,4,2,0,7,5,10,11,10.7
2023-24,202403170LAC,3/17/2024,LAC vs ATL,Trent Forrest,forretr01,29,ATL,0,LAC,2,1,3,0,0,0,16.16666667,0,1,1,3,0,0,0,0,1,0,4,5,3,6,7.7
2023-24,202403170SAS,3/17/2024,SAS vs BRK,Zach Collins,colliza01,56,SAS,1,BRK,6,7,2,2,0,2,16.85,2,5,1,3,0,1,4,4,4,2,9,8,13,15,21.4
2023-24,202403170SAS,3/17/2024,SAS vs BRK,Dennis Smith Jr.,smithde03,52,BRK,0,SAS,5,3,4,2,0,1,16.98333333,1,2,2,6,1,2,0,0,1,2,7,9,8,12,19.6
2023-24,202403170ORL,3/17/2024,ORL vs TOR,Moritz Wagner,wagnemo01,66,ORL,1,TOR,14,4,1,0,1,1,17.8,1,3,6,9,1,3,1,1,1,1,5,15,18,19,22.3
2023-24,202403170DAL,3/17/2024,DAL vs DEN,Dante Exum,exumda01,42,DAL,1,DEN,8,3,1,0,0,0,17.86666667,0,3,4,8,0,1,0,0,1,0,4,9,11,12,13.1
2023-24,202403170DET,3/17/2024,DET vs MIA,Marcus Sasser,sassema01,58,DET,1,MIA,7,3,6,0,0,1,17.96666667,0,3,3,5,1,2,0,0,0,0,9,13,10,16,18.6
2023-24,202403170MIL,3/17/2024,MIL vs PHO,Brook Lopez,lopezbr01,65,MIL,1,PHO,10,7,3,1,1,1,18.2,3,4,4,8,2,5,0,0,1,2,10,13,17,20,27.9
2023-24,202403170DET,3/17/2024,DET vs MIA,Stanley Umude,umudest01,22,DET,1,MIA,9,2,1,0,1,0,18.55,1,1,3,5,3,5,0,0,0,1,3,10,11,12,15.9
2023-24,202403170ORL,3/17/2024,ORL vs TOR,Jahmi'us Ramsey,ramseja01,4,TOR,0,ORL,5,1,2,2,0,3,18.65,1,0,2,6,1,4,0,0,1,2,3,7,6,8,12.2
2023-24,202403170SAS,3/17/2024,SAS vs BRK,Day'Ron Sharpe,sharpda01,51,BRK,0,SAS,15,3,2,1,1,1,19.08333333,2,1,7,9,0,0,1,3,3,2,5,17,18,20,26.6
2023-24,202403170DAL,3/17/2024,DAL vs DEN,Christian Braun,braunch01,68,DEN,0,DAL,10,1,1,0,0,1,19.16666667,0,1,4,5,1,1,1,2,2,0,2,11,11,12,11.7
2023-24,202403170WAS,3/17/2024,WAS vs BOS,Richaun Holmes,holmeri01,35,WAS,1,BOS,8,4,1,0,1,1,19.2,0,4,4,6,0,0,0,0,3,1,5,9,12,13,16.3
2023-24,202403170ORL,3/17/2024,ORL vs TOR,Jalen Suggs,suggsja01,61,ORL,1,TOR,10,2,2,2,1,2,20.01666667,1,1,3,6,2,2,2,2,2,3,4,12,12,14,22.4
2023-24,202403170WAS,3/17/2024,WAS vs BOS,Luke Kornet,kornelu01,49,BOS,0,WAS,14,6,1,0,2,1,20.05,3,3,5,9,0,0,4,4,1,2,7,15,20,21,27.7
2023-24,202403170MIL,3/17/2024,MIL vs PHO,Jusuf Nurkic,nurkiju01,64,PHO,0,MIL,8,6,6,0,0,2,20.13333333,3,3,3,5,0,0,2,2,2,0,12,14,14,20,22.2
2023-24,202403170LAC,3/17/2024,LAC vs ATL,P.J. Tucker,tuckepj01,21,LAC,1,ATL,3,4,0,1,0,0,20.66666667,2,2,1,3,1,1,0,0,1,1,4,3,7,7,10.8
2023-24,202403170DET,3/17/2024,DET vs MIA,Delon Wright,wrighde01,37,MIA,0,DET,6,3,0,2,0,0,20.68333333,1,2,3,7,0,0,0,0,0,2,3,6,9,9,15.6
2023-24,202403170DAL,3/17/2024,DAL vs DEN,Maxi Kleber,klebima01,31,DAL,1,DEN,0,4,3,0,0,0,20.91666667,0,4,0,3,0,3,0,0,3,0,7,3,4,7,9.3
2023-24,202403170WAS,3/17/2024,WAS vs BOS,Corey Kispert,kispeco01,66,WAS,1,BOS,4,2,1,0,0,1,21.15,0,2,1,5,1,5,1,2,3,0,3,5,6,7,6.9
2023-24,202403170MIL,3/17/2024,MIL vs PHO,Eric Gordon,gordoer01,55,PHO,0,MIL,10,1,2,1,1,1,21.55,1,0,4,5,2,2,0,0,2,2,3,12,11,13,19.2
2023-24,202403170WAS,3/17/2024,WAS vs BOS,Jared Butler,butleja02,26,WAS,1,BOS,8,3,6,0,0,3,22.11666667,1,2,3,6,0,1,2,2,0,0,9,14,11,17,17.6
2023-24,202403170MIL,3/17/2024,MIL vs PHO,Pat Connaughton,connapa01,62,MIL,1,PHO,3,2,0,0,1,1,22.13333333,1,1,1,3,0,1,1,1,0,1,2,3,5,5,7.4
2023-24,202403170WAS,3/17/2024,WAS vs BOS,Jrue Holiday,holidjr01,61,BOS,0,WAS,7,1,3,1,2,3,22.21666667,0,1,3,7,1,2,0,0,2,3,4,10,8,11,18.7
2023-24,202403170LAC,3/17/2024,LAC vs ATL,Bruno Fernando,fernabr01,30,ATL,0,LAC,6,7,1,2,0,4,22.33333333,2,5,2,6,0,0,2,2,4,2,8,7,13,14,17.9
2023-24,202403170WAS,3/17/2024,WAS vs BOS,Johnny Davis,davisjo06,37,WAS,1,BOS,8,4,1,0,2,0,22.4,1,3,4,7,0,2,0,0,3,2,5,9,12,13,20.3
2023-24,202403170LAC,3/17/2024,LAC vs ATL,Amir Coffey,coffeam01,55,LAC,1,ATL,2,5,0,1,0,1,22.41666667,1,4,1,6,0,4,0,0,2,1,5,2,7,7,10
2023-24,202403170ORL,3/17/2024,ORL vs TOR,Jontay Porter,portejo01,24,TOR,0,ORL,4,7,3,1,1,1,22.43333333,4,3,2,5,0,2,0,0,0,2,10,7,11,14,21.9
2023-24,202403170WAS,3/17/2024,WAS vs BOS,Svi Mykhailiuk,mykhasv01,28,BOS,0,WAS,9,5,2,0,0,0,22.58333333,0,5,3,7,3,6,0,0,0,0,7,11,14,16,18
2023-24,202403170ORL,3/17/2024,ORL vs TOR,Bruce Brown,brownbr01,57,TOR,0,ORL,12,0,4,0,0,2,22.71666667,0,0,3,6,0,1,6,6,2,0,4,16,12,16,16
2023-24,202403170WAS,3/17/2024,WAS vs BOS,Al Horford,horfoal01,56,BOS,0,WAS,14,4,2,0,0,1,22.8,2,2,5,7,2,4,2,2,3,0,6,16,18,20,20.8
2023-24,202403170WAS,3/17/2024,WAS vs BOS,Sam Hauser,hausesa01,66,BOS,0,WAS,30,6,1,1,0,0,22.81666667,0,6,10,13,10,13,0,0,1,1,7,31,36,37,41.7
2023-24,202403170DAL,3/17/2024,DAL vs DEN,Dereck Lively II,livelde01,49,DAL,1,DEN,14,8,0,0,2,3,23.1,4,4,7,8,0,0,0,3,3,2,8,14,22,22,26.6
2023-24,202403170LAC,3/17/2024,LAC vs ATL,Ivica Zubac,zubaciv01,55,LAC,1,ATL,6,6,1,0,1,1,23.25,4,2,1,1,0,0,4,4,2,1,7,7,12,13,16.7
2023-24,202403170WAS,3/17/2024,WAS vs BOS,Jordan Poole,poolejo01,66,WAS,1,BOS,31,2,4,0,0,1,23.38333333,1,1,12,19,3,6,4,5,2,0,6,35,33,37,38.4
2023-24,202403170WAS,3/17/2024,WAS vs BOS,Jules Bernard,bernaju01,11,WAS,1,BOS,12,4,1,0,0,2,23.81666667,2,2,5,12,1,4,1,1,0,0,5,13,16,17,16.3
2023-24,202403170LAC,3/17/2024,LAC vs ATL,De'Andre Hunter,huntede01,43,ATL,0,LAC,20,2,2,0,1,1,24.15,0,2,8,13,2,5,2,2,4,1,4,22,22,24,27.4
2023-24,202403170DET,3/17/2024,DET vs MIA,Jaden Ivey,iveyja01,63,DET,1,MIA,10,1,2,0,1,2,24.15,0,1,4,7,1,3,1,2,4,1,3,12,11,13,15.2
2023-24,202403170DAL,3/17/2024,DAL vs DEN,Daniel Gafford,gaffoda01,61,DAL,1,DEN,8,6,1,0,1,0,24.35,3,3,4,7,0,0,0,0,5,1,7,9,14,15,19.7
2023-24,202403170DAL,3/17/2024,DAL vs DEN,Derrick Jones Jr.,jonesde02,63,DAL,1,DEN,9,8,1,0,0,0,24.48333333,6,2,4,11,0,3,1,2,1,0,9,10,17,18,20.1
2023-24,202403170LAC,3/17/2024,LAC vs ATL,Vit Krejci,krejcvi01,7,ATL,0,LAC,5,2,3,0,1,0,24.66666667,0,2,1,2,0,0,3,3,4,1,5,8,7,10,14.9
2023-24,202403170WAS,3/17/2024,WAS vs BOS,Anthony Gill,gillan01,38,WAS,1,BOS,13,4,3,0,0,2,24.73333333,2,2,5,11,1,4,2,2,4,0,7,16,17,20,20.3
2023-24,202403170ORL,3/17/2024,ORL vs TOR,Jordan Nwora,nworajo01,39,TOR,0,ORL,18,7,1,0,1,0,25,0,7,7,9,1,3,3,3,2,1,8,19,25,26,30.9
2023-24,202403170ORL,3/17/2024,ORL vs TOR,Cole Anthony,anthoco01,67,ORL,1,TOR,6,5,2,1,0,0,25.15,2,3,3,8,0,3,0,0,2,1,7,8,11,13,18
2023-24,202403170DET,3/17/2024,DET vs MIA,Haywood Highsmith,highsha01,51,MIA,0,DET,3,2,1,0,0,0,25.46666667,2,0,1,6,0,3,1,2,3,0,3,4,5,6,6.9
2023-24,202403170MIL,3/17/2024,MIL vs PHO,Khris Middleton,middlkh01,44,MIL,1,PHO,22,3,7,1,0,2,25.48333333,1,2,8,15,2,4,4,4,4,1,10,29,25,32,37.1
2023-24,202403170ORL,3/17/2024,ORL vs TOR,Kelly Olynyk,olynyke01,66,TOR,0,ORL,11,4,3,1,0,3,25.56666667,1,3,5,8,1,1,0,0,5,1,7,14,15,18,20.3
2023-24,202403170LAC,3/17/2024,LAC vs ATL,Clint Capela,capelca01,59,ATL,0,LAC,15,13,3,1,2,1,25.66666667,6,7,7,11,0,0,1,2,0,3,16,18,28,31,43.1
2023-24,202403170MIL,3/17/2024,MIL vs PHO,Royce O'Neale,onealro01,65,PHO,0,MIL,16,5,3,0,0,0,26.18333333,1,4,6,12,4,9,0,0,1,0,8,19,21,24,26.5
2023-24,202403170WAS,3/17/2024,WAS vs BOS,Jayson Tatum,tatumja01,64,BOS,0,WAS,30,6,6,3,1,2,26.6,0,6,8,17,6,12,8,10,1,4,12,36,36,42,56.2
2023-24,202403170ORL,3/17/2024,ORL vs TOR,Gary Harris,harriga01,44,ORL,1,TOR,7,2,1,1,0,0,26.63333333,1,1,3,9,1,7,0,1,1,1,3,8,9,10,13.9
2023-24,202403170ORL,3/17/2024,ORL vs TOR,Gradey Dick,dickgr01,47,TOR,0,ORL,10,0,1,0,0,3,26.68333333,0,0,4,11,2,3,0,0,2,0,1,11,10,11,8.5
2023-24,202403170SAS,3/17/2024,SAS vs BRK,Cameron Johnson,johnsca02,52,BRK,0,SAS,12,5,2,1,0,0,26.71666667,1,4,4,9,1,5,3,4,1,1,7,14,17,19,24
2023-24,202403170ORL,3/17/2024,ORL vs TOR,Wendell Carter Jr.,cartewe01,41,ORL,1,TOR,9,3,3,1,0,1,27.46666667,0,3,4,8,1,4,0,0,1,1,6,12,12,15,19.1
2023-24,202403170WAS,3/17/2024,WAS vs BOS,Oshae Brissett,brissos01,44,BOS,0,WAS,7,4,2,0,0,1,28.9,3,1,1,5,0,3,5,6,3,0,6,9,11,13,13.8
2023-24,202403170MIL,3/17/2024,MIL vs PHO,Patrick Beverley,beverpa01,63,MIL,1,PHO,3,2,4,1,0,1,29.2,0,2,1,6,1,3,0,0,3,1,6,7,5,9,13.4
2023-24,202403170MIL,3/17/2024,MIL vs PHO,Malik Beasley,beaslma01,65,MIL,1,PHO,17,3,3,0,0,0,29.25,0,3,6,11,5,8,0,0,1,0,6,20,20,23,25.1
2023-24,202403170DET,3/17/2024,DET vs MIA,Jalen Duren,durenja01,52,DET,1,MIA,11,10,1,0,1,2,29.48333333,3,7,4,10,0,0,3,4,3,1,11,12,21,22,25.5
2023-24,202403170LAC,3/17/2024,LAC vs ATL,Bogdan Bogdanovic,bogdabo01,64,ATL,0,LAC,11,5,4,0,0,3,29.65,1,4,4,14,3,11,0,0,2,0,9,15,16,20,20
2023-24,202403170MIL,3/17/2024,MIL vs PHO,Bobby Portis,portibo01,68,MIL,1,PHO,31,10,2,3,0,1,29.8,3,7,13,20,5,5,0,0,0,3,12,33,41,43,54
2023-24,202403170ORL,3/17/2024,ORL vs TOR,Franz Wagner,wagnefr01,60,ORL,1,TOR,22,8,4,0,1,5,30.5,2,6,8,13,0,2,6,6,5,1,12,26,30,34,35.6
2023-24,202403170DET,3/17/2024,DET vs MIA,Caleb Martin,martica02,50,MIA,0,DET,10,7,0,1,1,2,30.61666667,1,6,3,9,2,6,2,2,1,2,7,10,17,17,22.4
2023-24,202403170DAL,3/17/2024,DAL vs DEN,P.J. Washington,washipj01,60,DAL,1,DEN,4,11,3,0,1,0,30.81666667,2,9,2,10,0,4,0,0,1,1,14,7,15,18,24.7
2023-24,202403170ORL,3/17/2024,ORL vs TOR,Gary Trent Jr.,trentga02,61,TOR,0,ORL,15,4,3,3,1,0,30.83333333,0,4,6,12,2,6,1,1,2,4,7,18,19,22,36.3
2023-24,202403170ORL,3/17/2024,ORL vs TOR,Ochai Agbaji,agbajoc01,67,TOR,0,ORL,9,7,1,0,0,2,31.21666667,4,3,4,10,1,3,0,0,2,0,8,10,16,17,16.9
2023-24,202403170DET,3/17/2024,DET vs MIA,Evan Fournier,fournev01,18,DET,1,MIA,18,4,1,3,0,2,31.26666667,0,4,6,14,4,8,2,3,5,3,5,19,22,23,31.3
2023-24,202403170ORL,3/17/2024,ORL vs TOR,Immanuel Quickley,quickim01,62,TOR,0,ORL,12,7,5,0,0,4,31.43333333,1,6,4,15,0,6,4,5,1,0,12,17,19,24,23.9
2023-24,202403170DAL,3/17/2024,DAL vs DEN,Kentavious Caldwell-Pope,caldwke01,62,DEN,0,DAL,10,3,2,0,2,0,31.63333333,0,3,4,8,2,5,0,0,2,2,5,12,13,15,22.6
2023-24,202403170LAC,3/17/2024,LAC vs ATL,Terance Mann,mannte01,61,LAC,1,ATL,7,4,0,2,1,0,31.78333333,0,4,2,6,1,2,2,2,2,3,4,7,11,11,20.8
2023-24,202403170WAS,3/17/2024,WAS vs BOS,Patrick Baldwin Jr.,baldwpa01,25,WAS,1,BOS,6,7,4,1,2,2,31.83333333,0,7,2,11,2,7,0,0,1,3,11,10,13,17,27.4
2023-24,202403170MIL,3/17/2024,MIL vs PHO,Jae Crowder,crowdja01,37,MIL,1,PHO,18,2,0,3,0,0,31.85,0,2,7,11,4,6,0,0,1,3,2,18,20,20,29.4
2023-24,202403170DET,3/17/2024,DET vs MIA,Cade Cunningham,cunnica01,57,DET,1,MIA,17,4,9,1,1,3,32.01666667,0,4,8,19,1,6,0,0,2,2,13,26,21,30,38.3
2023-24,202403170SAS,3/17/2024,SAS vs BRK,Nic Claxton,claxtni01,58,BRK,0,SAS,11,14,2,1,1,1,32.35,3,11,5,9,0,1,1,3,4,2,16,13,25,27,35.8
2023-24,202403170DAL,3/17/2024,DAL vs DEN,Aaron Gordon,gordoaa01,62,DEN,0,DAL,11,8,4,0,1,0,33.55,0,8,4,7,0,2,3,4,3,1,12,15,19,23,29.6
2023-24,202403170SAS,3/17/2024,SAS vs BRK,Keldon Johnson,johnske04,63,SAS,1,BRK,24,5,0,0,0,1,33.76666667,2,3,8,12,5,8,3,3,2,0,5,24,29,29,29
2023-24,202403170LAC,3/17/2024,LAC vs ATL,Dejounte Murray,murrade01,64,ATL,0,LAC,21,2,10,2,0,4,34.28333333,0,2,7,14,5,10,2,2,3,2,12,31,23,33,40.4
2023-24,202403170DET,3/17/2024,DET vs MIA,Jaime Jaquez Jr.,jaqueja01,61,MIA,0,DET,15,3,4,1,1,1,34.65,3,0,6,14,1,3,2,4,1,2,7,19,18,22,29.6
2023-24,202403170LAC,3/17/2024,LAC vs ATL,Paul George,georgpa01,61,LAC,1,ATL,26,6,1,4,1,1,34.66666667,0,6,9,20,4,12,4,4,1,5,7,27,32,33,48.7
2023-24,202403170DET,3/17/2024,DET vs MIA,Simone Fontecchio,fontesi01,66,DET,1,MIA,13,8,2,0,2,0,34.71666667,2,6,5,12,2,7,1,1,3,2,10,15,21,23,31.6
2023-24,202403170WAS,3/17/2024,WAS vs BOS,Payton Pritchard,pritcpa01,67,BOS,0,WAS,14,5,13,1,0,1,34.9,2,3,6,15,2,5,0,0,0,1,18,27,19,32,41.5
2023-24,202403170DET,3/17/2024,DET vs MIA,Duncan Robinson,robindu01,62,MIA,0,DET,30,4,5,0,0,3,35.41666667,0,4,10,15,7,12,3,3,2,0,9,35,34,39,39.3
2023-24,202403170DAL,3/17/2024,DAL vs DEN,Jamal Murray,murraja01,52,DEN,0,DAL,23,4,7,1,1,1,35.53333333,0,4,7,20,2,5,7,7,2,2,11,30,27,34,43.3
2023-24,202403170ORL,3/17/2024,ORL vs TOR,Paolo Banchero,banchpa01,66,ORL,1,TOR,29,6,5,1,1,1,35.55,0,6,11,16,4,7,3,6,0,2,11,34,35,40,48.7
2023-24,202403170DET,3/17/2024,DET vs MIA,Terry Rozier,roziete01,50,MIA,0,DET,17,6,9,1,0,0,35.6,0,6,8,20,1,6,0,0,0,1,15,26,23,32,40.7
2023-24,202403170DET,3/17/2024,DET vs MIA,Isaiah Stewart,stewais01,45,DET,1,MIA,12,6,1,0,1,0,35.73333333,1,5,5,9,2,5,0,0,0,1,7,13,18,19,23.7
2023-24,202403170SAS,3/17/2024,SAS vs BRK,Tre Jones,jonestr01,63,SAS,1,BRK,11,4,7,3,0,1,35.93333333,1,3,4,7,0,1,3,3,1,3,11,18,15,22,34.3
2023-24,202403170LAC,3/17/2024,LAC vs ATL,James Harden,hardeja01,60,LAC,1,ATL,9,6,9,1,1,3,36,0,6,3,10,2,5,1,1,2,2,15,18,15,24,32.7
2023-24,202403170WAS,3/17/2024,WAS vs BOS,Justin Champagnie,champju01,6,WAS,1,BOS,14,8,1,2,0,3,36.03333333,2,6,5,11,2,4,2,2,2,2,9,15,22,23,28.1
2023-24,202403170SAS,3/17/2024,SAS vs BRK,Victor Wembanyama,wembavi01,60,SAS,1,BRK,33,15,7,0,7,4,36.15,4,11,14,26,1,7,4,6,1,7,22,40,48,55,78.5
2023-24,202403170LAC,3/17/2024,LAC vs ATL,Jalen Johnson,johnsja05,50,ATL,0,LAC,18,12,6,3,2,1,36.31666667,1,11,7,14,3,3,1,1,4,5,18,24,30,36,55.4
2023-24,202403170LAC,3/17/2024,LAC vs ATL,Kawhi Leonard,leonaka01,61,LAC,1,ATL,28,2,2,1,1,3,36.78333333,0,2,8,17,3,8,9,10,0,2,4,30,30,32,36.4
2023-24,202403170DAL,3/17/2024,DAL vs DEN,Michael Porter Jr.,portemi01,67,DEN,0,DAL,20,7,3,2,2,1,37.2,2,5,6,13,4,9,4,4,2,4,10,23,27,30,43.9
2023-24,202403170MIL,3/17/2024,MIL vs PHO,Bradley Beal,bealbr01,39,PHO,0,MIL,28,4,7,1,1,3,37.28333333,0,4,11,15,1,3,5,6,1,2,11,35,32,39,46.3
2023-24,202403170DET,3/17/2024,DET vs MIA,Bam Adebayo,adebaba01,57,MIA,0,DET,20,17,3,1,0,3,37.55,4,13,9,13,1,1,1,2,2,1,20,23,37,40,44.9
2023-24,202403170SAS,3/17/2024,SAS vs BRK,Dorian Finney-Smith,finnedo01,59,BRK,0,SAS,8,7,1,4,1,1,37.58333333,3,4,4,9,0,3,0,0,3,5,8,9,15,16,31.9
2023-24,202403170DAL,3/17/2024,DAL vs DEN,Nikola Jokic,jokicni01,66,DEN,0,DAL,16,11,7,2,0,3,38.51666667,3,8,6,16,0,2,4,5,1,2,18,23,27,34,42.7
2023-24,202403170MIL,3/17/2024,MIL vs PHO,Damian Lillard,lillada01,63,MIL,1,PHO,31,5,16,1,0,4,38.63333333,1,4,10,19,4,8,7,7,1,1,21,47,36,52,60
2023-24,202403170MIL,3/17/2024,MIL vs PHO,Grayson Allen,allengr01,62,PHO,0,MIL,25,3,8,1,0,2,39.08333333,0,3,8,14,6,11,3,3,2,1,11,33,28,36,41.6
2023-24,202403170SAS,3/17/2024,SAS vs BRK,Cam Thomas,thomaca02,53,BRK,0,SAS,31,3,5,2,0,0,39.46666667,0,3,12,23,1,5,6,6,2,2,8,36,34,39,48.1
2023-24,202403170DAL,3/17/2024,DAL vs DEN,Kyrie Irving,irvinky01,46,DAL,1,DEN,24,7,9,3,1,3,39.65,3,4,9,23,4,11,2,2,2,4,16,33,31,40,54.9
2023-24,202403170SAS,3/17/2024,SAS vs BRK,Mikal Bridges,bridgmi01,68,BRK,0,SAS,14,7,5,1,0,3,39.81666667,1,6,5,16,3,7,1,1,3,1,12,19,21,26,29.9
2023-24,202403170MIL,3/17/2024,MIL vs PHO,Devin Booker,bookede01,54,PHO,0,MIL,23,9,6,1,1,2,40.05,1,8,11,22,0,5,1,2,3,2,15,29,32,38,46.8
2023-24,202403170DAL,3/17/2024,DAL vs DEN,Luka Doncic,doncilu01,59,DAL,1,DEN,37,10,3,2,0,3,40.13333333,4,6,12,27,5,11,8,10,3,2,13,40,47,50,56.5
2023-24,202403170MIL,3/17/2024,MIL vs PHO,Kevin Durant,duranke01,61,PHO,0,MIL,11,9,4,3,2,1,41.31666667,1,8,4,10,1,3,2,2,3,5,13,15,20,24,41.8
2023-24,202403170SAS,3/17/2024,SAS vs BRK,Dennis Schroder,schrode01,68,BRK,0,SAS,19,3,7,1,1,5,42.1,0,3,8,19,2,6,1,2,2,2,10,26,22,29,34.1
2023-24,202403170SAS,3/17/2024,SAS vs BRK,Jeremy Sochan,sochaje01,68,SAS,1,BRK,4,9,4,1,3,3,42.36666667,3,6,1,8,0,2,2,2,2,4,13,8,13,17,29.8
2023-24,202403170SAS,3/17/2024,SAS vs BRK,Devin Vassell,vassede01,62,SAS,1,BRK,25,2,8,0,0,2,44.06666667,0,2,11,21,1,7,2,2,3,0,10,33,27,35,37.4
2023-24,202403160UTA,3/16/2024,UTA vs MIN,Monte Morris,morrimo01,18,MIN,0,UTA,2,0,0,0,0,1,10.35,0,0,1,1,0,0,0,0,0,0,0,2,2,2,1
2023-24,202403160HOU,3/16/2024,HOU vs CLE,Damian Jones,jonesda03,31,CLE,0,HOU,3,6,1,0,1,1,11.08333333,3,3,1,4,0,2,1,1,1,1,7,4,9,10,13.7
2023-24,202403160IND,3/16/2024,IND vs BRK,Dennis Smith Jr.,smithde03,51,BRK,0,IND,4,0,2,0,0,1,11.41666667,0,0,2,4,0,1,0,0,3,0,2,6,4,6,6
2023-24,202403160HOU,3/16/2024,HOU vs CLE,Aaron Holiday,holidaa01,64,HOU,1,CLE,2,1,3,1,0,0,11.58333333,0,1,1,4,0,2,0,0,3,1,4,5,3,6,10.7
2023-24,202403160NOP,3/16/2024,NOP vs POR,Rayan Rupert,ruperra01,24,POR,0,NOP,2,1,0,0,0,2,11.63333333,0,1,0,1,0,0,2,2,1,0,1,2,3,3,1.2
2023-24,202403160SAC,3/16/2024,SAC vs NYK,Miles McBride,mcbrimi01,54,NYK,0,SAC,0,1,0,0,0,0,11.76666667,0,1,0,1,0,1,0,0,1,0,1,0,1,1,1.2
2023-24,202403160LAL,3/16/2024,LAL vs GSW,Anthony Davis,davisan02,65,LAL,1,GSW,8,4,2,1,1,0,11.95,1,3,3,6,0,0,2,2,0,2,6,10,12,14,21.8
2023-24,202403160SAC,3/16/2024,SAC vs NYK,Davion Mitchell,mitchda01,56,SAC,1,NYK,0,1,1,0,0,0,11.96666667,0,1,0,2,0,2,0,0,2,0,2,1,1,2,2.7
2023-24,202403160HOU,3/16/2024,HOU vs CLE,Jae'Sean Tate,tateja01,57,HOU,1,CLE,8,1,0,1,0,0,12.55,0,1,3,6,1,3,1,2,2,1,1,8,9,9,12.2
2023-24,202403160UTA,3/16/2024,UTA vs MIN,Jason Preston,prestja01,3,UTA,1,MIN,2,4,5,0,0,0,12.76666667,1,3,1,3,0,0,0,0,0,0,9,7,6,11,14.3
2023-24,202403160UTA,3/16/2024,UTA vs MIN,Micah Potter,pottemi01,5,UTA,1,MIN,2,3,0,0,0,0,12.9,1,2,0,1,0,0,2,2,0,0,3,2,5,5,5.6
2023-24,202403160PHI,3/16/2024,PHI vs CHO,KJ Martin,martike04,50,PHI,1,CHO,6,3,2,0,0,1,13.06666667,1,2,2,3,1,1,1,1,4,0,5,8,9,11,11.6
2023-24,202403160UTA,3/16/2024,UTA vs MIN,Luka Garza,garzalu01,16,MIN,0,UTA,9,3,0,0,0,0,13.1,1,2,4,9,1,4,0,0,2,0,3,9,12,12,12.6
2023-24,202403160MEM,3/16/2024,MEM vs OKC,Kenrich Williams,willike04,55,OKC,0,MEM,6,3,1,1,1,0,13.13333333,1,2,2,4,2,4,0,0,1,2,4,7,9,10,17.1
2023-24,202403160IND,3/16/2024,IND vs BRK,Lonnie Walker IV,walkelo01,46,BRK,0,IND,2,1,0,0,0,0,13.58333333,0,1,1,4,0,0,0,0,0,0,1,2,3,3,3.2
2023-24,202403160IND,3/16/2024,IND vs BRK,Day'Ron Sharpe,sharpda01,50,BRK,0,IND,3,7,1,1,0,4,13.63333333,3,4,1,1,0,0,1,3,2,1,8,4,10,11,11.9
2023-24,202403160MEM,3/16/2024,MEM vs OKC,Wenyen Gabriel,gabriwe01,5,MEM,1,OKC,2,4,0,0,0,0,14.16666667,1,3,1,4,0,1,0,0,2,0,4,2,6,6,6.8
2023-24,202403160MEM,3/16/2024,MEM vs OKC,Gordon Hayward,haywago01,38,OKC,0,MEM,6,0,1,0,0,0,14.23333333,0,0,2,3,1,1,1,2,0,0,1,7,6,7,7.5
2023-24,202403160CHI,3/16/2024,CHI vs WAS,Johnny Davis,davisjo06,36,WAS,0,CHI,5,0,3,1,0,0,14.8,0,0,2,6,1,3,0,0,1,1,3,8,5,8,12.5
2023-24,202403160CHI,3/16/2024,CHI vs WAS,Andre Drummond,drumman01,68,CHI,1,WAS,13,9,1,0,0,0,14.93333333,4,5,4,5,0,0,5,8,2,0,10,14,22,23,25.3
2023-24,202403160PHI,3/16/2024,PHI vs CHO,Brandon Miller,millebr02,61,CHO,0,PHI,6,2,1,0,1,3,15.33333333,1,1,3,7,0,2,0,0,3,1,3,7,8,9,9.9
2023-24,202403160HOU,3/16/2024,HOU vs CLE,Tristan Thompson,thomptr01,37,CLE,0,HOU,5,5,1,1,0,2,15.48333333,3,2,2,3,0,0,1,2,2,1,6,6,10,11,13.5
2023-24,202403160HOU,3/16/2024,HOU vs CLE,Reggie Bullock,bullore01,29,HOU,1,CLE,3,5,0,0,0,2,15.66666667,0,5,1,2,1,2,0,0,0,0,5,3,8,8,7
2023-24,202403160CHI,3/16/2024,CHI vs WAS,Patrick Baldwin Jr.,baldwpa01,24,WAS,0,CHI,6,1,2,1,0,0,15.96666667,0,1,2,6,2,5,0,0,1,1,3,8,7,9,13.2
2023-24,202403160SAC,3/16/2024,SAC vs NYK,Kevin Huerter,huertke01,63,SAC,1,NYK,0,1,2,1,0,0,15.96666667,0,1,0,3,0,2,0,0,1,1,3,2,1,3,7.2
2023-24,202403160UTA,3/16/2024,UTA vs MIN,Jordan McLaughlin,mclaujo01,41,MIN,0,UTA,3,2,4,0,0,0,15.98333333,1,1,1,2,1,2,0,0,0,0,6,7,5,9,11.4
2023-24,202403160UTA,3/16/2024,UTA vs MIN,T.J. Warren,warretj01,5,MIN,0,UTA,2,4,2,1,0,0,16.03333333,1,3,1,7,0,1,0,0,2,1,6,4,6,8,12.8
2023-24,202403160NOP,3/16/2024,NOP vs POR,Jabari Walker,walkeja01,58,POR,0,NOP,10,5,0,0,0,1,16.86666667,0,5,3,6,2,3,2,2,2,0,5,10,15,15,15
2023-24,202403160HOU,3/16/2024,HOU vs CLE,Jock Landale,landajo01,41,HOU,1,CLE,6,3,0,0,1,0,17.08333333,1,2,3,5,0,2,0,0,2,1,3,6,9,9,12.6
2023-24,202403160CHI,3/16/2024,CHI vs WAS,Eugene Omoruyi,omorueu01,35,WAS,0,CHI,7,2,1,1,1,1,17.38333333,1,1,2,3,0,0,3,6,4,2,3,8,9,10,15.9
2023-24,202403160IND,3/16/2024,IND vs BRK,Obi Toppin,toppiob01,69,IND,1,BRK,6,3,2,1,0,0,17.66666667,2,1,3,5,0,2,0,0,2,1,5,8,9,11,15.6
2023-24,202403160UTA,3/16/2024,UTA vs MIN,Omer Yurtseven,yurtsom01,36,UTA,1,MIN,14,5,0,0,3,1,17.66666667,1,4,6,7,0,0,2,2,3,3,5,14,19,19,28
2023-24,202403160SAC,3/16/2024,SAC vs NYK,Alec Burks,burksal01,58,NYK,0,SAC,12,3,2,0,0,0,18.35,1,2,4,10,2,5,2,2,1,0,5,14,15,17,18.6
2023-24,202403160CHI,3/16/2024,CHI vs WAS,Torrey Craig,craigto01,39,CHI,1,WAS,4,1,2,0,0,1,18.45,1,0,2,5,0,3,0,0,1,0,3,6,5,7,7.2
2023-24,202403160CHI,3/16/2024,CHI vs WAS,Dalen Terry,terryda01,45,CHI,1,WAS,6,5,3,2,0,3,18.66666667,0,5,2,3,1,1,1,2,1,2,8,9,11,14,19.5
2023-24,202403160IND,3/16/2024,IND vs BRK,Jalen Smith,smithja04,48,IND,1,BRK,9,5,0,0,0,0,18.76666667,4,1,4,8,1,3,0,0,3,0,5,9,14,14,15
2023-24,202403160LAL,3/16/2024,LAL vs GSW,Chris Paul,paulch01,42,GSW,0,LAL,8,6,4,0,0,1,18.88333333,1,5,4,7,0,0,0,0,2,0,10,12,14,18,20.2
2023-24,202403160PHI,3/16/2024,PHI vs CHO,Cameron Payne,payneca01,63,PHI,1,CHO,10,0,4,1,0,1,19.06666667,0,0,4,7,2,5,0,0,0,1,4,14,10,14,18
2023-24,202403160CHI,3/16/2024,CHI vs WAS,Jevon Carter,carteje01,64,CHI,1,WAS,2,3,3,0,0,3,19.1,0,3,1,4,0,3,0,0,0,0,6,5,5,8,7.1
2023-24,202403160IND,3/16/2024,IND vs BRK,Trendon Watford,watfotr01,49,BRK,0,IND,12,0,1,2,1,1,19.1,0,0,3,6,0,0,6,7,1,3,1,13,12,13,21.5
2023-24,202403160LAL,3/16/2024,LAL vs GSW,Spencer Dinwiddie,dinwisp01,62,LAL,1,GSW,7,2,0,0,0,0,19.13333333,0,2,2,2,1,1,2,2,2,0,2,7,9,9,9.4
2023-24,202403160MEM,3/16/2024,MEM vs OKC,Josh Giddey,giddejo01,66,OKC,0,MEM,13,6,2,0,0,2,19.2,2,4,6,12,1,6,0,0,1,0,8,15,19,21,21.2
2023-24,202403160NOP,3/16/2024,NOP vs POR,Jonas Valanciunas,valanjo01,67,NOP,1,POR,4,3,5,0,0,2,19.36666667,1,2,2,3,0,1,0,0,2,0,8,9,7,12,13.1
2023-24,202403160PHI,3/16/2024,PHI vs CHO,Paul Reed,reedpa01,67,PHI,1,CHO,11,8,1,0,1,0,19.51666667,5,3,3,9,0,2,5,5,1,1,9,12,19,20,25.1
2023-24,202403160MEM,3/16/2024,MEM vs OKC,Isaiah Joe,joeis01,63,OKC,0,MEM,10,2,1,0,1,0,19.91666667,0,2,4,8,2,5,0,0,2,1,3,11,12,13,16.9
2023-24,202403160PHI,3/16/2024,PHI vs CHO,Buddy Hield,hieldbu01,70,PHI,1,CHO,14,2,2,0,0,1,20.13333333,0,2,6,12,2,6,0,0,1,0,4,16,16,18,18.4
2023-24,202403160SAC,3/16/2024,SAC vs NYK,Precious Achiuwa,achiupr01,60,NYK,0,SAC,2,5,4,0,1,1,20.18333333,1,4,1,2,0,0,0,0,3,1,9,6,7,11,16
2023-24,202403160IND,3/16/2024,IND vs BRK,T.J. McConnell,mccontj01,58,IND,1,BRK,13,5,1,2,0,2,20.4,1,4,6,14,1,1,0,0,4,2,6,14,18,19,24.5
2023-24,202403160PHI,3/16/2024,PHI vs CHO,Aleksej Pokusevski,pokusal01,15,CHO,0,PHI,5,3,2,2,0,0,20.71666667,1,2,2,7,1,3,0,0,2,2,5,7,8,10,17.6
2023-24,202403160NOP,3/16/2024,NOP vs POR,Jeremiah Robinson-Earl,robinje02,29,NOP,1,POR,6,5,6,1,0,0,20.88333333,3,2,3,7,0,2,0,0,3,1,11,12,11,17,24
2023-24,202403160LAL,3/16/2024,LAL vs GSW,Trayce Jackson-Davis,jackstr02,53,GSW,0,LAL,10,3,4,0,2,1,21.35,2,1,4,5,0,0,2,2,2,2,7,14,13,17,24.6
2023-24,202403160UTA,3/16/2024,UTA vs MIN,Johnny Juzang,juzanjo01,8,UTA,1,MIN,8,4,0,0,0,1,21.63333333,0,4,3,5,2,3,0,0,2,0,4,8,12,12,11.8
2023-24,202403160UTA,3/16/2024,UTA vs MIN,Jaden McDaniels,mcdanja02,57,MIN,0,UTA,8,1,0,0,0,1,21.68333333,0,1,4,9,0,2,0,0,5,0,1,8,9,9,8.2
2023-24,202403160CHI,3/16/2024,CHI vs WAS,Jared Butler,butleja02,25,WAS,0,CHI,5,0,1,1,0,3,21.81666667,0,0,2,5,0,1,1,1,2,1,1,6,5,6,6.5
2023-24,202403160CHI,3/16/2024,CHI vs WAS,Jordan Poole,poolejo01,65,WAS,0,CHI,13,0,8,1,0,4,22.51666667,0,0,4,12,3,6,2,2,0,1,8,21,13,21,24
2023-24,202403160NOP,3/16/2024,NOP vs POR,Naji Marshall,marshna01,55,NOP,1,POR,11,5,2,1,0,0,23.08333333,1,4,5,7,1,1,0,0,0,1,7,13,16,18,23
2023-24,202403160MEM,3/16/2024,MEM vs OKC,Jake LaRavia,laravja01,23,MEM,1,OKC,14,4,0,2,0,1,23.51666667,1,3,4,9,2,5,4,4,1,2,4,14,18,18,23.8
2023-24,202403160MEM,3/16/2024,MEM vs OKC,Cason Wallace,wallaca01,67,OKC,0,MEM,4,2,4,3,0,0,23.65,0,2,2,5,0,3,0,0,2,3,6,8,6,10,21.4
2023-24,202403160CHI,3/16/2024,CHI vs WAS,Onuralp Bitim,bitimon01,12,CHI,1,WAS,6,6,2,1,1,0,23.93333333,0,6,3,5,0,2,0,0,3,2,8,8,12,14,22.2
2023-24,202403160SAC,3/16/2024,SAC vs NYK,Bojan Bogdanovic,bogdabo02,42,NYK,0,SAC,9,4,1,0,0,3,24,0,4,4,11,1,5,0,0,2,0,5,10,13,14,12.3
2023-24,202403160IND,3/16/2024,IND vs BRK,Ben Sheppard,sheppbe01,44,IND,1,BRK,11,1,2,1,0,1,24.21666667,0,1,4,7,1,4,2,2,0,1,3,13,12,14,17.2
2023-24,202403160NOP,3/16/2024,NOP vs POR,Scoot Henderson,hendesc01,48,POR,0,NOP,11,2,2,2,1,3,24.25,0,2,5,8,0,2,1,1,2,3,4,13,13,15,22.4
2023-24,202403160UTA,3/16/2024,UTA vs MIN,Kris Dunn,dunnkr01,58,UTA,1,MIN,4,3,3,2,0,0,24.28333333,1,2,2,7,0,1,0,0,1,2,6,7,7,10,18.1
2023-24,202403160MEM,3/16/2024,MEM vs OKC,John Konchar,konchjo01,52,MEM,1,OKC,9,2,3,1,0,2,24.53333333,2,0,3,5,1,2,2,3,1,1,5,12,11,14,16.9
2023-24,202403160IND,3/16/2024,IND vs BRK,Myles Turner,turnemy01,65,IND,1,BRK,11,7,1,1,0,0,24.71666667,3,4,5,10,0,2,1,1,3,1,8,12,18,19,23.9
2023-24,202403160CHI,3/16/2024,CHI vs WAS,Justin Champagnie,champju01,5,WAS,0,CHI,11,7,3,1,3,2,25.03333333,2,5,4,9,3,6,0,0,2,4,10,14,18,21,33.9
2023-24,202403160IND,3/16/2024,IND vs BRK,Nic Claxton,claxtni01,57,BRK,0,IND,9,10,1,1,2,0,25.16666667,2,8,4,6,0,0,1,3,2,3,11,10,19,20,31.5
2023-24,202403160HOU,3/16/2024,HOU vs CLE,Donovan Mitchell,mitchdo01,49,CLE,0,HOU,13,3,2,1,0,2,25.73333333,0,3,4,13,3,8,2,2,0,1,5,15,16,18,20.6
2023-24,202403160HOU,3/16/2024,HOU vs CLE,Jeff Green,greenje02,63,HOU,1,CLE,9,4,1,1,0,1,25.81666667,0,4,4,8,1,4,0,0,1,1,5,10,13,14,17.3
2023-24,202403160IND,3/16/2024,IND vs BRK,Aaron Nesmith,nesmiaa01,60,IND,1,BRK,16,4,3,2,2,0,25.88333333,2,2,5,8,1,2,5,5,3,4,7,19,20,23,37.3
2023-24,202403160HOU,3/16/2024,HOU vs CLE,Dillon Brooks,brookdi01,58,HOU,1,CLE,12,3,2,2,0,1,25.96666667,1,2,5,12,2,6,0,0,4,2,5,14,15,17,23.6
2023-24,202403160IND,3/16/2024,IND vs BRK,Dorian Finney-Smith,finnedo01,58,BRK,0,IND,12,4,0,1,0,0,25.96666667,1,3,5,5,2,2,0,0,4,1,4,12,16,16,19.8
2023-24,202403160CHI,3/16/2024,CHI vs WAS,Richaun Holmes,holmeri01,34,WAS,0,CHI,7,4,1,1,0,0,26.01666667,1,3,3,8,0,1,1,2,5,1,5,8,11,12,16.3
2023-24,202403160HOU,3/16/2024,HOU vs CLE,Amen Thompson,thompam01,48,HOU,1,CLE,18,8,0,1,0,1,26.03333333,3,5,8,11,0,0,2,3,3,1,8,18,26,26,29.6
2023-24,202403160NOP,3/16/2024,NOP vs POR,Kris Murray,murrakr01,47,POR,0,NOP,0,5,4,0,1,0,26.21666667,1,4,0,4,0,2,0,0,3,1,9,4,5,9,15
2023-24,202403160HOU,3/16/2024,HOU vs CLE,Jarrett Allen,allenja01,62,CLE,0,HOU,10,7,0,0,3,3,26.4,0,7,4,7,0,0,2,2,2,3,7,10,17,17,24.4
2023-24,202403160UTA,3/16/2024,UTA vs MIN,Nickeil Alexander-Walker,alexani01,67,MIN,0,UTA,8,5,2,0,0,2,26.55,1,4,3,7,2,5,0,0,1,0,7,10,13,15,15
2023-24,202403160IND,3/16/2024,IND vs BRK,Cameron Johnson,johnsca02,51,BRK,0,IND,14,4,2,2,0,2,26.65,1,3,4,11,3,7,3,4,0,2,6,16,18,20,25.8
2023-24,202403160UTA,3/16/2024,UTA vs MIN,Brice Sensabaugh,sensabr01,17,UTA,1,MIN,8,7,2,0,0,3,26.8,2,5,4,12,0,5,0,0,1,0,9,10,15,17,16.4
2023-24,202403160PHI,3/16/2024,PHI vs CHO,Grant Williams,willigr01,64,CHO,0,PHI,14,3,1,1,1,2,27.06666667,2,1,6,10,2,4,0,0,4,2,4,15,17,18,23.1
2023-24,202403160IND,3/16/2024,IND vs BRK,Pascal Siakam,siakapa01,66,IND,1,BRK,28,11,4,3,0,2,27.75,4,7,11,22,0,1,6,6,3,3,15,32,39,43,54.2
2023-24,202403160SAC,3/16/2024,SAC vs NYK,Isaiah Hartenstein,harteis01,61,NYK,0,SAC,7,14,3,1,4,1,27.81666667,4,10,3,3,0,0,1,1,3,5,17,10,21,24,42.3
2023-24,202403160LAL,3/16/2024,LAL vs GSW,Jaxson Hayes,hayesja02,58,LAL,1,GSW,7,12,0,0,0,2,28.03333333,2,10,3,5,0,0,1,3,3,0,12,7,19,19,19.4
2023-24,202403160HOU,3/16/2024,HOU vs CLE,Sam Merrill,merrisa01,49,CLE,0,HOU,11,8,2,0,1,1,28.08333333,0,8,3,5,3,5,2,2,0,1,10,13,19,21,25.6
2023-24,202403160SAC,3/16/2024,SAC vs NYK,Malik Monk,monkma01,65,SAC,1,NYK,18,3,4,0,0,2,28.3,1,2,6,14,3,9,3,3,4,0,7,22,21,25,25.6
2023-24,202403160PHI,3/16/2024,PHI vs CHO,Mo Bamba,bambamo01,45,PHI,1,CHO,3,8,0,1,1,3,28.48333333,0,8,1,2,1,2,0,0,4,2,8,3,11,11,15.6
2023-24,202403160HOU,3/16/2024,HOU vs CLE,Georges Niang,niangge01,67,CLE,0,HOU,14,5,2,0,0,2,28.76666667,0,5,4,8,2,5,4,4,1,0,7,16,19,21,21
2023-24,202403160PHI,3/16/2024,PHI vs CHO,Kyle Lowry,lowryky01,48,PHI,1,CHO,5,6,7,3,0,1,28.88333333,0,6,1,5,1,5,2,2,4,3,13,12,11,18,30.7
2023-24,202403160CHI,3/16/2024,CHI vs WAS,Corey Kispert,kispeco01,65,WAS,0,CHI,16,3,1,3,3,0,28.9,0,3,6,12,3,6,1,1,1,6,4,17,19,20,39.1
2023-24,202403160CHI,3/16/2024,CHI vs WAS,Kyle Kuzma,kuzmaky01,65,WAS,0,CHI,11,5,4,1,0,3,28.95,1,4,5,10,0,0,1,2,2,1,9,15,16,20,23
2023-24,202403160IND,3/16/2024,IND vs BRK,Mikal Bridges,bridgmi01,67,BRK,0,IND,7,7,4,0,0,1,29.26666667,3,4,1,8,1,4,4,4,0,0,11,11,14,18,20.4
2023-24,202403160SAC,3/16/2024,SAC vs NYK,Keon Ellis,elliske01,41,SAC,1,NYK,5,3,0,2,1,0,29.31666667,0,3,2,4,1,2,0,0,4,3,3,5,8,8,17.6
2023-24,202403160LAL,3/16/2024,LAL vs GSW,Rui Hachimura,hachiru01,55,LAL,1,GSW,14,4,2,0,1,0,29.51666667,0,4,7,10,0,2,0,0,3,1,6,16,18,20,24.8
2023-24,202403160LAL,3/16/2024,LAL vs GSW,Klay Thompson,thompkl01,63,GSW,0,LAL,26,4,3,0,0,0,29.55,1,3,9,15,5,10,3,3,1,0,7,29,30,33,35.3
2023-24,202403160SAC,3/16/2024,SAC vs NYK,Donte DiVincenzo,divindo01,66,NYK,0,SAC,15,2,2,1,0,0,29.65,1,1,5,16,3,12,2,3,4,1,4,17,17,19,23.4
2023-24,202403160LAL,3/16/2024,LAL vs GSW,Taurean Prince,princta02,66,LAL,1,GSW,8,2,3,0,1,0,29.66666667,1,1,3,8,2,5,0,0,1,1,5,11,10,13,17.9
2023-24,202403160PHI,3/16/2024,PHI vs CHO,Nick Richards,richani01,58,CHO,0,PHI,11,11,0,1,1,1,29.68333333,3,8,4,5,0,0,3,3,3,2,11,11,22,22,29.2
2023-24,202403160LAL,3/16/2024,LAL vs GSW,Andrew Wiggins,wiggian01,57,GSW,0,LAL,16,6,1,0,1,0,29.68333333,3,3,7,17,2,6,0,0,3,1,7,17,22,23,27.7
2023-24,202403160UTA,3/16/2024,UTA vs MIN,Keyonte George,georgke01,60,UTA,1,MIN,18,3,2,0,0,4,29.81666667,0,3,5,16,1,7,7,8,2,0,5,20,21,23,20.6
2023-24,202403160UTA,3/16/2024,UTA vs MIN,Mike Conley,conlemi01,62,MIN,0,UTA,25,2,2,0,0,0,30.2,1,1,8,12,5,8,4,5,1,0,4,27,27,29,30.4
2023-24,202403160UTA,3/16/2024,UTA vs MIN,Walker Kessler,kesslwa01,55,UTA,1,MIN,7,10,0,0,1,0,30.33333333,2,8,3,4,0,0,1,2,2,1,10,7,17,17,22
2023-24,202403160CHI,3/16/2024,CHI vs WAS,Bilal Coulibaly,coulibi01,63,WAS,0,CHI,15,8,2,1,0,2,30.35,2,6,5,9,1,3,4,8,3,1,10,17,23,25,28.6
2023-24,202403160MEM,3/16/2024,MEM vs OKC,Luke Kennard,kennalu01,36,MEM,1,OKC,9,3,9,1,0,2,30.38333333,0,3,3,7,3,7,0,0,2,1,12,18,12,21,27.1
2023-24,202403160UTA,3/16/2024,UTA vs MIN,Collin Sexton,sextoco01,67,UTA,1,MIN,22,2,10,1,0,5,30.6,1,1,9,16,1,3,3,3,2,1,12,32,24,34,37.4
2023-24,202403160NOP,3/16/2024,NOP vs POR,Jose Alvarado,alvarjo01,46,NOP,1,POR,7,1,4,2,0,1,30.68333333,0,1,2,7,1,2,2,2,3,2,5,11,8,12,19.2
2023-24,202403160IND,3/16/2024,IND vs BRK,Dennis Schroder,schrode01,67,BRK,0,IND,13,2,5,1,0,4,30.68333333,0,2,4,13,2,4,3,4,1,1,7,18,15,20,21.9
2023-24,202403160CHI,3/16/2024,CHI vs WAS,Nikola Vucevic,vucevni01,63,CHI,1,WAS,29,13,2,1,0,3,30.68333333,4,9,11,19,1,3,6,6,2,1,15,31,42,44,47.6
2023-24,202403160IND,3/16/2024,IND vs BRK,Tyrese Haliburton,halibty01,56,IND,1,BRK,14,7,4,2,1,2,30.73333333,0,7,6,18,1,9,1,1,0,3,11,18,21,25,35.4
2023-24,202403160PHI,3/16/2024,PHI vs CHO,Davis Bertans,bertada01,30,CHO,0,PHI,16,1,1,1,0,0,30.78333333,0,1,5,8,2,5,4,4,4,1,2,17,17,18,21.7
2023-24,202403160MEM,3/16/2024,MEM vs OKC,Luguentz Dort,dortlu01,65,OKC,0,MEM,12,5,4,0,0,2,30.93333333,2,3,3,6,2,5,4,4,5,0,9,16,17,21,22
2023-24,202403160LAL,3/16/2024,LAL vs GSW,Jonathan Kuminga,kuminjo01,65,GSW,0,LAL,23,2,4,0,0,1,31.13333333,0,2,9,16,2,3,3,5,5,0,6,27,25,29,30.4
2023-24,202403160UTA,3/16/2024,UTA vs MIN,Kyle Anderson,anderky01,64,MIN,0,UTA,4,5,9,2,1,0,31.2,1,4,1,6,0,0,2,2,3,3,14,13,9,18,32.5
2023-24,202403160MEM,3/16/2024,MEM vs OKC,Chet Holmgren,holmgch01,67,OKC,0,MEM,22,11,2,1,3,1,31.58333333,1,10,8,13,2,4,4,4,2,4,13,24,33,35,49.2
2023-24,202403160MEM,3/16/2024,MEM vs OKC,Desmond Bane,banede01,38,MEM,1,OKC,22,3,7,0,1,3,31.8,1,2,7,17,4,9,4,6,4,1,10,29,25,32,36.1
2023-24,202403160HOU,3/16/2024,HOU vs CLE,Caris LeVert,leverca01,55,CLE,0,HOU,21,3,7,3,1,1,31.96666667,1,2,8,14,1,4,4,5,3,4,10,28,24,31,46.1
2023-24,202403160IND,3/16/2024,IND vs BRK,Cam Thomas,thomaca02,52,BRK,0,IND,22,8,2,0,0,5,31.98333333,2,6,7,16,2,6,6,6,3,0,10,24,30,32,29.6
2023-24,202403160IND,3/16/2024,IND vs BRK,Andrew Nembhard,nembhan01,54,IND,1,BRK,7,2,3,1,0,1,32.13333333,0,2,3,5,1,3,0,1,3,1,5,10,9,12,15.9
2023-24,202403160HOU,3/16/2024,HOU vs CLE,Jabari Smith Jr.,smithja05,62,HOU,1,CLE,20,7,2,1,3,2,32.33333333,3,4,8,13,3,5,1,1,3,4,9,22,27,29,41.4
2023-24,202403160SAC,3/16/2024,SAC vs NYK,OG Anunoby,anunoog01,44,NYK,0,SAC,2,6,2,1,3,3,33.1,1,5,1,8,0,4,0,0,2,4,8,4,8,10,21.2
2023-24,202403160HOU,3/16/2024,HOU vs CLE,Darius Garland,garlada01,43,CLE,0,HOU,12,5,4,1,0,0,33.2,0,5,5,13,1,6,1,2,0,1,9,16,17,21,27
2023-24,202403160UTA,3/16/2024,UTA vs MIN,Taylor Hendricks,hendrita0,25,UTA,1,MIN,15,10,1,1,1,1,33.2,1,9,5,12,2,7,3,4,1,2,11,16,25,26,33.5
2023-24,202403160HOU,3/16/2024,HOU vs CLE,Jalen Green,greenja05,67,HOU,1,CLE,26,11,4,1,2,1,33.3,2,9,9,20,4,9,4,6,0,3,15,30,37,41,53.2
2023-24,202403160PHI,3/16/2024,PHI vs CHO,Vasilije Micic,micicva01,47,CHO,0,PHI,11,2,4,1,1,5,33.41666667,0,2,5,12,1,4,0,0,1,2,6,15,13,17,20.4
2023-24,202403160HOU,3/16/2024,HOU vs CLE,Isaac Okoro,okorois01,58,CLE,0,HOU,10,2,1,0,1,1,33.45,0,2,4,12,2,7,0,0,3,1,3,11,12,13,15.9
2023-24,202403160SAC,3/16/2024,SAC vs NYK,Keegan Murray,murrake02,61,SAC,1,NYK,11,6,1,0,1,0,33.51666667,1,5,3,12,1,7,4,4,3,1,7,12,17,18,22.7
2023-24,202403160NOP,3/16/2024,NOP vs POR,Toumani Camara,camarto01,64,POR,0,NOP,11,6,1,0,2,1,33.6,3,3,5,12,1,5,0,0,3,2,7,12,17,18,24.7
2023-24,202403160PHI,3/16/2024,PHI vs CHO,Kelly Oubre Jr.,oubreke01,54,PHI,1,CHO,22,3,1,1,0,4,33.65,1,2,8,16,1,5,5,5,4,1,4,23,25,26,26.1
2023-24,202403160NOP,3/16/2024,NOP vs POR,Zion Williamson,willizi01,56,NOP,1,POR,26,10,3,1,1,3,33.85,2,8,11,17,0,0,4,5,2,2,13,29,36,39,45.5
2023-24,202403160LAL,3/16/2024,LAL vs GSW,Stephen Curry,curryst01,60,GSW,0,LAL,31,6,5,2,0,1,33.86666667,1,5,12,24,3,10,4,5,0,2,11,36,37,42,50.7
2023-24,202403160CHI,3/16/2024,CHI vs WAS,Alex Caruso,carusal01,59,CHI,1,WAS,16,5,5,2,1,3,34.2,1,4,7,12,2,4,0,0,2,3,10,21,21,26,35.5
2023-24,202403160LAL,3/16/2024,LAL vs GSW,Draymond Green,greendr01,41,GSW,0,LAL,6,12,13,1,0,2,34.25,2,10,3,6,0,2,0,0,3,1,25,19,18,31,40.9
2023-24,202403160LAL,3/16/2024,LAL vs GSW,Austin Reaves,reaveau01,69,LAL,1,GSW,11,3,3,0,0,3,34.35,0,3,4,13,2,9,1,1,0,0,6,14,14,17,16.1
2023-24,202403160NOP,3/16/2024,NOP vs POR,Trey Murphy III,murphtr02,42,NOP,1,POR,20,6,5,0,0,0,34.61666667,1,5,7,13,4,8,2,2,0,0,11,25,26,31,34.7
2023-24,202403160LAL,3/16/2024,LAL vs GSW,Brandin Podziemski,podzibr01,58,GSW,0,LAL,5,5,3,0,0,1,34.75,3,2,2,4,1,2,0,0,1,0,8,8,10,13,14.5
2023-24,202403160CHI,3/16/2024,CHI vs WAS,DeMar DeRozan,derozde01,66,CHI,1,WAS,13,4,6,2,2,1,34.88333333,0,4,3,7,0,1,7,11,3,4,10,19,17,23,37.8
2023-24,202403160UTA,3/16/2024,UTA vs MIN,Naz Reid,reidna01,67,MIN,0,UTA,22,12,5,2,2,0,34.9,0,12,7,18,4,11,4,5,1,4,17,27,34,39,55.9
2023-24,202403160MEM,3/16/2024,MEM vs OKC,Shai Gilgeous-Alexander,gilgesh01,66,OKC,0,MEM,20,7,3,0,1,3,35.05,1,6,8,16,1,4,3,6,2,1,10,23,27,30,32.9
2023-24,202403160UTA,3/16/2024,UTA vs MIN,Anthony Edwards,edwaran01,64,MIN,0,UTA,31,10,5,3,3,4,35.2,1,9,12,20,5,7,2,3,1,6,15,36,41,46,64.5
2023-24,202403160MEM,3/16/2024,MEM vs OKC,Jalen Williams,willija06,60,OKC,0,MEM,23,7,6,1,2,2,35.23333333,1,6,9,17,1,3,4,5,2,3,13,29,30,36,47.4
2023-24,202403160MEM,3/16/2024,MEM vs OKC,GG Jackson II,jacksgg01,34,MEM,1,OKC,19,4,4,0,1,0,35.31666667,1,3,5,14,2,8,7,8,1,1,8,23,23,27,32.8
2023-24,202403160NOP,3/16/2024,NOP vs POR,Brandon Ingram,ingrabr01,61,NOP,1,POR,22,7,2,1,4,1,35.33333333,2,5,10,21,1,5,1,1,2,5,9,24,29,31,47.4
2023-24,202403160HOU,3/16/2024,HOU vs CLE,Fred VanVleet,vanvlfr01,60,HOU,1,CLE,13,5,16,1,1,1,35.43333333,1,4,5,15,3,8,0,0,0,2,21,29,18,34,48
2023-24,202403160NOP,3/16/2024,NOP vs POR,Anfernee Simons,simonan01,43,POR,0,NOP,25,4,8,0,0,5,35.78333333,0,4,9,18,5,10,2,2,1,0,12,33,29,37,36.8
2023-24,202403160MEM,3/16/2024,MEM vs OKC,Jaren Jackson Jr.,jacksja02,58,MEM,1,OKC,19,6,7,2,1,5,36.2,0,6,7,11,3,4,2,2,4,3,13,26,25,32,40.7
2023-24,202403160SAC,3/16/2024,SAC vs NYK,Jalen Brunson,brunsja01,62,NYK,0,SAC,42,4,2,4,1,6,36.23333333,1,3,17,28,5,10,3,4,1,5,6,44,46,48,58.8
2023-24,202403160SAC,3/16/2024,SAC vs NYK,Harrison Barnes,barneha02,66,SAC,1,NYK,16,6,3,1,0,2,36.36666667,4,2,5,13,2,7,4,4,1,1,9,19,22,25,28.7
2023-24,202403160SAC,3/16/2024,SAC vs NYK,De'Aaron Fox,foxde01,58,SAC,1,NYK,20,7,9,2,0,3,36.45,1,6,5,19,2,7,8,10,4,2,16,29,27,36,44.9
2023-24,202403160NOP,3/16/2024,NOP vs POR,CJ McCollum,mccolcj01,51,NOP,1,POR,30,2,8,2,0,2,36.71666667,0,2,12,20,6,12,0,0,1,2,10,38,32,40,48.4
2023-24,202403160PHI,3/16/2024,PHI vs CHO,Nicolas Batum,batumni01,46,PHI,1,CHO,8,8,4,3,2,2,36.96666667,3,5,3,7,2,6,0,0,3,5,12,12,16,20,36.6
2023-24,202403160PHI,3/16/2024,PHI vs CHO,Tre Mann,manntr01,27,CHO,0,PHI,21,8,6,4,0,2,36.98333333,3,5,7,16,3,6,4,7,3,4,14,27,29,35,49.6
2023-24,202403160LAL,3/16/2024,LAL vs GSW,LeBron James,jamesle01,60,LAL,1,GSW,40,8,9,1,1,4,37.7,3,5,15,23,3,5,7,8,1,2,17,49,48,57,65.1
2023-24,202403160NOP,3/16/2024,NOP vs POR,Deandre Ayton,aytonde01,45,POR,0,NOP,20,8,2,1,1,2,37.96666667,4,4,10,13,0,1,0,1,2,2,10,22,28,30,36.6
2023-24,202403160SAC,3/16/2024,SAC vs NYK,Josh Hart,hartjo01,66,NYK,0,SAC,9,13,3,1,0,0,38.9,1,12,2,7,0,2,5,6,4,1,16,12,22,25,32.1
2023-24,202403160MEM,3/16/2024,MEM vs OKC,Santi Aldama,aldamsa01,55,MEM,1,OKC,16,6,4,1,1,0,38.98333333,1,5,6,12,3,7,1,3,4,2,10,20,22,26,35.2
2023-24,202403160PHI,3/16/2024,PHI vs CHO,Miles Bridges,bridgmi02,57,CHO,0,PHI,14,9,6,1,0,3,39.25,2,7,5,15,1,6,3,4,0,1,15,20,23,29,33.8
2023-24,202403160LAL,3/16/2024,LAL vs GSW,D'Angelo Russell,russeda01,64,LAL,1,GSW,23,3,13,1,0,0,40.15,1,2,9,21,3,10,2,2,2,1,16,36,26,39,49.1
2023-24,202403160SAC,3/16/2024,SAC vs NYK,Domantas Sabonis,sabondo01,66,SAC,1,NYK,21,14,2,1,0,5,40.18333333,3,11,9,16,1,1,2,5,1,1,16,23,35,37,38.8
2023-24,202403160PHI,3/16/2024,PHI vs CHO,Tyrese Maxey,maxeyty01,58,PHI,1,CHO,30,3,4,0,0,2,40.23333333,0,3,8,20,3,9,11,12,2,0,7,34,33,37,37.6
2023-24,202403160CHI,3/16/2024,CHI vs WAS,Ayo Dosunmu,dosunay01,66,CHI,1,WAS,34,3,9,1,0,1,40.5,1,2,14,22,4,7,2,2,2,1,12,43,37,46,53.1
2023-24,202403160NOP,3/16/2024,NOP vs POR,Dalano Banton,bantoda01,40,POR,0,NOP,28,5,6,0,2,5,41.91666667,2,3,10,20,4,8,4,4,0,2,11,34,33,39,44
2023-24,202403150DET,3/15/2024,DET vs MIA,Stanley Umude,umudest01,21,DET,1,MIA,0,0,0,1,0,1,10.66666667,0,0,0,4,0,4,0,0,1,1,0,0,0,0,2
2023-24,202403150SAS,3/15/2024,SAS vs DEN,Malaki Branham,branhma01,62,SAS,1,DEN,2,0,0,0,0,0,11.7,0,0,1,5,0,2,0,0,0,0,0,2,2,2,2
2023-24,202403150UTA,3/15/2024,UTA vs ATL,Jason Preston,prestja01,2,UTA,1,ATL,2,2,2,0,0,1,12.26666667,1,1,1,3,0,0,0,0,1,0,4,4,4,6,6.4
2023-24,202403150TOR,3/15/2024,TOR vs ORL,Moritz Wagner,wagnemo01,65,ORL,0,TOR,7,3,0,1,0,1,12.28333333,0,3,3,5,1,2,0,0,0,1,3,7,10,10,12.6
2023-24,202403150SAS,3/15/2024,SAS vs DEN,Dominick Barlow,barlodo01,29,SAS,1,DEN,6,6,1,0,0,1,12.66666667,2,4,3,3,0,0,0,0,1,0,7,7,12,13,13.7
2023-24,202403150DET,3/15/2024,DET vs MIA,James Wiseman,wisemja01,47,DET,1,MIA,6,7,1,0,0,0,13.21666667,1,6,3,6,0,0,0,0,1,0,8,7,13,14,15.9
2023-24,202403150SAS,3/15/2024,SAS vs DEN,Reggie Jackson,jacksre01,67,DEN,0,SAS,7,1,3,0,0,1,14.01666667,0,1,3,8,1,2,0,0,1,0,4,10,8,11,11.7
2023-24,202403150NOP,3/15/2024,NOP vs LAC,Naji Marshall,marshna01,54,NOP,1,LAC,8,2,1,1,0,0,14.15,0,2,3,8,2,5,0,0,3,1,3,9,10,11,14.9
2023-24,202403150UTA,3/15/2024,UTA vs ATL,Micah Potter,pottemi01,4,UTA,1,ATL,11,2,1,0,0,0,14.18333333,1,1,4,4,2,2,1,1,1,0,3,12,13,14,14.9
2023-24,202403150NOP,3/15/2024,NOP vs LAC,Jose Alvarado,alvarjo01,45,NOP,1,LAC,9,0,0,1,0,0,14.65,0,0,3,5,3,5,0,0,3,1,0,9,9,9,12
2023-24,202403150CHO,3/15/2024,CHO vs PHO,Drew Eubanks,eubandr01,61,PHO,0,CHO,6,8,0,0,0,1,14.78333333,2,6,3,4,0,0,0,0,2,0,8,6,14,14,14.6
2023-24,202403150SAS,3/15/2024,SAS vs DEN,Zach Collins,colliza01,55,SAS,1,DEN,13,6,0,0,0,2,14.81666667,0,6,5,8,1,1,2,2,1,0,6,13,19,19,18.2
2023-24,202403150CHO,3/15/2024,CHO vs PHO,Royce O'Neale,onealro01,64,PHO,0,CHO,5,3,1,0,0,0,14.81666667,0,3,2,2,1,1,0,0,1,0,4,6,8,9,10.1
2023-24,202403150DET,3/15/2024,DET vs MIA,Patty Mills,millspa02,23,MIA,0,DET,0,0,2,2,0,2,15.06666667,0,0,0,4,0,3,0,0,1,2,2,2,0,2,7
2023-24,202403150SAS,3/15/2024,SAS vs DEN,Blake Wesley,weslebl01,46,SAS,1,DEN,5,1,2,0,0,0,15.06666667,1,0,1,4,0,0,3,4,1,0,3,7,6,8,9.2
2023-24,202403150TOR,3/15/2024,TOR vs ORL,Joe Ingles,inglejo01,53,ORL,0,TOR,5,1,5,0,0,1,15.28333333,0,1,1,2,1,2,2,2,1,0,6,10,6,11,12.7
2023-24,202403150DET,3/15/2024,DET vs MIA,Nikola Jovic,jovicni01,32,MIA,0,DET,7,5,0,1,0,1,15.28333333,0,5,3,6,1,3,0,0,4,1,5,7,12,12,15
2023-24,202403150DET,3/15/2024,DET vs MIA,Evan Fournier,fournev01,17,DET,1,MIA,12,1,3,1,0,0,15.71666667,0,1,4,8,1,5,3,3,1,1,4,15,13,16,20.7
2023-24,202403150UTA,3/15/2024,UTA vs ATL,Bruno Fernando,fernabr01,29,ATL,0,UTA,2,5,2,2,0,0,15.98333333,1,4,1,1,0,0,0,0,3,2,7,4,7,9,17
2023-24,202403150CHO,3/15/2024,CHO vs PHO,Aleksej Pokusevski,pokusal01,14,CHO,1,PHO,4,5,3,1,1,0,16.28333333,2,3,2,9,0,4,0,0,1,2,8,7,9,12,20.5
2023-24,202403150TOR,3/15/2024,TOR vs ORL,Jordan Nwora,nworajo01,38,TOR,1,ORL,14,5,0,2,1,4,16.33333333,0,5,5,8,3,5,1,1,0,3,5,14,19,19,25
2023-24,202403150SAS,3/15/2024,SAS vs DEN,Zeke Nnaji,nnajize01,52,DEN,0,SAS,4,4,2,0,3,0,16.4,1,3,2,2,0,0,0,0,1,3,6,6,8,10,20.8
2023-24,202403150UTA,3/15/2024,UTA vs ATL,Wesley Matthews,matthwe02,26,ATL,0,UTA,13,3,1,0,1,0,16.71666667,0,3,4,5,3,3,2,2,1,1,4,14,16,17,21.1
2023-24,202403150DET,3/15/2024,DET vs MIA,Thomas Bryant,bryanth01,29,MIA,0,DET,11,5,0,0,1,0,17.16666667,1,4,5,8,0,2,1,1,0,1,5,11,16,16,20
2023-24,202403150TOR,3/15/2024,TOR vs ORL,Markelle Fultz,fultzma01,29,ORL,0,TOR,6,0,2,0,1,0,17.43333333,0,0,3,8,0,0,0,0,1,1,2,8,6,8,12
2023-24,202403150NOP,3/15/2024,NOP vs LAC,Terance Mann,mannte01,60,LAC,0,NOP,9,4,0,1,0,1,17.81666667,1,3,3,5,1,1,2,2,1,1,4,9,13,13,15.8
2023-24,202403150NOP,3/15/2024,NOP vs LAC,Jonas Valanciunas,valanjo01,66,NOP,1,LAC,4,6,0,0,0,0,18.15,2,4,1,6,0,1,2,2,3,0,6,4,10,10,11.2
2023-24,202403150TOR,3/15/2024,TOR vs ORL,Jahmi'us Ramsey,ramseja01,3,TOR,1,ORL,10,5,1,1,0,0,18.21666667,1,4,3,5,1,2,3,4,2,1,6,11,15,16,20.5
2023-24,202403150UTA,3/15/2024,UTA vs ATL,Talen Horton-Tucker,hortota01,43,UTA,1,ATL,5,0,5,1,1,1,19,0,0,1,6,1,4,2,2,1,2,5,10,5,10,17.5
2023-24,202403150UTA,3/15/2024,UTA vs ATL,Trent Forrest,forretr01,28,ATL,0,UTA,0,2,4,0,1,0,19.11666667,0,2,0,1,0,0,0,0,1,1,6,4,2,6,11.4
2023-24,202403150UTA,3/15/2024,UTA vs ATL,Taylor Hendricks,hendrita0,24,UTA,1,ATL,3,10,0,0,3,0,19.4,2,8,1,7,0,3,1,2,5,3,10,3,13,13,24
2023-24,202403150TOR,3/15/2024,TOR vs ORL,Jonathan Isaac,isaacjo01,46,ORL,0,TOR,10,6,0,0,2,0,20.35,0,6,4,7,2,4,0,0,1,2,6,10,16,16,23.2
2023-24,202403150SAS,3/15/2024,SAS vs DEN,Justin Holiday,holidju01,43,DEN,0,SAS,13,1,2,2,0,0,21.16666667,0,1,5,9,3,6,0,0,2,2,3,15,14,16,23.2
2023-24,202403150NOP,3/15/2024,NOP vs LAC,Amir Coffey,coffeam01,54,LAC,0,NOP,8,3,3,0,0,2,21.56666667,0,3,3,5,2,4,0,0,2,0,6,11,11,14,14.1
2023-24,202403150UTA,3/15/2024,UTA vs ATL,Garrison Mathews,mathega01,50,ATL,0,UTA,9,3,4,1,1,0,21.7,0,3,3,5,3,4,0,0,2,2,7,13,12,16,24.6
2023-24,202403150TOR,3/15/2024,TOR vs ORL,Cole Anthony,anthoco01,66,ORL,0,TOR,12,3,0,0,0,1,22.06666667,1,2,4,7,2,3,2,2,1,0,3,12,15,15,14.6
2023-24,202403150TOR,3/15/2024,TOR vs ORL,Gradey Dick,dickgr01,46,TOR,1,ORL,8,2,1,0,1,1,22.73333333,1,1,3,9,0,3,2,2,3,1,3,9,10,11,13.9
2023-24,202403150SAS,3/15/2024,SAS vs DEN,Peyton Watson,watsope01,65,DEN,0,SAS,10,3,2,0,0,1,22.9,1,2,5,11,0,3,0,1,4,0,5,12,13,15,15.6
2023-24,202403150SAS,3/15/2024,SAS vs DEN,Michael Porter Jr.,portemi01,66,DEN,0,SAS,13,7,1,1,0,0,23.01666667,0,7,5,9,2,5,1,1,1,1,8,14,20,21,25.9
2023-24,202403150DET,3/15/2024,DET vs MIA,Marcus Sasser,sassema01,57,DET,1,MIA,3,2,2,1,0,3,23.81666667,0,2,1,6,1,6,0,0,2,1,4,5,5,7,8.4
2023-24,202403150NOP,3/15/2024,NOP vs LAC,P.J. Tucker,tuckepj01,20,LAC,0,NOP,6,2,0,0,3,1,24.13333333,0,2,2,3,2,3,0,0,2,3,2,6,8,8,16.4
2023-24,202403150NOP,3/15/2024,NOP vs LAC,Bones Hyland,hylanbo01,28,LAC,0,NOP,5,2,4,2,1,2,24.16666667,1,1,2,9,1,6,0,0,1,3,6,9,7,11,20.4
2023-24,202403150SAS,3/15/2024,SAS vs DEN,Christian Braun,braunch01,67,DEN,0,SAS,13,4,4,3,0,1,24.28333333,1,3,5,7,2,3,1,2,1,3,8,17,17,21,31.8
2023-24,202403150TOR,3/15/2024,TOR vs ORL,Gary Harris,harriga01,43,ORL,0,TOR,6,1,0,0,1,0,25.01666667,0,1,2,7,2,5,0,0,3,1,1,6,7,7,10.2
2023-24,202403150SAS,3/15/2024,SAS vs DEN,Aaron Gordon,gordoaa01,61,DEN,0,SAS,7,3,7,0,0,1,25.1,1,2,3,3,0,0,1,2,2,0,10,14,10,17,20.1
2023-24,202403150UTA,3/15/2024,UTA vs ATL,Johnny Juzang,juzanjo01,7,UTA,1,ATL,19,3,0,0,0,1,25.21666667,0,3,7,11,5,8,0,0,1,0,3,19,22,22,21.6
2023-24,202403150CHO,3/15/2024,CHO vs PHO,Eric Gordon,gordoer01,54,PHO,0,CHO,14,1,2,0,0,0,25.75,0,1,5,9,4,8,0,0,4,0,3,16,15,17,18.2
2023-24,202403150DET,3/15/2024,DET vs MIA,Jaime Jaquez Jr.,jaqueja01,60,MIA,0,DET,2,5,4,1,0,0,25.9,0,5,1,5,0,2,0,0,5,1,9,6,7,11,17
2023-24,202403150CHO,3/15/2024,CHO vs PHO,Davis Bertans,bertada01,29,CHO,1,PHO,2,2,2,1,0,1,25.98333333,0,2,1,5,0,4,0,0,2,1,4,4,4,6,9.4
2023-24,202403150SAS,3/15/2024,SAS vs DEN,Julian Champagnie,champju02,59,SAS,1,DEN,10,1,1,0,0,0,26,0,1,3,7,3,6,1,2,1,0,2,11,11,12,12.7
2023-24,202403150UTA,3/15/2024,UTA vs ATL,Walker Kessler,kesslwa01,54,UTA,1,ATL,6,9,1,1,2,2,26,3,6,3,5,0,0,0,0,2,3,10,7,15,16,25.3
2023-24,202403150NOP,3/15/2024,NOP vs LAC,Norman Powell,powelno01,65,LAC,0,NOP,15,0,1,1,0,1,26.13333333,0,0,4,9,2,6,5,5,3,1,1,16,15,16,18.5
2023-24,202403150SAS,3/15/2024,SAS vs DEN,Keldon Johnson,johnske04,62,SAS,1,DEN,9,7,2,1,0,2,26.25,1,6,4,7,1,4,0,0,2,1,9,11,16,18,21.4
2023-24,202403150TOR,3/15/2024,TOR vs ORL,Kelly Olynyk,olynyke01,65,TOR,1,ORL,10,9,3,1,0,3,26.3,4,5,5,12,0,1,0,2,6,1,12,13,19,22,25.3
2023-24,202403150SAS,3/15/2024,SAS vs DEN,Kentavious Caldwell-Pope,caldwke01,61,DEN,0,SAS,4,0,3,3,0,2,26.81666667,0,0,2,5,0,1,0,0,3,3,3,7,4,7,15.5
2023-24,202403150TOR,3/15/2024,TOR vs ORL,Jontay Porter,portejo01,23,TOR,1,ORL,0,4,4,3,2,1,26.83333333,1,3,0,4,0,3,0,0,1,5,8,4,4,8,24.8
2023-24,202403150NOP,3/15/2024,NOP vs LAC,Larry Nance Jr.,nancela02,48,NOP,1,LAC,12,4,3,0,0,0,27.53333333,2,2,4,6,0,1,4,4,3,0,7,15,16,19,21.3
2023-24,202403150TOR,3/15/2024,TOR vs ORL,Wendell Carter Jr.,cartewe01,40,ORL,0,TOR,15,8,3,0,0,1,27.65,2,6,6,10,2,5,1,2,2,0,11,18,23,26,28.1
2023-24,202403150CHO,3/15/2024,CHO vs PHO,Nick Richards,richani01,57,CHO,1,PHO,2,15,0,0,0,0,27.86666667,2,13,1,5,0,0,0,0,4,0,15,2,17,17,20
2023-24,202403150UTA,3/15/2024,UTA vs ATL,Brice Sensabaugh,sensabr01,16,UTA,1,ATL,14,4,2,0,0,1,28.28333333,0,4,5,9,0,4,4,4,2,0,6,16,18,20,20.8
2023-24,202403150SAS,3/15/2024,SAS vs DEN,Jeremy Sochan,sochaje01,67,SAS,1,DEN,19,6,4,1,0,3,28.41666667,4,2,8,16,1,3,2,3,1,1,10,23,25,29,32.2
2023-24,202403150CHO,3/15/2024,CHO vs PHO,Brandon Miller,millebr02,60,CHO,1,PHO,14,4,1,2,1,0,28.68333333,1,3,4,15,2,8,4,5,4,3,5,15,18,19,29.3
2023-24,202403150UTA,3/15/2024,UTA vs ATL,Vit Krejci,krejcvi01,6,ATL,0,UTA,2,0,2,1,0,0,28.88333333,0,0,1,5,0,3,0,0,4,1,2,4,2,4,8
2023-24,202403150DET,3/15/2024,DET vs MIA,Bam Adebayo,adebaba01,56,MIA,0,DET,22,9,2,2,3,0,28.93333333,3,6,10,14,1,1,1,3,1,5,11,24,31,33,50.8
2023-24,202403150UTA,3/15/2024,UTA vs ATL,John Collins,collijo01,62,UTA,1,ATL,18,11,2,0,1,2,29.68333333,3,8,7,10,2,2,2,3,4,1,13,20,29,31,35.2
2023-24,202403150TOR,3/15/2024,TOR vs ORL,Bruce Brown,brownbr01,56,TOR,1,ORL,12,4,5,1,0,2,29.76666667,0,4,5,8,2,3,0,0,2,1,9,17,16,21,25.3
2023-24,202403150NOP,3/15/2024,NOP vs LAC,CJ McCollum,mccolcj01,50,NOP,1,LAC,11,6,4,1,0,2,29.8,0,6,5,13,1,7,0,0,1,1,10,15,17,21,25.2
2023-24,202403150TOR,3/15/2024,TOR vs ORL,Jalen Suggs,suggsja01,60,ORL,0,TOR,16,1,3,3,0,0,30.23333333,0,1,6,9,3,6,1,2,2,3,4,19,17,20,30.7
2023-24,202403150CHO,3/15/2024,CHO vs PHO,Jusuf Nurkic,nurkiju01,63,PHO,0,CHO,13,21,2,0,1,2,30.55,5,16,5,9,0,0,3,7,5,1,23,15,34,36,42.2
2023-24,202403150CHO,3/15/2024,CHO vs PHO,Vasilije Micic,micicva01,46,CHO,1,PHO,21,1,3,0,1,1,30.65,1,0,7,12,0,2,7,9,1,1,4,24,22,25,28.7
2023-24,202403150SAS,3/15/2024,SAS vs DEN,Nikola Jokic,jokicni01,65,DEN,0,SAS,31,7,5,0,2,3,30.9,1,6,13,19,1,3,4,4,1,2,12,36,38,43,49.9
2023-24,202403150TOR,3/15/2024,TOR vs ORL,Franz Wagner,wagnefr01,59,ORL,0,TOR,19,7,4,2,0,4,30.98333333,1,6,6,9,0,1,7,8,2,2,11,23,26,30,35.4
2023-24,202403150DET,3/15/2024,DET vs MIA,Jimmy Butler,butleji01,47,MIA,0,DET,14,4,3,2,0,1,31.4,1,3,5,11,0,1,4,5,2,2,7,17,18,21,28.3
2023-24,202403150DET,3/15/2024,DET vs MIA,Cade Cunningham,cunnica01,56,DET,1,MIA,11,6,9,0,0,3,31.45,3,3,5,15,0,4,1,1,2,0,15,20,17,26,28.7
2023-24,202403150UTA,3/15/2024,UTA vs ATL,Collin Sexton,sextoco01,66,UTA,1,ATL,21,4,6,2,0,1,31.45,0,4,9,16,3,6,0,0,2,2,10,27,25,31,39.8
2023-24,202403150TOR,3/15/2024,TOR vs ORL,Gary Trent Jr.,trentga02,60,TOR,1,ORL,31,4,0,1,0,0,31.61666667,0,4,10,17,7,11,4,5,3,1,4,31,35,35,38.8
2023-24,202403150UTA,3/15/2024,UTA vs ATL,Clint Capela,capelca01,58,ATL,0,UTA,10,15,4,0,2,1,32.01666667,7,8,4,8,0,0,2,4,2,2,19,14,25,29,39
2023-24,202403150UTA,3/15/2024,UTA vs ATL,De'Andre Hunter,huntede01,42,ATL,0,UTA,27,2,1,1,0,2,32.15,0,2,10,17,5,7,2,2,2,1,3,28,29,30,31.9
2023-24,202403150NOP,3/15/2024,NOP vs LAC,Trey Murphy III,murphtr02,41,NOP,1,LAC,14,6,4,0,0,0,32.35,1,5,5,10,4,9,0,0,0,0,10,18,20,24,27.2
2023-24,202403150CHO,3/15/2024,CHO vs PHO,Grant Williams,willigr01,63,CHO,1,PHO,20,6,1,1,0,0,32.38333333,3,3,8,17,3,8,1,1,0,1,7,21,26,27,31.7
2023-24,202403150NOP,3/15/2024,NOP vs LAC,Ivica Zubac,zubaciv01,54,LAC,0,NOP,9,11,2,1,1,1,32.73333333,2,9,4,7,0,0,1,2,3,2,13,11,20,22,30.2
2023-24,202403150SAS,3/15/2024,SAS vs DEN,Tre Jones,jonestr01,62,SAS,1,DEN,8,6,9,1,0,3,32.93333333,0,6,2,6,1,2,3,4,0,1,15,17,14,23,28.7
2023-24,202403150DET,3/15/2024,DET vs MIA,Duncan Robinson,robindu01,61,MIA,0,DET,16,2,5,3,1,2,32.93333333,0,2,6,14,4,12,0,0,1,4,7,21,18,23,35.9
2023-24,202403150NOP,3/15/2024,NOP vs LAC,Herbert Jones,joneshe01,61,NOP,1,LAC,7,4,5,1,1,3,33.13333333,0,4,3,6,1,3,0,0,3,2,9,12,11,16,22.3
2023-24,202403150CHO,3/15/2024,CHO vs PHO,Grayson Allen,allengr01,61,PHO,0,CHO,17,0,3,1,0,0,33.18333333,0,0,6,12,3,9,2,2,1,1,3,20,17,20,24.5
2023-24,202403150SAS,3/15/2024,SAS vs DEN,Victor Wembanyama,wembavi01,59,SAS,1,DEN,17,9,2,2,3,4,33.18333333,4,5,4,12,1,5,8,9,5,5,11,19,26,28,41.8
2023-24,202403150DET,3/15/2024,DET vs MIA,Caleb Martin,martica02,49,MIA,0,DET,18,8,6,2,0,2,33.48333333,3,5,8,14,1,5,1,1,0,2,14,24,26,32,40.6
2023-24,202403150DET,3/15/2024,DET vs MIA,Terry Rozier,roziete01,49,MIA,0,DET,18,5,1,1,1,0,33.51666667,1,4,5,15,0,5,8,11,2,2,6,19,23,24,31.5
2023-24,202403150TOR,3/15/2024,TOR vs ORL,Ochai Agbaji,agbajoc01,66,TOR,1,ORL,8,4,0,0,0,2,33.66666667,2,2,4,9,0,3,0,0,4,0,4,8,12,12,10.8
2023-24,202403150DET,3/15/2024,DET vs MIA,Jalen Duren,durenja01,51,DET,1,MIA,15,17,1,0,1,3,33.88333333,2,15,7,9,0,0,1,2,2,1,18,16,32,33,36.9
2023-24,202403150SAS,3/15/2024,SAS vs DEN,Jamal Murray,murraja01,51,DEN,0,SAS,15,10,8,4,0,3,33.98333333,2,8,6,16,1,2,2,2,4,4,18,23,25,33,48
2023-24,202403150DET,3/15/2024,DET vs MIA,Simone Fontecchio,fontesi01,65,DET,1,MIA,24,6,0,1,0,2,34.31666667,1,5,9,16,5,8,1,2,2,1,6,24,30,30,32.2
2023-24,202403150UTA,3/15/2024,UTA vs ATL,Keyonte George,georgke01,59,UTA,1,ATL,25,4,5,2,0,2,34.51666667,0,4,8,19,1,7,8,8,2,2,9,30,29,34,41.3
2023-24,202403150TOR,3/15/2024,TOR vs ORL,Immanuel Quickley,quickim01,61,TOR,1,ORL,10,3,10,2,0,2,34.53333333,0,3,3,9,1,3,3,6,3,2,13,20,13,23,32.6
2023-24,202403150UTA,3/15/2024,UTA vs ATL,Jalen Johnson,johnsja05,49,ATL,0,UTA,26,5,5,0,0,3,34.6,1,4,8,23,4,8,6,10,1,0,10,31,31,36,36.5
2023-24,202403150NOP,3/15/2024,NOP vs LAC,Brandon Ingram,ingrabr01,60,NOP,1,LAC,13,5,7,1,0,0,34.95,0,5,4,12,2,4,3,4,3,1,12,20,18,25,32.5
2023-24,202403150NOP,3/15/2024,NOP vs LAC,Zion Williamson,willizi01,55,NOP,1,LAC,34,7,4,3,1,3,35.28333333,4,3,14,21,0,0,6,10,2,4,11,38,41,45,57.4
2023-24,202403150CHO,3/15/2024,CHO vs PHO,Tre Mann,manntr01,26,CHO,1,PHO,12,4,7,1,0,0,35.53333333,1,3,4,10,1,5,3,5,2,1,11,19,16,23,30.3
2023-24,202403150TOR,3/15/2024,TOR vs ORL,Paolo Banchero,banchpa01,65,ORL,0,TOR,17,9,8,1,0,6,35.71666667,2,7,5,15,1,2,6,6,2,1,17,25,26,34,36.8
2023-24,202403150CHO,3/15/2024,CHO vs PHO,Devin Booker,bookede01,53,PHO,0,CHO,21,6,11,1,1,2,36.06666667,0,6,6,18,1,8,8,8,2,2,17,32,27,38,48.7
2023-24,202403150CHO,3/15/2024,CHO vs PHO,Bradley Beal,bealbr01,38,PHO,0,CHO,15,6,7,0,0,2,36.18333333,2,4,7,11,1,3,0,0,2,0,13,22,21,28,30.7
2023-24,202403150DET,3/15/2024,DET vs MIA,Isaiah Stewart,stewais01,44,DET,1,MIA,10,6,2,0,1,1,37.13333333,2,4,4,6,1,2,1,1,2,1,8,12,16,18,22.2
2023-24,202403150DET,3/15/2024,DET vs MIA,Jaden Ivey,iveyja01,62,DET,1,MIA,14,3,9,1,0,4,37.53333333,0,3,3,14,2,9,6,6,3,1,12,23,17,26,30.1
2023-24,202403150CHO,3/15/2024,CHO vs PHO,Kevin Durant,duranke01,60,PHO,0,CHO,13,8,5,1,0,3,37.95,0,8,5,15,1,6,2,2,1,1,13,18,21,26,30.1
2023-24,202403150CHO,3/15/2024,CHO vs PHO,Miles Bridges,bridgmi02,56,CHO,1,PHO,17,10,3,0,0,2,38.16666667,2,8,6,18,0,5,5,7,2,0,13,20,27,30,31.5
2023-24,202403150NOP,3/15/2024,NOP vs LAC,Kawhi Leonard,leonaka01,60,LAC,0,NOP,23,7,2,0,2,1,38.7,1,6,8,15,1,3,6,6,1,2,9,25,30,32,39.4
2023-24,202403150UTA,3/15/2024,UTA vs ATL,Dejounte Murray,murrade01,63,ATL,0,UTA,33,6,9,2,0,3,38.83333333,2,4,10,27,5,14,8,9,0,2,15,42,39,48,56.7
2023-24,202403150SAS,3/15/2024,SAS vs DEN,Devin Vassell,vassede01,61,SAS,1,DEN,17,2,2,1,1,1,38.96666667,0,2,6,13,3,6,2,3,1,2,4,19,19,21,27.4
2023-24,202403150NOP,3/15/2024,NOP vs LAC,Paul George,georgpa01,60,LAC,0,NOP,26,5,6,1,1,2,41.36666667,0,5,10,21,3,9,3,3,1,2,11,32,31,37,45
2023-24,202403140OKC,3/14/2024,OKC vs DAL,Jaylin Williams,willija07,54,OKC,1,DAL,3,1,2,0,0,1,10.06666667,0,1,1,3,1,3,0,0,3,0,3,5,4,6,6.2
2023-24,202403140BOS,3/14/2024,BOS vs PHO,Ish Wainright,wainris01,8,PHO,0,BOS,3,5,1,1,0,1,10.55,3,2,1,6,1,4,0,0,1,1,6,4,8,9,12.5
2023-24,202403140HOU,3/14/2024,HOU vs WAS,Aaron Holiday,holidaa01,63,HOU,1,WAS,0,0,0,0,0,1,10.91666667,0,0,0,3,0,3,0,0,2,0,0,0,0,0,-1
2023-24,202403140POR,3/14/2024,POR vs NYK,Duop Reath,reathdu01,52,POR,1,NYK,0,3,0,0,0,1,11.23333333,2,1,0,2,0,0,0,0,2,0,3,0,3,3,2.6
2023-24,202403140BOS,3/14/2024,BOS vs PHO,Luke Kornet,kornelu01,48,BOS,1,PHO,2,1,1,1,0,0,11.56666667,0,1,1,2,0,0,0,0,1,1,2,3,3,4,7.7
2023-24,202403140MIL,3/14/2024,MIL vs PHI,Cameron Payne,payneca01,62,PHI,0,MIL,13,1,2,0,0,3,11.75,1,0,5,6,3,3,0,0,0,0,3,15,14,16,14.2
2023-24,202403140HOU,3/14/2024,HOU vs WAS,Patrick Baldwin Jr.,baldwpa01,23,WAS,0,HOU,0,7,1,1,0,1,11.76666667,2,5,0,5,0,2,0,0,1,1,8,1,7,8,11.9
2023-24,202403140HOU,3/14/2024,HOU vs WAS,Jeff Green,greenje02,62,HOU,1,WAS,2,0,1,0,0,2,12.9,0,0,1,7,0,2,0,0,0,0,1,3,2,3,1.5
2023-24,202403140POR,3/14/2024,POR vs NYK,Justin Minaya,minayju01,23,POR,1,NYK,4,5,0,0,0,0,12.91666667,2,3,1,3,1,3,1,2,1,0,5,4,9,9,10
2023-24,202403140CHI,3/14/2024,CHI vs LAC,Dalen Terry,terryda01,44,CHI,1,LAC,4,1,0,0,0,0,13.41666667,0,1,2,4,0,1,0,0,0,0,1,4,5,5,5.2
2023-24,202403140HOU,3/14/2024,HOU vs WAS,Jared Butler,butleja02,24,WAS,0,HOU,0,4,4,0,0,0,13.75,0,4,0,5,0,2,0,0,2,0,8,4,4,8,10.8
2023-24,202403140POR,3/14/2024,POR vs NYK,Bojan Bogdanovic,bogdabo02,41,NYK,0,POR,5,0,1,0,0,1,13.88333333,0,0,1,6,0,2,3,3,0,0,1,6,5,6,5.5
2023-24,202403140OKC,3/14/2024,OKC vs DAL,Dereck Lively II,livelde01,48,DAL,0,OKC,4,2,0,0,0,0,14.01666667,1,1,2,3,0,0,0,0,2,0,2,4,6,6,6.4
2023-24,202403140CHI,3/14/2024,CHI vs LAC,Daniel Theis,theisda01,50,LAC,0,CHI,4,2,3,0,0,0,14.05,2,0,2,4,0,1,0,0,2,0,5,7,6,9,10.9
2023-24,202403140HOU,3/14/2024,HOU vs WAS,Reggie Bullock,bullore01,28,HOU,1,WAS,3,4,1,1,0,0,14.11666667,0,4,1,1,1,1,0,0,0,1,5,4,7,8,12.3
2023-24,202403140MIL,3/14/2024,MIL vs PHI,KJ Martin,martike04,49,PHI,0,MIL,4,1,1,2,0,0,14.4,0,1,1,1,0,0,2,2,4,2,2,5,5,6,12.7
2023-24,202403140HOU,3/14/2024,HOU vs WAS,Jae'Sean Tate,tateja01,56,HOU,1,WAS,2,4,1,1,1,1,14.65,1,3,1,4,0,0,0,1,2,2,5,3,6,7,13.3
2023-24,202403140BOS,3/14/2024,BOS vs PHO,Bol Bol,bolbo01,28,PHO,0,BOS,10,4,0,0,0,0,15.08333333,2,2,4,5,2,2,0,0,0,0,4,10,14,14,14.8
2023-24,202403140CHI,3/14/2024,CHI vs LAC,Andre Drummond,drumman01,67,CHI,1,LAC,15,7,1,0,1,0,16.3,3,4,7,8,0,0,1,1,2,1,8,16,22,23,27.9
2023-24,202403140CHI,3/14/2024,CHI vs LAC,Onuralp Bitim,bitimon01,11,CHI,1,LAC,2,0,2,0,0,0,16.91666667,0,0,1,2,0,1,0,0,1,0,2,4,2,4,5
2023-24,202403140OKC,3/14/2024,OKC vs DAL,Jaden Hardy,hardyja02,59,DAL,0,OKC,9,2,5,1,0,3,17.23333333,0,2,4,10,0,0,1,1,1,1,7,14,11,16,18.9
2023-24,202403140CHI,3/14/2024,CHI vs LAC,Jevon Carter,carteje01,63,CHI,1,LAC,12,3,2,1,1,1,17.45,1,2,5,7,2,3,0,0,2,2,5,14,15,17,23.6
2023-24,202403140BOS,3/14/2024,BOS vs PHO,Xavier Tillman Sr.,tillmxa01,40,BOS,1,PHO,5,4,1,0,1,0,17.91666667,1,3,2,4,1,3,0,0,3,1,5,6,9,10,14.3
2023-24,202403140OKC,3/14/2024,OKC vs DAL,Cason Wallace,wallaca01,66,OKC,1,DAL,3,2,3,2,1,2,18.11666667,1,1,1,2,1,2,0,0,2,3,5,6,5,8,16.9
2023-24,202403140OKC,3/14/2024,OKC vs DAL,Isaiah Joe,joeis01,62,OKC,1,DAL,8,2,2,1,0,1,18.53333333,1,1,3,7,2,5,0,0,0,1,4,10,10,12,15.4
2023-24,202403140MIL,3/14/2024,MIL vs PHI,Jae Crowder,crowdja01,36,MIL,1,PHI,9,2,0,0,0,0,18.56666667,1,1,3,8,3,6,0,0,1,0,2,9,11,11,11.4
2023-24,202403140BOS,3/14/2024,BOS vs PHO,Payton Pritchard,pritcpa01,66,BOS,1,PHO,3,3,1,1,0,3,19.11666667,1,2,1,3,1,1,0,0,1,1,4,4,6,7,8.1
2023-24,202403140MIL,3/14/2024,MIL vs PHI,Nicolas Batum,batumni01,45,PHI,0,MIL,5,2,3,0,0,0,20.51666667,1,1,2,5,1,4,0,0,0,0,5,8,7,10,11.9
2023-24,202403140OKC,3/14/2024,OKC vs DAL,Maxi Kleber,klebima01,30,DAL,0,OKC,3,2,1,1,1,0,20.61666667,0,2,1,2,0,1,1,2,0,2,3,4,5,6,12.9
2023-24,202403140POR,3/14/2024,POR vs NYK,Matisse Thybulle,thybuma01,63,POR,1,NYK,5,2,3,2,0,2,20.68333333,0,2,2,6,1,4,0,0,1,2,5,8,7,10,15.9
2023-24,202403140MIL,3/14/2024,MIL vs PHI,Buddy Hield,hieldbu01,69,PHI,0,MIL,9,0,2,0,1,1,20.76666667,0,0,3,6,3,4,0,0,3,1,2,11,9,11,14
2023-24,202403140OKC,3/14/2024,OKC vs DAL,Gordon Hayward,haywago01,37,OKC,1,DAL,6,1,1,1,0,0,21.18333333,1,0,1,3,0,1,4,4,2,1,2,7,7,8,11.7
2023-24,202403140OKC,3/14/2024,OKC vs DAL,Dante Exum,exumda01,41,DAL,0,OKC,7,0,2,0,0,4,21.6,0,0,2,8,1,2,2,2,3,0,2,9,7,9,6
2023-24,202403140MIL,3/14/2024,MIL vs PHI,Bobby Portis,portibo01,67,MIL,1,PHI,8,3,1,1,0,4,21.6,0,3,4,6,0,1,0,0,0,1,4,9,11,12,12.1
2023-24,202403140POR,3/14/2024,POR vs NYK,Miles McBride,mcbrimi01,53,NYK,0,POR,6,3,0,1,0,2,21.91666667,2,1,3,6,0,1,0,0,3,1,3,6,9,9,10.6
2023-24,202403140CHI,3/14/2024,CHI vs LAC,Amir Coffey,coffeam01,53,LAC,0,CHI,9,3,1,1,0,0,21.98333333,0,3,3,8,3,6,0,0,1,1,4,10,12,13,17.1
2023-24,202403140POR,3/14/2024,POR vs NYK,Ashton Hagans,haganas01,13,POR,1,NYK,8,5,3,0,0,2,22.03333333,1,4,3,5,2,3,0,0,2,0,8,11,13,16,16.5
2023-24,202403140OKC,3/14/2024,OKC vs DAL,Josh Giddey,giddejo01,65,OKC,1,DAL,18,3,5,1,1,3,22.2,1,2,8,14,2,7,0,0,4,2,8,23,21,26,32.1
2023-24,202403140BOS,3/14/2024,BOS vs PHO,Sam Hauser,hausesa01,65,BOS,1,PHO,8,4,2,1,0,0,22.6,0,4,3,7,2,5,0,0,0,1,6,10,12,14,18.8
2023-24,202403140MIL,3/14/2024,MIL vs PHI,Mo Bamba,bambamo01,44,PHI,0,MIL,5,5,3,1,0,1,23.11666667,1,4,2,3,1,2,0,0,4,1,8,8,10,13,17.5
2023-24,202403140POR,3/14/2024,POR vs NYK,Isaiah Hartenstein,harteis01,60,NYK,0,POR,9,9,2,0,0,0,23.93333333,1,8,4,6,0,0,1,1,2,0,11,11,18,20,22.8
2023-24,202403140POR,3/14/2024,POR vs NYK,Precious Achiuwa,achiupr01,59,NYK,0,POR,4,7,2,2,0,0,24.06666667,3,4,2,3,0,0,0,0,1,2,9,6,11,13,21.4
2023-24,202403140MIL,3/14/2024,MIL vs PHI,Paul Reed,reedpa01,66,PHI,0,MIL,3,7,2,2,2,2,24.26666667,2,5,1,4,1,2,0,0,3,4,9,5,10,12,24.4
2023-24,202403140MIL,3/14/2024,MIL vs PHI,Patrick Beverley,beverpa01,62,MIL,1,PHI,6,2,2,1,1,1,25.63333333,0,2,2,5,2,3,0,0,3,2,4,8,8,10,16.4
2023-24,202403140HOU,3/14/2024,HOU vs WAS,Jabari Smith Jr.,smithja05,61,HOU,1,WAS,16,5,1,0,0,1,25.83333333,0,5,6,10,2,4,2,2,4,0,6,17,21,22,22.5
2023-24,202403140OKC,3/14/2024,OKC vs DAL,Daniel Gafford,gaffoda01,60,DAL,0,OKC,19,15,1,0,1,2,25.86666667,6,9,8,11,0,0,3,3,3,1,16,20,34,35,39.5
2023-24,202403140POR,3/14/2024,POR vs NYK,Scoot Henderson,hendesc01,47,POR,1,NYK,12,7,6,1,0,2,25.96666667,0,7,4,13,1,4,3,4,5,1,13,18,19,25,30.4
2023-24,202403140HOU,3/14/2024,HOU vs WAS,Jock Landale,landajo01,40,HOU,1,WAS,13,5,1,0,0,2,26.73333333,1,4,4,5,0,0,5,6,2,0,6,14,18,19,18.5
2023-24,202403140HOU,3/14/2024,HOU vs WAS,Corey Kispert,kispeco01,64,WAS,0,HOU,11,2,2,1,0,0,26.93333333,0,2,4,9,3,7,0,2,4,1,4,13,13,15,19.4
2023-24,202403140MIL,3/14/2024,MIL vs PHI,Kyle Lowry,lowryky01,47,PHI,0,MIL,12,2,0,0,0,2,26.98333333,0,2,4,7,1,3,3,3,2,0,2,12,14,14,12.4
2023-24,202403140CHI,3/14/2024,CHI vs LAC,Torrey Craig,craigto01,38,CHI,1,LAC,12,6,1,0,0,0,27.01666667,0,6,4,8,4,7,0,2,1,0,7,13,18,19,20.7
2023-24,202403140BOS,3/14/2024,BOS vs PHO,Royce O'Neale,onealro01,63,PHO,0,BOS,0,5,4,0,0,1,27.03333333,1,4,0,7,0,5,0,0,1,0,9,4,5,9,11
2023-24,202403140HOU,3/14/2024,HOU vs WAS,Amen Thompson,thompam01,47,HOU,1,WAS,20,11,4,3,0,1,27.61666667,5,6,9,12,0,0,2,2,3,3,15,24,31,35,47.2
2023-24,202403140MIL,3/14/2024,MIL vs PHI,Tobias Harris,harrito02,60,PHI,0,MIL,15,4,3,1,1,0,27.71666667,0,4,5,11,2,4,3,4,1,2,7,18,19,22,30.3
2023-24,202403140CHI,3/14/2024,CHI vs LAC,Norman Powell,powelno01,64,LAC,0,CHI,18,2,2,1,0,2,27.96666667,0,2,6,10,3,6,3,4,3,1,4,20,20,22,24.4
2023-24,202403140MIL,3/14/2024,MIL vs PHI,A.J. Green,greenaj01,44,MIL,1,PHI,14,5,0,1,0,0,28.11666667,0,5,4,8,3,7,3,3,1,1,5,14,19,19,23
2023-24,202403140OKC,3/14/2024,OKC vs DAL,Luguentz Dort,dortlu01,64,OKC,1,DAL,12,1,3,1,0,1,28.31666667,1,0,4,9,3,6,1,1,6,1,4,15,13,16,19.7
2023-24,202403140MIL,3/14/2024,MIL vs PHI,Pat Connaughton,connapa01,61,MIL,1,PHI,9,3,4,0,0,0,29.25,0,3,3,5,1,2,2,2,0,0,7,13,12,16,18.6
2023-24,202403140CHI,3/14/2024,CHI vs LAC,Terance Mann,mannte01,59,LAC,0,CHI,12,4,2,1,0,0,30.53333333,0,4,4,13,2,7,2,2,2,1,6,14,16,18,22.8
2023-24,202403140BOS,3/14/2024,BOS vs PHO,Jusuf Nurkic,nurkiju01,62,PHO,0,BOS,8,20,6,1,1,2,30.78333333,7,13,4,9,0,0,0,2,1,2,26,14,28,34,45
2023-24,202403140OKC,3/14/2024,OKC vs DAL,Tim Hardaway Jr.,hardati02,64,DAL,0,OKC,23,9,3,1,0,2,30.83333333,1,8,8,13,5,9,2,2,2,1,12,26,32,35,39.3
2023-24,202403140HOU,3/14/2024,HOU vs WAS,Kyle Kuzma,kuzmaky01,64,WAS,0,HOU,23,3,3,2,0,5,30.83333333,0,3,8,10,0,1,7,7,2,2,6,26,26,29,32.1
2023-24,202403140HOU,3/14/2024,HOU vs WAS,Tyus Jones,jonesty01,66,WAS,0,HOU,13,1,8,0,0,2,30.95,0,1,5,11,3,6,0,0,0,0,9,21,14,22,24.2
2023-24,202403140HOU,3/14/2024,HOU vs WAS,Dillon Brooks,brookdi01,57,HOU,1,WAS,13,6,4,0,0,2,31.03333333,1,5,5,8,1,3,2,2,3,0,10,17,19,23,24.2
2023-24,202403140POR,3/14/2024,POR vs NYK,Kris Murray,murrakr01,46,POR,1,NYK,10,4,1,0,1,0,31.23333333,1,3,3,8,2,6,2,2,1,1,5,11,14,15,19.3
2023-24,202403140CHI,3/14/2024,CHI vs LAC,Ivica Zubac,zubaciv01,53,LAC,0,CHI,6,8,2,0,0,2,31.5,2,6,2,3,0,0,2,2,1,0,10,8,14,16,16.6
2023-24,202403140HOU,3/14/2024,HOU vs WAS,Jordan Poole,poolejo01,64,WAS,0,HOU,25,1,2,2,0,2,31.55,0,1,10,19,5,12,0,0,4,2,3,27,26,28,33.2
2023-24,202403140CHI,3/14/2024,CHI vs LAC,Bones Hyland,hylanbo01,27,LAC,0,CHI,17,5,11,4,0,1,31.61666667,0,5,6,9,4,7,1,2,2,4,16,28,22,33,50.5
2023-24,202403140OKC,3/14/2024,OKC vs DAL,Derrick Jones Jr.,jonesde02,62,DAL,0,OKC,10,1,0,1,0,1,31.85,1,0,4,6,2,2,0,0,4,1,1,10,11,11,13.2
2023-24,202403140OKC,3/14/2024,OKC vs DAL,Chet Holmgren,holmgch01,66,OKC,1,DAL,11,8,1,1,1,0,32.11666667,1,7,4,6,2,3,1,1,1,2,9,12,19,20,28.1
2023-24,202403140BOS,3/14/2024,BOS vs PHO,Al Horford,horfoal01,55,BOS,1,PHO,24,3,3,3,1,1,32.8,2,1,8,14,6,10,2,2,1,4,6,27,27,30,43.1
2023-24,202403140BOS,3/14/2024,BOS vs PHO,Jrue Holiday,holidjr01,60,BOS,1,PHO,9,0,10,2,2,0,33.08333333,0,0,3,5,3,5,0,0,1,4,10,19,9,19,36
2023-24,202403140BOS,3/14/2024,BOS vs PHO,Jayson Tatum,tatumja01,63,BOS,1,PHO,26,5,5,0,0,3,33.08333333,1,4,10,18,4,8,2,3,3,0,10,31,31,36,36.5
2023-24,202403140BOS,3/14/2024,BOS vs PHO,Jaylen Brown,brownja02,60,BOS,1,PHO,37,5,3,2,0,1,33.43333333,0,5,14,23,5,9,4,6,2,2,8,40,42,45,52.5
2023-24,202403140BOS,3/14/2024,BOS vs PHO,Derrick White,whitede01,62,BOS,1,PHO,13,8,5,2,1,0,33.43333333,1,7,5,13,3,9,0,0,1,3,13,18,21,26,39.1
2023-24,202403140MIL,3/14/2024,MIL vs PHI,Kelly Oubre Jr.,oubreke01,53,PHI,0,MIL,9,4,0,0,0,0,33.46666667,1,3,4,13,0,4,1,2,1,0,4,9,13,13,13.8
2023-24,202403140CHI,3/14/2024,CHI vs LAC,Kawhi Leonard,leonaka01,59,LAC,0,CHI,27,5,3,1,1,3,33.88333333,2,3,12,17,2,5,1,2,0,2,8,30,32,35,40.5
2023-24,202403140HOU,3/14/2024,HOU vs WAS,Bilal Coulibaly,coulibi01,62,WAS,0,HOU,10,3,4,2,0,0,33.91666667,2,1,3,9,0,3,4,4,1,2,7,14,13,17,25.6
2023-24,202403140BOS,3/14/2024,BOS vs PHO,Kevin Durant,duranke01,59,PHO,0,BOS,20,3,1,0,1,3,34.15,0,3,9,19,1,3,1,2,1,1,4,21,23,24,25.1
2023-24,202403140POR,3/14/2024,POR vs NYK,Toumani Camara,camarto01,63,POR,1,NYK,7,3,4,3,0,2,34.18333333,1,2,3,6,1,3,0,0,4,3,7,11,10,14,23.6
2023-24,202403140CHI,3/14/2024,CHI vs LAC,Ayo Dosunmu,dosunay01,65,CHI,1,LAC,7,4,4,0,0,3,34.85,2,2,2,11,1,5,2,2,2,0,8,11,11,15,14.8
2023-24,202403140OKC,3/14/2024,OKC vs DAL,Jalen Williams,willija06,59,OKC,1,DAL,27,4,5,1,3,3,35.23333333,0,4,11,21,3,5,2,2,3,4,9,32,31,36,48.3
2023-24,202403140CHI,3/14/2024,CHI vs LAC,Paul George,georgpa01,59,LAC,0,CHI,28,5,7,1,1,1,35.36666667,0,5,11,12,6,7,0,0,4,2,12,35,33,40,49.5
2023-24,202403140CHI,3/14/2024,CHI vs LAC,Nikola Vucevic,vucevni01,62,CHI,1,LAC,19,6,5,0,0,1,35.36666667,3,3,8,14,2,4,1,1,2,0,11,24,25,30,32.7
2023-24,202403140OKC,3/14/2024,OKC vs DAL,P.J. Washington,washipj01,59,DAL,0,OKC,6,5,1,0,0,2,35.5,0,5,1,11,0,7,4,8,4,0,6,7,11,12,11.5
2023-24,202403140BOS,3/14/2024,BOS vs PHO,Bradley Beal,bealbr01,37,PHO,0,BOS,22,3,7,1,1,3,35.56666667,1,2,9,17,2,4,2,2,2,2,10,29,25,32,39.1
2023-24,202403140CHI,3/14/2024,CHI vs LAC,DeMar DeRozan,derozde01,65,CHI,1,LAC,21,5,4,0,0,5,35.7,1,4,6,16,2,5,7,8,2,0,9,25,26,30,28
2023-24,202403140POR,3/14/2024,POR vs NYK,OG Anunoby,anunoog01,43,NYK,0,POR,12,9,2,2,0,2,35.71666667,2,7,5,11,1,4,1,2,4,2,11,14,21,23,29.8
2023-24,202403140CHI,3/14/2024,CHI vs LAC,Alex Caruso,carusal01,58,CHI,1,LAC,17,3,6,3,0,3,35.8,0,3,5,13,5,8,2,2,2,3,9,23,20,26,35.6
2023-24,202403140BOS,3/14/2024,BOS vs PHO,Grayson Allen,allengr01,60,PHO,0,BOS,20,3,0,1,0,2,35.88333333,1,2,8,9,4,5,0,0,3,1,3,20,23,23,24.6
2023-24,202403140HOU,3/14/2024,HOU vs WAS,Deni Avdija,avdijde01,63,WAS,0,HOU,24,9,5,3,0,2,36.03333333,2,7,10,13,0,1,4,5,0,3,14,29,33,38,49.3
2023-24,202403140POR,3/14/2024,POR vs NYK,Donte DiVincenzo,divindo01,65,NYK,0,POR,12,5,3,2,0,1,36.55,0,5,4,12,2,8,2,2,3,2,8,15,17,20,27.5
2023-24,202403140MIL,3/14/2024,MIL vs PHI,Brook Lopez,lopezbr01,64,MIL,1,PHI,19,7,5,1,2,2,36.78333333,0,7,7,12,5,10,0,0,3,3,12,24,26,31,41.9
2023-24,202403140HOU,3/14/2024,HOU vs WAS,Jalen Green,greenja05,66,HOU,1,WAS,37,8,2,0,0,2,36.8,0,8,15,23,5,9,2,2,2,0,10,39,45,47,47.6
2023-24,202403140MIL,3/14/2024,MIL vs PHI,Giannis Antetokounmpo,antetgi01,64,MIL,1,PHI,32,11,7,1,0,7,36.93333333,4,7,9,12,0,0,14,18,4,1,18,39,43,50,51.7
2023-24,202403140MIL,3/14/2024,MIL vs PHI,Tyrese Maxey,maxeyty01,57,PHI,0,MIL,30,4,4,0,0,2,37.01666667,0,4,12,23,5,9,1,3,0,0,8,34,34,38,38.8
2023-24,202403140OKC,3/14/2024,OKC vs DAL,Shai Gilgeous-Alexander,gilgesh01,65,OKC,1,DAL,31,9,5,2,0,1,37.13333333,1,8,9,16,1,4,12,15,2,2,14,36,40,45,54.3
2023-24,202403140HOU,3/14/2024,HOU vs WAS,Fred VanVleet,vanvlfr01,59,HOU,1,WAS,27,3,9,2,0,5,37.21666667,0,3,9,14,3,6,6,7,1,2,12,36,30,39,45.1
2023-24,202403140BOS,3/14/2024,BOS vs PHO,Devin Booker,bookede01,52,PHO,0,BOS,23,2,7,0,0,0,37.83333333,0,2,9,20,1,6,4,4,3,0,9,30,25,32,35.9
2023-24,202403140POR,3/14/2024,POR vs NYK,Jalen Brunson,brunsja01,61,NYK,0,POR,45,1,4,1,1,5,37.93333333,1,0,14,30,2,10,15,17,0,2,5,49,46,50,53.2
2023-24,202403140MIL,3/14/2024,MIL vs PHI,Damian Lillard,lillada01,62,MIL,1,PHI,17,3,9,1,1,0,38.16666667,1,2,7,16,2,7,1,1,1,2,12,26,20,29,40.1
2023-24,202403140OKC,3/14/2024,OKC vs DAL,Kyrie Irving,irvinky01,45,DAL,0,OKC,36,4,12,2,0,4,38.26666667,1,3,12,18,4,7,8,8,1,2,16,48,40,52,60.8
2023-24,202403140POR,3/14/2024,POR vs NYK,Deandre Ayton,aytonde01,44,POR,1,NYK,31,14,0,0,1,3,40,6,8,12,21,1,1,6,6,1,1,14,31,45,45,47.8
2023-24,202403140POR,3/14/2024,POR vs NYK,Josh Hart,hartjo01,65,NYK,0,POR,7,15,2,3,0,0,41.7,5,10,3,8,0,2,1,1,4,3,17,9,22,24,37
2023-24,202403140POR,3/14/2024,POR vs NYK,Dalano Banton,bantoda01,39,POR,1,NYK,16,2,2,4,0,5,41.75,0,2,6,20,2,9,2,2,2,4,4,18,18,20,28.4
2023-24,202403130ORL,3/13/2024,ORL vs BRK,Moritz Wagner,wagnemo01,64,ORL,1,BRK,2,0,1,0,0,2,11.13333333,0,0,1,3,0,1,0,0,1,0,1,3,2,3,1.5
2023-24,202403130IND,3/13/2024,IND vs CHI,Julian Phillips,phillju01,40,CHI,0,IND,0,1,0,0,1,1,11.18333333,0,1,0,2,0,1,0,0,2,1,1,0,1,1,3.2
2023-24,202403130POR,3/13/2024,POR vs ATL,Trent Forrest,forretr01,27,ATL,0,POR,6,0,4,0,0,1,11.35,0,0,2,4,0,0,2,2,0,0,4,10,6,10,11
2023-24,202403130MIA,3/13/2024,MIA vs DEN,Justin Holiday,holidju01,42,DEN,0,MIA,2,3,2,0,1,0,12.91666667,0,3,1,5,0,3,0,0,2,1,5,4,5,7,11.6
2023-24,202403130IND,3/13/2024,IND vs CHI,Onuralp Bitim,bitimon01,10,CHI,0,IND,2,1,1,0,0,1,12.96666667,0,1,1,1,0,0,0,0,0,0,2,3,3,4,3.7
2023-24,202403130SAC,3/13/2024,SAC vs LAL,Taurean Prince,princta02,65,LAL,0,SAC,7,1,0,2,0,0,13.28333333,0,1,2,2,1,1,2,2,1,2,1,7,8,8,14.2
2023-24,202403130MIA,3/13/2024,MIA vs DEN,Thomas Bryant,bryanth01,28,MIA,1,DEN,9,6,0,0,0,0,13.65,2,4,3,4,0,0,3,4,1,0,6,9,15,15,16.2
2023-24,202403130MIA,3/13/2024,MIA vs DEN,Patty Mills,millspa02,22,MIA,1,DEN,2,3,3,1,0,1,13.86666667,0,3,1,6,0,3,0,0,0,1,6,5,5,8,12.1
2023-24,202403130ORL,3/13/2024,ORL vs BRK,Day'Ron Sharpe,sharpda01,49,BRK,0,ORL,5,2,0,0,0,1,13.93333333,0,2,1,2,0,0,3,4,2,0,2,5,7,7,6.4
2023-24,202403130POR,3/13/2024,POR vs ATL,Wesley Matthews,matthwe02,25,ATL,0,POR,3,0,0,0,1,0,14.16666667,0,0,1,7,1,4,0,0,0,1,0,3,3,3,6
2023-24,202403130DAL,3/13/2024,DAL vs GSW,Tim Hardaway Jr.,hardati02,63,DAL,1,GSW,5,0,2,0,0,1,14.33333333,0,0,2,7,1,5,0,0,0,0,2,7,5,7,7
2023-24,202403130ORL,3/13/2024,ORL vs BRK,Jalen Wilson,wilsoja03,28,BRK,0,ORL,3,2,2,0,0,0,14.48333333,1,1,1,4,0,2,1,2,1,0,4,5,5,7,8.4
2023-24,202403130DET,3/13/2024,DET vs TOR,Stanley Umude,umudest01,20,DET,1,TOR,5,7,0,3,0,0,14.51666667,0,7,1,4,1,2,2,2,1,3,7,5,12,12,22.4
2023-24,202403130POR,3/13/2024,POR vs ATL,Justin Minaya,minayju01,22,POR,1,ATL,2,0,1,1,0,1,14.81666667,0,0,1,3,0,1,0,0,1,1,1,3,2,3,5.5
2023-24,202403130NOP,3/13/2024,NOP vs CLE,Jonas Valanciunas,valanjo01,65,NOP,1,CLE,5,7,2,0,0,1,14.85,2,5,2,7,1,2,0,0,1,0,9,7,12,14,15.4
2023-24,202403130DET,3/13/2024,DET vs TOR,Quentin Grimes,grimequ01,51,DET,1,TOR,5,0,3,0,0,1,15.11666667,0,0,1,6,0,3,3,4,3,0,3,8,5,8,8.5
2023-24,202403130DAL,3/13/2024,DAL vs GSW,Gary Payton II,paytoga02,30,GSW,0,DAL,0,4,2,1,0,0,15.51666667,3,1,0,3,0,2,0,0,2,1,6,2,4,6,10.8
2023-24,202403130MIA,3/13/2024,MIA vs DEN,Nikola Jovic,jovicni01,31,MIA,1,DEN,3,1,1,1,0,1,15.58333333,0,1,1,3,1,2,0,0,1,1,2,4,4,5,7.7
2023-24,202403130SAC,3/13/2024,SAC vs LAL,Davion Mitchell,mitchda01,55,SAC,1,LAL,6,2,2,0,0,1,16.01666667,0,2,3,6,0,2,0,0,0,0,4,8,8,10,10.4
2023-24,202403130MEM,3/13/2024,MEM vs CHO,Wenyen Gabriel,gabriwe01,4,MEM,1,CHO,0,6,1,0,1,3,16.08333333,2,4,0,4,0,1,0,0,3,1,7,1,6,7,8.7
2023-24,202403130ORL,3/13/2024,ORL vs BRK,Cole Anthony,anthoco01,65,ORL,1,BRK,6,1,2,0,1,0,16.38333333,0,1,2,5,0,0,2,4,1,1,3,8,7,9,13.2
2023-24,202403130ORL,3/13/2024,ORL vs BRK,Joe Ingles,inglejo01,52,ORL,1,BRK,6,0,3,0,0,0,16.38333333,0,0,2,3,2,3,0,0,1,0,3,9,6,9,10.5
2023-24,202403130NOP,3/13/2024,NOP vs CLE,Larry Nance Jr.,nancela02,47,NOP,1,CLE,0,5,3,2,0,1,16.81666667,0,5,0,2,0,0,0,0,0,2,8,3,5,8,15.5
2023-24,202403130MEM,3/13/2024,MEM vs CHO,DeJon Jarreau,jarrede01,3,MEM,1,CHO,2,5,4,0,0,1,16.93333333,0,5,0,3,0,1,2,2,0,0,9,6,7,11,13
2023-24,202403130DAL,3/13/2024,DAL vs GSW,Kevon Looney,looneke01,62,GSW,0,DAL,4,2,0,0,0,0,17.38333333,1,1,2,2,0,0,0,1,3,0,2,4,6,6,6.4
2023-24,202403130POR,3/13/2024,POR vs ATL,Scoot Henderson,hendesc01,46,POR,1,ATL,2,1,3,1,0,3,17.48333333,0,1,1,8,0,4,0,0,5,1,4,5,3,6,7.7
2023-24,202403130IND,3/13/2024,IND vs CHI,Jalen Smith,smithja04,47,IND,1,CHI,15,6,0,0,0,0,17.51666667,2,4,5,7,2,4,3,4,5,0,6,15,21,21,22.2
2023-24,202403130IND,3/13/2024,IND vs CHI,Obi Toppin,toppiob01,68,IND,1,CHI,4,4,4,0,1,2,18.2,1,3,2,7,0,3,0,0,2,1,8,8,8,12,15.8
2023-24,202403130ORL,3/13/2024,ORL vs BRK,Dennis Smith Jr.,smithde03,50,BRK,0,ORL,10,3,2,2,0,0,18.38333333,2,1,4,7,2,5,0,0,0,2,5,12,13,15,22.6
2023-24,202403130ORL,3/13/2024,ORL vs BRK,Markelle Fultz,fultzma01,28,ORL,1,BRK,10,8,2,1,0,3,18.68333333,2,6,4,10,0,0,2,2,1,1,10,12,18,20,22.6
2023-24,202403130NOP,3/13/2024,NOP vs CLE,Jose Alvarado,alvarjo01,44,NOP,1,CLE,5,2,0,0,0,0,18.73333333,0,2,2,4,1,1,0,0,1,0,2,5,7,7,7.4
2023-24,202403130DAL,3/13/2024,DAL vs GSW,Derrick Jones Jr.,jonesde02,61,DAL,1,GSW,7,3,0,0,0,2,18.76666667,2,1,3,4,0,1,1,2,0,0,3,7,10,10,8.6
2023-24,202403130MIA,3/13/2024,MIA vs DEN,Reggie Jackson,jacksre01,66,DEN,0,MIA,9,1,2,0,0,2,18.86666667,0,1,4,9,1,1,0,0,1,0,3,11,10,12,11.2
2023-24,202403130DAL,3/13/2024,DAL vs GSW,Moses Moody,moodymo01,51,GSW,0,DAL,9,3,1,1,1,1,19.03333333,1,2,4,8,1,3,0,0,5,2,4,10,12,13,19.1
2023-24,202403130MEM,3/13/2024,MEM vs CHO,Jordan Goodwin,goodwjo01,48,MEM,1,CHO,12,3,1,2,1,2,19.1,0,3,5,11,2,5,0,0,4,3,4,13,15,16,24.1
2023-24,202403130POR,3/13/2024,POR vs ATL,Dalano Banton,bantoda01,38,POR,1,ATL,12,5,2,0,0,1,19.41666667,1,4,4,8,2,3,2,2,1,0,7,14,17,19,20
2023-24,202403130DET,3/13/2024,DET vs TOR,Jahmi'us Ramsey,ramseja01,2,TOR,0,DET,4,7,0,1,0,0,19.43333333,1,6,1,7,0,4,2,2,1,1,7,4,11,11,15.4
2023-24,202403130DET,3/13/2024,DET vs TOR,James Wiseman,wisemja01,46,DET,1,TOR,6,10,1,0,3,2,19.46666667,1,9,3,4,0,0,0,0,2,3,11,7,16,17,26.5
2023-24,202403130ORL,3/13/2024,ORL vs BRK,Jonathan Isaac,isaacjo01,45,ORL,1,BRK,11,3,0,0,2,0,19.55,0,3,4,6,3,5,0,0,1,2,3,11,14,14,20.6
2023-24,202403130DAL,3/13/2024,DAL vs GSW,Dereck Lively II,livelde01,47,DAL,1,GSW,12,8,0,0,2,1,19.7,1,7,6,8,0,0,0,0,0,2,8,12,20,20,26.6
2023-24,202403130SAC,3/13/2024,SAC vs LAL,Spencer Dinwiddie,dinwisp01,61,LAL,0,SAC,0,1,1,1,0,0,19.71666667,0,1,0,2,0,1,0,0,1,1,2,1,1,2,5.7
2023-24,202403130IND,3/13/2024,IND vs CHI,T.J. McConnell,mccontj01,57,IND,1,CHI,16,4,4,2,0,0,19.98333333,0,4,5,11,1,2,5,5,0,2,8,20,20,24,32.8
2023-24,202403130MIA,3/13/2024,MIA vs DEN,Christian Braun,braunch01,66,DEN,0,MIA,7,2,1,0,0,1,20.06666667,0,2,3,3,1,1,0,0,3,0,3,8,9,10,9.9
2023-24,202403130NOP,3/13/2024,NOP vs CLE,Damian Jones,jonesda03,30,CLE,0,NOP,14,6,0,1,0,1,20.71666667,1,5,7,8,0,0,0,0,2,1,6,14,20,20,23.2
2023-24,202403130POR,3/13/2024,POR vs ATL,Garrison Mathews,mathega01,49,ATL,0,POR,8,2,0,1,0,0,20.75,0,2,2,3,2,3,2,2,4,1,2,8,10,10,13.4
2023-24,202403130IND,3/13/2024,IND vs CHI,Ben Sheppard,sheppbe01,43,IND,1,CHI,2,3,1,0,0,0,20.76666667,0,3,0,5,0,5,2,2,2,0,4,3,5,6,7.1
2023-24,202403130DET,3/13/2024,DET vs TOR,Jontay Porter,portejo01,22,TOR,0,DET,10,6,6,1,4,0,20.81666667,0,6,3,6,2,5,2,4,2,5,12,16,16,22,41.2
2023-24,202403130DET,3/13/2024,DET vs TOR,Jalen McDaniels,mcdanja01,38,TOR,0,DET,8,3,1,0,0,1,20.93333333,0,3,4,11,0,2,0,1,4,0,4,9,11,12,12.1
2023-24,202403130POR,3/13/2024,POR vs ATL,Bruno Fernando,fernabr01,28,ATL,0,POR,6,7,0,1,1,2,20.96666667,1,6,3,5,0,0,0,0,2,2,7,6,13,13,18.4
2023-24,202403130DET,3/13/2024,DET vs TOR,Jordan Nwora,nworajo01,37,TOR,0,DET,12,2,0,3,0,1,21.06666667,0,2,5,11,2,6,0,0,1,3,2,12,14,14,22.4
2023-24,202403130MEM,3/13/2024,MEM vs CHO,Davis Bertans,bertada01,28,CHO,0,MEM,3,5,0,1,1,2,21.3,0,5,1,10,1,9,0,0,0,2,5,3,8,8,13
2023-24,202403130IND,3/13/2024,IND vs CHI,Torrey Craig,craigto01,37,CHI,0,IND,10,5,2,0,0,1,21.95,1,4,3,5,2,4,2,2,3,0,7,12,15,17,18
2023-24,202403130DET,3/13/2024,DET vs TOR,Marcus Sasser,sassema01,56,DET,1,TOR,11,5,3,0,0,0,21.96666667,0,5,4,12,3,7,0,0,4,0,8,14,16,19,21.5
2023-24,202403130MIA,3/13/2024,MIA vs DEN,Peyton Watson,watsope01,64,DEN,0,MIA,6,3,2,0,1,0,22.61666667,0,3,3,7,0,2,0,0,0,1,5,8,9,11,15.6
2023-24,202403130DAL,3/13/2024,DAL vs GSW,Josh Green,greenjo02,53,DAL,1,GSW,11,5,0,0,0,1,23.55,2,3,5,6,1,2,0,0,4,0,5,11,16,16,16
2023-24,202403130IND,3/13/2024,IND vs CHI,Jarace Walker,walkeja02,26,IND,1,CHI,10,4,0,0,0,0,23.7,1,3,3,5,2,4,2,2,1,0,4,10,14,14,14.8
2023-24,202403130MIA,3/13/2024,MIA vs DEN,Kentavious Caldwell-Pope,caldwke01,60,DEN,0,MIA,9,1,2,2,0,0,24.71666667,0,1,4,9,1,5,0,0,0,2,3,11,10,12,19.2
2023-24,202403130ORL,3/13/2024,ORL vs BRK,Dorian Finney-Smith,finnedo01,57,BRK,0,ORL,6,3,2,2,0,0,24.73333333,1,2,2,8,0,5,2,2,3,2,5,8,9,11,18.6
2023-24,202403130DAL,3/13/2024,DAL vs GSW,Dante Exum,exumda01,40,DAL,1,GSW,9,2,6,1,0,1,24.95,0,2,3,4,1,1,2,3,1,1,8,15,11,17,22.4
2023-24,202403130DAL,3/13/2024,DAL vs GSW,Trayce Jackson-Davis,jackstr02,52,GSW,0,DAL,10,9,1,0,1,1,25.2,6,3,5,9,0,0,0,0,1,1,10,11,19,20,24.3
2023-24,202403130MIA,3/13/2024,MIA vs DEN,Caleb Martin,martica02,48,MIA,1,DEN,9,2,1,0,0,1,25.4,1,1,3,7,1,3,2,2,1,0,3,10,11,12,11.9
2023-24,202403130NOP,3/13/2024,NOP vs CLE,Herbert Jones,joneshe01,60,NOP,1,CLE,3,5,3,2,3,1,25.75,1,4,0,0,0,0,3,4,5,5,8,6,8,11,27.5
2023-24,202403130NOP,3/13/2024,NOP vs CLE,Naji Marshall,marshna01,53,NOP,1,CLE,7,5,2,1,0,1,26.01666667,0,5,2,7,1,5,2,2,0,1,7,9,12,14,18
2023-24,202403130DET,3/13/2024,DET vs TOR,Ochai Agbaji,agbajoc01,65,TOR,0,DET,0,1,3,2,0,1,26.16666667,0,1,0,3,0,1,0,0,2,2,4,3,1,4,10.7
2023-24,202403130SAC,3/13/2024,SAC vs LAL,Malik Monk,monkma01,64,SAC,1,LAL,8,3,6,0,0,2,26.28333333,0,3,3,10,1,4,1,2,3,0,9,14,11,17,18.6
2023-24,202403130DAL,3/13/2024,DAL vs GSW,Daniel Gafford,gaffoda01,59,DAL,1,GSW,10,6,1,2,7,2,26.31666667,2,4,5,5,0,0,0,0,4,9,7,11,16,17,43.7
2023-24,202403130MEM,3/13/2024,MEM vs CHO,Aleksej Pokusevski,pokusal01,13,CHO,0,MEM,9,5,3,1,2,3,26.53333333,1,4,4,5,1,2,0,0,2,3,8,12,14,17,25.5
2023-24,202403130IND,3/13/2024,IND vs CHI,Aaron Nesmith,nesmiaa01,59,IND,1,CHI,13,4,1,0,0,0,26.65,1,3,4,12,3,7,2,2,6,0,5,14,17,18,19.3
2023-24,202403130ORL,3/13/2024,ORL vs BRK,Wendell Carter Jr.,cartewe01,39,ORL,1,BRK,15,8,2,1,1,2,26.66666667,2,6,5,8,1,4,4,6,4,2,10,17,23,25,31.6
2023-24,202403130DAL,3/13/2024,DAL vs GSW,Klay Thompson,thompkl01,62,GSW,0,DAL,8,4,0,1,1,2,26.76666667,1,3,3,13,2,7,0,0,0,2,4,8,12,12,16.8
2023-24,202403130MEM,3/13/2024,MEM vs CHO,Scotty Pippen Jr.,pippesc02,9,MEM,1,CHO,9,4,10,2,1,3,27.16666667,1,3,4,8,0,2,1,2,2,3,14,19,13,23,34.8
2023-24,202403130POR,3/13/2024,POR vs ATL,Clint Capela,capelca01,57,ATL,0,POR,13,14,1,2,0,2,27.23333333,7,7,6,9,0,0,1,5,4,2,15,14,27,28,35.3
2023-24,202403130MEM,3/13/2024,MEM vs CHO,Luke Kennard,kennalu01,35,MEM,1,CHO,17,4,3,1,0,2,27.35,1,3,6,13,4,8,1,1,0,1,7,20,21,24,27.3
2023-24,202403130DET,3/13/2024,DET vs TOR,Cade Cunningham,cunnica01,55,DET,1,TOR,19,3,6,1,0,3,27.51666667,0,3,8,20,2,5,1,2,2,1,9,25,22,28,31.6
2023-24,202403130ORL,3/13/2024,ORL vs BRK,Franz Wagner,wagnefr01,58,ORL,1,BRK,14,5,6,3,0,0,27.53333333,1,4,6,14,1,4,1,1,5,3,11,20,19,25,38
2023-24,202403130NOP,3/13/2024,NOP vs CLE,Trey Murphy III,murphtr02,40,NOP,1,CLE,11,1,3,0,1,2,27.6,0,1,4,10,1,6,2,2,3,1,4,14,12,15,17.7
2023-24,202403130DAL,3/13/2024,DAL vs GSW,Brandin Podziemski,podzibr01,57,GSW,0,DAL,11,5,6,4,0,2,27.68333333,1,4,4,12,2,5,1,2,1,4,11,17,16,22,36
2023-24,202403130DAL,3/13/2024,DAL vs GSW,Andrew Wiggins,wiggian01,56,GSW,0,DAL,17,5,1,1,0,2,27.75,1,4,5,12,1,4,6,6,1,1,6,18,22,23,25.5
2023-24,202403130MEM,3/13/2024,MEM vs CHO,Grant Williams,willigr01,62,CHO,0,MEM,18,6,3,1,1,6,27.75,0,6,6,11,1,4,5,5,0,2,9,21,24,27,29.7
2023-24,202403130NOP,3/13/2024,NOP vs CLE,Sam Merrill,merrisa01,48,CLE,0,NOP,15,2,9,0,0,1,27.81666667,0,2,5,10,5,10,0,0,0,0,11,24,17,26,29.9
2023-24,202403130NOP,3/13/2024,NOP vs CLE,Donovan Mitchell,mitchdo01,48,CLE,0,NOP,14,4,5,0,1,2,27.88333333,1,3,5,16,4,9,0,0,2,1,9,19,18,23,27.3
2023-24,202403130NOP,3/13/2024,NOP vs CLE,Georges Niang,niangge01,66,CLE,0,NOP,16,6,1,0,0,0,27.96666667,0,6,6,12,4,8,0,0,5,0,7,17,22,23,24.7
2023-24,202403130MIA,3/13/2024,MIA vs DEN,Jaime Jaquez Jr.,jaqueja01,59,MIA,1,DEN,8,2,0,0,0,1,28.16666667,0,2,2,6,0,1,4,4,2,0,2,8,10,10,9.4
2023-24,202403130SAC,3/13/2024,SAC vs LAL,Keon Ellis,elliske01,40,SAC,1,LAL,14,2,0,3,1,1,28.18333333,0,2,5,8,3,5,1,2,2,4,2,14,16,16,27.4
2023-24,202403130DET,3/13/2024,DET vs TOR,Jalen Duren,durenja01,50,DET,1,TOR,24,23,5,1,0,5,28.3,9,14,8,9,0,0,8,10,3,1,28,29,47,52,57.1
2023-24,202403130ORL,3/13/2024,ORL vs BRK,Cameron Johnson,johnsca02,50,BRK,0,ORL,13,3,2,1,0,2,28.68333333,0,3,4,7,2,4,3,3,2,1,5,15,16,18,20.6
2023-24,202403130MEM,3/13/2024,MEM vs CHO,Nick Richards,richani01,56,CHO,0,MEM,8,5,1,0,2,2,28.73333333,2,3,3,4,0,0,2,4,3,2,6,9,13,14,19.5
2023-24,202403130ORL,3/13/2024,ORL vs BRK,Dennis Schroder,schrode01,66,BRK,0,ORL,13,1,3,1,0,4,29,0,1,3,8,1,4,6,6,3,1,4,16,14,17,17.7
2023-24,202403130NOP,3/13/2024,NOP vs CLE,CJ McCollum,mccolcj01,49,NOP,1,CLE,8,3,1,0,2,1,29.26666667,0,3,3,10,0,5,2,2,0,2,4,9,11,12,18.1
2023-24,202403130DAL,3/13/2024,DAL vs GSW,Luka Doncic,doncilu01,58,DAL,1,GSW,21,3,9,0,0,6,29.58333333,1,2,7,18,1,6,6,8,0,0,12,30,24,33,32.1
2023-24,202403130NOP,3/13/2024,NOP vs CLE,Caris LeVert,leverca01,54,CLE,0,NOP,2,5,9,1,0,1,29.61666667,1,4,1,6,0,3,0,0,1,1,14,11,7,16,23.5
2023-24,202403130IND,3/13/2024,IND vs CHI,Andrew Nembhard,nembhan01,53,IND,1,CHI,8,3,2,0,1,1,29.63333333,1,2,4,12,0,5,0,0,0,1,5,10,11,13,16.6
2023-24,202403130ORL,3/13/2024,ORL vs BRK,Mikal Bridges,bridgmi01,66,BRK,0,ORL,17,4,1,0,1,2,29.71666667,1,3,5,13,1,2,6,7,1,1,5,18,21,22,24.3
2023-24,202403130ORL,3/13/2024,ORL vs BRK,Gary Harris,harriga01,42,ORL,1,BRK,13,2,1,1,1,0,29.83333333,0,2,4,8,2,5,3,4,0,2,3,14,15,16,22.9
2023-24,202403130ORL,3/13/2024,ORL vs BRK,Jalen Suggs,suggsja01,59,ORL,1,BRK,14,4,2,0,0,3,29.83333333,1,3,5,12,4,8,0,0,2,0,6,16,18,20,18.8
2023-24,202403130MEM,3/13/2024,MEM vs CHO,Tre Mann,manntr01,25,CHO,0,MEM,10,5,0,2,0,3,29.88333333,1,4,5,9,0,2,0,1,1,2,5,10,15,15,19
2023-24,202403130ORL,3/13/2024,ORL vs BRK,Nic Claxton,claxtni01,56,BRK,0,ORL,10,5,5,0,2,1,29.95,2,3,5,8,0,0,0,0,2,2,10,15,15,20,28.5
2023-24,202403130MEM,3/13/2024,MEM vs CHO,Jake LaRavia,laravja01,22,MEM,1,CHO,5,5,0,3,0,1,30.2,3,2,2,13,1,6,0,0,2,3,5,5,10,10,19
2023-24,202403130MEM,3/13/2024,MEM vs CHO,Vasilije Micic,micicva01,45,CHO,0,MEM,25,0,8,2,0,2,30.25,0,0,9,10,5,6,2,2,2,2,8,33,25,33,41
2023-24,202403130POR,3/13/2024,POR vs ATL,Toumani Camara,camarto01,62,POR,1,ATL,3,6,3,0,1,1,30.35,2,4,1,3,0,1,1,2,3,1,9,6,9,12,16.7
2023-24,202403130DET,3/13/2024,DET vs TOR,Kelly Olynyk,olynyke01,64,TOR,0,DET,19,6,8,2,2,6,30.6,2,4,8,11,2,4,1,2,4,4,14,27,25,33,44.2
2023-24,202403130MIA,3/13/2024,MIA vs DEN,Duncan Robinson,robindu01,60,MIA,1,DEN,11,6,3,1,0,1,30.76666667,0,6,5,10,1,6,0,0,2,1,9,14,17,20,24.7
2023-24,202403130DAL,3/13/2024,DAL vs GSW,Chris Paul,paulch01,41,GSW,0,DAL,9,4,4,0,0,0,31.16666667,0,4,4,12,1,4,0,0,3,0,8,13,13,17,19.8
2023-24,202403130POR,3/13/2024,POR vs ATL,Vit Krejci,krejcvi01,5,ATL,0,POR,7,2,2,1,1,1,31.26666667,1,1,2,4,2,4,1,2,2,2,4,9,9,11,17.4
2023-24,202403130MIA,3/13/2024,MIA vs DEN,Jamal Murray,murraja01,50,DEN,0,MIA,14,2,5,1,0,0,31.4,0,2,5,14,2,8,2,2,1,1,7,19,16,21,26.9
2023-24,202403130NOP,3/13/2024,NOP vs CLE,Jarrett Allen,allenja01,61,CLE,0,NOP,17,10,1,0,2,1,31.61666667,2,8,8,13,0,0,1,2,1,2,11,18,27,28,35.5
2023-24,202403130MEM,3/13/2024,MEM vs CHO,Trey Jemison,jemistr01,15,MEM,1,CHO,14,6,1,1,2,3,31.91666667,5,1,6,8,0,0,2,2,3,3,7,15,20,21,28.7
2023-24,202403130POR,3/13/2024,POR vs ATL,Matisse Thybulle,thybuma01,62,POR,1,ATL,8,5,4,2,2,1,32.06666667,1,4,3,6,2,4,0,0,1,4,9,12,13,17,31
2023-24,202403130NOP,3/13/2024,NOP vs CLE,Brandon Ingram,ingrabr01,59,NOP,1,CLE,20,5,5,1,0,2,32.08333333,1,4,8,14,0,1,4,5,2,1,10,25,25,30,34.5
2023-24,202403130DET,3/13/2024,DET vs TOR,Gradey Dick,dickgr01,45,TOR,0,DET,9,3,1,1,0,2,32.38333333,0,3,4,13,1,6,0,0,2,1,4,10,12,13,15.1
2023-24,202403130POR,3/13/2024,POR vs ATL,De'Andre Hunter,huntede01,41,ATL,0,POR,11,1,1,1,1,1,32.66666667,1,0,4,12,1,6,2,2,2,2,2,12,12,13,18.7
2023-24,202403130DET,3/13/2024,DET vs TOR,Isaiah Stewart,stewais01,43,DET,1,TOR,15,2,1,0,3,2,32.78333333,0,2,5,6,3,3,2,3,2,3,3,16,17,18,25.9
2023-24,202403130NOP,3/13/2024,NOP vs CLE,Isaac Okoro,okorois01,57,CLE,0,NOP,7,7,2,0,0,1,32.96666667,3,4,3,8,1,4,0,0,4,0,9,9,14,16,17.4
2023-24,202403130DET,3/13/2024,DET vs TOR,Bruce Brown,brownbr01,55,TOR,0,DET,17,4,5,2,1,0,33,0,4,8,12,0,0,1,2,2,3,9,22,21,26,38.3
2023-24,202403130SAC,3/13/2024,SAC vs LAL,D'Angelo Russell,russeda01,63,LAL,0,SAC,6,2,6,1,1,2,33.16666667,1,1,2,9,1,4,1,2,1,2,8,12,8,14,21.4
2023-24,202403130MIA,3/13/2024,MIA vs DEN,Aaron Gordon,gordoaa01,60,DEN,0,MIA,16,8,4,0,0,1,33.4,2,6,6,11,1,4,3,6,4,0,12,20,24,28,30.6
2023-24,202403130POR,3/13/2024,POR vs ATL,Bogdan Bogdanovic,bogdabo01,63,ATL,0,POR,8,7,8,3,1,2,33.51666667,2,5,3,15,2,9,0,0,3,4,15,16,15,23,38.4
2023-24,202403130MIA,3/13/2024,MIA vs DEN,Michael Porter Jr.,portemi01,65,DEN,0,MIA,25,7,0,0,0,1,33.53333333,2,5,9,16,5,9,2,2,0,0,7,25,32,32,32.4
2023-24,202403130MEM,3/13/2024,MEM vs CHO,John Konchar,konchjo01,51,MEM,1,CHO,13,9,4,3,0,3,34,1,8,5,8,3,5,0,0,2,3,13,17,22,26,35.8
2023-24,202403130IND,3/13/2024,IND vs CHI,Myles Turner,turnemy01,64,IND,1,CHI,27,7,1,0,1,1,34,0,7,9,15,5,8,4,6,1,1,8,28,34,35,38.9
2023-24,202403130DAL,3/13/2024,DAL vs GSW,P.J. Washington,washipj01,58,DAL,1,GSW,11,7,1,2,3,1,34,1,6,5,11,1,6,0,0,1,5,8,12,18,19,34.9
2023-24,202403130NOP,3/13/2024,NOP vs CLE,Darius Garland,garlada01,42,CLE,0,NOP,27,6,11,2,1,1,34.18333333,0,6,10,16,6,10,1,1,2,3,17,38,33,44,58.7
2023-24,202403130MIA,3/13/2024,MIA vs DEN,Bam Adebayo,adebaba01,55,MIA,1,DEN,17,13,3,1,1,0,34.35,1,12,7,15,1,1,2,4,2,2,16,20,30,33,43.1
2023-24,202403130MIA,3/13/2024,MIA vs DEN,Terry Rozier,roziete01,48,MIA,1,DEN,14,4,4,1,0,2,34.83333333,1,3,6,13,0,3,2,2,1,1,8,18,18,22,25.8
2023-24,202403130POR,3/13/2024,POR vs ATL,Kris Murray,murrakr01,45,POR,1,ATL,9,6,2,1,1,6,34.91666667,2,4,3,8,1,3,2,3,4,2,8,11,15,17,19.2
2023-24,202403130DAL,3/13/2024,DAL vs GSW,Kyrie Irving,irvinky01,44,DAL,1,GSW,23,8,10,1,1,1,34.95,0,8,8,16,1,5,6,6,3,2,18,33,31,41,52.6
2023-24,202403130NOP,3/13/2024,NOP vs CLE,Zion Williamson,willizi01,54,NOP,1,CLE,33,9,1,1,0,2,34.98333333,2,7,13,21,0,0,7,9,1,1,10,34,42,43,46.3
2023-24,202403130ORL,3/13/2024,ORL vs BRK,Paolo Banchero,banchpa01,64,ORL,1,BRK,21,3,9,0,0,2,35.08333333,0,3,6,6,1,1,8,9,4,0,12,30,24,33,36.1
2023-24,202403130DAL,3/13/2024,DAL vs GSW,Jonathan Kuminga,kuminjo01,64,GSW,0,DAL,27,4,2,1,0,6,35.2,1,3,8,17,2,2,9,10,2,1,6,29,31,33,31.8
2023-24,202403130SAC,3/13/2024,SAC vs LAL,De'Aaron Fox,foxde01,57,SAC,1,LAL,21,4,7,1,0,2,35.21666667,1,3,9,20,1,5,2,2,3,1,11,28,25,32,37.3
2023-24,202403130DET,3/13/2024,DET vs TOR,Immanuel Quickley,quickim01,60,TOR,0,DET,25,5,8,1,1,0,35.6,0,5,8,19,2,8,7,8,2,2,13,33,30,38,49
2023-24,202403130MIA,3/13/2024,MIA vs DEN,Jimmy Butler,butleji01,46,MIA,1,DEN,15,5,2,0,1,1,35.85,3,2,6,16,1,2,2,2,2,1,7,17,20,22,26
2023-24,202403130SAC,3/13/2024,SAC vs LAL,Rui Hachimura,hachiru01,54,LAL,0,SAC,20,3,1,0,0,2,35.88333333,1,2,9,11,2,3,0,0,1,0,4,21,23,24,23.1
2023-24,202403130MEM,3/13/2024,MEM vs CHO,Brandon Miller,millebr02,59,CHO,0,MEM,10,3,5,4,0,1,36.03333333,1,2,4,12,2,6,0,1,1,4,8,15,13,18,32.1
2023-24,202403130IND,3/13/2024,IND vs CHI,Pascal Siakam,siakapa01,65,IND,1,CHI,17,9,3,2,2,2,36.23333333,3,6,8,12,0,1,1,3,5,4,12,20,26,29,42.3
2023-24,202403130IND,3/13/2024,IND vs CHI,Coby White,whiteco01,66,CHI,0,IND,15,4,3,2,1,1,36.33333333,2,2,6,17,1,3,2,3,2,3,7,18,19,22,32.3
2023-24,202403130IND,3/13/2024,IND vs CHI,Alex Caruso,carusal01,57,CHI,0,IND,23,7,7,1,0,1,36.73333333,1,6,9,13,5,6,0,0,3,1,14,30,30,37,43.9
2023-24,202403130DET,3/13/2024,DET vs TOR,Jaden Ivey,iveyja01,61,DET,1,TOR,14,3,7,2,1,5,37.03333333,1,2,5,13,0,2,4,6,2,3,10,21,17,24,32.1
2023-24,202403130MEM,3/13/2024,MEM vs CHO,GG Jackson II,jacksgg01,33,MEM,1,CHO,26,4,0,0,0,3,37.25,3,1,8,17,6,12,4,4,3,0,4,26,30,30,27.8
2023-24,202403130SAC,3/13/2024,SAC vs LAL,Austin Reaves,reaveau01,68,LAL,0,SAC,28,6,4,1,0,1,37.46666667,0,6,10,17,7,12,1,2,1,1,10,32,34,38,43.2
2023-24,202403130MIA,3/13/2024,MIA vs DEN,Nikola Jokic,jokicni01,64,DEN,0,MIA,12,14,6,1,0,4,37.61666667,3,11,5,8,0,0,2,3,1,1,20,18,26,32,36.8
2023-24,202403130SAC,3/13/2024,SAC vs LAL,Domantas Sabonis,sabondo01,65,SAC,1,LAL,17,19,10,2,1,2,37.93333333,5,14,6,10,0,1,5,6,4,3,29,27,36,46,61.8
2023-24,202403130IND,3/13/2024,IND vs CHI,Tyrese Haliburton,halibty01,55,IND,1,CHI,17,3,14,0,1,2,38.31666667,0,3,6,13,1,6,4,4,3,1,17,31,20,34,42.6
2023-24,202403130SAC,3/13/2024,SAC vs LAL,Harrison Barnes,barneha02,65,SAC,1,LAL,23,2,2,0,0,0,38.36666667,0,2,8,15,7,11,0,0,2,0,4,25,25,27,28.4
2023-24,202403130DET,3/13/2024,DET vs TOR,Simone Fontecchio,fontesi01,64,DET,1,TOR,12,4,0,0,0,3,38.43333333,0,4,3,11,2,7,4,4,1,0,4,12,16,16,13.8
2023-24,202403130ORL,3/13/2024,ORL vs BRK,Cam Thomas,thomaca02,51,BRK,0,ORL,21,8,4,1,0,2,38.76666667,1,7,9,19,1,4,2,3,5,1,12,25,29,33,37.6
2023-24,202403130SAC,3/13/2024,SAC vs LAL,Keegan Murray,murrake02,60,SAC,1,LAL,19,11,3,2,0,3,38.9,3,8,7,13,5,10,0,0,3,2,14,22,30,33,39.7
2023-24,202403130MEM,3/13/2024,MEM vs CHO,Miles Bridges,bridgmi02,55,CHO,0,MEM,27,6,6,1,1,1,39.51666667,1,5,12,21,3,7,0,0,2,2,12,33,33,39,48.2
2023-24,202403130SAC,3/13/2024,SAC vs LAL,LeBron James,jamesle01,59,LAL,0,SAC,18,13,9,2,0,5,40.11666667,1,12,6,16,2,8,4,6,3,2,22,27,31,40,48.1
2023-24,202403130POR,3/13/2024,POR vs ATL,Deandre Ayton,aytonde01,43,POR,1,ATL,33,19,1,1,1,3,40.5,4,15,15,20,0,0,3,4,3,2,20,34,52,53,60.3
2023-24,202403130SAC,3/13/2024,SAC vs LAL,Anthony Davis,davisan02,64,LAL,0,SAC,22,10,3,1,1,2,41.13333333,3,7,7,18,1,2,7,8,1,2,13,25,32,35,42.5
2023-24,202403130POR,3/13/2024,POR vs ATL,Anfernee Simons,simonan01,42,POR,1,ATL,36,7,8,1,0,1,42.95,2,5,10,23,5,13,11,11,2,1,15,44,43,51,58.4
2023-24,202403130IND,3/13/2024,IND vs CHI,Ayo Dosunmu,dosunay01,64,CHI,0,IND,20,4,3,0,2,2,43.03333333,0,4,7,12,1,4,5,6,3,2,7,23,24,27,33.3
2023-24,202403130IND,3/13/2024,IND vs CHI,Nikola Vucevic,vucevni01,61,CHI,0,IND,12,12,3,1,0,1,43.16666667,1,11,6,14,0,4,0,0,4,1,15,15,24,27,32.9
2023-24,202403130POR,3/13/2024,POR vs ATL,Dejounte Murray,murrade01,62,ATL,0,POR,40,4,3,2,1,5,43.23333333,1,3,15,29,6,13,4,5,5,3,7,43,44,47,53.3
2023-24,202403130IND,3/13/2024,IND vs CHI,DeMar DeRozan,derozde01,64,CHI,0,IND,46,9,3,2,1,2,44.13333333,0,9,15,24,1,6,15,17,1,3,12,49,55,58,68.3
2023-24,202403120MEM,3/12/2024,MEM vs WAS,Jared Butler,butleja02,23,WAS,0,MEM,6,0,2,1,0,1,10.13333333,0,0,3,4,0,0,0,0,1,1,2,8,6,8,11
2023-24,202403120NYK,3/12/2024,NYK vs PHI,KJ Martin,martike04,48,PHI,0,NYK,0,0,0,0,0,0,10.58333333,0,0,0,2,0,0,0,0,0,0,0,0,0,0,0
2023-24,202403120SAC,3/12/2024,SAC vs MIL,Chris Duarte,duartch01,44,SAC,1,MIL,6,5,2,0,0,0,10.78333333,1,4,2,4,1,2,1,2,2,0,7,8,11,13,15
2023-24,202403120SAS,3/12/2024,SAS vs HOU,Aaron Holiday,holidaa01,62,HOU,0,SAS,8,1,0,0,0,0,11.1,0,1,3,6,0,1,2,2,1,0,1,8,9,9,9.2
2023-24,202403120SAS,3/12/2024,SAS vs HOU,Sandro Mamukelashvili,mamuksa01,37,SAS,1,HOU,6,5,3,0,0,0,11.18333333,4,1,3,3,0,0,0,0,2,0,8,9,11,14,16.5
2023-24,202403120MEM,3/12/2024,MEM vs WAS,Patrick Baldwin Jr.,baldwpa01,22,WAS,0,MEM,0,3,0,1,0,0,11.45,0,3,0,1,0,1,0,0,0,1,3,0,3,3,6.6
2023-24,202403120NYK,3/12/2024,NYK vs PHI,Alec Burks,burksal01,56,NYK,1,PHI,2,2,1,0,0,0,11.56666667,0,2,1,6,0,4,0,0,0,0,3,3,4,5,5.9
2023-24,202403120LAC,3/12/2024,LAC vs MIN,Kawhi Leonard,leonaka01,58,LAC,1,MIN,6,2,2,0,0,0,12,0,2,2,4,1,2,1,2,0,0,4,8,8,10,11.4
2023-24,202403120UTA,3/12/2024,UTA vs BOS,Micah Potter,pottemi01,3,UTA,1,BOS,8,2,0,0,0,0,12.86666667,0,2,3,3,2,2,0,0,1,0,2,8,10,10,10.4
2023-24,202403120SAS,3/12/2024,SAS vs HOU,Jae'Sean Tate,tateja01,55,HOU,0,SAS,2,2,0,0,2,1,12.96666667,1,1,1,2,0,0,0,0,1,2,2,2,4,4,9.4
2023-24,202403120LAC,3/12/2024,LAC vs MIN,T.J. Warren,warretj01,4,MIN,0,LAC,2,0,1,0,0,1,13.73333333,0,0,1,4,0,2,0,0,2,0,1,3,2,3,2.5
2023-24,202403120SAS,3/12/2024,SAS vs HOU,Reggie Bullock,bullore01,27,HOU,0,SAS,2,0,0,2,0,0,13.8,0,0,1,3,0,2,0,0,0,2,0,2,2,2,8
2023-24,202403120UTA,3/12/2024,UTA vs BOS,Luka Samanic,samanlu01,33,UTA,1,BOS,7,7,1,0,0,0,14.31666667,1,6,2,4,1,1,2,2,0,0,8,8,14,15,16.9
2023-24,202403120SAS,3/12/2024,SAS vs HOU,Jeff Green,greenje02,61,HOU,0,SAS,8,1,0,1,0,0,14.33333333,0,1,2,5,1,2,3,4,0,1,1,8,9,9,12.2
2023-24,202403120OKC,3/12/2024,OKC vs IND,Aaron Wiggins,wiggiaa01,62,OKC,1,IND,7,2,0,0,0,1,15.21666667,1,1,3,7,0,2,1,2,0,0,2,7,9,9,8.4
2023-24,202403120LAC,3/12/2024,LAC vs MIN,Daniel Theis,theisda01,49,LAC,1,MIN,10,4,1,1,2,1,15.25,1,3,4,5,1,1,1,1,0,3,5,11,14,15,24.3
2023-24,202403120SAC,3/12/2024,SAC vs MIL,Jae Crowder,crowdja01,35,MIL,0,SAC,0,0,2,1,0,0,15.93333333,0,0,0,0,0,0,0,0,1,1,2,2,0,2,6
2023-24,202403120SAS,3/12/2024,SAS vs HOU,Blake Wesley,weslebl01,45,SAS,1,HOU,10,3,3,0,0,0,16.16666667,0,3,4,7,0,1,2,2,1,0,6,13,13,16,18.1
2023-24,202403120SAS,3/12/2024,SAS vs HOU,Zach Collins,colliza01,54,SAS,1,HOU,7,2,1,1,2,1,16.46666667,1,1,2,7,0,2,3,4,3,3,3,8,9,10,18.9
2023-24,202403120NYK,3/12/2024,NYK vs PHI,Mo Bamba,bambamo01,43,PHI,0,NYK,5,2,0,0,1,0,16.61666667,1,1,2,3,1,1,0,0,3,1,2,5,7,7,10.4
2023-24,202403120UTA,3/12/2024,UTA vs BOS,Oshae Brissett,brissos01,42,BOS,0,UTA,2,5,1,0,0,0,16.75,2,3,1,1,0,0,0,2,0,0,6,3,7,8,9.5
2023-24,202403120MEM,3/12/2024,MEM vs WAS,Wenyen Gabriel,gabriwe01,3,MEM,1,WAS,7,6,0,0,1,2,16.86666667,2,4,3,6,1,2,0,0,2,1,6,7,13,13,15.2
2023-24,202403120LAC,3/12/2024,LAC vs MIN,Jordan McLaughlin,mclaujo01,40,MIN,0,LAC,4,6,2,2,1,0,17.05,1,5,2,3,0,0,0,0,1,3,8,6,10,12,23.2
2023-24,202403120SAC,3/12/2024,SAC vs MIL,A.J. Green,greenaj01,43,MIL,0,SAC,3,1,1,0,0,0,17.06666667,0,1,1,6,1,4,0,0,2,0,2,4,4,5,5.7
2023-24,202403120UTA,3/12/2024,UTA vs BOS,Talen Horton-Tucker,hortota01,42,UTA,1,BOS,5,2,0,2,0,0,17.26666667,0,2,2,7,1,2,0,0,0,2,2,5,7,7,13.4
2023-24,202403120OKC,3/12/2024,OKC vs IND,Ben Sheppard,sheppbe01,42,IND,0,OKC,4,2,0,0,0,0,17.45,1,1,2,5,0,3,0,0,1,0,2,4,6,6,6.4
2023-24,202403120OKC,3/12/2024,OKC vs IND,T.J. McConnell,mccontj01,56,IND,0,OKC,9,0,4,1,0,1,17.48333333,0,0,4,8,1,1,0,0,0,1,4,13,9,13,17
2023-24,202403120LAC,3/12/2024,LAC vs MIN,Bones Hyland,hylanbo01,26,LAC,1,MIN,8,2,3,0,0,2,17.88333333,0,2,3,8,2,4,0,0,4,0,5,11,10,13,12.9
2023-24,202403120SAC,3/12/2024,SAC vs MIL,Davion Mitchell,mitchda01,54,SAC,1,MIL,3,2,2,0,0,1,17.88333333,0,2,1,5,1,5,0,0,1,0,4,5,5,7,7.4
2023-24,202403120OKC,3/12/2024,OKC vs IND,Jalen Smith,smithja04,46,IND,0,OKC,6,9,3,0,1,1,17.96666667,1,8,2,5,0,2,2,2,1,1,12,9,15,18,23.3
2023-24,202403120LAC,3/12/2024,LAC vs MIN,Amir Coffey,coffeam01,52,LAC,1,MIN,8,1,1,0,0,0,18.23333333,0,1,3,6,1,4,1,1,1,0,2,9,9,10,10.7
2023-24,202403120OKC,3/12/2024,OKC vs IND,Obi Toppin,toppiob01,67,IND,0,OKC,10,4,1,0,0,0,18.65,1,3,4,6,0,1,2,4,1,0,5,11,14,15,16.3
2023-24,202403120UTA,3/12/2024,UTA vs BOS,Walker Kessler,kesslwa01,53,UTA,1,BOS,2,8,1,0,1,0,18.68333333,3,5,1,1,0,0,0,0,0,1,9,3,10,11,16.1
2023-24,202403120OKC,3/12/2024,OKC vs IND,Isaiah Joe,joeis01,61,OKC,1,IND,6,3,1,1,0,1,18.75,0,3,2,8,2,5,0,0,1,1,4,7,9,10,13.1
2023-24,202403120NYK,3/12/2024,NYK vs PHI,Isaiah Hartenstein,harteis01,59,NYK,1,PHI,6,5,2,0,0,0,19.85,3,2,3,3,0,0,0,0,3,0,7,8,11,13,15
2023-24,202403120NYK,3/12/2024,NYK vs PHI,Cameron Payne,payneca01,61,PHI,0,NYK,7,1,1,0,1,0,20.18333333,0,1,2,9,0,3,3,4,5,1,2,8,8,9,12.7
2023-24,202403120SAC,3/12/2024,SAC vs MIL,Bobby Portis,portibo01,66,MIL,0,SAC,11,7,1,0,0,0,20.68333333,0,7,4,7,0,0,3,4,3,0,8,12,18,19,20.9
2023-24,202403120MEM,3/12/2024,MEM vs WAS,DeJon Jarreau,jarrede01,2,MEM,1,WAS,8,5,6,2,0,2,20.95,1,4,3,8,0,1,2,2,4,2,11,14,13,19,27
2023-24,202403120NYK,3/12/2024,NYK vs PHI,Nicolas Batum,batumni01,44,PHI,0,NYK,0,2,0,1,0,0,21.06666667,0,2,0,4,0,3,0,0,1,1,2,0,2,2,5.4
2023-24,202403120NYK,3/12/2024,NYK vs PHI,Kyle Lowry,lowryky01,46,PHI,0,NYK,2,2,6,2,0,1,21.11666667,0,2,1,4,0,3,0,0,0,2,8,8,4,10,18.4
2023-24,202403120LAC,3/12/2024,LAC vs MIN,Naz Reid,reidna01,66,MIN,0,LAC,6,5,3,1,1,0,21.93333333,1,4,3,7,0,3,0,0,3,2,8,9,11,14,22.5
2023-24,202403120SAS,3/12/2024,SAS vs HOU,Malaki Branham,branhma01,61,SAS,1,HOU,4,1,3,0,0,2,22.25,0,1,2,7,0,4,0,0,1,0,4,7,5,8,7.7
2023-24,202403120NYK,3/12/2024,NYK vs PHI,Bojan Bogdanovic,bogdabo02,40,NYK,1,PHI,0,2,1,0,0,2,22.26666667,0,2,0,2,0,1,0,0,1,0,3,1,2,3,1.9
2023-24,202403120SAS,3/12/2024,SAS vs HOU,Amen Thompson,thompam01,46,HOU,0,SAS,6,4,2,1,0,1,22.55,1,3,2,2,0,0,2,2,1,1,6,8,10,12,15.8
2023-24,202403120SAC,3/12/2024,SAC vs MIL,Pat Connaughton,connapa01,60,MIL,0,SAC,7,4,1,0,0,1,22.91666667,3,1,2,9,1,7,2,2,1,0,5,8,11,12,12.3
2023-24,202403120NYK,3/12/2024,NYK vs PHI,Miles McBride,mcbrimi01,52,NYK,1,PHI,13,2,2,0,0,0,22.96666667,0,2,5,8,3,5,0,0,2,0,4,15,15,17,18.4
2023-24,202403120UTA,3/12/2024,UTA vs BOS,Brice Sensabaugh,sensabr01,15,UTA,1,BOS,2,4,4,0,0,0,23.05,0,4,1,5,0,2,0,0,1,0,8,6,6,10,12.8
2023-24,202403120OKC,3/12/2024,OKC vs IND,Cason Wallace,wallaca01,65,OKC,1,IND,11,3,0,0,1,3,23.33333333,0,3,4,7,3,4,0,0,2,1,3,11,14,14,14.6
2023-24,202403120LAC,3/12/2024,LAC vs MIN,Jaden McDaniels,mcdanja02,56,MIN,0,LAC,0,4,1,2,0,1,23.4,1,3,0,8,0,4,0,0,4,2,5,1,4,5,11.3
2023-24,202403120MEM,3/12/2024,MEM vs WAS,Jake LaRavia,laravja01,21,MEM,1,WAS,16,4,1,2,0,0,23.68333333,2,2,4,9,1,4,7,7,2,2,5,17,20,21,28.3
2023-24,202403120NYK,3/12/2024,NYK vs PHI,Precious Achiuwa,achiupr01,58,NYK,1,PHI,13,8,1,0,2,4,23.95,3,5,6,8,0,1,1,2,5,2,9,14,21,22,26.1
2023-24,202403120NYK,3/12/2024,NYK vs PHI,Buddy Hield,hieldbu01,68,PHI,0,NYK,9,4,4,0,1,1,24.25,1,3,4,11,1,7,0,0,1,1,8,13,13,17,21.8
2023-24,202403120UTA,3/12/2024,UTA vs BOS,Kris Dunn,dunnkr01,57,UTA,1,BOS,6,3,4,1,1,0,24.41666667,0,3,2,6,2,3,0,0,2,2,7,10,9,13,21.6
2023-24,202403120SAC,3/12/2024,SAC vs MIL,Malik Beasley,beaslma01,64,MIL,0,SAC,11,3,2,0,0,2,25,0,3,4,13,3,11,0,0,1,0,5,13,14,16,15.6
2023-24,202403120SAC,3/12/2024,SAC vs MIL,Kevin Huerter,huertke01,62,SAC,1,MIL,11,5,3,2,0,1,25.25,0,5,4,10,3,8,0,0,3,2,8,14,16,19,26.5
2023-24,202403120UTA,3/12/2024,UTA vs BOS,Payton Pritchard,pritcpa01,65,BOS,0,UTA,10,2,2,0,0,1,25.28333333,0,2,3,12,2,9,2,2,2,0,4,12,12,14,14.4
2023-24,202403120SAS,3/12/2024,SAS vs HOU,Jock Landale,landajo01,39,HOU,0,SAS,11,4,5,2,1,1,25.76666667,3,1,5,8,1,2,0,0,4,3,9,16,15,20,31.3
2023-24,202403120SAC,3/12/2024,SAC vs MIL,Brook Lopez,lopezbr01,63,MIL,0,SAC,7,4,0,0,1,2,25.93333333,3,1,2,7,1,4,2,2,1,1,4,7,11,11,12.8
2023-24,202403120MEM,3/12/2024,MEM vs WAS,Luke Kennard,kennalu01,34,MEM,1,WAS,13,4,8,1,0,2,26.13333333,1,3,5,11,3,6,0,0,2,1,12,21,17,25,30.8
2023-24,202403120NYK,3/12/2024,NYK vs PHI,Tobias Harris,harrito02,59,PHI,0,NYK,2,3,1,2,0,1,26.48333333,0,3,1,6,0,2,0,0,0,2,4,3,5,6,12.1
2023-24,202403120UTA,3/12/2024,UTA vs BOS,Xavier Tillman Sr.,tillmxa01,39,BOS,0,UTA,7,8,1,1,0,0,26.51666667,4,4,3,5,1,1,0,0,0,1,9,8,15,16,21.1
2023-24,202403120MEM,3/12/2024,MEM vs WAS,Jordan Poole,poolejo01,63,WAS,0,MEM,10,3,4,0,1,2,26.53333333,1,2,4,11,2,6,0,0,2,1,7,14,13,17,20.6
2023-24,202403120MEM,3/12/2024,MEM vs WAS,GG Jackson II,jacksgg01,32,MEM,1,WAS,19,2,1,0,1,3,26.63333333,0,2,7,16,1,7,4,6,0,1,3,20,21,22,22.9
2023-24,202403120SAC,3/12/2024,SAC vs MIL,Patrick Beverley,beverpa01,61,MIL,0,SAC,4,2,4,0,0,0,26.65,0,2,1,4,0,3,2,3,3,0,6,8,6,10,12.4
2023-24,202403120LAC,3/12/2024,LAC vs MIN,Ivica Zubac,zubaciv01,52,LAC,1,MIN,10,8,1,0,0,2,26.71666667,3,5,3,5,0,0,4,4,2,0,9,11,18,19,19.1
2023-24,202403120NYK,3/12/2024,NYK vs PHI,Jalen Brunson,brunsja01,60,NYK,1,PHI,20,4,9,1,0,1,27.06666667,0,4,7,12,4,8,2,3,0,1,13,29,24,33,40.3
2023-24,202403120SAC,3/12/2024,SAC vs MIL,Keon Ellis,elliske01,39,SAC,1,MIL,7,4,2,3,0,1,27.1,0,4,3,4,1,2,0,0,4,3,6,9,11,13,22.8
2023-24,202403120OKC,3/12/2024,OKC vs IND,Andrew Nembhard,nembhan01,52,IND,0,OKC,14,4,5,1,0,2,27.4,0,4,4,7,2,5,4,4,3,1,9,19,18,23,27.3
2023-24,202403120LAC,3/12/2024,LAC vs MIN,Mike Conley,conlemi01,61,MIN,0,LAC,23,3,3,1,0,1,27.46666667,2,1,9,15,5,8,0,0,0,1,6,26,26,29,33.1
2023-24,202403120LAC,3/12/2024,LAC vs MIN,Nickeil Alexander-Walker,alexani01,66,MIN,0,LAC,28,3,1,0,1,2,27.61666667,1,2,9,10,5,6,5,6,3,1,4,29,31,32,34.1
2023-24,202403120LAC,3/12/2024,LAC vs MIN,Terance Mann,mannte01,58,LAC,1,MIN,7,2,0,3,0,1,27.63333333,1,1,3,6,1,3,0,0,2,3,2,7,9,9,17.4
2023-24,202403120NYK,3/12/2024,NYK vs PHI,Paul Reed,reedpa01,65,PHI,0,NYK,14,8,0,2,0,1,27.75,3,5,6,8,0,1,2,4,3,2,8,14,22,22,28.6
2023-24,202403120OKC,3/12/2024,OKC vs IND,Josh Giddey,giddejo01,64,OKC,1,IND,15,7,3,0,0,1,27.83333333,4,3,7,15,1,2,0,0,0,0,10,18,22,25,26.9
2023-24,202403120NYK,3/12/2024,NYK vs PHI,Tyrese Maxey,maxeyty01,56,PHI,0,NYK,17,2,4,0,0,2,27.86666667,1,1,6,14,3,6,2,2,1,0,6,21,19,23,23.4
2023-24,202403120LAC,3/12/2024,LAC vs MIN,Norman Powell,powelno01,63,LAC,1,MIN,11,4,2,0,1,1,27.95,1,3,4,9,1,2,2,3,3,1,6,13,15,17,20.8
2023-24,202403120UTA,3/12/2024,UTA vs BOS,Luke Kornet,kornelu01,47,BOS,0,UTA,12,9,6,0,1,0,28.21666667,4,5,4,7,0,0,4,4,2,1,15,18,21,27,34.8
2023-24,202403120SAC,3/12/2024,SAC vs MIL,Malik Monk,monkma01,63,SAC,1,MIL,25,5,5,0,0,0,28.25,1,4,9,19,3,8,4,5,3,0,10,30,30,35,38.5
2023-24,202403120NYK,3/12/2024,NYK vs PHI,OG Anunoby,anunoog01,42,NYK,1,PHI,14,4,2,1,0,3,28.75,0,4,6,11,2,5,0,0,0,1,6,16,18,20,21.8
2023-24,202403120LAC,3/12/2024,LAC vs MIN,Kyle Anderson,anderky01,63,MIN,0,LAC,10,5,7,0,0,2,28.8,3,2,5,8,0,1,0,1,1,0,12,17,15,22,24.5
2023-24,202403120UTA,3/12/2024,UTA vs BOS,John Collins,collijo01,61,UTA,1,BOS,10,4,0,0,2,1,29.31666667,0,4,2,9,2,4,4,4,1,2,4,10,14,14,19.8
2023-24,202403120NYK,3/12/2024,NYK vs PHI,Kelly Oubre Jr.,oubreke01,52,PHI,0,NYK,19,6,1,0,0,2,29.65,1,5,7,15,3,6,2,4,2,0,7,20,25,26,25.7
2023-24,202403120OKC,3/12/2024,OKC vs IND,Gordon Hayward,haywago01,36,OKC,1,IND,9,4,5,1,0,2,29.73333333,1,3,3,4,1,2,2,4,3,1,9,14,13,18,22.3
2023-24,202403120SAS,3/12/2024,SAS vs HOU,Dillon Brooks,brookdi01,56,HOU,0,SAS,14,1,1,0,0,3,29.88333333,0,1,6,11,2,7,0,0,6,0,2,15,15,16,13.7
2023-24,202403120MEM,3/12/2024,MEM vs WAS,Santi Aldama,aldamsa01,54,MEM,1,WAS,11,4,1,2,0,1,29.9,0,4,5,14,0,5,1,2,3,2,5,12,15,16,22.3
2023-24,202403120OKC,3/12/2024,OKC vs IND,Myles Turner,turnemy01,63,IND,0,OKC,24,3,4,1,4,1,30.03333333,0,3,11,17,2,3,0,0,1,5,7,28,27,31,47.6
2023-24,202403120SAS,3/12/2024,SAS vs HOU,Victor Wembanyama,wembavi01,58,SAS,1,HOU,13,10,6,1,2,2,31.1,1,9,5,12,2,7,1,1,2,3,16,19,23,29,41
2023-24,202403120MEM,3/12/2024,MEM vs WAS,Trey Jemison,jemistr01,14,MEM,1,WAS,24,6,0,0,2,3,31.13333333,5,1,11,13,0,0,2,2,4,2,6,24,30,30,34.2
2023-24,202403120UTA,3/12/2024,UTA vs BOS,Collin Sexton,sextoco01,65,UTA,1,BOS,20,7,5,0,1,5,31.28333333,5,2,9,16,1,4,1,1,5,1,12,25,27,32,33.9
2023-24,202403120SAC,3/12/2024,SAC vs MIL,Harrison Barnes,barneha02,64,SAC,1,MIL,16,6,2,1,0,0,31.55,0,6,6,12,4,7,0,0,2,1,8,18,22,24,29.2
2023-24,202403120SAS,3/12/2024,SAS vs HOU,Tre Jones,jonestr01,61,SAS,1,HOU,24,3,5,3,0,2,31.91666667,1,2,9,15,4,7,2,2,3,3,8,29,27,32,42.1
2023-24,202403120MEM,3/12/2024,MEM vs WAS,Jordan Goodwin,goodwjo01,47,MEM,1,WAS,8,12,7,1,1,2,32.15,3,9,3,12,1,5,1,2,2,2,19,15,20,27,36.9
2023-24,202403120SAS,3/12/2024,SAS vs HOU,Jeremy Sochan,sochaje01,66,SAS,1,HOU,21,8,2,1,1,2,32.16666667,2,6,9,14,2,6,1,1,3,2,10,23,29,31,37.6
2023-24,202403120MEM,3/12/2024,MEM vs WAS,Bilal Coulibaly,coulibi01,61,WAS,0,MEM,11,5,4,2,1,2,32.35,1,4,3,12,3,10,2,2,3,3,9,15,16,20,30
2023-24,202403120SAC,3/12/2024,SAC vs MIL,De'Aaron Fox,foxde01,56,SAC,1,MIL,29,6,7,2,1,4,32.4,1,5,11,17,4,5,3,3,2,3,13,36,35,42,51.7
2023-24,202403120OKC,3/12/2024,OKC vs IND,Pascal Siakam,siakapa01,64,IND,0,OKC,18,11,4,2,1,0,32.48333333,0,11,6,12,0,0,6,7,1,3,15,22,29,33,46.2
2023-24,202403120MEM,3/12/2024,MEM vs WAS,John Konchar,konchjo01,50,MEM,1,WAS,3,10,3,0,2,2,32.55,3,7,1,5,1,3,0,0,0,2,13,6,13,16,23.5
2023-24,202403120SAC,3/12/2024,SAC vs MIL,Giannis Antetokounmpo,antetgi01,63,MIL,0,SAC,30,13,4,1,0,4,32.88333333,1,12,10,17,0,2,10,14,3,1,17,34,43,47,50.6
2023-24,202403120SAC,3/12/2024,SAC vs MIL,Damian Lillard,lillada01,61,MIL,0,SAC,10,5,6,1,1,2,33.03333333,0,5,2,12,1,6,5,6,2,2,11,16,15,21,29
2023-24,202403120SAS,3/12/2024,SAS vs HOU,Jabari Smith Jr.,smithja05,60,HOU,0,SAS,15,9,1,2,0,1,33.4,1,8,5,11,1,3,4,4,2,2,10,16,24,25,32.3
2023-24,202403120LAC,3/12/2024,LAC vs MIN,Rudy Gobert,goberru01,63,MIN,0,LAC,8,11,3,2,2,0,33.43333333,7,4,4,7,0,0,0,0,2,4,14,11,19,22,37.7
2023-24,202403120UTA,3/12/2024,UTA vs BOS,Jordan Clarkson,clarkjo01,54,UTA,1,BOS,21,0,2,1,0,1,33.68333333,0,0,10,18,1,4,0,0,3,1,2,23,21,23,26
2023-24,202403120LAC,3/12/2024,LAC vs MIN,James Harden,hardeja01,59,LAC,1,MIN,12,2,7,2,0,4,33.85,0,2,4,10,2,6,2,2,1,2,9,19,14,21,26.9
2023-24,202403120SAC,3/12/2024,SAC vs MIL,Domantas Sabonis,sabondo01,64,SAC,1,MIL,22,11,8,1,0,0,33.9,2,9,10,14,0,0,2,2,3,1,19,30,33,41,50.2
2023-24,202403120UTA,3/12/2024,UTA vs BOS,Jayson Tatum,tatumja01,62,BOS,0,UTA,38,6,2,0,1,3,34,2,4,13,25,4,10,8,8,3,1,8,40,44,46,48.2
2023-24,202403120MEM,3/12/2024,MEM vs WAS,Tyus Jones,jonesty01,65,WAS,0,MEM,4,0,9,1,0,1,34.16666667,0,0,1,9,0,4,2,2,1,1,9,13,4,13,19.5
2023-24,202403120UTA,3/12/2024,UTA vs BOS,Sam Hauser,hausesa01,64,BOS,0,UTA,14,5,2,1,2,0,34.21666667,1,4,5,13,4,11,0,0,3,3,7,16,19,21,32
2023-24,202403120NYK,3/12/2024,NYK vs PHI,Donte DiVincenzo,divindo01,64,NYK,1,PHI,16,2,4,1,1,1,34.4,1,1,4,11,4,9,4,4,2,2,6,20,18,22,29.4
2023-24,202403120SAS,3/12/2024,SAS vs HOU,Julian Champagnie,champju02,58,SAS,1,HOU,10,3,1,2,0,1,34.46666667,0,3,3,9,2,5,2,2,1,2,4,11,13,14,20.1
2023-24,202403120OKC,3/12/2024,OKC vs IND,Luguentz Dort,dortlu01,63,OKC,1,IND,18,2,3,1,0,0,35.05,1,1,6,12,3,6,3,3,2,1,5,21,20,23,27.9
2023-24,202403120UTA,3/12/2024,UTA vs BOS,Derrick White,whitede01,61,BOS,0,UTA,24,6,3,1,3,3,35.06666667,0,6,8,17,7,11,1,1,3,4,9,27,30,33,44.7
2023-24,202403120UTA,3/12/2024,UTA vs BOS,Keyonte George,georgke01,58,UTA,1,BOS,26,1,6,0,2,3,35.11666667,0,1,9,17,5,10,3,4,5,2,7,32,27,33,39.2
2023-24,202403120LAC,3/12/2024,LAC vs MIN,Paul George,georgpa01,58,LAC,1,MIN,22,3,3,1,0,5,35.11666667,0,3,5,11,2,5,10,10,4,1,6,25,25,28,28.1
2023-24,202403120OKC,3/12/2024,OKC vs IND,Chet Holmgren,holmgch01,65,OKC,1,IND,15,13,3,0,2,0,35.41666667,2,11,6,16,3,6,0,0,2,2,16,18,28,31,41.1
2023-24,202403120MEM,3/12/2024,MEM vs WAS,Deni Avdija,avdijde01,62,WAS,0,MEM,16,4,1,0,0,3,35.71666667,1,3,6,10,0,3,4,7,3,0,5,17,20,21,19.3
2023-24,202403120OKC,3/12/2024,OKC vs IND,Tyrese Haliburton,halibty01,54,IND,0,OKC,18,4,12,2,2,4,35.76666667,0,4,8,15,2,6,0,0,0,4,16,30,22,34,48.8
2023-24,202403120SAS,3/12/2024,SAS vs HOU,Devin Vassell,vassede01,60,SAS,1,HOU,6,5,6,1,0,2,35.85,0,5,2,6,1,2,1,2,2,1,11,12,11,17,22
2023-24,202403120MEM,3/12/2024,MEM vs WAS,Corey Kispert,kispeco01,63,WAS,0,MEM,22,2,0,1,0,0,35.86666667,0,2,8,12,5,7,1,2,3,1,2,22,24,24,27.4
2023-24,202403120OKC,3/12/2024,OKC vs IND,Aaron Nesmith,nesmiaa01,58,IND,0,OKC,15,4,1,1,2,0,35.91666667,0,4,6,12,1,5,2,2,3,3,5,16,19,20,30.3
2023-24,202403120LAC,3/12/2024,LAC vs MIN,Anthony Edwards,edwaran01,63,MIN,0,LAC,37,8,4,1,0,2,36.5,2,6,15,29,2,8,5,7,3,1,12,41,45,49,53.6
2023-24,202403120MEM,3/12/2024,MEM vs WAS,Kyle Kuzma,kuzmaky01,63,WAS,0,MEM,24,7,5,1,0,4,36.55,1,6,10,18,1,4,3,3,2,1,12,29,31,36,38.9
2023-24,202403120OKC,3/12/2024,OKC vs IND,Shai Gilgeous-Alexander,gilgesh01,64,OKC,1,IND,30,10,5,2,1,4,36.96666667,2,8,12,27,1,7,5,6,4,3,15,35,40,45,54.5
2023-24,202403120SAS,3/12/2024,SAS vs HOU,Jalen Green,greenja05,65,HOU,0,SAS,16,7,5,0,0,3,37.16666667,1,6,5,16,2,6,4,5,0,0,12,21,23,28,28.9
2023-24,202403120UTA,3/12/2024,UTA vs BOS,Jrue Holiday,holidjr01,59,BOS,0,UTA,16,5,8,2,1,1,37.7,1,4,6,12,2,7,2,2,1,3,13,24,21,29,42
2023-24,202403120SAS,3/12/2024,SAS vs HOU,Fred VanVleet,vanvlfr01,58,HOU,0,SAS,21,7,7,2,2,2,39.03333333,1,6,7,16,3,9,4,4,4,4,14,28,28,35,49.9
2023-24,202403120NYK,3/12/2024,NYK vs PHI,Josh Hart,hartjo01,64,NYK,1,PHI,20,19,10,1,1,1,39.06666667,1,18,8,16,1,6,3,4,1,2,29,30,39,49,62.8
2023-24,202403110DET,3/11/2024,DET vs CHO,Aleksej Pokusevski,pokusal01,12,CHO,0,DET,2,1,2,0,1,0,10.56666667,1,0,1,4,0,0,0,0,0,1,3,4,3,5,9.2
2023-24,202403110DET,3/11/2024,DET vs CHO,Evan Fournier,fournev01,15,DET,1,CHO,3,1,2,2,0,0,11.26666667,0,1,1,4,1,4,0,0,2,2,3,5,4,6,13.2
2023-24,202403110CLE,3/11/2024,CLE vs PHO,Damian Jones,jonesda03,29,CLE,1,PHO,9,5,1,1,0,0,11.85,2,3,4,7,0,2,1,1,0,1,6,10,14,15,19.5
2023-24,202403110DET,3/11/2024,DET vs CHO,JT Thor,thorjt01,50,CHO,0,DET,2,2,1,0,0,0,11.95,0,2,1,4,0,2,0,0,1,0,3,3,4,5,5.9
2023-24,202403110SAS,3/11/2024,SAS vs GSW,Moses Moody,moodymo01,50,GSW,0,SAS,2,1,0,1,2,0,11.98333333,0,1,1,3,0,0,0,0,1,3,1,2,3,3,12.2
2023-24,202403110DEN,3/11/2024,DEN vs TOR,Javon Freeman-Liberty,freemja01,7,TOR,0,DEN,0,1,2,0,1,0,12.36666667,0,1,0,2,0,2,0,0,1,1,3,2,1,3,7.2
2023-24,202403110SAS,3/11/2024,SAS vs GSW,Blake Wesley,weslebl01,44,SAS,1,GSW,4,1,3,0,0,0,12.73333333,1,0,2,3,0,1,0,0,0,0,4,7,5,8,9.7
2023-24,202403110CHI,3/11/2024,CHI vs DAL,Maxi Kleber,klebima01,28,DAL,0,CHI,2,4,1,0,0,0,12.78333333,0,4,0,1,0,1,2,2,1,0,5,3,6,7,8.3
2023-24,202403110POR,3/11/2024,POR vs BOS,Duop Reath,reathdu01,50,POR,1,BOS,8,1,0,0,0,1,13,1,0,3,5,2,3,0,0,1,0,1,8,9,9,8.2
2023-24,202403110CHI,3/11/2024,CHI vs DAL,Jevon Carter,carteje01,62,CHI,1,DAL,3,0,0,0,0,0,13.41666667,0,0,1,1,0,0,1,2,1,0,0,3,3,3,3
2023-24,202403110CLE,3/11/2024,CLE vs PHO,Isaiah Mobley,mobleis01,5,CLE,1,PHO,3,0,1,0,0,0,13.41666667,0,0,1,4,1,4,0,0,1,0,1,4,3,4,4.5
2023-24,202403110DEN,3/11/2024,DEN vs TOR,Reggie Jackson,jacksre01,65,DEN,1,TOR,9,1,0,0,0,0,14.53333333,1,0,4,9,1,5,0,0,2,0,1,9,10,10,10.2
2023-24,202403110SAS,3/11/2024,SAS vs GSW,Gary Payton II,paytoga02,29,GSW,0,SAS,0,0,2,0,0,0,14.76666667,0,0,0,0,0,0,0,0,1,0,2,2,0,2,3
2023-24,202403110DET,3/11/2024,DET vs CHO,Nick Smith Jr.,smithni01,40,CHO,0,DET,0,2,1,0,0,1,15.13333333,0,2,0,4,0,2,0,0,2,0,3,1,2,3,2.9
2023-24,202403110DEN,3/11/2024,DEN vs TOR,Peyton Watson,watsope01,63,DEN,1,TOR,7,5,0,0,1,1,15.38333333,0,5,3,4,1,1,0,2,2,1,5,7,12,12,15
2023-24,202403110CHI,3/11/2024,CHI vs DAL,Derrick Jones Jr.,jonesde02,60,DAL,0,CHI,8,0,2,0,0,0,16.3,0,0,3,7,2,5,0,0,1,0,2,10,8,10,11
2023-24,202403110CHI,3/11/2024,CHI vs DAL,Andre Drummond,drumman01,65,CHI,1,DAL,4,10,1,1,0,1,16.46666667,1,9,1,3,0,0,2,4,0,1,11,5,14,15,19.5
2023-24,202403110CHI,3/11/2024,CHI vs DAL,Torrey Craig,craigto01,36,CHI,1,DAL,0,1,0,0,0,1,16.53333333,1,0,0,1,0,1,0,0,2,0,1,0,1,1,0.2
2023-24,202403110SAS,3/11/2024,SAS vs GSW,Zach Collins,colliza01,53,SAS,1,GSW,10,10,3,1,3,5,16.56666667,4,6,5,8,0,1,0,0,3,4,13,13,20,23,33.5
2023-24,202403110DEN,3/11/2024,DEN vs TOR,Jordan Nwora,nworajo01,36,TOR,0,DEN,5,7,1,0,1,0,16.83333333,1,6,2,7,1,4,0,0,0,1,8,6,12,13,17.9
2023-24,202403110SAS,3/11/2024,SAS vs GSW,Malaki Branham,branhma01,60,SAS,1,GSW,2,1,0,0,1,2,16.9,1,0,1,8,0,4,0,0,2,1,1,2,3,3,4.2
2023-24,202403110DET,3/11/2024,DET vs CHO,James Wiseman,wisemja01,45,DET,1,CHO,10,9,1,0,1,0,17.68333333,3,6,4,6,0,0,2,2,2,1,10,11,19,20,25.3
2023-24,202403110CLE,3/11/2024,CLE vs PHO,Drew Eubanks,eubandr01,59,PHO,0,CLE,4,6,0,1,1,0,17.98333333,2,4,2,2,0,0,0,0,0,2,6,4,10,10,17.2
2023-24,202403110CHI,3/11/2024,CHI vs DAL,Tim Hardaway Jr.,hardati02,62,DAL,0,CHI,4,1,4,2,0,0,18.16666667,0,1,1,4,0,3,2,2,0,2,5,8,5,9,17.2
2023-24,202403110CHI,3/11/2024,CHI vs DAL,Dante Exum,exumda01,39,DAL,0,CHI,2,4,2,0,0,1,18.85,1,3,1,3,0,2,0,0,0,0,6,4,6,8,8.8
2023-24,202403110POR,3/11/2024,POR vs BOS,Oshae Brissett,brissos01,41,BOS,0,POR,3,7,1,0,0,0,19.2,4,3,1,2,0,1,1,2,3,0,8,4,10,11,12.9
2023-24,202403110DEN,3/11/2024,DEN vs TOR,Christian Braun,braunch01,65,DEN,1,TOR,5,2,2,0,1,1,19.25,0,2,2,6,1,3,0,0,2,1,4,7,7,9,12.4
2023-24,202403110POR,3/11/2024,POR vs BOS,Kris Murray,murrakr01,44,POR,1,BOS,2,4,1,0,1,0,19.3,0,4,1,1,0,0,0,0,0,1,5,3,6,7,11.3
2023-24,202403110DEN,3/11/2024,DEN vs TOR,Jalen McDaniels,mcdanja01,37,TOR,0,DEN,12,3,1,3,0,1,19.48333333,2,1,5,9,0,3,2,3,1,3,4,13,15,16,25.1
2023-24,202403110DET,3/11/2024,DET vs CHO,Marcus Sasser,sassema01,55,DET,1,CHO,9,2,4,0,0,3,19.56666667,0,2,3,4,1,1,2,2,1,0,6,13,11,15,14.4
2023-24,202403110CHI,3/11/2024,CHI vs DAL,Dereck Lively II,livelde01,46,DAL,0,CHI,22,7,3,2,2,1,20,2,5,11,12,0,0,0,0,3,4,10,25,29,32,45.9
2023-24,202403110CHI,3/11/2024,CHI vs DAL,Alex Caruso,carusal01,56,CHI,1,DAL,4,5,3,1,0,1,21.03333333,2,3,1,6,1,6,1,4,1,1,8,7,9,12,16.5
2023-24,202403110POR,3/11/2024,POR vs BOS,Luke Kornet,kornelu01,46,BOS,0,POR,6,5,2,0,2,1,21.06666667,3,2,3,3,0,0,0,0,0,2,7,8,11,13,20
2023-24,202403110DET,3/11/2024,DET vs CHO,Quentin Grimes,grimequ01,50,DET,1,CHO,6,4,3,1,0,1,21.45,1,3,1,8,0,6,4,4,2,1,7,9,10,13,17.3
2023-24,202403110CLE,3/11/2024,CLE vs PHO,Sam Merrill,merrisa01,47,CLE,1,PHO,3,1,5,0,0,0,21.45,0,1,1,5,1,5,0,0,0,0,6,8,4,9,11.7
2023-24,202403110CLE,3/11/2024,CLE vs PHO,Craig Porter Jr.,portecr01,41,CLE,1,PHO,13,6,1,0,0,1,21.86666667,2,4,5,7,1,2,2,2,3,0,7,14,19,20,20.7
2023-24,202403110POR,3/11/2024,POR vs BOS,Matisse Thybulle,thybuma01,61,POR,1,BOS,5,3,1,1,3,0,21.86666667,0,3,2,3,1,2,0,0,0,4,4,6,8,9,22.1
2023-24,202403110POR,3/11/2024,POR vs BOS,Dalano Banton,bantoda01,37,POR,1,BOS,8,2,4,0,0,1,21.95,0,2,2,6,2,4,2,2,3,0,6,12,10,14,15.4
2023-24,202403110DEN,3/11/2024,DEN vs TOR,Jontay Porter,portejo01,21,TOR,0,DEN,14,2,5,1,0,2,21.96666667,1,1,5,9,4,7,0,0,2,1,7,19,16,21,24.9
2023-24,202403110CHI,3/11/2024,CHI vs DAL,DeMar DeRozan,derozde01,63,CHI,1,DAL,13,2,2,0,0,1,22.08333333,0,2,4,9,0,1,5,6,1,0,4,15,15,17,17.4
2023-24,202403110CHI,3/11/2024,CHI vs DAL,Daniel Gafford,gaffoda01,58,DAL,0,CHI,20,7,1,1,2,0,22.8,3,4,9,9,0,0,2,3,4,3,8,21,27,28,38.9
2023-24,202403110CHI,3/11/2024,CHI vs DAL,Josh Green,greenjo02,52,DAL,0,CHI,5,3,3,0,0,0,23.15,0,3,2,3,1,2,0,0,0,0,6,8,8,11,13.1
2023-24,202403110CHI,3/11/2024,CHI vs DAL,P.J. Washington,washipj01,57,DAL,0,CHI,7,5,0,2,1,0,23.21666667,0,5,3,5,1,3,0,0,2,3,5,7,12,12,22
2023-24,202403110POR,3/11/2024,POR vs BOS,Toumani Camara,camarto01,61,POR,1,BOS,8,1,2,0,1,0,24.56666667,0,1,3,5,0,1,2,2,0,1,3,10,9,11,15.2
2023-24,202403110CLE,3/11/2024,CLE vs PHO,Georges Niang,niangge01,65,CLE,1,PHO,8,3,1,1,0,2,25.11666667,0,3,3,9,0,6,2,2,4,1,4,9,11,12,14.1
2023-24,202403110CHI,3/11/2024,CHI vs DAL,Onuralp Bitim,bitimon01,9,CHI,1,DAL,17,5,1,0,0,1,25.26666667,3,2,8,16,1,6,0,0,3,0,6,18,22,23,23.5
2023-24,202403110DET,3/11/2024,DET vs CHO,Davis Bertans,bertada01,27,CHO,0,DET,7,1,2,2,0,1,26.11666667,1,0,2,8,2,7,1,2,1,2,3,9,8,10,16.2
2023-24,202403110CHI,3/11/2024,CHI vs DAL,Nikola Vucevic,vucevni01,60,CHI,1,DAL,13,6,2,0,1,3,26.33333333,2,4,6,13,1,4,0,0,0,1,8,15,19,21,23.2
2023-24,202403110SAS,3/11/2024,SAS vs GSW,Trayce Jackson-Davis,jackstr02,51,GSW,0,SAS,13,10,5,0,0,1,26.46666667,3,7,6,7,0,0,1,1,0,0,15,18,23,28,31.5
2023-24,202403110CHI,3/11/2024,CHI vs DAL,Coby White,whiteco01,65,CHI,1,DAL,12,2,1,0,0,2,27.08333333,1,1,4,14,1,6,3,3,2,0,3,13,14,15,13.9
2023-24,202403110CHI,3/11/2024,CHI vs DAL,Kyrie Irving,irvinky01,43,DAL,0,CHI,14,3,1,1,1,1,27.33333333,0,3,6,14,2,6,0,0,2,2,4,15,17,18,24.1
2023-24,202403110SAS,3/11/2024,SAS vs GSW,Julian Champagnie,champju02,57,SAS,1,GSW,9,2,2,1,0,1,27.61666667,0,2,3,5,3,5,0,0,0,1,4,11,11,13,16.4
2023-24,202403110SAS,3/11/2024,SAS vs GSW,Draymond Green,greendr01,40,GSW,0,SAS,5,6,4,2,0,5,27.78333333,2,4,2,7,0,2,1,2,6,2,10,9,11,15,19.2
2023-24,202403110CHI,3/11/2024,CHI vs DAL,Julian Phillips,phillju01,39,CHI,1,DAL,11,3,0,2,0,0,27.95,2,1,3,7,2,3,3,3,0,2,3,11,14,14,20.6
2023-24,202403110SAS,3/11/2024,SAS vs GSW,Jeremy Sochan,sochaje01,65,SAS,1,GSW,9,7,7,1,2,1,28.2,1,6,4,10,1,2,0,0,2,3,14,16,16,23,35.9
2023-24,202403110DEN,3/11/2024,DEN vs TOR,Ochai Agbaji,agbajoc01,64,TOR,0,DEN,8,2,1,0,2,0,28.63333333,1,1,4,7,0,0,0,1,5,2,3,9,10,11,17.9
2023-24,202403110DEN,3/11/2024,DEN vs TOR,Kelly Olynyk,olynyke01,63,TOR,0,DEN,24,6,1,0,0,1,28.71666667,2,4,9,13,2,4,4,5,4,0,7,25,30,31,31.7
2023-24,202403110CHI,3/11/2024,CHI vs DAL,Ayo Dosunmu,dosunay01,63,CHI,1,DAL,9,8,6,1,1,2,29.06666667,2,6,4,13,1,5,0,0,2,2,14,15,17,23,31.6
2023-24,202403110CLE,3/11/2024,CLE vs PHO,Royce O'Neale,onealro01,62,PHO,0,CLE,0,4,4,1,0,2,29.16666667,0,4,0,2,0,2,0,0,4,1,8,4,4,8,11.8
2023-24,202403110CLE,3/11/2024,CLE vs PHO,Jusuf Nurkic,nurkiju01,61,PHO,0,CLE,9,8,0,0,1,3,29.46666667,3,5,4,5,0,0,1,6,4,1,8,9,17,17,18.6
2023-24,202403110POR,3/11/2024,POR vs BOS,Payton Pritchard,pritcpa01,64,BOS,0,POR,11,8,8,0,0,0,29.68333333,1,7,5,11,1,4,0,0,0,0,16,19,19,27,32.6
2023-24,202403110POR,3/11/2024,POR vs BOS,Al Horford,horfoal01,54,BOS,0,POR,11,4,4,1,3,0,29.85,0,4,4,4,3,3,0,0,1,4,8,15,15,19,33.8
2023-24,202403110SAS,3/11/2024,SAS vs GSW,Andrew Wiggins,wiggian01,55,GSW,0,SAS,16,4,2,0,0,1,30.06666667,1,3,6,8,2,3,2,4,1,0,6,18,20,22,22.8
2023-24,202403110SAS,3/11/2024,SAS vs GSW,Klay Thompson,thompkl01,61,GSW,0,SAS,21,2,2,1,0,1,30.21666667,1,1,8,21,4,10,1,2,0,1,4,23,23,25,28.4
2023-24,202403110DET,3/11/2024,DET vs CHO,Jalen Duren,durenja01,49,DET,1,CHO,20,10,1,1,1,3,30.31666667,4,6,8,10,0,0,4,6,3,2,11,21,30,31,36.5
2023-24,202403110SAS,3/11/2024,SAS vs GSW,Keldon Johnson,johnske04,61,SAS,1,GSW,16,6,1,0,1,0,30.35,2,4,5,12,2,6,4,4,0,1,7,17,22,23,27.7
2023-24,202403110DEN,3/11/2024,DEN vs TOR,Aaron Gordon,gordoaa01,59,DEN,1,TOR,19,2,1,0,0,1,30.68333333,0,2,8,9,1,2,2,3,1,0,3,20,21,22,21.9
2023-24,202403110SAS,3/11/2024,SAS vs GSW,Jonathan Kuminga,kuminjo01,63,GSW,0,SAS,22,5,1,1,1,2,31.13333333,0,5,9,18,2,3,2,2,4,2,6,23,27,28,33.5
2023-24,202403110SAS,3/11/2024,SAS vs GSW,Victor Wembanyama,wembavi01,57,SAS,1,GSW,27,14,3,1,2,3,31.43333333,2,12,10,25,3,9,4,9,1,3,17,30,41,44,54.3
2023-24,202403110SAS,3/11/2024,SAS vs GSW,Tre Jones,jonestr01,60,SAS,1,GSW,6,5,7,1,0,1,31.78333333,1,4,3,5,0,1,0,0,3,1,12,13,11,18,24.5
2023-24,202403110POR,3/11/2024,POR vs BOS,Sam Hauser,hausesa01,63,BOS,0,POR,22,2,0,2,1,0,31.91666667,0,2,8,12,6,10,0,0,0,3,2,22,24,24,33.4
2023-24,202403110DET,3/11/2024,DET vs CHO,Grant Williams,willigr01,61,CHO,0,DET,22,4,2,2,0,5,32.03333333,0,4,6,13,2,5,8,9,5,2,6,24,26,28,30.8
2023-24,202403110DET,3/11/2024,DET vs CHO,Cade Cunningham,cunnica01,54,DET,1,CHO,22,6,8,1,0,2,32.3,0,6,8,20,2,10,4,4,1,1,14,30,28,36,42.2
2023-24,202403110DEN,3/11/2024,DEN vs TOR,Kentavious Caldwell-Pope,caldwke01,59,DEN,1,TOR,3,2,6,1,0,2,32.46666667,0,2,1,6,1,3,0,0,1,1,8,9,5,11,15.4
2023-24,202403110POR,3/11/2024,POR vs BOS,Jaylen Brown,brownja02,59,BOS,0,POR,27,6,5,1,0,0,32.76666667,3,3,13,29,1,8,0,0,3,1,11,32,33,38,44.7
2023-24,202403110POR,3/11/2024,POR vs BOS,Deandre Ayton,aytonde01,42,POR,1,BOS,22,15,1,0,0,1,32.83333333,6,9,11,19,0,0,0,0,0,0,16,23,37,38,40.5
2023-24,202403110DET,3/11/2024,DET vs CHO,Jaden Ivey,iveyja01,60,DET,1,CHO,12,3,4,1,1,1,32.86666667,1,2,4,13,0,6,4,4,1,2,7,16,15,19,26.6
2023-24,202403110DET,3/11/2024,DET vs CHO,Vasilije Micic,micicva01,44,CHO,0,DET,11,5,7,1,0,2,32.86666667,1,4,3,7,3,5,2,2,3,1,12,18,16,23,28.5
2023-24,202403110DEN,3/11/2024,DEN vs TOR,Michael Porter Jr.,portemi01,64,DEN,1,TOR,19,8,3,1,1,0,32.86666667,3,5,8,14,2,6,1,2,2,2,11,22,27,30,39.1
2023-24,202403110CLE,3/11/2024,CLE vs PHO,Caris LeVert,leverca01,53,CLE,1,PHO,17,6,11,1,0,1,33.01666667,1,5,7,16,3,10,0,0,2,1,17,28,23,34,42.7
2023-24,202403110SAS,3/11/2024,SAS vs GSW,Chris Paul,paulch01,40,GSW,0,SAS,19,9,8,1,0,1,33.05,2,7,9,19,1,4,0,0,4,1,17,27,28,36,43.8
2023-24,202403110POR,3/11/2024,POR vs BOS,Scoot Henderson,hendesc01,45,POR,1,BOS,13,6,8,0,0,5,33.28333333,2,4,5,12,1,5,2,2,3,0,14,21,19,27,27.2
2023-24,202403110CHI,3/11/2024,CHI vs DAL,Luka Doncic,doncilu01,57,DAL,0,CHI,27,12,14,1,0,2,33.61666667,2,10,9,23,6,15,3,4,2,1,26,41,39,53,63.4
2023-24,202403110DET,3/11/2024,DET vs CHO,Isaiah Stewart,stewais01,42,DET,1,CHO,12,6,0,0,1,0,33.65,0,6,4,9,2,7,2,2,2,1,6,12,18,18,22.2
2023-24,202403110POR,3/11/2024,POR vs BOS,Anfernee Simons,simonan01,41,POR,1,BOS,17,4,3,0,0,1,33.8,0,4,6,18,3,9,2,2,3,0,7,20,21,24,25.3
2023-24,202403110POR,3/11/2024,POR vs BOS,Derrick White,whitede01,60,BOS,0,POR,11,6,5,2,3,1,34.15,2,4,5,14,1,5,0,0,3,5,11,16,17,22,39.7
2023-24,202403110SAS,3/11/2024,SAS vs GSW,Brandin Podziemski,podzibr01,56,GSW,0,SAS,14,8,4,1,1,2,34.53333333,1,7,5,10,3,5,1,1,2,2,12,18,22,26,33.6
2023-24,202403110DET,3/11/2024,DET vs CHO,Brandon Miller,millebr02,58,CHO,0,DET,19,5,7,1,1,0,35.31666667,1,4,7,17,3,10,2,3,2,2,12,26,24,31,41.5
2023-24,202403110POR,3/11/2024,POR vs BOS,Jerami Grant,grantje01,54,POR,1,BOS,14,2,2,2,0,2,35.6,0,2,5,14,1,4,3,3,0,2,4,16,16,18,23.4
2023-24,202403110DET,3/11/2024,DET vs CHO,Nick Richards,richani01,55,CHO,0,DET,10,13,2,0,0,1,35.6,4,9,5,7,0,0,0,2,1,0,15,12,23,25,27.6
2023-24,202403110CLE,3/11/2024,CLE vs PHO,Bradley Beal,bealbr01,36,PHO,0,CLE,24,5,4,3,0,1,35.65,2,3,10,19,2,7,2,2,3,3,9,28,29,33,44
2023-24,202403110CLE,3/11/2024,CLE vs PHO,Grayson Allen,allengr01,59,PHO,0,CLE,14,3,2,2,2,2,35.66666667,1,2,4,6,4,5,2,2,3,4,5,16,17,19,30.6
2023-24,202403110POR,3/11/2024,POR vs BOS,Jayson Tatum,tatumja01,61,BOS,0,POR,26,5,8,0,0,1,35.66666667,0,5,9,23,2,8,6,8,0,0,13,34,31,39,43
2023-24,202403110CLE,3/11/2024,CLE vs PHO,Darius Garland,garlada01,41,CLE,1,PHO,30,2,5,1,0,5,36.33333333,0,2,10,17,7,10,3,4,2,1,7,35,32,37,37.9
2023-24,202403110DEN,3/11/2024,DEN vs TOR,Gradey Dick,dickgr01,44,TOR,0,DEN,17,4,7,2,0,1,36.41666667,1,3,7,12,2,4,1,1,0,2,11,24,21,28,37.3
2023-24,202403110SAS,3/11/2024,SAS vs GSW,Devin Vassell,vassede01,59,SAS,1,GSW,17,1,1,1,0,2,36.5,0,1,5,14,5,8,2,2,2,1,2,18,18,19,20.7
2023-24,202403110DET,3/11/2024,DET vs CHO,Simone Fontecchio,fontesi01,63,DET,1,CHO,17,8,3,2,1,2,37.11666667,0,8,7,11,3,7,0,0,4,3,11,20,25,28,38.1
2023-24,202403110CLE,3/11/2024,CLE vs PHO,Jarrett Allen,allenja01,60,CLE,1,PHO,15,10,2,1,0,1,37.55,4,6,5,7,0,0,5,6,3,1,12,17,25,27,32
2023-24,202403110DEN,3/11/2024,DEN vs TOR,Bruce Brown,brownbr01,54,TOR,0,DEN,13,10,3,0,0,2,37.61666667,1,9,5,14,1,3,2,2,2,0,13,16,23,26,27.5
2023-24,202403110DEN,3/11/2024,DEN vs TOR,RJ Barrett,barrerj01,53,TOR,0,DEN,26,7,9,0,0,4,37.96666667,2,5,10,20,1,3,5,5,1,0,16,35,33,42,43.9
2023-24,202403110DEN,3/11/2024,DEN vs TOR,Nikola Jokic,jokicni01,63,DEN,1,TOR,35,17,12,6,2,2,38.1,6,11,14,26,1,3,6,6,3,8,29,47,52,64,95.4
2023-24,202403110CLE,3/11/2024,CLE vs PHO,Devin Booker,bookede01,51,PHO,0,CLE,27,6,7,0,1,2,38.15,4,2,11,22,1,7,4,4,2,1,13,34,33,40,45.7
2023-24,202403110DEN,3/11/2024,DEN vs TOR,Jamal Murray,murraja01,49,DEN,1,TOR,26,5,12,0,2,1,39.1,1,4,11,19,2,6,2,5,1,2,17,38,31,43,55
2023-24,202403110CLE,3/11/2024,CLE vs PHO,Kevin Durant,duranke01,58,PHO,0,CLE,37,8,6,1,0,3,39.18333333,0,8,14,26,5,10,4,5,2,1,14,43,45,51,55.6
2023-24,202403110CLE,3/11/2024,CLE vs PHO,Isaac Okoro,okorois01,56,CLE,1,PHO,13,4,3,4,0,2,39.4,1,3,4,12,2,7,3,4,3,4,7,16,17,20,32.3
2023-24,202403110DET,3/11/2024,DET vs CHO,Miles Bridges,bridgmi02,54,CHO,0,DET,24,7,3,1,0,2,40.41666667,1,6,9,24,3,9,3,5,1,1,10,27,31,34,37.9
2023-24,202403100LAL,3/10/2024,LAL vs MIN,Luka Garza,garzalu01,15,MIN,0,LAL,9,3,1,0,0,1,10.03333333,2,1,2,5,1,3,4,4,3,0,4,10,12,13,13.1
2023-24,202403100OKC,3/10/2024,OKC vs MEM,Jalen Williams,willija06,58,OKC,1,MEM,7,2,3,1,1,0,10.15,0,2,3,6,1,4,0,0,0,2,5,10,9,12,19.9
2023-24,202403100SAC,3/10/2024,SAC vs HOU,Jeff Green,greenje02,60,HOU,0,SAC,5,2,1,0,0,0,10.53333333,1,1,2,4,1,1,0,0,1,0,3,6,7,8,8.9
2023-24,202403100ORL,3/10/2024,ORL vs IND,Isaiah Jackson,jacksis01,49,IND,0,ORL,7,3,0,1,0,0,10.78333333,2,1,2,3,0,0,3,4,4,1,3,7,10,10,13.6
2023-24,202403100MIA,3/10/2024,MIA vs WAS,Patrick Baldwin Jr.,baldwpa01,21,WAS,0,MIA,8,2,0,0,0,1,11.11666667,0,2,3,5,1,3,1,1,0,0,2,8,10,10,9.4
2023-24,202403100ORL,3/10/2024,ORL vs IND,Anthony Black,blackan01,59,ORL,1,IND,2,2,0,1,0,1,11.25,0,2,1,4,0,1,0,0,3,1,2,2,4,4,6.4
2023-24,202403100ORL,3/10/2024,ORL vs IND,Ben Sheppard,sheppbe01,41,IND,0,ORL,2,0,0,0,0,0,11.41666667,0,0,1,2,0,1,0,0,0,0,0,2,2,2,2
2023-24,202403100NYK,3/10/2024,NYK vs PHI,Alec Burks,burksal01,55,NYK,1,PHI,5,1,0,0,0,1,11.96666667,0,1,1,3,1,3,2,2,0,0,1,5,6,6,5.2
2023-24,202403100CLE,3/10/2024,CLE vs BRK,Emoni Bates,batesem01,11,CLE,1,BRK,7,1,0,0,0,1,12,0,1,3,7,1,4,0,2,0,0,1,7,8,8,7.2
2023-24,202403100OKC,3/10/2024,OKC vs MEM,Ousmane Dieng,diengou01,30,OKC,1,MEM,0,0,2,0,0,0,12,0,0,0,2,0,2,0,0,0,0,2,2,0,2,3
2023-24,202403100OKC,3/10/2024,OKC vs MEM,Jaylin Williams,willija07,52,OKC,1,MEM,5,4,1,0,1,0,12.58333333,0,4,2,4,1,3,0,0,0,1,5,6,9,10,14.3
2023-24,202403100OKC,3/10/2024,OKC vs MEM,Aaron Wiggins,wiggiaa01,61,OKC,1,MEM,4,1,3,1,1,2,12.83333333,1,0,2,3,0,0,0,0,0,2,4,7,5,8,13.7
2023-24,202403100CLE,3/10/2024,CLE vs BRK,Lonnie Walker IV,walkelo01,44,BRK,0,CLE,4,1,1,0,1,2,13.53333333,0,1,1,6,0,2,2,2,1,1,2,5,5,6,7.7
2023-24,202403100MIA,3/10/2024,MIA vs WAS,Patty Mills,millspa02,21,MIA,1,WAS,7,2,0,0,0,0,14.06666667,0,2,3,7,1,4,0,0,2,0,2,7,9,9,9.4
2023-24,202403100LAC,3/10/2024,LAC vs MIL,Daniel Theis,theisda01,48,LAC,1,MIL,2,6,0,0,2,0,14.56666667,1,5,1,2,0,1,0,0,2,2,6,2,8,8,15.2
2023-24,202403100LAC,3/10/2024,LAC vs MIL,Patrick Beverley,beverpa01,60,MIL,0,LAC,5,4,1,2,1,0,15.55,0,4,2,4,1,2,0,0,5,3,5,6,9,10,20.3
2023-24,202403100NYK,3/10/2024,NYK vs PHI,Miles McBride,mcbrimi01,51,NYK,1,PHI,0,0,2,1,0,0,15.6,0,0,0,5,0,2,0,0,0,1,2,2,0,2,6
2023-24,202403100OKC,3/10/2024,OKC vs MEM,Isaiah Joe,joeis01,60,OKC,1,MEM,7,1,0,0,0,0,15.7,0,1,3,6,1,4,0,0,2,0,1,7,8,8,8.2
2023-24,202403100LAL,3/10/2024,LAL vs MIN,Jaxson Hayes,hayesja02,56,LAL,1,MIN,9,5,0,0,0,2,15.83333333,2,3,4,4,0,0,1,1,2,0,5,9,14,14,13
2023-24,202403100ORL,3/10/2024,ORL vs IND,Moritz Wagner,wagnemo01,63,ORL,1,IND,9,6,2,0,0,1,15.88333333,2,4,3,6,0,2,3,5,2,0,8,11,15,17,18.2
2023-24,202403100ATL,3/10/2024,ATL vs NOP,Jonas Valanciunas,valanjo01,64,NOP,0,ATL,4,9,1,0,2,2,16.53333333,0,9,1,2,0,0,2,2,1,2,10,5,13,14,20.3
2023-24,202403100CLE,3/10/2024,CLE vs BRK,Day'Ron Sharpe,sharpda01,48,BRK,0,CLE,4,3,4,0,1,0,16.61666667,0,3,2,2,0,0,0,0,2,1,7,8,7,11,16.6
2023-24,202403100LAL,3/10/2024,LAL vs MIN,Spencer Dinwiddie,dinwisp01,60,LAL,1,MIN,0,1,1,0,0,1,16.85,0,1,0,3,0,1,0,0,3,0,2,1,1,2,1.7
2023-24,202403100OKC,3/10/2024,OKC vs MEM,Kenrich Williams,willike04,52,OKC,1,MEM,5,8,3,2,0,0,16.95,2,6,2,5,1,2,0,0,4,2,11,8,13,16,25.1
2023-24,202403100ATL,3/10/2024,ATL vs NOP,Jose Alvarado,alvarjo01,43,NOP,0,ATL,6,2,1,1,0,1,17.31666667,0,2,2,4,2,3,0,0,0,1,3,7,8,9,11.9
2023-24,202403100SAC,3/10/2024,SAC vs HOU,Jock Landale,landajo01,38,HOU,0,SAC,9,5,4,0,1,0,17.4,2,3,3,4,1,1,2,3,2,1,9,13,14,18,24
2023-24,202403100ATL,3/10/2024,ATL vs NOP,Naji Marshall,marshna01,52,NOP,0,ATL,7,5,3,0,0,0,17.56666667,0,5,3,5,1,1,0,0,0,0,8,10,12,15,17.5
2023-24,202403100SAC,3/10/2024,SAC vs HOU,Keon Ellis,elliske01,38,SAC,1,HOU,0,1,3,0,0,0,17.71666667,0,1,0,2,0,1,0,0,1,0,4,3,1,4,5.7
2023-24,202403100OKC,3/10/2024,OKC vs MEM,Gordon Hayward,haywago01,35,OKC,1,MEM,5,3,6,0,0,1,17.81666667,0,3,2,3,1,1,0,0,1,0,9,11,8,14,16.6
2023-24,202403100LAC,3/10/2024,LAC vs MIL,Brandon Boston Jr.,bostobr01,20,LAC,1,MIL,5,5,1,0,2,0,17.96666667,2,3,2,9,1,3,0,0,2,2,6,6,10,11,18.5
2023-24,202403100SAC,3/10/2024,SAC vs HOU,Davion Mitchell,mitchda01,53,SAC,1,HOU,8,2,3,0,0,1,18.21666667,1,1,3,7,2,5,0,0,1,0,5,11,10,13,13.9
2023-24,202403100NYK,3/10/2024,NYK vs PHI,Bojan Bogdanovic,bogdabo02,39,NYK,1,PHI,10,1,0,0,0,2,18.43333333,1,0,4,8,2,4,0,0,2,0,1,10,11,11,9.2
2023-24,202403100ATL,3/10/2024,ATL vs NOP,Garrison Mathews,mathega01,48,ATL,1,NOP,2,0,0,0,0,0,18.91666667,0,0,1,3,0,2,0,0,4,0,0,2,2,2,2
2023-24,202403100ORL,3/10/2024,ORL vs IND,Jonathan Isaac,isaacjo01,44,ORL,1,IND,9,7,0,0,2,1,19,3,4,3,7,3,4,0,0,2,2,7,9,16,16,22.4
2023-24,202403100CLE,3/10/2024,CLE vs BRK,Jalen Wilson,wilsoja03,27,BRK,0,CLE,7,3,1,0,0,2,19.01666667,0,3,2,4,1,2,2,2,1,0,4,8,10,11,10.1
2023-24,202403100CLE,3/10/2024,CLE vs BRK,Damian Jones,jonesda03,28,CLE,1,BRK,8,3,0,2,0,0,19.11666667,2,1,3,4,0,0,2,4,1,2,3,8,11,11,17.6
2023-24,202403100OKC,3/10/2024,OKC vs MEM,Josh Giddey,giddejo01,63,OKC,1,MEM,16,10,4,2,0,1,19.28333333,3,7,7,15,1,4,1,1,2,2,14,20,26,30,39
2023-24,202403100LAC,3/10/2024,LAC vs MIL,Jae Crowder,crowdja01,34,MIL,0,LAC,7,2,1,1,1,0,19.38333333,1,1,3,5,1,2,0,0,3,2,3,8,9,10,16.9
2023-24,202403100CLE,3/10/2024,CLE vs BRK,Isaiah Mobley,mobleis01,4,CLE,1,BRK,2,4,1,0,0,0,19.6,0,4,1,3,0,0,0,0,1,0,5,3,6,7,8.3
2023-24,202403100SAC,3/10/2024,SAC vs HOU,Cam Whitmore,whitmca01,38,HOU,0,SAC,10,4,0,0,0,0,19.68333333,0,4,4,10,2,5,0,0,0,0,4,10,14,14,14.8
2023-24,202403100NYK,3/10/2024,NYK vs PHI,Mo Bamba,bambamo01,42,PHI,0,NYK,4,1,0,0,0,0,19.96666667,0,1,2,4,0,2,0,0,0,0,1,4,5,5,5.2
2023-24,202403100SAC,3/10/2024,SAC vs HOU,Amen Thompson,thompam01,45,HOU,0,SAC,13,5,0,0,0,2,19.98333333,1,4,6,9,1,1,0,0,3,0,5,13,18,18,17
2023-24,202403100SAC,3/10/2024,SAC vs HOU,Trey Lyles,lylestr01,48,SAC,1,HOU,5,2,0,0,0,1,20.13333333,1,1,1,3,0,0,3,4,1,0,2,5,7,7,6.4
2023-24,202403100CLE,3/10/2024,CLE vs BRK,Dennis Smith Jr.,smithde03,49,BRK,0,CLE,7,3,2,0,0,1,20.36666667,2,1,2,3,1,2,2,2,4,0,5,9,10,12,12.6
2023-24,202403100OKC,3/10/2024,OKC vs MEM,Trey Jemison,jemistr01,13,MEM,0,OKC,2,4,2,0,0,1,20.88333333,2,2,1,3,0,0,0,0,0,0,6,4,6,8,8.8
2023-24,202403100LAC,3/10/2024,LAC vs MIL,Bones Hyland,hylanbo01,25,LAC,1,MIL,12,2,5,1,0,0,21.05,0,2,5,12,2,5,0,0,2,1,7,17,14,19,24.9
2023-24,202403100SAC,3/10/2024,SAC vs HOU,Harrison Barnes,barneha02,63,SAC,1,HOU,5,1,0,0,0,0,21.13333333,0,1,2,6,0,1,1,2,2,0,1,5,6,6,6.2
2023-24,202403100OKC,3/10/2024,OKC vs MEM,Wenyen Gabriel,gabriwe01,2,MEM,0,OKC,6,5,0,1,0,2,21.15,0,5,3,5,0,2,0,3,1,1,5,6,11,11,13
2023-24,202403100LAL,3/10/2024,LAL vs MIN,Jordan McLaughlin,mclaujo01,39,MIN,0,LAL,12,4,2,0,0,1,21.2,0,4,4,9,4,9,0,0,2,0,6,14,16,18,18.8
2023-24,202403100OKC,3/10/2024,OKC vs MEM,Chet Holmgren,holmgch01,64,OKC,1,MEM,8,6,2,0,2,3,21.56666667,1,5,4,10,0,4,0,0,2,2,8,10,14,16,21.2
2023-24,202403100CLE,3/10/2024,CLE vs BRK,Sam Merrill,merrisa01,46,CLE,1,BRK,5,0,2,1,1,0,21.83333333,0,0,1,7,1,7,2,2,4,2,2,7,5,7,14
2023-24,202403100ORL,3/10/2024,ORL vs IND,Caleb Houstan,houstca01,48,ORL,1,IND,0,2,1,0,0,0,22.08333333,1,1,0,2,0,1,0,0,3,0,3,1,2,3,3.9
2023-24,202403100ATL,3/10/2024,ATL vs NOP,Vit Krejci,krejcvi01,4,ATL,1,NOP,3,2,3,1,0,1,22.2,0,2,1,3,1,2,0,0,0,1,5,6,5,8,11.9
2023-24,202403100ATL,3/10/2024,ATL vs NOP,Bruno Fernando,fernabr01,27,ATL,1,NOP,6,11,2,2,3,1,22.4,3,8,3,5,0,0,0,0,3,5,13,8,17,19,36.2
2023-24,202403100MIA,3/10/2024,MIA vs WAS,Jordan Poole,poolejo01,62,WAS,0,MIA,6,4,6,1,0,4,22.56666667,0,4,2,6,2,5,0,0,5,1,10,12,10,16,18.8
2023-24,202403100OKC,3/10/2024,OKC vs MEM,Luguentz Dort,dortlu01,62,OKC,1,MEM,14,2,0,2,0,0,22.58333333,0,2,5,5,4,4,0,0,0,2,2,14,16,16,22.4
2023-24,202403100NYK,3/10/2024,NYK vs PHI,Jericho Sims,simsje01,37,NYK,1,PHI,4,6,0,2,1,1,22.6,0,6,2,3,0,0,0,0,1,3,6,4,10,10,19.2
2023-24,202403100MIA,3/10/2024,MIA vs WAS,Nikola Jovic,jovicni01,30,MIA,1,WAS,10,6,4,1,1,1,22.88333333,1,5,3,6,1,4,3,3,3,2,10,14,16,20,28.2
2023-24,202403100OKC,3/10/2024,OKC vs MEM,Luke Kennard,kennalu01,33,MEM,0,OKC,3,2,2,1,0,2,22.91666667,0,2,1,6,1,6,0,0,0,1,4,5,5,7,9.4
2023-24,202403100LAL,3/10/2024,LAL vs MIN,T.J. Warren,warretj01,3,MIN,0,LAL,4,3,2,1,0,1,22.96666667,1,2,2,7,0,2,0,0,2,1,5,6,7,9,12.6
2023-24,202403100ORL,3/10/2024,ORL vs IND,Joe Ingles,inglejo01,51,ORL,1,IND,11,2,2,1,0,1,22.98333333,0,2,4,5,3,4,0,0,2,1,4,13,13,15,18.4
2023-24,202403100NYK,3/10/2024,NYK vs PHI,Isaiah Hartenstein,harteis01,58,NYK,1,PHI,3,10,4,0,0,0,23.63333333,5,5,1,1,0,0,1,2,3,0,14,7,13,17,21
2023-24,202403100LAL,3/10/2024,LAL vs MIN,Rui Hachimura,hachiru01,53,LAL,1,MIN,15,2,3,0,0,1,23.85,1,1,5,10,3,5,2,2,0,0,5,18,17,20,20.9
2023-24,202403100LAL,3/10/2024,LAL vs MIN,Taurean Prince,princta02,64,LAL,1,MIN,6,3,1,1,1,0,24.18333333,0,3,3,6,0,3,0,0,1,2,4,7,9,10,17.1
2023-24,202403100OKC,3/10/2024,OKC vs MEM,Jake LaRavia,laravja01,20,MEM,0,OKC,13,1,4,2,0,1,24.21666667,0,1,4,9,2,4,3,4,4,2,5,17,14,18,25.2
2023-24,202403100CLE,3/10/2024,CLE vs BRK,Georges Niang,niangge01,64,CLE,1,BRK,20,3,2,0,0,0,24.61666667,1,2,8,12,3,5,1,1,2,0,5,22,23,25,26.6
2023-24,202403100CLE,3/10/2024,CLE vs BRK,Craig Porter Jr.,portecr01,40,CLE,1,BRK,13,2,4,0,0,2,24.63333333,0,2,5,11,3,4,0,0,1,0,6,17,15,19,19.4
2023-24,202403100MIA,3/10/2024,MIA vs WAS,Jaime Jaquez Jr.,jaqueja01,58,MIA,1,WAS,6,7,2,2,2,2,24.85,2,5,3,6,0,1,0,1,2,4,9,8,13,15,27.4
2023-24,202403100SAC,3/10/2024,SAC vs HOU,Kevin Huerter,huertke01,61,SAC,1,HOU,6,3,3,2,1,1,25.13333333,0,3,3,7,0,3,0,0,5,3,6,9,9,12,22.1
2023-24,202403100ORL,3/10/2024,ORL vs IND,Obi Toppin,toppiob01,66,IND,0,ORL,17,8,0,1,1,1,25.41666667,1,7,7,9,1,2,2,2,1,2,8,17,25,25,31.6
2023-24,202403100ORL,3/10/2024,ORL vs IND,Andrew Nembhard,nembhan01,51,IND,0,ORL,0,2,2,0,0,1,25.45,0,2,0,2,0,1,0,0,3,0,4,2,2,4,4.4
2023-24,202403100LAC,3/10/2024,LAC vs MIL,P.J. Tucker,tuckepj01,19,LAC,1,MIL,7,6,2,0,1,1,25.5,4,2,3,9,1,6,0,0,0,1,8,9,13,15,19.2
2023-24,202403100ATL,3/10/2024,ATL vs NOP,Clint Capela,capelca01,56,ATL,1,NOP,18,14,0,0,1,2,25.6,6,8,9,13,0,0,0,0,3,1,14,18,32,32,35.8
2023-24,202403100LAC,3/10/2024,LAC vs MIL,Bobby Portis,portibo01,65,MIL,0,LAC,11,8,1,0,0,0,25.88333333,3,5,5,14,1,2,0,0,1,0,9,12,19,20,22.1
2023-24,202403100ORL,3/10/2024,ORL vs IND,Cole Anthony,anthoco01,64,ORL,1,IND,16,2,3,0,0,0,25.91666667,1,1,4,14,1,6,7,8,3,0,5,19,18,21,22.9
2023-24,202403100NYK,3/10/2024,NYK vs PHI,Buddy Hield,hieldbu01,67,PHI,0,NYK,16,7,3,1,0,1,26.05,2,5,6,9,4,6,0,0,1,1,10,19,23,26,30.9
2023-24,202403100LAC,3/10/2024,LAC vs MIL,Ivica Zubac,zubaciv01,51,LAC,1,MIL,18,6,1,1,1,1,26.18333333,3,3,9,11,0,0,0,0,5,2,7,19,24,25,31.7
2023-24,202403100LAC,3/10/2024,LAC vs MIL,Pat Connaughton,connapa01,59,MIL,0,LAC,5,3,2,1,1,0,26.23333333,0,3,1,5,1,5,2,2,0,2,5,7,8,10,17.6
2023-24,202403100OKC,3/10/2024,OKC vs MEM,Cason Wallace,wallaca01,64,OKC,1,MEM,22,2,4,0,1,0,26.78333333,0,2,9,14,4,6,0,0,3,1,6,26,24,28,33.4
2023-24,202403100OKC,3/10/2024,OKC vs MEM,Santi Aldama,aldamsa01,53,MEM,0,OKC,7,6,3,0,2,0,26.85,1,5,2,5,0,2,3,4,0,2,9,10,13,16,24.7
2023-24,202403100ORL,3/10/2024,ORL vs IND,T.J. McConnell,mccontj01,55,IND,0,ORL,17,6,6,2,1,2,27.05,0,6,8,12,0,0,1,2,1,3,12,23,23,29,40.2
2023-24,202403100ATL,3/10/2024,ATL vs NOP,Saddiq Bey,beysa01,63,ATL,1,NOP,14,5,2,0,0,0,27.08333333,1,4,3,11,3,8,5,6,1,0,7,16,19,21,23
2023-24,202403100OKC,3/10/2024,OKC vs MEM,Shai Gilgeous-Alexander,gilgesh01,63,OKC,1,MEM,23,2,6,0,0,1,27.3,0,2,8,14,5,7,2,2,2,0,8,29,25,31,33.4
2023-24,202403100SAC,3/10/2024,SAC vs HOU,Malik Monk,monkma01,62,SAC,1,HOU,20,4,5,2,0,0,27.31666667,2,2,8,16,2,8,2,2,4,2,9,25,24,29,38.3
2023-24,202403100CLE,3/10/2024,CLE vs BRK,Darius Garland,garlada01,40,CLE,1,BRK,14,1,5,1,0,4,27.35,0,1,4,9,3,6,3,3,3,1,6,19,15,20,21.7
2023-24,202403100ORL,3/10/2024,ORL vs IND,Wendell Carter Jr.,cartewe01,38,ORL,1,IND,13,15,2,1,1,2,27.65,6,9,5,13,0,5,3,3,3,2,17,15,28,30,38
2023-24,202403100CLE,3/10/2024,CLE vs BRK,Nic Claxton,claxtni01,55,BRK,0,CLE,16,10,3,1,0,1,27.8,2,8,7,10,0,0,2,2,3,1,13,19,26,29,34.5
2023-24,202403100ORL,3/10/2024,ORL vs IND,Gary Harris,harriga01,41,ORL,1,IND,5,1,1,0,0,2,27.83333333,0,1,2,3,1,2,0,0,3,0,2,6,6,7,5.7
2023-24,202403100NYK,3/10/2024,NYK vs PHI,Paul Reed,reedpa01,64,PHI,0,NYK,13,7,1,0,4,1,27.95,3,4,5,8,2,2,1,2,3,4,8,14,20,21,33.9
2023-24,202403100OKC,3/10/2024,OKC vs MEM,Jaren Jackson Jr.,jacksja02,57,MEM,0,OKC,16,2,2,0,1,4,28.06666667,1,1,4,10,3,5,5,8,3,1,4,18,18,20,20.4
2023-24,202403100OKC,3/10/2024,OKC vs MEM,DeJon Jarreau,jarrede01,1,MEM,0,OKC,7,10,5,3,0,2,28.08333333,0,10,3,9,1,2,0,0,1,3,15,12,17,22,33.5
2023-24,202403100LAL,3/10/2024,LAL vs MIN,Mike Conley,conlemi01,60,MIN,0,LAL,9,3,6,1,0,0,28.53333333,0,3,3,6,1,3,2,2,3,1,9,15,12,18,24.6
2023-24,202403100CLE,3/10/2024,CLE vs BRK,Caris LeVert,leverca01,52,CLE,1,BRK,6,3,7,3,0,3,28.76666667,0,3,2,6,1,3,1,2,0,3,10,13,9,16,26.1
2023-24,202403100CLE,3/10/2024,CLE vs BRK,Jarrett Allen,allenja01,59,CLE,1,BRK,15,9,3,0,2,1,28.88333333,2,7,6,11,0,0,3,4,2,2,12,18,24,27,35.3
2023-24,202403100ATL,3/10/2024,ATL vs NOP,Larry Nance Jr.,nancela02,46,NOP,0,ATL,10,2,3,4,0,0,28.9,1,1,4,4,0,0,2,3,1,4,5,13,12,15,28.9
2023-24,202403100SAC,3/10/2024,SAC vs HOU,Alperen Sengun,sengual01,63,HOU,0,SAC,14,6,2,2,0,0,29.38333333,0,6,7,14,0,0,0,2,4,2,8,16,20,22,30.2
2023-24,202403100ORL,3/10/2024,ORL vs IND,Franz Wagner,wagnefr01,57,ORL,1,IND,13,4,2,2,0,1,29.48333333,0,4,5,14,0,3,3,5,3,2,6,15,17,19,25.8
2023-24,202403100NYK,3/10/2024,NYK vs PHI,Cameron Payne,payneca01,60,PHI,0,NYK,7,1,5,0,1,2,29.5,0,1,3,13,1,6,0,0,4,1,6,12,8,13,16.7
2023-24,202403100CLE,3/10/2024,CLE vs BRK,Isaac Okoro,okorois01,55,CLE,1,BRK,11,4,1,1,1,1,29.93333333,0,4,4,6,2,3,1,2,3,2,5,12,15,16,22.3
2023-24,202403100LAC,3/10/2024,LAC vs MIL,Terance Mann,mannte01,57,LAC,1,MIL,16,2,1,0,2,0,30.03333333,2,0,6,10,2,6,2,2,2,2,3,17,18,19,25.9
2023-24,202403100SAC,3/10/2024,SAC vs HOU,Dillon Brooks,brookdi01,55,HOU,0,SAC,10,2,1,1,0,2,30.1,0,2,3,8,2,5,2,2,0,1,3,11,12,13,14.9
2023-24,202403100LAC,3/10/2024,LAC vs MIL,Amir Coffey,coffeam01,51,LAC,1,MIL,16,10,4,0,1,1,30.16666667,1,9,6,11,4,6,0,0,4,1,14,20,26,30,36
2023-24,202403100OKC,3/10/2024,OKC vs MEM,Lamar Stevens,stevela01,31,MEM,0,OKC,9,3,0,1,0,3,30.3,1,2,4,12,1,2,0,0,2,1,3,9,12,12,12.6
2023-24,202403100ATL,3/10/2024,ATL vs NOP,Trey Murphy III,murphtr02,39,NOP,0,ATL,28,7,2,0,0,2,30.31666667,0,7,10,18,6,13,2,2,1,0,9,30,35,37,37.4
2023-24,202403100ATL,3/10/2024,ATL vs NOP,Herbert Jones,joneshe01,59,NOP,0,ATL,7,1,2,2,3,2,30.43333333,0,1,3,5,1,2,0,0,3,5,3,9,8,10,24.2
2023-24,202403100MIA,3/10/2024,MIA vs WAS,Caleb Martin,martica02,47,MIA,1,WAS,11,7,3,1,1,1,30.46666667,3,4,4,9,3,3,0,0,1,2,10,14,18,21,28.9
2023-24,202403100CLE,3/10/2024,CLE vs BRK,Cam Thomas,thomaca02,50,BRK,0,CLE,29,7,5,1,0,1,30.63333333,2,5,9,19,5,7,6,8,2,1,12,34,36,41,46.9
2023-24,202403100ATL,3/10/2024,ATL vs NOP,CJ McCollum,mccolcj01,48,NOP,0,ATL,20,4,3,0,0,2,30.68333333,1,3,7,14,4,7,2,3,0,0,7,23,24,27,27.3
2023-24,202403100NYK,3/10/2024,NYK vs PHI,Nicolas Batum,batumni01,43,PHI,0,NYK,0,5,3,2,0,1,30.73333333,0,5,0,2,0,2,0,0,2,2,8,3,5,8,15.5
2023-24,202403100NYK,3/10/2024,NYK vs PHI,Kyle Lowry,lowryky01,45,PHI,0,NYK,8,2,3,1,0,2,30.95,0,2,3,8,2,5,0,0,2,1,5,11,10,13,15.9
2023-24,202403100LAC,3/10/2024,LAC vs MIL,Norman Powell,powelno01,62,LAC,1,MIL,26,7,2,1,0,1,31.15,0,7,9,21,3,14,5,6,2,1,9,28,33,35,39.4
2023-24,202403100ORL,3/10/2024,ORL vs IND,Myles Turner,turnemy01,62,IND,0,ORL,12,8,0,0,6,3,31.16666667,1,7,4,11,1,3,3,5,4,6,8,12,20,20,36.6
2023-24,202403100LAC,3/10/2024,LAC vs MIL,Brook Lopez,lopezbr01,62,MIL,0,LAC,7,6,1,0,2,1,31.2,2,4,2,4,1,2,2,2,2,2,7,8,13,14,20.7
2023-24,202403100ATL,3/10/2024,ATL vs NOP,Brandon Ingram,ingrabr01,58,NOP,0,ATL,7,7,10,1,0,2,31.83333333,0,7,3,9,0,1,1,2,2,1,17,17,14,24,31.4
2023-24,202403100LAL,3/10/2024,LAL vs MIN,Jaden McDaniels,mcdanja02,55,MIN,0,LAL,10,6,1,2,0,0,32.1,3,3,5,17,0,5,0,0,1,2,7,11,16,17,24.7
2023-24,202403100SAC,3/10/2024,SAC vs HOU,Keegan Murray,murrake02,59,SAC,1,HOU,13,6,0,2,1,0,32.28333333,1,5,3,11,0,5,7,7,2,3,6,13,19,19,29.2
2023-24,202403100NYK,3/10/2024,NYK vs PHI,Jalen Brunson,brunsja01,59,NYK,1,PHI,19,3,8,0,0,2,32.4,2,1,6,22,1,9,6,8,1,0,11,27,22,30,32.6
2023-24,202403100ORL,3/10/2024,ORL vs IND,Pascal Siakam,siakapa01,63,IND,0,ORL,20,7,3,0,0,0,32.73333333,1,6,6,14,1,3,7,9,2,0,10,23,27,30,32.9
2023-24,202403100NYK,3/10/2024,NYK vs PHI,Kelly Oubre Jr.,oubreke01,51,PHI,0,NYK,18,10,3,3,0,3,32.85,5,5,6,19,0,3,6,9,5,3,13,21,28,31,40.5
2023-24,202403100CLE,3/10/2024,CLE vs BRK,Dorian Finney-Smith,finnedo01,56,BRK,0,CLE,11,4,4,0,1,0,33,2,2,3,10,3,9,2,2,1,1,8,15,15,19,24.8
2023-24,202403100SAC,3/10/2024,SAC vs HOU,De'Aaron Fox,foxde01,55,SAC,1,HOU,18,9,1,1,1,0,33.51666667,0,9,7,21,2,9,2,2,2,2,10,19,27,28,36.3
2023-24,202403100MIA,3/10/2024,MIA vs WAS,Duncan Robinson,robindu01,59,MIA,1,WAS,16,2,1,0,0,5,33.55,1,1,5,16,4,13,2,2,3,0,3,17,18,19,14.9
2023-24,202403100LAL,3/10/2024,LAL vs MIN,D'Angelo Russell,russeda01,62,LAL,1,MIN,13,3,6,0,0,2,33.61666667,1,2,5,12,2,5,1,2,1,0,9,19,16,22,23.6
2023-24,202403100CLE,3/10/2024,CLE vs BRK,Dennis Schroder,schrode01,65,BRK,0,CLE,17,2,8,2,0,4,33.65,0,2,7,11,3,5,0,0,1,2,10,25,19,27,33.4
2023-24,202403100SAC,3/10/2024,SAC vs HOU,Jabari Smith Jr.,smithja05,59,HOU,0,SAC,10,11,2,3,0,3,33.85,2,9,3,10,2,6,2,2,3,3,13,12,21,23,32.2
2023-24,202403100SAC,3/10/2024,SAC vs HOU,Jalen Green,greenja05,64,HOU,0,SAC,19,2,3,0,0,0,34.56666667,0,2,6,15,1,6,6,8,2,0,5,22,21,24,25.9
2023-24,202403100CLE,3/10/2024,CLE vs BRK,Mikal Bridges,bridgmi01,65,BRK,0,CLE,25,5,5,3,0,1,34.66666667,0,5,9,14,5,8,2,2,2,3,10,30,30,35,46.5
2023-24,202403100MIA,3/10/2024,MIA vs WAS,Bam Adebayo,adebaba01,54,MIA,1,WAS,16,16,2,2,1,0,34.98333333,7,9,7,14,0,0,2,6,3,3,18,18,32,34,47.2
2023-24,202403100MIA,3/10/2024,MIA vs WAS,Terry Rozier,roziete01,47,MIA,1,WAS,16,7,4,2,0,2,34.98333333,0,7,8,16,0,3,0,0,2,2,11,20,23,27,34.4
2023-24,202403100MIA,3/10/2024,MIA vs WAS,Deni Avdija,avdijde01,61,WAS,0,MIA,16,10,2,1,1,2,35.48333333,2,8,7,14,1,4,1,1,5,2,12,18,26,28,35
2023-24,202403100ATL,3/10/2024,ATL vs NOP,De'Andre Hunter,huntede01,40,ATL,1,NOP,12,6,2,0,0,2,35.56666667,0,6,5,15,2,8,0,0,0,0,8,14,18,20,20.2
2023-24,202403100ORL,3/10/2024,ORL vs IND,Tyrese Haliburton,halibty01,53,IND,0,ORL,20,7,8,0,0,4,35.8,0,7,6,15,1,6,7,7,2,0,15,28,27,35,36.4
2023-24,202403100LAL,3/10/2024,LAL vs MIN,Austin Reaves,reaveau01,67,LAL,1,MIN,19,6,4,0,0,4,35.93333333,0,6,7,13,3,6,2,2,2,0,10,23,25,29,28.2
2023-24,202403100NYK,3/10/2024,NYK vs PHI,Precious Achiuwa,achiupr01,57,NYK,1,PHI,8,9,0,2,3,3,36.08333333,3,6,2,8,1,3,3,4,2,5,9,8,17,17,30.8
2023-24,202403100NYK,3/10/2024,NYK vs PHI,Donte DiVincenzo,divindo01,63,NYK,1,PHI,15,9,3,2,1,4,36.26666667,2,7,6,17,3,12,0,0,3,3,12,18,24,27,35.3
2023-24,202403100MIA,3/10/2024,MIA vs WAS,Bilal Coulibaly,coulibi01,60,WAS,0,MIA,11,4,1,2,2,1,36.31666667,0,4,4,8,3,5,0,0,2,4,5,12,15,16,28.3
2023-24,202403100ATL,3/10/2024,ATL vs NOP,Zion Williamson,willizi01,53,NOP,0,ATL,27,6,7,0,2,1,36.41666667,2,4,10,14,0,0,7,10,2,2,13,34,33,40,49.7
2023-24,202403100ATL,3/10/2024,ATL vs NOP,Bogdan Bogdanovic,bogdabo01,62,ATL,1,NOP,25,1,7,2,0,1,36.43333333,1,0,9,19,7,15,0,0,1,2,8,32,26,33,41.7
2023-24,202403100LAC,3/10/2024,LAC vs MIL,James Harden,hardeja01,58,LAC,1,MIL,13,5,11,0,0,5,36.43333333,3,2,5,16,1,6,2,2,4,0,16,24,18,29,30.5
2023-24,202403100MIA,3/10/2024,MIA vs WAS,Jimmy Butler,butleji01,45,MIA,1,WAS,23,3,4,1,1,2,36.48333333,1,2,9,20,0,4,5,6,2,2,7,27,26,30,36.6
2023-24,202403100ORL,3/10/2024,ORL vs IND,Aaron Nesmith,nesmiaa01,57,IND,0,ORL,16,5,1,1,2,1,37.16666667,0,5,4,8,4,6,4,4,3,3,6,17,21,22,31.5
2023-24,202403100OKC,3/10/2024,OKC vs MEM,GG Jackson II,jacksgg01,31,MEM,0,OKC,30,6,3,0,1,1,37.53333333,3,3,10,19,3,10,7,8,3,1,9,33,36,39,43.7
2023-24,202403100LAL,3/10/2024,LAL vs MIN,LeBron James,jamesle01,58,LAL,1,MIN,29,8,9,0,0,4,37.85,0,8,10,16,2,4,7,9,1,0,17,38,37,46,48.1
2023-24,202403100ORL,3/10/2024,ORL vs IND,Paolo Banchero,banchpa01,63,ORL,1,IND,19,5,5,2,0,3,37.91666667,0,5,6,20,1,8,6,8,3,2,10,24,24,29,35.5
2023-24,202403100LAC,3/10/2024,LAC vs MIL,Damian Lillard,lillada01,60,MIL,0,LAC,35,7,11,0,0,2,38.01666667,1,6,11,19,7,13,6,7,1,0,18,46,42,53,57.9
2023-24,202403100SAC,3/10/2024,SAC vs HOU,Fred VanVleet,vanvlfr01,57,HOU,0,SAC,22,4,9,2,0,5,38.1,0,4,5,8,2,4,10,10,3,2,13,31,26,35,41.3
2023-24,202403100MIA,3/10/2024,MIA vs WAS,Tyus Jones,jonesty01,64,WAS,0,MIA,12,4,16,1,0,1,38.18333333,0,4,5,9,2,5,0,0,0,1,20,28,16,32,42.8
2023-24,202403100NYK,3/10/2024,NYK vs PHI,Tobias Harris,harrito02,58,PHI,0,NYK,11,12,2,2,0,3,38.26666667,2,10,5,14,0,4,1,3,1,2,14,13,23,25,31.4
2023-24,202403100MIA,3/10/2024,MIA vs WAS,Kyle Kuzma,kuzmaky01,62,WAS,0,MIA,32,9,4,0,2,4,38.43333333,1,8,9,23,2,7,12,16,2,2,13,36,41,45,50.8
2023-24,202403100LAC,3/10/2024,LAC vs MIL,Giannis Antetokounmpo,antetgi01,62,MIL,0,LAC,34,7,10,1,1,3,38.61666667,0,7,12,24,0,2,10,15,3,2,17,44,41,51,60.4
2023-24,202403100LAC,3/10/2024,LAC vs MIL,Malik Beasley,beaslma01,63,MIL,0,LAC,17,4,1,0,0,1,38.66666667,0,4,6,11,4,9,1,1,0,0,5,18,21,22,22.3
2023-24,202403100LAL,3/10/2024,LAL vs MIN,Nickeil Alexander-Walker,alexani01,65,MIN,0,LAL,15,7,5,2,0,1,39.03333333,4,3,6,11,3,4,0,0,1,2,12,20,22,27,35.9
2023-24,202403100MIA,3/10/2024,MIA vs WAS,Corey Kispert,kispeco01,62,WAS,0,MIA,22,5,6,0,0,2,39.26666667,3,2,8,15,5,10,1,2,1,0,11,28,27,33,35
2023-24,202403100LAL,3/10/2024,LAL vs MIN,Anthony Davis,davisan02,63,LAL,1,MIN,27,25,5,7,3,3,39.3,10,15,9,17,0,0,9,13,2,10,30,32,52,57,91.5
2023-24,202403100SAC,3/10/2024,SAC vs HOU,Domantas Sabonis,sabondo01,63,SAC,1,HOU,25,15,8,3,2,9,39.6,2,13,10,11,0,0,5,6,1,5,23,33,40,48,61
2023-24,202403100LAL,3/10/2024,LAL vs MIN,Anthony Edwards,edwaran01,62,MIN,0,LAL,25,7,7,2,2,3,39.88333333,1,6,10,23,2,9,3,4,2,4,14,32,32,39,52.9
2023-24,202403100ATL,3/10/2024,ATL vs NOP,Dejounte Murray,murrade01,61,ATL,1,NOP,23,1,11,1,0,4,40.98333333,1,0,7,20,4,10,5,7,2,1,12,34,24,35,39.7
2023-24,202403100LAL,3/10/2024,LAL vs MIN,Naz Reid,reidna01,65,MIN,0,LAL,25,5,3,0,4,3,42.3,0,5,9,17,5,10,2,3,4,4,8,28,30,33,44.5
2023-24,202403100NYK,3/10/2024,NYK vs PHI,Josh Hart,hartjo01,63,NYK,1,PHI,9,11,2,2,0,6,43.01666667,3,8,4,13,1,7,0,0,2,2,13,11,20,22,25.2
2023-24,202403090PHO,3/9/2024,PHO vs BOS,Bol Bol,bolbo01,26,PHO,1,BOS,13,4,0,0,0,0,10.23333333,1,3,6,7,1,2,0,0,0,0,4,13,17,17,17.8
2023-24,202403090LAC,3/9/2024,LAC vs CHI,Onuralp Bitim,bitimon01,8,CHI,0,LAC,6,1,0,0,0,0,10.35,1,0,2,3,2,3,0,0,0,0,1,6,7,7,7.2
2023-24,202403090CHO,3/9/2024,CHO vs BRK,Day'Ron Sharpe,sharpda01,47,BRK,0,CHO,2,5,2,0,0,1,10.46666667,4,1,1,3,0,0,0,0,1,0,7,4,7,9,10
2023-24,202403090PHO,3/9/2024,PHO vs BOS,Drew Eubanks,eubandr01,58,PHO,1,BOS,0,1,0,0,0,0,10.75,0,1,0,0,0,0,0,0,1,0,1,0,1,1,1.2
2023-24,202403090DET,3/9/2024,DET vs DAL,Evan Fournier,fournev01,14,DET,1,DAL,0,2,1,0,0,0,10.75,0,2,0,3,0,2,0,0,0,0,3,1,2,3,3.9
2023-24,202403090DET,3/9/2024,DET vs DAL,Ausar Thompson,thompau01,63,DET,1,DAL,4,5,0,1,0,0,11.26666667,4,1,1,7,0,2,2,4,1,1,5,4,9,9,13
2023-24,202403090GSW,3/9/2024,GSW vs SAS,Devonte Graham,grahade01,13,SAS,0,GSW,8,2,0,1,0,0,11.3,0,2,3,4,2,2,0,0,2,1,2,8,10,10,13.4
2023-24,202403090LAC,3/9/2024,LAC vs CHI,Andre Drummond,drumman01,64,CHI,0,LAC,3,7,0,0,0,1,11.91666667,3,4,0,1,0,0,3,4,1,0,7,3,10,10,10.4
2023-24,202403090DET,3/9/2024,DET vs DAL,Dwight Powell,poweldw01,52,DAL,0,DET,3,2,1,0,0,1,12.01666667,1,1,1,2,0,0,1,1,4,0,3,4,5,6,5.9
2023-24,202403090POR,3/9/2024,POR vs TOR,Jordan Nwora,nworajo01,35,TOR,0,POR,10,1,1,1,0,0,12.33333333,0,1,4,6,1,2,1,1,0,1,2,11,11,12,15.7
2023-24,202403090CHO,3/9/2024,CHO vs BRK,JT Thor,thorjt01,49,CHO,1,BRK,5,1,0,0,0,0,12.5,0,1,2,2,1,1,0,0,1,0,1,5,6,6,6.2
2023-24,202403090POR,3/9/2024,POR vs TOR,Rayan Rupert,ruperra01,22,POR,1,TOR,0,3,3,1,0,0,12.58333333,2,1,0,3,0,3,0,0,2,1,6,3,3,6,11.1
2023-24,202403090POR,3/9/2024,POR vs TOR,Duop Reath,reathdu01,49,POR,1,TOR,4,1,0,0,0,0,13.05,0,1,1,3,0,1,2,2,1,0,1,4,5,5,5.2
2023-24,202403090LAC,3/9/2024,LAC vs CHI,Torrey Craig,craigto01,35,CHI,0,LAC,6,3,0,1,0,2,13.21666667,2,1,2,6,2,5,0,0,2,1,3,6,9,9,10.6
2023-24,202403090CHO,3/9/2024,CHO vs BRK,Trendon Watford,watfotr01,46,BRK,0,CHO,6,5,0,0,0,1,13.4,3,2,2,6,1,2,1,2,3,0,5,6,11,11,11
2023-24,202403090LAC,3/9/2024,LAC vs CHI,Bones Hyland,hylanbo01,24,LAC,1,CHI,10,2,1,3,0,1,13.45,0,2,3,3,3,3,1,2,1,3,3,11,12,13,21.9
2023-24,202403090DET,3/9/2024,DET vs DAL,Stanley Umude,umudest01,18,DET,1,DAL,3,2,0,0,1,0,13.6,2,0,1,5,1,3,0,0,3,1,2,3,5,5,8.4
2023-24,202403090CHO,3/9/2024,CHO vs BRK,Dennis Smith Jr.,smithde03,48,BRK,0,CHO,7,3,0,0,0,1,14.11666667,0,3,2,4,1,3,2,2,1,0,3,7,10,10,9.6
2023-24,202403090DEN,3/9/2024,DEN vs UTA,Luka Samanic,samanlu01,32,UTA,0,DEN,7,5,1,0,1,1,14.5,1,4,2,6,0,3,3,3,3,1,6,8,12,13,16.5
2023-24,202403090DEN,3/9/2024,DEN vs UTA,Zeke Nnaji,nnajize01,49,DEN,1,UTA,1,2,2,0,2,0,14.51666667,1,1,0,1,0,0,1,2,2,2,4,3,3,5,12.4
2023-24,202403090DEN,3/9/2024,DEN vs UTA,Kris Dunn,dunnkr01,56,UTA,0,DEN,0,1,1,0,0,0,14.96666667,0,1,0,0,0,0,0,0,4,0,2,1,1,2,2.7
2023-24,202403090LAC,3/9/2024,LAC vs CHI,Amir Coffey,coffeam01,50,LAC,1,CHI,0,1,0,0,0,0,15.48333333,0,1,0,2,0,2,0,0,0,0,1,0,1,1,1.2
2023-24,202403090DET,3/9/2024,DET vs DAL,Jalen Duren,durenja01,48,DET,1,DAL,6,8,3,0,0,2,15.76666667,2,6,1,4,0,0,4,4,4,0,11,9,14,17,18.1
2023-24,202403090CHO,3/9/2024,CHO vs BRK,Nick Smith Jr.,smithni01,39,CHO,1,BRK,4,1,3,1,0,0,16.63333333,1,0,2,4,0,1,0,0,3,1,4,7,5,8,12.7
2023-24,202403090DEN,3/9/2024,DEN vs UTA,Christian Braun,braunch01,64,DEN,1,UTA,13,4,1,0,1,0,16.66666667,0,4,5,5,3,3,0,0,6,1,5,14,17,18,22.3
2023-24,202403090DET,3/9/2024,DET vs DAL,Maxi Kleber,klebima01,27,DAL,0,DET,0,6,0,1,1,0,17.06666667,1,5,0,2,0,2,0,0,2,2,6,0,6,6,13.2
2023-24,202403090DET,3/9/2024,DET vs DAL,Tim Hardaway Jr.,hardati02,61,DAL,0,DET,17,1,2,0,0,0,17.58333333,0,1,6,13,4,8,1,4,0,0,3,19,18,20,21.2
2023-24,202403090PHO,3/9/2024,PHO vs BOS,Sam Hauser,hausesa01,62,BOS,0,PHO,3,2,0,0,1,0,17.81666667,0,2,1,5,1,4,0,0,0,1,2,3,5,5,8.4
2023-24,202403090POR,3/9/2024,POR vs TOR,Javon Freeman-Liberty,freemja01,6,TOR,0,POR,6,4,2,0,0,3,18.08333333,1,3,2,3,0,1,2,2,3,0,6,8,10,12,10.8
2023-24,202403090DET,3/9/2024,DET vs DAL,Dante Exum,exumda01,38,DAL,0,DET,2,2,5,0,0,0,18.11666667,1,1,1,3,0,1,0,0,2,0,7,7,4,9,11.9
2023-24,202403090DET,3/9/2024,DET vs DAL,Derrick Jones Jr.,jonesde02,59,DAL,0,DET,12,1,1,4,1,0,18.2,0,1,5,7,0,2,2,2,2,5,2,13,13,14,29.7
2023-24,202403090DET,3/9/2024,DET vs DAL,Marcus Sasser,sassema01,54,DET,1,DAL,10,4,1,1,0,3,18.5,0,4,4,8,2,5,0,0,3,1,5,11,14,15,16.3
2023-24,202403090PHO,3/9/2024,PHO vs BOS,Luke Kornet,kornelu01,45,BOS,0,PHO,14,6,0,0,1,0,19.8,3,3,6,7,0,0,2,2,2,1,6,14,20,20,24.2
2023-24,202403090CHO,3/9/2024,CHO vs BRK,Jalen Wilson,wilsoja03,26,BRK,0,CHO,0,4,1,1,0,2,20.23333333,2,2,0,5,0,3,0,0,2,1,5,1,4,5,7.3
2023-24,202403090GSW,3/9/2024,GSW vs SAS,Blake Wesley,weslebl01,43,SAS,0,GSW,4,5,9,1,2,1,20.31666667,0,5,1,3,0,0,2,2,3,3,14,13,9,18,31.5
2023-24,202403090DEN,3/9/2024,DEN vs UTA,Aaron Gordon,gordoaa01,58,DEN,1,UTA,7,2,7,2,0,3,20.35,0,2,3,3,0,0,1,1,4,2,9,14,9,16,22.9
2023-24,202403090LAC,3/9/2024,LAC vs CHI,Daniel Theis,theisda01,47,LAC,1,CHI,6,3,2,0,1,2,20.78333333,3,0,3,8,0,1,0,0,4,1,5,8,9,11,13.6
2023-24,202403090POR,3/9/2024,POR vs TOR,Ochai Agbaji,agbajoc01,63,TOR,0,POR,7,1,1,1,0,0,21.78333333,0,1,2,7,1,4,2,2,0,1,2,8,8,9,12.7
2023-24,202403090GSW,3/9/2024,GSW vs SAS,Zach Collins,colliza01,52,SAS,0,GSW,9,2,0,1,1,0,22.25,0,2,4,8,1,1,0,2,5,2,2,9,11,11,17.4
2023-24,202403090DEN,3/9/2024,DEN vs UTA,Michael Porter Jr.,portemi01,63,DEN,1,UTA,19,4,2,1,1,2,22.36666667,1,3,8,13,3,5,0,0,1,2,6,21,23,25,30.8
2023-24,202403090PHO,3/9/2024,PHO vs BOS,Payton Pritchard,pritcpa01,63,BOS,0,PHO,10,2,1,1,0,0,22.51666667,1,1,4,6,2,4,0,0,0,1,3,11,12,13,16.9
2023-24,202403090GSW,3/9/2024,GSW vs SAS,Trayce Jackson-Davis,jackstr02,50,GSW,1,SAS,11,6,0,1,3,1,23.66666667,1,5,5,5,0,0,1,5,4,4,6,11,17,17,29.2
2023-24,202403090DET,3/9/2024,DET vs DAL,Daniel Gafford,gaffoda01,57,DAL,0,DET,17,7,1,0,4,1,24.05,0,7,7,7,0,0,3,4,3,4,8,18,24,25,37.9
2023-24,202403090DEN,3/9/2024,DEN vs UTA,Walker Kessler,kesslwa01,52,UTA,0,DEN,6,11,2,0,1,0,24.35,7,4,3,9,0,0,0,0,1,1,13,8,17,19,25.2
2023-24,202403090GSW,3/9/2024,GSW vs SAS,Jeremy Sochan,sochaje01,64,SAS,0,GSW,20,5,1,0,1,3,24.38333333,0,5,7,14,2,4,4,6,5,1,6,21,25,26,27.5
2023-24,202403090POR,3/9/2024,POR vs TOR,Kris Murray,murrakr01,43,POR,1,TOR,5,4,3,0,0,1,24.58333333,0,4,2,7,1,5,0,0,1,0,7,8,9,12,13.3
2023-24,202403090POR,3/9/2024,POR vs TOR,Jalen McDaniels,mcdanja01,36,TOR,0,POR,4,10,3,2,1,1,24.61666667,1,9,2,3,0,0,0,0,3,3,13,7,14,17,28.5
2023-24,202403090DEN,3/9/2024,DEN vs UTA,Justin Holiday,holidju01,40,DEN,1,UTA,3,2,7,0,1,0,24.78333333,0,2,1,1,1,1,0,0,1,1,9,10,5,12,18.9
2023-24,202403090GSW,3/9/2024,GSW vs SAS,Klay Thompson,thompkl01,60,GSW,1,SAS,27,2,1,0,1,3,24.85,0,2,8,16,5,10,6,6,4,1,3,28,29,30,30.9
2023-24,202403090LAC,3/9/2024,LAC vs CHI,Ivica Zubac,zubaciv01,50,LAC,1,CHI,16,9,2,0,1,1,24.91666667,2,7,7,9,0,0,2,2,3,1,11,18,25,27,31.8
2023-24,202403090LAC,3/9/2024,LAC vs CHI,Terance Mann,mannte01,56,LAC,1,CHI,7,1,1,0,0,1,25.25,0,1,3,7,1,3,0,0,2,0,2,8,8,9,8.7
2023-24,202403090DEN,3/9/2024,DEN vs UTA,Peyton Watson,watsope01,62,DEN,1,UTA,12,5,0,1,1,1,26.16666667,0,5,4,8,0,2,4,4,1,2,5,12,17,17,23
2023-24,202403090GSW,3/9/2024,GSW vs SAS,Andrew Wiggins,wiggian01,54,GSW,1,SAS,11,6,1,1,0,0,26.23333333,1,5,5,12,1,3,0,0,3,1,7,12,17,18,22.7
2023-24,202403090GSW,3/9/2024,GSW vs SAS,Moses Moody,moodymo01,49,GSW,1,SAS,9,5,0,0,1,1,26.26666667,1,4,2,11,0,6,5,6,2,1,5,9,14,14,17
2023-24,202403090POR,3/9/2024,POR vs TOR,Scoot Henderson,hendesc01,44,POR,1,TOR,13,1,5,1,0,1,26.33333333,0,1,5,12,1,4,2,2,4,1,6,18,14,19,23.7
2023-24,202403090DET,3/9/2024,DET vs DAL,Josh Green,greenjo02,51,DAL,0,DET,8,1,2,2,0,0,27,0,1,2,5,0,1,4,5,3,2,3,10,9,11,18.2
2023-24,202403090LAC,3/9/2024,LAC vs CHI,Norman Powell,powelno01,61,LAC,1,CHI,18,4,0,1,0,2,27.21666667,2,2,6,14,2,9,4,4,2,1,4,18,22,22,23.8
2023-24,202403090PHO,3/9/2024,PHO vs BOS,Jusuf Nurkic,nurkiju01,60,PHO,1,BOS,11,11,4,1,1,3,27.63333333,5,6,5,6,0,0,1,3,2,2,15,15,22,26,33.2
2023-24,202403090GSW,3/9/2024,GSW vs SAS,Draymond Green,greendr01,39,GSW,1,SAS,7,5,4,2,1,3,27.9,2,3,3,6,1,3,0,0,2,3,9,11,12,16,25
2023-24,202403090DEN,3/9/2024,DEN vs UTA,Jordan Clarkson,clarkjo01,53,UTA,0,DEN,22,4,3,3,0,3,27.98333333,1,3,10,18,1,4,1,1,1,3,7,25,26,29,37.3
2023-24,202403090CHO,3/9/2024,CHO vs BRK,Davis Bertans,bertada01,26,CHO,1,BRK,11,3,4,2,0,1,28.11666667,1,2,3,8,3,6,2,2,4,2,7,15,14,18,25.6
2023-24,202403090DET,3/9/2024,DET vs DAL,P.J. Washington,washipj01,56,DAL,0,DET,7,2,1,2,0,0,28.96666667,0,2,2,4,1,3,2,2,0,2,3,8,9,10,16.9
2023-24,202403090GSW,3/9/2024,GSW vs SAS,Malaki Branham,branhma01,59,SAS,0,GSW,20,3,2,0,0,3,29,1,2,7,15,3,6,3,4,1,0,5,22,23,25,23.6
2023-24,202403090PHO,3/9/2024,PHO vs BOS,Eric Gordon,gordoer01,53,PHO,1,BOS,0,2,2,0,0,0,29.15,0,2,0,3,0,2,0,0,0,0,4,2,2,4,5.4
2023-24,202403090GSW,3/9/2024,GSW vs SAS,Chris Paul,paulch01,39,GSW,1,SAS,10,4,9,3,0,0,29.21666667,0,4,4,9,2,3,0,0,1,3,13,19,14,23,37.3
2023-24,202403090DET,3/9/2024,DET vs DAL,Kyrie Irving,irvinky01,42,DAL,0,DET,21,3,5,1,0,4,29.73333333,1,2,9,18,3,6,0,0,1,1,8,26,24,29,31.1
2023-24,202403090GSW,3/9/2024,GSW vs SAS,Dominick Barlow,barlodo01,26,SAS,0,GSW,19,8,4,1,1,0,30.08333333,5,3,7,10,0,1,5,6,4,2,12,23,27,31,40.6
2023-24,202403090DET,3/9/2024,DET vs DAL,James Wiseman,wisemja01,44,DET,1,DAL,17,12,4,0,1,1,30.13333333,4,8,8,10,0,0,1,2,5,1,16,21,29,33,39.4
2023-24,202403090GSW,3/9/2024,GSW vs SAS,Jonathan Kuminga,kuminjo01,62,GSW,1,SAS,26,3,2,1,0,2,30.35,0,3,10,17,0,1,6,8,4,1,5,28,29,31,33.6
2023-24,202403090DEN,3/9/2024,DEN vs UTA,Kentavious Caldwell-Pope,caldwke01,58,DEN,1,UTA,13,1,2,1,2,1,30.46666667,0,1,5,8,3,6,0,0,2,3,3,15,14,16,25.2
2023-24,202403090CHO,3/9/2024,CHO vs BRK,Cam Thomas,thomaca02,49,BRK,0,CHO,31,1,2,0,0,2,30.46666667,0,1,12,24,5,10,2,3,2,0,3,33,32,34,33.2
2023-24,202403090GSW,3/9/2024,GSW vs SAS,Brandin Podziemski,podzibr01,55,GSW,1,SAS,8,6,7,1,1,2,30.61666667,4,2,2,7,1,1,3,4,0,2,13,15,14,21,29.7
2023-24,202403090CHO,3/9/2024,CHO vs BRK,Nick Richards,richani01,54,CHO,1,BRK,15,11,0,1,1,1,30.71666667,5,6,6,10,0,0,3,3,3,2,11,15,26,26,33.2
2023-24,202403090GSW,3/9/2024,GSW vs SAS,Tre Jones,jonestr01,59,SAS,0,GSW,7,5,11,2,0,1,31.06666667,1,4,1,5,0,2,5,6,1,2,16,18,12,23,34.5
2023-24,202403090POR,3/9/2024,POR vs TOR,Chris Boucher,bouchch01,50,TOR,0,POR,16,8,2,0,3,3,31.25,1,7,4,5,2,3,6,6,2,3,10,18,24,26,34.6
2023-24,202403090CHO,3/9/2024,CHO vs BRK,Vasilije Micic,micicva01,43,CHO,1,BRK,12,5,10,0,0,5,31.36666667,1,4,5,13,1,5,1,1,1,0,15,22,17,27,28
2023-24,202403090GSW,3/9/2024,GSW vs SAS,Keldon Johnson,johnske04,60,SAS,0,GSW,22,11,1,0,0,1,31.7,3,8,9,18,4,9,0,0,1,0,12,23,33,34,35.7
2023-24,202403090DEN,3/9/2024,DEN vs UTA,Brice Sensabaugh,sensabr01,14,UTA,0,DEN,16,2,3,3,0,5,31.83333333,1,1,7,11,0,3,2,3,0,3,5,19,18,21,26.9
2023-24,202403090POR,3/9/2024,POR vs TOR,Toumani Camara,camarto01,60,POR,1,TOR,15,9,4,1,0,1,31.86666667,5,4,5,10,2,4,3,3,3,1,13,19,24,28,33.8
2023-24,202403090DEN,3/9/2024,DEN vs UTA,Nikola Jokic,jokicni01,62,DEN,1,UTA,26,6,8,1,2,3,32,2,4,12,14,0,0,2,2,1,3,14,34,32,40,51.2
2023-24,202403090PHO,3/9/2024,PHO vs BOS,Al Horford,horfoal01,53,BOS,0,PHO,9,12,3,1,0,1,32.18333333,3,9,4,12,1,7,0,0,4,1,15,12,21,24,29.9
2023-24,202403090DET,3/9/2024,DET vs DAL,Simone Fontecchio,fontesi01,62,DET,1,DAL,27,4,2,1,1,0,32.2,1,3,9,13,4,5,5,5,4,2,6,29,31,33,40.8
2023-24,202403090DET,3/9/2024,DET vs DAL,Cade Cunningham,cunnica01,53,DET,1,DAL,33,9,10,0,0,5,32.43333333,3,6,11,21,3,7,8,8,2,0,19,43,42,52,53.8
2023-24,202403090POR,3/9/2024,POR vs TOR,Kelly Olynyk,olynyke01,62,TOR,0,POR,15,6,8,2,2,5,32.45,2,4,6,10,3,4,0,0,4,4,14,23,21,29,41.2
2023-24,202403090POR,3/9/2024,POR vs TOR,Matisse Thybulle,thybuma01,60,POR,1,TOR,13,4,4,4,1,1,32.48333333,2,2,5,9,3,5,0,0,3,5,8,17,17,21,37.8
2023-24,202403090DEN,3/9/2024,DEN vs UTA,John Collins,collijo01,60,UTA,0,DEN,19,7,1,0,0,2,32.6,3,4,7,10,0,0,5,8,1,0,8,20,26,27,26.9
2023-24,202403090GSW,3/9/2024,GSW vs SAS,Julian Champagnie,champju02,56,SAS,0,GSW,17,7,5,0,1,3,33.6,1,6,5,8,5,8,2,2,0,1,12,22,24,29,32.9
2023-24,202403090LAC,3/9/2024,LAC vs CHI,James Harden,hardeja01,57,LAC,1,CHI,14,11,10,1,0,1,33.95,0,11,4,10,4,10,2,2,2,1,21,24,25,35,44.2
2023-24,202403090DET,3/9/2024,DET vs DAL,Isaiah Stewart,stewais01,41,DET,1,DAL,5,4,0,3,0,1,34.33333333,0,4,2,6,1,4,0,0,0,3,4,5,9,9,17.8
2023-24,202403090CHO,3/9/2024,CHO vs BRK,Nic Claxton,claxtni01,54,BRK,0,CHO,14,10,4,0,2,3,34.38333333,4,6,6,10,0,0,2,3,3,2,14,18,24,28,35
2023-24,202403090PHO,3/9/2024,PHO vs BOS,Jaylen Brown,brownja02,58,BOS,0,PHO,27,3,3,2,0,2,34.41666667,1,2,10,21,3,7,4,7,1,2,6,30,30,33,39.1
2023-24,202403090PHO,3/9/2024,PHO vs BOS,Derrick White,whitede01,59,BOS,0,PHO,10,5,9,0,1,2,34.53333333,2,3,5,8,0,3,0,0,3,1,14,19,15,24,30.5
2023-24,202403090LAC,3/9/2024,LAC vs CHI,Nikola Vucevic,vucevni01,59,CHI,0,LAC,22,11,2,0,0,1,35.48333333,4,7,9,22,2,4,2,2,1,0,13,24,33,35,37.2
2023-24,202403090DEN,3/9/2024,DEN vs UTA,Collin Sexton,sextoco01,64,UTA,0,DEN,17,1,4,1,0,0,35.65,1,0,6,17,1,3,4,5,2,1,5,21,18,22,27.2
2023-24,202403090PHO,3/9/2024,PHO vs BOS,Jrue Holiday,holidjr01,58,BOS,0,PHO,15,3,6,2,1,3,35.73333333,0,3,5,7,3,5,2,2,1,3,9,21,18,24,33.6
2023-24,202403090CHO,3/9/2024,CHO vs BRK,Brandon Miller,millebr02,57,CHO,1,BRK,23,7,3,0,1,2,36.13333333,0,7,10,21,2,10,1,2,2,1,10,26,30,33,36.9
2023-24,202403090LAC,3/9/2024,LAC vs CHI,Ayo Dosunmu,dosunay01,62,CHI,0,LAC,13,2,4,2,1,1,36.25,0,2,5,11,3,7,0,0,4,3,6,17,15,19,29.4
2023-24,202403090LAC,3/9/2024,LAC vs CHI,Alex Caruso,carusal01,55,CHI,0,LAC,9,1,6,4,2,0,36.3,0,1,4,7,1,3,0,0,3,6,7,15,10,16,37.2
2023-24,202403090DET,3/9/2024,DET vs DAL,Jaden Ivey,iveyja01,59,DET,1,DAL,17,6,4,2,1,6,36.41666667,4,2,7,21,2,9,1,2,3,3,10,21,23,27,33.2
2023-24,202403090DET,3/9/2024,DET vs DAL,Luka Doncic,doncilu01,56,DAL,0,DET,39,10,10,3,2,6,36.63333333,0,10,13,24,4,13,9,10,1,5,20,49,49,59,75
2023-24,202403090DEN,3/9/2024,DEN vs UTA,Jamal Murray,murraja01,48,DEN,1,UTA,37,3,7,2,0,1,36.95,1,2,13,21,6,9,5,7,2,2,10,44,40,47,56.1
2023-24,202403090PHO,3/9/2024,PHO vs BOS,Royce O'Neale,onealro01,61,PHO,1,BOS,3,5,2,1,0,0,37.25,1,4,1,9,1,6,0,0,1,1,7,5,8,10,15
2023-24,202403090PHO,3/9/2024,PHO vs BOS,Kevin Durant,duranke01,57,PHO,1,BOS,45,10,6,1,0,6,37.4,1,9,18,26,4,7,5,7,2,1,16,51,55,61,63
2023-24,202403090CHO,3/9/2024,CHO vs BRK,Dorian Finney-Smith,finnedo01,55,BRK,0,CHO,8,5,2,1,0,2,37.51666667,2,3,2,8,1,6,3,4,1,1,7,10,13,15,18
2023-24,202403090CHO,3/9/2024,CHO vs BRK,Grant Williams,willigr01,60,CHO,1,BRK,9,5,2,3,0,3,37.55,0,5,4,6,1,1,0,0,3,3,7,11,14,16,24
2023-24,202403090PHO,3/9/2024,PHO vs BOS,Bradley Beal,bealbr01,35,PHO,1,BOS,25,1,4,3,0,1,37.73333333,0,1,10,20,3,5,2,2,4,3,5,29,26,30,40.2
2023-24,202403090LAC,3/9/2024,LAC vs CHI,Kawhi Leonard,leonaka01,57,LAC,1,CHI,19,9,4,0,1,2,38.33333333,2,7,8,15,0,1,3,3,1,1,13,23,28,32,36.8
2023-24,202403090DEN,3/9/2024,DEN vs UTA,Keyonte George,georgke01,57,UTA,0,DEN,29,5,6,0,0,4,38.38333333,0,5,10,17,5,8,4,5,2,0,11,35,34,40,40
2023-24,202403090CHO,3/9/2024,CHO vs BRK,Dennis Schroder,schrode01,64,BRK,0,CHO,12,6,7,1,0,2,38.5,1,5,5,12,2,7,0,0,0,1,13,19,18,25,30.7
2023-24,202403090POR,3/9/2024,POR vs TOR,Gradey Dick,dickgr01,43,TOR,0,POR,8,5,2,0,0,0,39.06666667,2,3,3,10,2,7,0,0,3,0,7,10,13,15,17
2023-24,202403090PHO,3/9/2024,PHO vs BOS,Grayson Allen,allengr01,58,PHO,1,BOS,7,5,2,0,0,3,39.21666667,0,5,3,8,0,4,1,2,2,0,7,9,12,14,13
2023-24,202403090CHO,3/9/2024,CHO vs BRK,Miles Bridges,bridgmi02,53,CHO,1,BRK,24,10,4,1,0,3,39.23333333,1,9,10,15,2,5,2,5,1,1,14,28,34,38,42
2023-24,202403090LAC,3/9/2024,LAC vs CHI,Paul George,georgpa01,57,LAC,1,CHI,22,5,9,2,3,3,39.53333333,0,5,8,16,2,6,4,5,5,5,14,31,27,36,53.5
2023-24,202403090POR,3/9/2024,POR vs TOR,Deandre Ayton,aytonde01,41,POR,1,TOR,30,19,1,2,1,3,39.95,5,14,14,25,0,1,2,2,1,3,20,31,49,50,60.3
2023-24,202403090CHO,3/9/2024,CHO vs BRK,Mikal Bridges,bridgmi01,64,BRK,0,CHO,19,2,4,1,0,1,40.91666667,0,2,6,18,4,11,3,3,1,1,6,23,21,25,29.4
2023-24,202403090LAC,3/9/2024,LAC vs CHI,Coby White,whiteco01,64,CHI,0,LAC,19,5,4,0,0,5,41.11666667,1,4,7,16,3,9,2,2,4,0,9,23,24,28,26
2023-24,202403090POR,3/9/2024,POR vs TOR,Gary Trent Jr.,trentga02,59,TOR,0,POR,23,5,3,2,0,2,41.78333333,2,3,10,26,3,12,0,1,2,2,8,26,28,31,37.5
2023-24,202403090POR,3/9/2024,POR vs TOR,Dalano Banton,bantoda01,36,POR,1,TOR,25,7,4,0,1,2,42.05,2,5,9,16,5,8,2,3,2,1,11,29,32,36,40.4
2023-24,202403090POR,3/9/2024,POR vs TOR,Anfernee Simons,simonan01,40,POR,1,TOR,23,4,7,1,0,5,42.08333333,2,2,8,18,4,9,3,3,1,1,11,30,27,34,36.3
2023-24,202403090LAC,3/9/2024,LAC vs CHI,DeMar DeRozan,derozde01,62,CHI,0,LAC,24,8,10,0,0,2,42.15,1,7,8,19,0,3,8,9,2,0,18,34,32,42,46.6
2023-24,202403090PHO,3/9/2024,PHO vs BOS,Jayson Tatum,tatumja01,60,BOS,0,PHO,29,10,7,1,0,4,42.26666667,3,7,11,28,5,9,2,2,0,1,17,36,39,46,50.5
2023-24,202403090POR,3/9/2024,POR vs TOR,Immanuel Quickley,quickim01,59,TOR,0,POR,29,3,7,1,0,6,43.6,0,3,10,21,4,10,5,7,1,1,10,36,32,39,40.1
2023-24,202403080WAS,3/8/2024,WAS vs CHO,Bryce McGowens,mcgowbr01,50,CHO,0,WAS,1,1,0,1,0,0,10.2,0,1,0,2,0,1,1,2,1,1,1,1,2,2,5.2
2023-24,202403080POR,3/8/2024,POR vs HOU,Moses Brown,brownmo01,13,POR,1,HOU,4,5,0,0,0,0,10.48333333,3,2,2,6,0,0,0,0,0,0,5,4,9,9,10
2023-24,202403080CLE,3/8/2024,CLE vs MIN,Jordan McLaughlin,mclaujo01,38,MIN,0,CLE,2,1,4,1,0,0,10.58333333,0,1,0,0,0,0,2,2,1,1,5,6,3,7,12.2
2023-24,202403080WAS,3/8/2024,WAS vs CHO,JT Thor,thorjt01,48,CHO,0,WAS,6,2,1,0,1,1,11.25,0,2,2,2,2,2,0,0,1,1,3,7,8,9,11.9
2023-24,202403080CLE,3/8/2024,CLE vs MIN,T.J. Warren,warretj01,2,MIN,0,CLE,6,4,0,0,0,1,11.45,1,3,3,3,0,0,0,0,3,0,4,6,10,10,9.8
2023-24,202403080NYK,3/8/2024,NYK vs ORL,Bojan Bogdanovic,bogdabo02,38,NYK,1,ORL,6,0,0,0,0,1,11.9,0,0,2,6,1,3,1,2,0,0,0,6,6,6,5
2023-24,202403080NYK,3/8/2024,NYK vs ORL,Moritz Wagner,wagnemo01,62,ORL,0,NYK,4,1,1,0,0,1,12.05,0,1,1,2,0,0,2,2,1,0,2,5,5,6,5.7
2023-24,202403080MEM,3/8/2024,MEM vs ATL,Wenyen Gabriel,gabriwe01,1,MEM,1,ATL,2,4,2,1,0,1,12.75,2,2,1,3,0,0,0,2,2,1,6,4,6,8,11.8
2023-24,202403080POR,3/8/2024,POR vs HOU,Jock Landale,landajo01,37,HOU,0,POR,5,3,3,0,1,0,13.35,2,1,2,4,1,1,0,0,1,1,6,8,8,11,16.1
2023-24,202403080OKC,3/8/2024,OKC vs MIA,Cason Wallace,wallaca01,63,OKC,1,MIA,3,0,1,0,1,2,14.21666667,0,0,1,4,1,3,0,0,1,1,1,4,3,4,5.5
2023-24,202403080POR,3/8/2024,POR vs HOU,Aaron Holiday,holidaa01,60,HOU,0,POR,6,1,1,2,0,0,14.78333333,0,1,3,7,0,3,0,0,2,2,2,7,7,8,14.7
2023-24,202403080LAL,3/8/2024,LAL vs MIL,Cam Reddish,reddica01,41,LAL,1,MIL,6,0,0,0,1,0,15.4,0,0,2,4,1,3,1,2,0,1,0,6,6,6,9
2023-24,202403080OKC,3/8/2024,OKC vs MIA,Patty Mills,millspa02,20,MIA,0,OKC,13,2,0,0,0,1,15.65,0,2,5,7,3,4,0,0,1,0,2,13,15,15,14.4
2023-24,202403080WAS,3/8/2024,WAS vs CHO,Nick Smith Jr.,smithni01,38,CHO,0,WAS,0,1,2,0,0,0,16,0,1,0,6,0,2,0,0,2,0,3,2,1,3,4.2
2023-24,202403080NYK,3/8/2024,NYK vs ORL,Jonathan Isaac,isaacjo01,43,ORL,0,NYK,11,6,0,1,2,0,16.11666667,2,4,4,6,1,2,2,2,0,3,6,11,17,17,27.2
2023-24,202403080MEM,3/8/2024,MEM vs ATL,Garrison Mathews,mathega01,47,ATL,0,MEM,6,3,0,0,0,0,16.16666667,2,1,2,4,2,3,0,0,3,0,3,6,9,9,9.6
2023-24,202403080LAL,3/8/2024,LAL vs MIL,Taurean Prince,princta02,63,LAL,1,MIL,8,6,1,0,0,0,16.31666667,1,5,3,7,2,5,0,0,0,0,7,9,14,15,16.7
2023-24,202403080LAL,3/8/2024,LAL vs MIL,Patrick Beverley,beverpa01,59,MIL,0,LAL,0,0,0,0,0,0,16.46666667,0,0,0,3,0,2,0,0,2,0,0,0,0,0,0
2023-24,202403080MEM,3/8/2024,MEM vs ATL,Trey Jemison,jemistr01,12,MEM,1,ATL,5,2,0,1,0,1,16.48333333,0,2,2,3,0,0,1,2,2,1,2,5,7,7,9.4
2023-24,202403080PHI,3/8/2024,PHI vs NOP,KJ Martin,martike04,46,PHI,1,NOP,0,2,0,0,0,1,16.75,1,1,0,3,0,1,0,0,3,0,2,0,2,2,1.4
2023-24,202403080OKC,3/8/2024,OKC vs MIA,Jaylin Williams,willija07,51,OKC,1,MIA,5,7,0,1,1,0,17.2,2,5,2,3,1,1,0,0,3,2,7,5,12,12,19.4
2023-24,202403080LAL,3/8/2024,LAL vs MIL,Jaxson Hayes,hayesja02,55,LAL,1,MIL,8,1,0,0,0,1,17.31666667,0,1,2,2,0,0,4,6,3,0,1,8,9,9,8.2
2023-24,202403080NYK,3/8/2024,NYK vs ORL,Joe Ingles,inglejo01,50,ORL,0,NYK,1,1,1,2,0,0,17.4,0,1,0,0,0,0,1,2,0,2,2,2,2,3,9.7
2023-24,202403080OKC,3/8/2024,OKC vs MIA,Gordon Hayward,haywago01,34,OKC,1,MIA,3,2,4,1,0,0,17.7,0,2,1,3,1,2,0,0,2,1,6,7,5,9,14.4
2023-24,202403080PHI,3/8/2024,PHI vs NOP,Naji Marshall,marshna01,51,NOP,0,PHI,19,4,1,1,1,2,17.8,1,3,7,8,4,4,1,1,1,2,5,20,23,24,29.3
2023-24,202403080PHI,3/8/2024,PHI vs NOP,Mo Bamba,bambamo01,41,PHI,1,NOP,2,6,0,0,2,1,18.31666667,1,5,1,2,0,1,0,0,2,2,6,2,8,8,14.2
2023-24,202403080POR,3/8/2024,POR vs HOU,Ashton Hagans,haganas01,12,POR,1,HOU,6,4,2,0,1,1,18.46666667,1,3,2,6,1,2,1,2,2,1,6,8,10,12,15.8
2023-24,202403080CLE,3/8/2024,CLE vs MIN,Sam Merrill,merrisa01,45,CLE,1,MIN,6,1,0,0,0,0,18.81666667,1,0,2,9,2,8,0,0,3,0,1,6,7,7,7.2
2023-24,202403080NYK,3/8/2024,NYK vs ORL,Miles McBride,mcbrimi01,50,NYK,1,ORL,14,3,1,2,0,1,19.3,1,2,5,7,3,3,1,1,2,2,4,15,17,18,24.1
2023-24,202403080OKC,3/8/2024,OKC vs MIA,Aaron Wiggins,wiggiaa01,60,OKC,1,MIA,7,3,1,0,2,0,19.38333333,2,1,3,5,1,3,0,0,1,2,4,8,10,11,18.1
2023-24,202403080OKC,3/8/2024,OKC vs MIA,Isaiah Joe,joeis01,59,OKC,1,MIA,10,4,1,0,0,1,19.41666667,2,2,4,10,2,6,0,0,0,0,5,11,14,15,15.3
2023-24,202403080PHI,3/8/2024,PHI vs NOP,Jeff Dowtin,dowtije01,3,PHI,1,NOP,6,0,1,0,0,2,19.46666667,0,0,2,3,2,3,0,0,0,0,1,7,6,7,5.5
2023-24,202403080PHI,3/8/2024,PHI vs NOP,Jonas Valanciunas,valanjo01,63,NOP,0,PHI,6,10,2,1,1,1,19.46666667,3,7,2,7,0,3,2,2,3,2,12,8,16,18,26
2023-24,202403080POR,3/8/2024,POR vs HOU,Matisse Thybulle,thybuma01,59,POR,1,HOU,5,3,0,0,1,1,19.48333333,3,0,2,5,1,2,0,2,2,1,3,5,8,8,10.6
2023-24,202403080NYK,3/8/2024,NYK vs ORL,Isaiah Hartenstein,harteis01,57,NYK,1,ORL,5,6,2,1,3,2,20.23333333,2,4,2,3,0,0,1,1,3,4,8,7,11,13,25.2
2023-24,202403080PHI,3/8/2024,PHI vs NOP,Jose Alvarado,alvarjo01,42,NOP,0,PHI,7,1,2,1,0,0,20.55,0,1,2,7,1,3,2,2,2,1,3,9,8,10,14.2
2023-24,202403080MEM,3/8/2024,MEM vs ATL,Bruno Fernando,fernabr01,26,ATL,0,MEM,1,7,0,2,0,1,21.13333333,1,6,0,1,0,0,1,2,3,2,7,1,8,8,14.4
2023-24,202403080LAL,3/8/2024,LAL vs MIL,Jae Crowder,crowdja01,33,MIL,0,LAL,4,3,0,1,0,0,21.21666667,1,2,1,5,0,2,2,2,2,1,3,4,7,7,10.6
2023-24,202403080POR,3/8/2024,POR vs HOU,Dillon Brooks,brookdi01,54,HOU,0,POR,4,3,1,1,0,0,21.28333333,0,3,1,5,1,3,1,2,1,1,4,5,7,8,12.1
2023-24,202403080WAS,3/8/2024,WAS vs CHO,Tyus Jones,jonesty01,63,WAS,1,CHO,7,4,4,0,1,1,21.75,0,4,3,7,1,4,0,0,1,1,8,11,11,15,19.8
2023-24,202403080MEM,3/8/2024,MEM vs ATL,Vit Krejci,krejcvi01,3,ATL,0,MEM,3,1,5,2,1,0,22.08333333,1,0,1,5,1,4,0,0,1,3,6,8,4,9,20.7
2023-24,202403080POR,3/8/2024,POR vs HOU,Rayan Rupert,ruperra01,21,POR,1,HOU,2,2,2,0,0,3,22.46666667,1,1,1,1,0,0,0,0,2,0,4,4,4,6,4.4
2023-24,202403080NYK,3/8/2024,NYK vs ORL,Anthony Black,blackan01,58,ORL,0,NYK,0,2,0,0,0,1,22.83333333,0,2,0,5,0,2,0,0,2,0,2,0,2,2,1.4
2023-24,202403080PHI,3/8/2024,PHI vs NOP,Cameron Payne,payneca01,59,PHI,1,NOP,13,1,4,1,0,2,22.95,0,1,5,9,0,3,3,3,1,1,5,17,14,18,21.2
2023-24,202403080OKC,3/8/2024,OKC vs MIA,Josh Giddey,giddejo01,62,OKC,1,MIA,11,9,6,0,0,1,23.28333333,1,8,5,9,1,3,0,0,0,0,15,17,20,26,29.8
2023-24,202403080POR,3/8/2024,POR vs HOU,Cam Whitmore,whitmca01,37,HOU,0,POR,13,8,0,1,1,1,23.85,4,4,4,10,1,5,4,6,2,2,8,13,21,21,27.6
2023-24,202403080MEM,3/8/2024,MEM vs ATL,Jordan Goodwin,goodwjo01,46,MEM,1,ATL,5,0,4,0,1,0,23.93333333,0,0,2,8,1,3,0,0,2,1,4,9,5,9,14
2023-24,202403080NYK,3/8/2024,NYK vs ORL,Gary Harris,harriga01,40,ORL,0,NYK,5,1,1,0,0,1,24.41666667,0,1,2,5,1,3,0,0,0,0,2,6,6,7,6.7
2023-24,202403080PHI,3/8/2024,PHI vs NOP,Buddy Hield,hieldbu01,66,PHI,1,NOP,8,2,2,2,1,2,24.51666667,0,2,2,10,2,9,2,2,3,3,4,10,10,12,20.4
2023-24,202403080NYK,3/8/2024,NYK vs ORL,Wendell Carter Jr.,cartewe01,37,ORL,0,NYK,7,9,2,0,2,3,24.55,7,2,2,8,2,4,1,2,2,2,11,9,16,18,23.8
2023-24,202403080CLE,3/8/2024,CLE vs MIN,Nickeil Alexander-Walker,alexani01,64,MIN,0,CLE,4,2,2,0,0,0,24.7,0,2,2,8,0,3,0,0,1,0,4,6,6,8,9.4
2023-24,202403080NYK,3/8/2024,NYK vs ORL,Cole Anthony,anthoco01,63,ORL,0,NYK,4,1,5,1,2,1,25.16666667,1,0,1,4,0,2,2,4,2,3,6,9,5,10,20.7
2023-24,202403080LAL,3/8/2024,LAL vs MIL,Bobby Portis,portibo01,64,MIL,0,LAL,14,8,0,0,0,0,25.71666667,1,7,6,13,0,4,2,2,2,0,8,14,22,22,23.6
2023-24,202403080MEM,3/8/2024,MEM vs ATL,Jake LaRavia,laravja01,19,MEM,1,ATL,14,3,3,3,1,0,26.1,2,1,3,10,2,7,6,6,2,4,6,17,17,20,34.1
2023-24,202403080POR,3/8/2024,POR vs HOU,Amen Thompson,thompam01,44,HOU,0,POR,16,8,3,2,5,1,26.46666667,1,7,7,10,0,1,2,2,3,7,11,19,24,27,50.1
2023-24,202403080MEM,3/8/2024,MEM vs ATL,Clint Capela,capelca01,55,ATL,0,MEM,15,11,3,0,1,1,26.86666667,5,6,5,13,0,0,5,5,2,1,14,18,26,29,34.7
2023-24,202403080PHI,3/8/2024,PHI vs NOP,Larry Nance Jr.,nancela02,45,NOP,0,PHI,7,4,1,1,1,0,26.91666667,2,2,2,7,1,1,2,2,2,2,5,8,11,12,19.3
2023-24,202403080WAS,3/8/2024,WAS vs CHO,Bilal Coulibaly,coulibi01,59,WAS,1,CHO,11,4,0,1,1,2,27.08333333,1,3,4,7,1,4,2,2,3,2,4,11,15,15,19.8
2023-24,202403080PHI,3/8/2024,PHI vs NOP,Paul Reed,reedpa01,63,PHI,1,NOP,17,11,2,1,3,0,27.38333333,6,5,7,16,2,4,1,1,2,4,13,19,28,30,45.2
2023-24,202403080PHI,3/8/2024,PHI vs NOP,CJ McCollum,mccolcj01,47,NOP,0,PHI,10,4,1,0,0,3,27.45,0,4,5,14,0,7,0,0,2,0,5,11,14,15,13.3
2023-24,202403080NYK,3/8/2024,NYK vs ORL,Jericho Sims,simsje01,36,NYK,1,ORL,2,6,1,0,1,0,27.76666667,3,3,1,1,0,0,0,0,2,1,7,3,8,9,13.7
2023-24,202403080PHI,3/8/2024,PHI vs NOP,Trey Murphy III,murphtr02,38,NOP,0,PHI,10,3,3,1,1,0,27.96666667,1,2,3,8,2,7,2,2,1,2,6,13,13,16,24.1
2023-24,202403080OKC,3/8/2024,OKC vs MIA,Duncan Robinson,robindu01,58,MIA,0,OKC,9,2,1,1,0,1,28.01666667,0,2,3,8,3,8,0,0,1,1,3,10,11,12,14.9
2023-24,202403080MEM,3/8/2024,MEM vs ATL,John Konchar,konchjo01,49,MEM,1,ATL,5,5,3,0,1,2,28.55,2,3,2,4,1,2,0,0,1,1,8,8,10,13,16.5
2023-24,202403080MEM,3/8/2024,MEM vs ATL,Lamar Stevens,stevela01,30,MEM,1,ATL,13,5,0,1,2,0,28.6,1,4,3,12,1,4,6,6,2,3,5,13,18,18,28
2023-24,202403080NYK,3/8/2024,NYK vs ORL,Jalen Brunson,brunsja01,58,NYK,1,ORL,26,3,2,0,0,1,28.7,0,3,11,19,4,7,0,0,2,0,5,28,29,31,31.6
2023-24,202403080MEM,3/8/2024,MEM vs ATL,De'Andre Hunter,huntede01,39,ATL,0,MEM,12,2,2,1,0,3,29.01666667,0,2,4,11,3,6,1,3,5,1,4,14,14,16,17.4
2023-24,202403080OKC,3/8/2024,OKC vs MIA,Chet Holmgren,holmgch01,63,OKC,1,MIA,7,3,3,0,0,0,29.46666667,0,3,3,9,1,4,0,0,1,0,6,10,10,13,15.1
2023-24,202403080OKC,3/8/2024,OKC vs MIA,Nikola Jovic,jovicni01,29,MIA,0,OKC,7,8,3,0,2,1,29.56666667,0,8,2,5,1,3,2,2,1,2,11,10,15,18,26.1
2023-24,202403080WAS,3/8/2024,WAS vs CHO,Corey Kispert,kispeco01,61,WAS,1,CHO,13,4,2,0,0,0,30,0,4,3,7,1,5,6,6,0,0,6,15,17,19,20.8
2023-24,202403080WAS,3/8/2024,WAS vs CHO,Nick Richards,richani01,53,CHO,0,WAS,10,13,0,2,1,2,30.08333333,5,8,5,6,0,0,0,0,3,3,13,10,23,23,32.6
2023-24,202403080WAS,3/8/2024,WAS vs CHO,Brandon Miller,millebr02,56,CHO,0,WAS,21,6,0,0,1,1,30.13333333,1,5,8,19,2,7,3,3,4,1,6,21,27,27,30.2
2023-24,202403080POR,3/8/2024,POR vs HOU,Toumani Camara,camarto01,59,POR,1,HOU,9,7,0,1,0,1,30.26666667,3,4,2,4,1,2,4,4,1,1,7,9,16,16,19.4
2023-24,202403080OKC,3/8/2024,OKC vs MIA,Jalen Williams,willija06,57,OKC,1,MIA,15,5,4,1,1,3,30.3,1,4,6,12,1,3,2,2,4,2,9,19,20,24,30
2023-24,202403080OKC,3/8/2024,OKC vs MIA,Caleb Martin,martica02,46,MIA,0,OKC,7,3,0,0,1,1,30.41666667,0,3,3,10,1,4,0,0,4,1,3,7,10,10,12.6
2023-24,202403080LAL,3/8/2024,LAL vs MIL,Pat Connaughton,connapa01,58,MIL,0,LAL,17,6,1,0,0,0,30.51666667,1,5,6,7,4,5,1,2,1,0,7,18,23,24,25.7
2023-24,202403080PHI,3/8/2024,PHI vs NOP,Herbert Jones,joneshe01,58,NOP,0,PHI,4,3,3,0,1,1,30.6,0,3,1,4,1,3,1,1,2,1,6,7,7,10,14.1
2023-24,202403080OKC,3/8/2024,OKC vs MIA,Bam Adebayo,adebaba01,53,MIA,0,OKC,5,10,4,1,2,4,30.76666667,4,6,1,9,0,0,3,4,1,3,14,9,15,19,28
2023-24,202403080OKC,3/8/2024,OKC vs MIA,Jaime Jaquez Jr.,jaqueja01,57,MIA,0,OKC,25,3,3,3,0,0,31.28333333,0,3,10,13,1,3,4,6,2,3,6,28,28,31,42.1
2023-24,202403080PHI,3/8/2024,PHI vs NOP,Kyle Lowry,lowryky01,44,PHI,1,NOP,6,3,7,1,0,1,31.3,1,2,1,5,1,4,3,4,1,1,10,13,9,16,22.1
2023-24,202403080MEM,3/8/2024,MEM vs ATL,Santi Aldama,aldamsa01,52,MEM,1,ATL,13,5,0,1,3,1,31.51666667,1,4,5,7,2,3,1,2,0,4,5,13,18,18,30
2023-24,202403080POR,3/8/2024,POR vs HOU,Alperen Sengun,sengual01,62,HOU,0,POR,19,9,6,1,1,1,31.51666667,5,4,7,15,0,0,5,8,2,2,15,25,28,34,43.8
2023-24,202403080LAL,3/8/2024,LAL vs MIL,Brook Lopez,lopezbr01,61,MIL,0,LAL,11,3,1,0,1,0,31.6,0,3,4,6,3,3,0,0,2,1,4,12,14,15,19.1
2023-24,202403080WAS,3/8/2024,WAS vs CHO,Davis Bertans,bertada01,25,CHO,0,WAS,11,6,3,2,0,0,31.66666667,3,3,4,14,3,10,0,0,2,2,9,14,17,20,28.7
2023-24,202403080CLE,3/8/2024,CLE vs MIN,Mike Conley,conlemi01,59,MIN,0,CLE,9,3,5,0,0,1,32,1,2,4,11,0,5,1,1,1,0,8,14,12,17,19.1
2023-24,202403080WAS,3/8/2024,WAS vs CHO,Vasilije Micic,micicva01,42,CHO,0,WAS,14,3,3,0,0,3,32,0,3,6,14,0,5,2,2,1,0,6,17,17,20,19.1
2023-24,202403080POR,3/8/2024,POR vs HOU,Duop Reath,reathdu01,48,POR,1,HOU,16,6,3,0,1,1,32,3,3,6,13,4,6,0,0,5,1,9,19,22,25,29.7
2023-24,202403080CLE,3/8/2024,CLE vs MIN,Naz Reid,reidna01,64,MIN,0,CLE,34,5,2,1,2,1,32.3,0,5,10,18,7,11,7,8,4,3,7,36,39,41,51
2023-24,202403080OKC,3/8/2024,OKC vs MIA,Terry Rozier,roziete01,46,MIA,0,OKC,14,5,4,1,0,1,32.45,1,4,6,14,2,4,0,0,4,1,9,18,19,23,28
2023-24,202403080CLE,3/8/2024,CLE vs MIN,Dean Wade,wadede01,54,CLE,1,MIN,0,4,2,0,1,0,32.95,1,3,0,2,0,2,0,0,2,1,6,2,4,6,10.8
2023-24,202403080OKC,3/8/2024,OKC vs MIA,Luguentz Dort,dortlu01,61,OKC,1,MIA,9,7,2,1,1,1,33.35,1,6,4,9,1,6,0,0,2,2,9,11,16,18,25.4
2023-24,202403080POR,3/8/2024,POR vs HOU,Kris Murray,murrakr01,42,POR,1,HOU,12,11,7,0,1,2,33.36666667,4,7,5,12,1,6,1,2,0,1,18,19,23,30,36.7
2023-24,202403080POR,3/8/2024,POR vs HOU,Anfernee Simons,simonan01,39,POR,1,HOU,23,3,3,3,0,6,33.66666667,0,3,7,14,4,7,5,7,2,3,6,26,26,29,34.1
2023-24,202403080LAL,3/8/2024,LAL vs MIL,Spencer Dinwiddie,dinwisp01,59,LAL,1,MIL,5,2,3,1,2,0,33.81666667,0,2,1,3,1,2,2,2,3,3,5,8,7,10,20.9
2023-24,202403080WAS,3/8/2024,WAS vs CHO,Jordan Poole,poolejo01,61,WAS,1,CHO,15,5,7,2,3,4,34.08333333,1,4,6,17,2,10,1,2,2,5,12,22,20,27,42.5
2023-24,202403080POR,3/8/2024,POR vs HOU,Jalen Green,greenja05,63,HOU,0,POR,27,3,5,2,0,2,34.1,0,3,11,19,4,9,1,2,1,2,8,32,30,35,42.1
2023-24,202403080LAL,3/8/2024,LAL vs MIL,Malik Beasley,beaslma01,62,MIL,0,LAL,14,4,2,1,0,1,34.15,1,3,5,12,4,9,0,0,3,1,6,16,18,20,23.8
2023-24,202403080POR,3/8/2024,POR vs HOU,Fred VanVleet,vanvlfr01,56,HOU,0,POR,18,1,10,1,0,0,34.18333333,0,1,5,13,4,8,4,4,1,1,11,28,19,29,37.2
2023-24,202403080NYK,3/8/2024,NYK vs ORL,Franz Wagner,wagnefr01,56,ORL,0,NYK,13,4,0,1,0,0,34.31666667,0,4,6,20,0,5,1,1,0,1,4,13,17,17,20.8
2023-24,202403080CLE,3/8/2024,CLE vs MIN,Caris LeVert,leverca01,51,CLE,1,MIN,15,5,8,3,1,2,34.33333333,0,5,5,15,2,6,3,5,1,4,13,23,20,28,43
2023-24,202403080PHI,3/8/2024,PHI vs NOP,Kelly Oubre Jr.,oubreke01,50,PHI,1,NOP,20,7,2,0,0,1,34.4,1,6,7,18,2,6,4,7,4,0,9,22,27,29,30.4
2023-24,202403080PHI,3/8/2024,PHI vs NOP,Zion Williamson,willizi01,52,NOP,0,PHI,23,12,4,2,3,1,34.61666667,2,10,7,14,0,1,9,9,2,5,16,27,35,39,57.4
2023-24,202403080PHI,3/8/2024,PHI vs NOP,Brandon Ingram,ingrabr01,57,NOP,0,PHI,17,7,5,0,2,4,34.63333333,0,7,6,10,2,2,3,4,3,2,12,22,24,29,34.9
2023-24,202403080MEM,3/8/2024,MEM vs ATL,Bogdan Bogdanovic,bogdabo01,61,ATL,0,MEM,16,6,3,1,2,4,34.96666667,2,4,6,14,3,6,1,2,4,3,9,19,22,25,32.7
2023-24,202403080WAS,3/8/2024,WAS vs CHO,Deni Avdija,avdijde01,60,WAS,1,CHO,18,14,2,0,2,1,35.05,3,11,8,14,1,2,1,3,2,2,16,20,32,34,42.8
2023-24,202403080MEM,3/8/2024,MEM vs ATL,Jaren Jackson Jr.,jacksja02,56,MEM,1,ATL,21,9,3,3,2,2,35.25,2,7,8,19,0,2,5,8,4,5,12,24,30,33,49.3
2023-24,202403080CLE,3/8/2024,CLE vs MIN,Kyle Anderson,anderky01,62,MIN,0,CLE,10,3,5,1,0,1,35.35,0,3,5,9,0,0,0,1,1,1,8,15,13,18,23.1
2023-24,202403080OKC,3/8/2024,OKC vs MIA,Shai Gilgeous-Alexander,gilgesh01,62,OKC,1,MIA,37,5,6,1,2,1,35.68333333,0,5,13,25,2,7,9,11,2,3,11,43,42,48,60
2023-24,202403080CLE,3/8/2024,CLE vs MIN,Georges Niang,niangge01,63,CLE,1,MIN,16,6,4,1,2,1,35.75,0,6,6,10,4,7,0,0,2,3,10,20,22,26,37.2
2023-24,202403080WAS,3/8/2024,WAS vs CHO,Richaun Holmes,holmeri01,33,WAS,1,CHO,14,11,1,1,1,0,36.03333333,3,8,5,5,0,0,4,4,5,2,12,15,25,26,34.7
2023-24,202403080NYK,3/8/2024,NYK vs ORL,Paolo Banchero,banchpa01,62,ORL,0,NYK,23,9,2,2,4,4,36.18333333,2,7,9,20,2,3,3,5,3,6,11,25,32,34,50.8
2023-24,202403080LAL,3/8/2024,LAL vs MIL,Austin Reaves,reaveau01,66,LAL,1,MIL,18,5,7,1,0,2,36.65,0,5,7,12,2,5,2,4,1,1,12,25,23,30,35.5
2023-24,202403080CLE,3/8/2024,CLE vs MIN,Rudy Gobert,goberru01,62,MIN,0,CLE,7,17,2,1,2,2,36.68333333,4,13,3,7,0,0,1,2,6,3,19,9,24,26,37.4
2023-24,202403080MEM,3/8/2024,MEM vs ATL,Vince Williams Jr.,willivi01,52,MEM,1,ATL,14,5,6,0,1,6,36.81666667,0,5,4,8,3,5,3,4,4,1,11,20,19,25,26
2023-24,202403080OKC,3/8/2024,OKC vs MIA,Jimmy Butler,butleji01,44,MIA,0,OKC,20,10,8,0,0,1,36.98333333,2,8,8,16,0,3,4,6,1,0,18,28,30,38,43
2023-24,202403080MEM,3/8/2024,MEM vs ATL,Saddiq Bey,beysa01,62,ATL,0,MEM,3,9,2,1,1,3,37.05,4,5,1,12,0,6,1,2,1,2,11,5,12,14,19.8
2023-24,202403080WAS,3/8/2024,WAS vs CHO,Grant Williams,willigr01,59,CHO,0,WAS,5,4,5,1,1,0,37.95,3,1,2,10,1,5,0,3,3,2,9,10,9,14,23.3
2023-24,202403080LAL,3/8/2024,LAL vs MIL,Rui Hachimura,hachiru01,52,LAL,1,MIL,12,5,2,0,0,0,38.03333333,0,5,5,16,1,6,1,2,1,0,7,14,17,19,21
2023-24,202403080LAL,3/8/2024,LAL vs MIL,D'Angelo Russell,russeda01,61,LAL,1,MIL,44,6,9,0,1,2,38.21666667,2,4,17,25,9,12,1,1,5,1,15,53,50,59,65.7
2023-24,202403080POR,3/8/2024,POR vs HOU,Dalano Banton,bantoda01,35,POR,1,HOU,30,8,5,1,1,2,38.38333333,1,7,10,27,4,10,6,8,2,2,13,35,38,43,51.1
2023-24,202403080LAL,3/8/2024,LAL vs MIL,Damian Lillard,lillada01,59,MIL,0,LAL,28,5,12,0,0,1,38.45,0,5,10,23,4,12,4,4,2,0,17,40,33,45,51
2023-24,202403080PHI,3/8/2024,PHI vs NOP,Tobias Harris,harrito02,57,PHI,1,NOP,21,10,3,3,1,0,38.56666667,3,7,9,19,0,5,3,3,1,4,13,24,31,34,49.5
2023-24,202403080LAL,3/8/2024,LAL vs MIL,Giannis Antetokounmpo,antetgi01,61,MIL,0,LAL,34,14,12,1,1,4,38.68333333,2,12,14,23,1,3,5,7,2,2,26,46,48,60,70.8
2023-24,202403080POR,3/8/2024,POR vs HOU,Jabari Smith Jr.,smithja05,58,HOU,0,POR,15,9,4,2,2,2,39,1,8,5,11,3,7,2,2,2,4,13,19,24,28,41.8
2023-24,202403080NYK,3/8/2024,NYK vs ORL,Precious Achiuwa,achiupr01,56,NYK,1,ORL,15,14,4,2,5,3,39.41666667,3,11,6,16,2,4,1,2,2,7,18,19,29,33,55.8
2023-24,202403080CLE,3/8/2024,CLE vs MIN,Jaden McDaniels,mcdanja02,54,MIN,0,CLE,13,5,2,0,0,1,39.56666667,0,5,5,11,1,4,2,3,5,0,7,15,18,20,21
2023-24,202403080WAS,3/8/2024,WAS vs CHO,Kyle Kuzma,kuzmaky01,61,WAS,1,CHO,28,8,9,1,2,2,39.93333333,0,8,11,23,0,7,6,6,3,3,17,37,36,45,58.1
2023-24,202403080MEM,3/8/2024,MEM vs ATL,Dejounte Murray,murrade01,60,ATL,0,MEM,41,7,6,2,0,2,40.13333333,0,7,17,25,6,10,1,1,1,2,13,47,48,54,62.4
2023-24,202403080WAS,3/8/2024,WAS vs CHO,Miles Bridges,bridgmi02,52,CHO,0,WAS,32,12,4,0,1,0,40.71666667,1,11,13,27,1,10,5,5,2,1,16,36,44,48,55.4
2023-24,202403080LAL,3/8/2024,LAL vs MIL,Anthony Davis,davisan02,62,LAL,1,MIL,22,13,5,0,3,0,41,1,12,10,21,0,1,2,2,3,3,18,27,35,40,54.1
2023-24,202403080NYK,3/8/2024,NYK vs ORL,Donte DiVincenzo,divindo01,62,NYK,1,ORL,11,4,6,2,1,5,41.78333333,0,4,3,13,3,10,2,2,1,3,10,17,15,21,28.8
2023-24,202403080NYK,3/8/2024,NYK vs ORL,Josh Hart,hartjo01,62,NYK,1,ORL,19,7,4,0,0,2,42.25,2,5,8,12,3,5,0,0,2,0,11,23,26,30,31.4
2023-24,202403080CLE,3/8/2024,CLE vs MIN,Anthony Edwards,edwaran01,61,MIN,0,CLE,19,5,3,1,1,5,42.36666667,1,4,7,27,0,7,5,5,3,2,8,22,24,27,30.5
2023-24,202403080CLE,3/8/2024,CLE vs MIN,Isaac Okoro,okorois01,54,CLE,1,MIN,9,6,2,1,2,0,42.71666667,1,5,3,5,1,1,2,3,4,3,8,11,15,17,28.2
2023-24,202403080CLE,3/8/2024,CLE vs MIN,Darius Garland,garlada01,39,CLE,1,MIN,34,4,8,0,0,6,44.21666667,2,2,13,26,2,10,6,7,5,0,12,42,38,46,44.8
2023-24,202403080CLE,3/8/2024,CLE vs MIN,Jarrett Allen,allenja01,58,CLE,1,MIN,33,18,3,2,2,1,46.46666667,5,13,9,19,0,0,15,21,1,4,21,36,51,54,70.1
2023-24,202403070DEN,3/7/2024,DEN vs BOS,Sam Hauser,hausesa01,61,BOS,0,DEN,6,0,1,0,1,0,10.28333333,0,0,2,3,2,3,0,0,0,1,1,7,6,7,10.5
2023-24,202403070DEN,3/7/2024,DEN vs BOS,Payton Pritchard,pritcpa01,62,BOS,0,DEN,0,0,0,0,0,0,10.6,0,0,0,1,0,1,0,0,1,0,0,0,0,0,0
2023-24,202403070DAL,3/7/2024,DAL vs MIA,Thomas Bryant,bryanth01,27,MIA,0,DAL,2,1,1,0,1,0,10.63333333,0,1,1,3,0,2,0,0,2,1,2,3,3,4,7.7
2023-24,202403070GSW,3/7/2024,GSW vs CHI,Gary Payton II,paytoga02,28,GSW,1,CHI,0,2,1,0,0,1,10.71666667,1,1,0,1,0,0,0,0,1,0,3,1,2,3,2.9
2023-24,202403070DEN,3/7/2024,DEN vs BOS,Reggie Jackson,jacksre01,63,DEN,1,BOS,4,1,2,0,1,0,11.05,0,1,2,7,0,1,0,0,0,1,3,6,5,7,11.2
2023-24,202403070DET,3/7/2024,DET vs BRK,Trendon Watford,watfotr01,45,BRK,0,DET,6,2,0,0,0,2,11.41666667,0,2,2,4,0,0,2,2,0,0,2,6,8,8,6.4
2023-24,202403070IND,3/7/2024,IND vs MIN,T.J. McConnell,mccontj01,54,IND,1,MIN,6,1,1,2,0,2,11.68333333,0,1,3,7,0,1,0,0,0,2,2,7,7,8,12.7
2023-24,202403070DAL,3/7/2024,DAL vs MIA,Derrick Jones Jr.,jonesde02,58,DAL,1,MIA,1,2,1,0,0,1,11.83333333,1,1,0,2,0,1,1,2,1,0,3,2,3,4,3.9
2023-24,202403070DET,3/7/2024,DET vs BRK,James Wiseman,wisemja01,43,DET,1,BRK,10,3,0,1,1,1,12.01666667,1,2,4,6,0,0,2,2,2,2,3,10,13,13,18.6
2023-24,202403070DET,3/7/2024,DET vs BRK,Evan Fournier,fournev01,13,DET,1,BRK,2,2,1,1,0,1,12.78333333,0,2,1,2,0,1,0,0,2,1,3,3,4,5,7.9
2023-24,202403070GSW,3/7/2024,GSW vs CHI,Andre Drummond,drumman01,63,CHI,0,GSW,1,7,0,0,0,2,12.83333333,3,4,0,1,0,0,1,6,1,0,7,1,8,8,7.4
2023-24,202403070DEN,3/7/2024,DEN vs BOS,Justin Holiday,holidju01,39,DEN,1,BOS,2,0,1,0,1,0,13.13333333,0,0,1,2,0,1,0,0,1,1,1,3,2,3,6.5
2023-24,202403070SAC,3/7/2024,SAC vs SAS,Dominick Barlow,barlodo01,25,SAS,0,SAC,4,1,0,1,0,0,13.18333333,0,1,2,3,0,0,0,0,3,1,1,4,5,5,8.2
2023-24,202403070DEN,3/7/2024,DEN vs BOS,Xavier Tillman Sr.,tillmxa01,38,BOS,0,DEN,2,4,1,0,0,0,13.41666667,1,3,1,2,0,1,0,0,0,0,5,3,6,7,8.3
2023-24,202403070GSW,3/7/2024,GSW vs CHI,Torrey Craig,craigto01,34,CHI,0,GSW,0,1,2,0,1,1,13.75,0,1,0,1,0,1,0,0,1,1,3,2,1,3,6.2
2023-24,202403070SAC,3/7/2024,SAC vs SAS,Davion Mitchell,mitchda01,52,SAC,1,SAS,9,0,0,0,0,0,14.31666667,0,0,4,5,1,2,0,0,1,0,0,9,9,9,9
2023-24,202403070IND,3/7/2024,IND vs MIN,Obi Toppin,toppiob01,65,IND,1,MIN,2,3,0,0,2,1,14.41666667,0,3,1,3,0,1,0,0,2,2,3,2,5,5,10.6
2023-24,202403070PHO,3/7/2024,PHO vs TOR,Saben Lee,leesa01,20,PHO,1,TOR,0,1,4,0,0,0,15.23333333,0,1,0,5,0,1,0,0,2,0,5,4,1,5,7.2
2023-24,202403070GSW,3/7/2024,GSW vs CHI,Andrew Wiggins,wiggian01,53,GSW,1,CHI,8,1,2,1,0,0,15.3,0,1,3,6,0,2,2,2,2,1,3,10,9,11,15.2
2023-24,202403070IND,3/7/2024,IND vs MIN,Jarace Walker,walkeja02,23,IND,1,MIN,5,5,1,1,0,0,15.66666667,1,4,2,4,1,2,0,0,2,1,6,6,10,11,15.5
2023-24,202403070DAL,3/7/2024,DAL vs MIA,Nikola Jovic,jovicni01,28,MIA,0,DAL,4,2,1,0,0,2,15.95,0,2,2,6,0,3,0,0,1,0,3,5,6,7,5.9
2023-24,202403070IND,3/7/2024,IND vs MIN,T.J. Warren,warretj01,1,MIN,0,IND,7,1,0,0,0,0,16.08333333,0,1,3,5,1,3,0,0,1,0,1,7,8,8,8.2
2023-24,202403070PHO,3/7/2024,PHO vs TOR,Bol Bol,bolbo01,25,PHO,1,TOR,11,8,0,1,0,0,16.38333333,1,7,5,7,1,1,0,0,0,1,8,11,19,19,23.6
2023-24,202403070SAC,3/7/2024,SAC vs SAS,Kevin Huerter,huertke01,60,SAC,1,SAS,0,2,2,1,1,1,16.38333333,1,1,0,5,0,3,0,0,1,2,4,2,2,4,10.4
2023-24,202403070DEN,3/7/2024,DEN vs BOS,Christian Braun,braunch01,63,DEN,1,BOS,7,6,1,0,0,0,16.66666667,1,5,2,3,0,1,3,4,4,0,7,8,13,14,15.7
2023-24,202403070SAC,3/7/2024,SAC vs SAS,Blake Wesley,weslebl01,42,SAS,0,SAC,11,1,3,1,1,1,16.7,0,1,5,6,1,1,0,0,3,2,4,14,12,15,21.7
2023-24,202403070GSW,3/7/2024,GSW vs CHI,Onuralp Bitim,bitimon01,7,CHI,0,GSW,6,0,1,2,0,0,16.83333333,0,0,2,4,2,4,0,0,1,2,1,7,6,7,13.5
2023-24,202403070SAC,3/7/2024,SAC vs SAS,Julian Champagnie,champju02,55,SAS,0,SAC,4,1,1,0,0,0,16.86666667,1,0,0,5,0,2,4,4,0,0,2,5,5,6,6.7
2023-24,202403070DEN,3/7/2024,DEN vs BOS,Peyton Watson,watsope01,61,DEN,1,BOS,11,4,1,1,2,0,17.25,0,4,5,9,1,4,0,0,1,3,5,12,15,16,26.3
2023-24,202403070DAL,3/7/2024,DAL vs MIA,Dante Exum,exumda01,37,DAL,1,MIA,13,4,5,0,0,1,17.26666667,0,4,3,5,2,2,5,5,2,0,9,18,17,22,24.3
2023-24,202403070SAC,3/7/2024,SAC vs SAS,Keon Ellis,elliske01,37,SAC,1,SAS,11,3,0,2,0,0,17.41666667,2,1,4,6,3,5,0,0,0,2,3,11,14,14,20.6
2023-24,202403070SAC,3/7/2024,SAC vs SAS,Trey Lyles,lylestr01,47,SAC,1,SAS,9,5,2,0,0,0,17.71666667,2,3,3,5,1,2,2,2,1,0,7,11,14,16,18
2023-24,202403070GSW,3/7/2024,GSW vs CHI,Trayce Jackson-Davis,jackstr02,49,GSW,1,CHI,8,4,2,1,0,0,17.96666667,0,4,3,3,0,0,2,3,4,1,6,10,12,14,18.8
2023-24,202403070PHO,3/7/2024,PHO vs TOR,Javon Freeman-Liberty,freemja01,5,TOR,0,PHO,5,3,2,0,1,0,18,0,3,1,4,1,2,2,2,1,1,5,7,8,10,14.6
2023-24,202403070IND,3/7/2024,IND vs MIN,Ben Sheppard,sheppbe01,40,IND,1,MIN,6,4,0,0,0,0,18.51666667,0,4,2,4,2,2,0,0,4,0,4,6,10,10,10.8
2023-24,202403070DEN,3/7/2024,DEN vs BOS,Al Horford,horfoal01,52,BOS,0,DEN,2,4,0,0,0,0,18.85,1,3,0,2,0,1,2,2,1,0,4,2,6,6,6.8
2023-24,202403070DAL,3/7/2024,DAL vs MIA,Josh Green,greenjo02,50,DAL,1,MIA,2,2,2,1,1,0,18.96666667,1,1,1,3,0,2,0,0,0,2,4,4,4,6,13.4
2023-24,202403070IND,3/7/2024,IND vs MIN,Jalen Smith,smithja04,45,IND,1,MIN,14,2,4,0,1,0,20.36666667,1,1,5,5,1,1,3,6,1,1,6,18,16,20,25.4
2023-24,202403070DAL,3/7/2024,DAL vs MIA,Tim Hardaway Jr.,hardati02,60,DAL,1,MIA,11,1,1,0,0,0,20.66666667,0,1,3,11,2,6,3,4,1,0,2,12,12,13,13.7
2023-24,202403070PHO,3/7/2024,PHO vs TOR,Drew Eubanks,eubandr01,57,PHO,1,TOR,6,8,1,1,1,1,20.75,4,4,3,5,0,0,0,0,0,2,9,7,14,15,22.1
2023-24,202403070IND,3/7/2024,IND vs MIN,Myles Turner,turnemy01,61,IND,1,MIN,12,7,1,0,4,2,20.81666667,1,6,4,8,1,3,3,5,5,4,8,13,19,20,31.9
2023-24,202403070GSW,3/7/2024,GSW vs CHI,Jevon Carter,carteje01,60,CHI,0,GSW,10,1,2,1,0,0,21.06666667,0,1,4,7,2,3,0,0,4,1,3,12,11,13,17.2
2023-24,202403070DAL,3/7/2024,DAL vs MIA,Daniel Gafford,gaffoda01,56,DAL,1,MIA,12,7,0,1,1,0,21.13333333,2,5,5,5,0,0,2,4,3,2,7,12,19,19,26.4
2023-24,202403070DAL,3/7/2024,DAL vs MIA,Maxi Kleber,klebima01,26,DAL,1,MIA,3,4,1,0,2,0,22.18333333,0,4,1,3,1,2,0,0,1,2,5,4,7,8,15.3
2023-24,202403070GSW,3/7/2024,GSW vs CHI,Alex Caruso,carusal01,54,CHI,0,GSW,5,5,2,0,1,2,22.45,1,4,2,4,1,3,0,0,4,1,7,7,10,12,15
2023-24,202403070GSW,3/7/2024,GSW vs CHI,Moses Moody,moodymo01,48,GSW,1,CHI,10,9,0,1,0,2,22.85,5,4,4,9,0,4,2,2,2,1,9,10,19,19,21.8
2023-24,202403070PHO,3/7/2024,PHO vs TOR,Eric Gordon,gordoer01,52,PHO,1,TOR,5,2,1,1,0,0,22.9,0,2,2,7,1,4,0,0,1,1,3,6,7,8,11.9
2023-24,202403070DAL,3/7/2024,DAL vs MIA,Dereck Lively II,livelde01,45,DAL,1,MIA,4,2,1,0,0,0,23.03333333,2,0,2,3,0,0,0,0,4,0,3,5,6,7,7.9
2023-24,202403070DET,3/7/2024,DET vs BRK,Simone Fontecchio,fontesi01,61,DET,1,BRK,4,6,1,0,1,1,23.2,2,4,2,7,0,2,0,0,0,1,7,5,10,11,14.7
2023-24,202403070DET,3/7/2024,DET vs BRK,Dennis Smith Jr.,smithde03,47,BRK,0,DET,9,2,3,4,0,1,23.56666667,0,2,3,10,1,4,2,2,6,4,5,12,11,14,26.9
2023-24,202403070PHO,3/7/2024,PHO vs TOR,Ochai Agbaji,agbajoc01,62,TOR,0,PHO,3,4,1,1,0,2,23.66666667,1,3,1,6,0,1,1,2,4,1,5,4,7,8,10.3
2023-24,202403070PHO,3/7/2024,PHO vs TOR,Chris Boucher,bouchch01,49,TOR,0,PHO,11,9,2,0,0,2,23.7,5,4,5,6,0,0,1,1,2,0,11,13,20,22,22.8
2023-24,202403070SAC,3/7/2024,SAC vs SAS,Tre Jones,jonestr01,58,SAS,0,SAC,2,5,12,0,0,2,23.93333333,0,5,1,1,0,0,0,0,0,0,17,14,7,19,24
2023-24,202403070GSW,3/7/2024,GSW vs CHI,Chris Paul,paulch01,38,GSW,1,CHI,15,4,5,0,0,1,24.25,1,3,6,8,1,3,2,2,0,0,9,20,19,24,26.3
2023-24,202403070PHO,3/7/2024,PHO vs TOR,Jusuf Nurkic,nurkiju01,59,PHO,1,TOR,7,14,5,0,2,7,26.01666667,3,11,3,5,0,0,1,2,5,2,19,12,21,26,30.3
2023-24,202403070IND,3/7/2024,IND vs MIN,Naz Reid,reidna01,63,MIN,0,IND,13,8,2,1,1,2,26.05,2,6,6,15,1,4,0,0,2,2,10,15,21,23,29.6
2023-24,202403070SAC,3/7/2024,SAC vs SAS,Malaki Branham,branhma01,58,SAS,0,SAC,23,1,4,2,0,3,26.06666667,0,1,6,11,5,5,6,6,3,2,5,27,24,28,33.2
2023-24,202403070GSW,3/7/2024,GSW vs CHI,Brandin Podziemski,podzibr01,54,GSW,1,CHI,11,4,4,1,0,0,26.96666667,1,3,4,7,1,2,2,4,1,1,8,15,15,19,24.8
2023-24,202403070IND,3/7/2024,IND vs MIN,Kyle Anderson,anderky01,61,MIN,0,IND,3,3,4,0,0,1,27.66666667,0,3,1,5,0,0,1,2,6,0,7,7,6,10,11.6
2023-24,202403070DAL,3/7/2024,DAL vs MIA,Jaime Jaquez Jr.,jaqueja01,56,MIA,0,DAL,13,6,2,1,0,0,27.8,0,6,4,7,3,4,2,2,2,1,8,15,19,21,26.2
2023-24,202403070IND,3/7/2024,IND vs MIN,Nickeil Alexander-Walker,alexani01,63,MIN,0,IND,10,2,2,2,0,2,27.86666667,1,1,4,10,0,4,2,2,3,2,4,12,12,14,19.4
2023-24,202403070GSW,3/7/2024,GSW vs CHI,Klay Thompson,thompkl01,59,GSW,1,CHI,25,1,2,2,0,0,27.86666667,0,1,9,21,5,12,2,3,1,2,3,27,26,28,35.2
2023-24,202403070IND,3/7/2024,IND vs MIN,Jaden McDaniels,mcdanja02,53,MIN,0,IND,11,8,6,0,0,0,27.88333333,1,7,4,7,1,1,2,2,4,0,14,17,19,25,29.6
2023-24,202403070PHO,3/7/2024,PHO vs TOR,Kelly Olynyk,olynyke01,61,TOR,0,PHO,8,4,2,2,0,1,27.93333333,1,3,3,9,1,6,1,2,6,2,6,10,12,14,20.8
2023-24,202403070SAC,3/7/2024,SAC vs SAS,Keldon Johnson,johnske04,59,SAS,0,SAC,22,3,4,1,0,1,27.98333333,1,2,9,17,4,11,0,0,0,1,7,26,25,29,33.6
2023-24,202403070GSW,3/7/2024,GSW vs CHI,Stephen Curry,curryst01,59,GSW,1,CHI,15,3,1,0,0,2,28.7,0,3,5,18,3,12,2,2,1,0,4,16,18,19,18.1
2023-24,202403070DET,3/7/2024,DET vs BRK,Lonnie Walker IV,walkelo01,43,BRK,0,DET,21,4,1,0,0,2,29.08333333,0,4,8,18,5,14,0,0,3,0,5,22,25,26,25.3
2023-24,202403070DAL,3/7/2024,DAL vs MIA,P.J. Washington,washipj01,55,DAL,1,MIA,10,8,1,1,1,1,29.08333333,4,4,4,12,1,6,1,2,1,2,9,11,18,19,26.1
2023-24,202403070DET,3/7/2024,DET vs BRK,Jalen Duren,durenja01,47,DET,1,BRK,12,14,4,2,0,3,29.85,3,11,6,8,0,0,0,0,3,2,18,16,26,30,37.8
2023-24,202403070SAC,3/7/2024,SAC vs SAS,Zach Collins,colliza01,51,SAS,0,SAC,22,7,4,0,0,1,30.08333333,4,3,8,17,2,3,4,4,4,0,11,26,29,33,35.4
2023-24,202403070DEN,3/7/2024,DEN vs BOS,Michael Porter Jr.,portemi01,62,DEN,1,BOS,9,2,1,0,0,0,30.1,0,2,4,9,1,4,0,0,4,0,3,10,11,12,12.9
2023-24,202403070DAL,3/7/2024,DAL vs MIA,Duncan Robinson,robindu01,57,MIA,0,DAL,19,4,2,0,0,1,30.13333333,0,4,7,10,5,8,0,0,4,0,6,21,23,25,25.8
2023-24,202403070IND,3/7/2024,IND vs MIN,Aaron Nesmith,nesmiaa01,56,IND,1,MIN,8,4,1,0,2,0,30.28333333,0,4,2,10,1,4,3,3,3,2,5,9,12,13,20.3
2023-24,202403070IND,3/7/2024,IND vs MIN,Mike Conley,conlemi01,58,MIN,0,IND,5,5,4,2,0,2,30.36666667,1,4,2,9,1,6,0,0,1,2,9,9,10,14,21
2023-24,202403070SAC,3/7/2024,SAC vs SAS,Harrison Barnes,barneha02,62,SAC,1,SAS,17,1,2,0,0,0,30.4,1,0,6,9,0,2,5,5,1,0,3,19,18,20,21.2
2023-24,202403070SAC,3/7/2024,SAC vs SAS,Malik Monk,monkma01,61,SAC,1,SAS,18,7,9,1,1,6,30.4,0,7,6,17,2,7,4,4,1,2,16,27,25,34,39.9
2023-24,202403070IND,3/7/2024,IND vs MIN,Andrew Nembhard,nembhan01,50,IND,1,MIN,7,6,3,1,0,3,30.55,2,4,3,5,1,2,0,0,4,1,9,10,13,16,18.7
2023-24,202403070PHO,3/7/2024,PHO vs TOR,Gradey Dick,dickgr01,42,TOR,0,PHO,12,2,0,0,0,1,30.61666667,0,2,4,12,4,10,0,0,2,0,2,12,14,14,13.4
2023-24,202403070SAC,3/7/2024,SAC vs SAS,Keegan Murray,murrake02,58,SAC,1,SAS,3,3,0,0,0,0,30.9,0,3,1,4,1,3,0,0,2,0,3,3,6,6,6.6
2023-24,202403070DET,3/7/2024,DET vs BRK,Isaiah Stewart,stewais01,40,DET,1,BRK,8,10,0,0,0,4,31.58333333,2,8,3,4,0,1,2,2,1,0,10,8,18,18,16
2023-24,202403070PHO,3/7/2024,PHO vs TOR,Royce O'Neale,onealro01,60,PHO,1,TOR,10,8,6,1,1,0,31.61666667,1,7,4,8,2,6,0,0,2,2,14,16,18,24,34.6
2023-24,202403070GSW,3/7/2024,GSW vs CHI,Jonathan Kuminga,kuminjo01,61,GSW,1,CHI,19,10,2,1,0,1,32.58333333,3,7,5,11,0,1,9,10,4,1,12,21,29,31,36
2023-24,202403070DAL,3/7/2024,DAL vs MIA,Caleb Martin,martica02,45,MIA,0,DAL,13,3,2,0,1,0,32.71666667,1,2,4,9,3,7,2,3,6,1,5,15,16,18,22.6
2023-24,202403070GSW,3/7/2024,GSW vs CHI,Draymond Green,greendr01,38,GSW,1,CHI,11,10,12,1,2,4,32.76666667,2,8,5,12,1,5,0,0,6,3,22,23,21,33,46
2023-24,202403070PHO,3/7/2024,PHO vs TOR,Bradley Beal,bealbr01,34,PHO,1,TOR,20,2,8,1,1,2,33.41666667,1,1,8,16,1,4,3,4,2,2,10,28,22,30,38.4
2023-24,202403070IND,3/7/2024,IND vs MIN,Pascal Siakam,siakapa01,62,IND,1,MIN,24,4,2,0,0,2,33.58333333,2,2,10,20,1,3,3,3,1,0,6,26,28,30,29.8
2023-24,202403070DEN,3/7/2024,DEN vs BOS,Kentavious Caldwell-Pope,caldwke01,57,DEN,1,BOS,11,3,1,3,0,2,33.9,0,3,4,7,1,4,2,2,3,3,4,12,14,15,23.1
2023-24,202403070DEN,3/7/2024,DEN vs BOS,Aaron Gordon,gordoaa01,57,DEN,1,BOS,16,9,1,1,0,0,34.01666667,3,6,8,15,0,2,0,0,2,1,10,17,25,26,31.3
2023-24,202403070DET,3/7/2024,DET vs BRK,Nic Claxton,claxtni01,53,BRK,0,DET,15,10,2,1,3,1,34.21666667,1,9,5,8,0,0,5,7,2,4,12,17,25,27,41
2023-24,202403070PHO,3/7/2024,PHO vs TOR,Kevin Durant,duranke01,56,PHO,1,TOR,35,3,1,1,0,4,34.86666667,0,3,11,19,2,5,11,12,1,1,4,36,38,39,39.1
2023-24,202403070DEN,3/7/2024,DEN vs BOS,Jrue Holiday,holidjr01,57,BOS,0,DEN,12,4,2,0,0,1,34.91666667,1,3,5,10,2,6,0,0,2,0,6,14,16,18,18.8
2023-24,202403070SAC,3/7/2024,SAC vs SAS,De'Aaron Fox,foxde01,54,SAC,1,SAS,33,5,5,3,0,1,35.06666667,2,3,14,32,1,7,4,4,6,3,10,38,38,43,54.5
2023-24,202403070GSW,3/7/2024,GSW vs CHI,Nikola Vucevic,vucevni01,58,CHI,0,GSW,33,11,5,0,0,4,35.16666667,2,9,14,23,3,6,2,2,2,0,16,38,44,49,49.7
2023-24,202403070DEN,3/7/2024,DEN vs BOS,Kristaps Porzingis,porzikr01,46,BOS,0,DEN,24,12,2,1,1,3,35.26666667,2,10,9,23,3,10,3,4,2,2,14,26,36,38,44.4
2023-24,202403070SAC,3/7/2024,SAC vs SAS,Jeremy Sochan,sochaje01,63,SAS,0,SAC,9,8,2,1,2,2,35.8,2,6,3,10,0,3,3,3,5,3,10,11,17,19,28.6
2023-24,202403070PHO,3/7/2024,PHO vs TOR,Gary Trent Jr.,trentga02,58,TOR,0,PHO,30,3,0,0,0,0,35.91666667,1,2,11,22,5,13,3,3,1,0,3,30,33,33,33.6
2023-24,202403070DAL,3/7/2024,DAL vs MIA,Kyrie Irving,irvinky01,41,DAL,1,MIA,23,4,4,1,1,2,36.26666667,0,4,9,19,3,9,2,2,1,2,8,27,27,31,37.8
2023-24,202403070DET,3/7/2024,DET vs BRK,Dorian Finney-Smith,finnedo01,54,BRK,0,DET,13,3,0,3,1,1,36.76666667,0,3,5,9,3,7,0,0,2,4,3,13,16,16,27.6
2023-24,202403070GSW,3/7/2024,GSW vs CHI,Coby White,whiteco01,63,CHI,0,GSW,20,4,7,2,0,2,36.91666667,0,4,7,16,2,6,4,4,4,2,11,27,24,31,39.3
2023-24,202403070DEN,3/7/2024,DEN vs BOS,Derrick White,whitede01,58,BOS,0,DEN,7,5,6,1,1,1,36.95,1,4,3,8,0,4,1,1,4,2,11,13,12,18,27
2023-24,202403070DEN,3/7/2024,DEN vs BOS,Jamal Murray,murraja01,47,DEN,1,BOS,19,6,8,2,0,5,37,0,6,7,18,1,4,4,4,2,2,14,27,25,33,39.2
2023-24,202403070PHO,3/7/2024,PHO vs TOR,RJ Barrett,barrerj01,52,TOR,0,PHO,23,2,4,1,1,1,37.16666667,1,1,9,16,3,4,2,3,4,2,6,27,25,29,36.4
2023-24,202403070IND,3/7/2024,IND vs MIN,Tyrese Haliburton,halibty01,52,IND,1,MIN,23,3,13,1,0,5,37.3,0,3,9,15,2,7,3,4,1,1,16,36,26,39,44.1
2023-24,202403070DAL,3/7/2024,DAL vs MIA,Bam Adebayo,adebaba01,52,MIA,0,DAL,14,9,5,3,0,1,37.36666667,1,8,5,14,0,2,4,8,1,3,14,19,23,28,40.3
2023-24,202403070GSW,3/7/2024,GSW vs CHI,Ayo Dosunmu,dosunay01,61,CHI,0,GSW,14,3,6,0,2,2,37.51666667,1,2,6,12,2,5,0,0,3,2,9,20,17,23,30.6
2023-24,202403070DAL,3/7/2024,DAL vs MIA,Jimmy Butler,butleji01,43,MIA,0,DAL,14,4,5,2,0,6,37.7,0,4,6,12,1,2,1,2,2,2,9,19,18,23,26.3
2023-24,202403070SAC,3/7/2024,SAC vs SAS,Domantas Sabonis,sabondo01,62,SAC,1,SAS,31,17,9,1,1,4,37.91666667,5,12,14,19,1,1,2,3,2,2,26,40,48,57,66.9
2023-24,202403070DET,3/7/2024,DET vs BRK,Cade Cunningham,cunnica01,52,DET,1,BRK,32,5,11,0,1,5,38.1,1,4,10,22,4,8,8,9,0,1,16,43,37,48,52.5
2023-24,202403070DET,3/7/2024,DET vs BRK,Dennis Schroder,schrode01,63,BRK,0,DET,31,1,8,0,0,3,38.58333333,0,1,12,17,5,7,2,3,1,0,9,39,32,40,41.2
2023-24,202403070IND,3/7/2024,IND vs MIN,Anthony Edwards,edwaran01,60,MIN,0,IND,44,6,3,2,2,0,38.6,2,4,18,35,3,7,5,8,1,4,9,47,50,53,67.7
2023-24,202403070DEN,3/7/2024,DEN vs BOS,Jayson Tatum,tatumja01,59,BOS,0,DEN,15,4,8,2,0,5,38.65,1,3,5,13,2,5,3,4,4,2,12,23,19,27,32.8
2023-24,202403070DEN,3/7/2024,DEN vs BOS,Nikola Jokic,jokicni01,61,DEN,1,BOS,32,12,11,2,0,0,38.75,4,8,11,19,0,0,10,10,1,2,23,43,44,55,68.9
2023-24,202403070PHO,3/7/2024,PHO vs TOR,Grayson Allen,allengr01,57,PHO,1,TOR,26,3,3,0,1,0,38.81666667,0,3,8,14,8,14,2,2,3,1,6,29,29,32,37.1
2023-24,202403070DET,3/7/2024,DET vs BRK,Jaden Ivey,iveyja01,58,DET,1,BRK,34,3,2,2,0,4,38.83333333,2,1,10,17,6,9,8,8,4,2,5,36,37,39,42.6
2023-24,202403070SAC,3/7/2024,SAC vs SAS,Devin Vassell,vassede01,58,SAS,0,SAC,30,5,9,2,1,2,38.93333333,0,5,11,18,4,6,4,4,0,3,14,39,35,44,56.5
2023-24,202403070GSW,3/7/2024,GSW vs CHI,DeMar DeRozan,derozde01,61,CHI,0,GSW,33,8,4,0,1,1,39.23333333,0,8,10,17,3,6,10,11,2,1,12,37,41,45,50.6
2023-24,202403070PHO,3/7/2024,PHO vs TOR,Immanuel Quickley,quickim01,58,TOR,0,PHO,21,9,18,1,0,2,39.51666667,0,9,9,17,2,7,1,2,0,1,27,39,30,48,59.8
2023-24,202403070DAL,3/7/2024,DAL vs MIA,Luka Doncic,doncilu01,55,DAL,1,MIA,35,11,11,1,0,4,39.55,0,11,12,24,7,13,4,4,2,1,22,46,46,57,63.7
2023-24,202403070DAL,3/7/2024,DAL vs MIA,Terry Rozier,roziete01,45,MIA,0,DAL,27,6,11,1,0,0,39.58333333,0,6,10,17,5,8,2,2,2,1,17,38,33,44,53.7
2023-24,202403070IND,3/7/2024,IND vs MIN,Rudy Gobert,goberru01,61,MIN,0,IND,18,14,0,2,3,2,39.68333333,6,8,7,11,0,0,4,5,2,5,14,18,32,32,47.8
2023-24,202403070DEN,3/7/2024,DEN vs BOS,Jaylen Brown,brownja02,57,BOS,0,DEN,41,14,4,2,0,2,41.06666667,6,8,16,29,2,7,7,14,4,2,18,45,55,59,67.8
2023-24,202403070DET,3/7/2024,DET vs BRK,Mikal Bridges,bridgmi01,63,BRK,0,DET,13,1,7,1,0,3,43.16666667,1,0,4,11,3,7,2,4,1,1,8,20,14,21,24.7
2023-24,202403070DET,3/7/2024,DET vs BRK,Ausar Thompson,thompau01,62,DET,1,BRK,14,7,3,1,1,3,43.33333333,2,5,6,12,2,7,0,0,4,2,10,17,21,24,29.9
2023-24,202403060HOU,3/6/2024,HOU vs LAC,Bones Hyland,hylanbo01,23,LAC,0,HOU,6,1,1,0,0,1,10.43333333,0,1,3,6,0,2,0,0,2,0,2,7,7,8,7.7
2023-24,202403060LAL,3/6/2024,LAL vs SAC,Max Christie,chrisma02,51,LAL,1,SAC,3,2,1,0,0,0,10.8,0,2,1,2,1,2,0,0,0,0,3,4,5,6,6.9
2023-24,202403060ATL,3/6/2024,ATL vs CLE,Damian Jones,jonesda03,26,CLE,0,ATL,2,2,0,0,1,0,10.88333333,1,1,1,1,0,0,0,0,1,1,2,2,4,4,7.4
2023-24,202403060LAL,3/6/2024,LAL vs SAC,Kevin Huerter,huertke01,59,SAC,0,LAL,2,1,3,1,0,0,11.7,1,0,1,3,0,2,0,0,3,1,4,5,3,6,10.7
2023-24,202403060LAL,3/6/2024,LAL vs SAC,Jaxson Hayes,hayesja02,54,LAL,1,SAC,1,5,0,0,1,2,12.88333333,1,4,0,1,0,0,1,2,4,1,5,1,6,6,8
2023-24,202403060GSW,3/6/2024,GSW vs MIL,A.J. Green,greenaj01,42,MIL,0,GSW,2,1,1,0,0,1,12.91666667,0,1,1,6,0,5,0,0,0,0,2,3,3,4,3.7
2023-24,202403060HOU,3/6/2024,HOU vs LAC,Amir Coffey,coffeam01,49,LAC,0,HOU,2,1,1,0,0,1,13.16666667,0,1,0,1,0,1,2,2,0,0,2,3,3,4,3.7
2023-24,202403060ATL,3/6/2024,ATL vs CLE,Trent Forrest,forretr01,24,ATL,1,CLE,6,3,1,0,0,0,13.66666667,1,2,3,4,0,0,0,0,1,0,4,7,9,10,11.1
2023-24,202403060GSW,3/6/2024,GSW vs MIL,Andrew Wiggins,wiggian01,52,GSW,1,MIL,3,2,2,1,0,1,13.7,1,1,1,5,1,2,0,0,0,1,4,5,5,7,10.4
2023-24,202403060WAS,3/6/2024,WAS vs ORL,Joe Ingles,inglejo01,49,ORL,0,WAS,0,1,0,0,0,1,13.75,0,1,0,0,0,0,0,0,1,0,1,0,1,1,0.2
2023-24,202403060LAL,3/6/2024,LAL vs SAC,Keon Ellis,elliske01,36,SAC,0,LAL,5,3,0,1,0,1,13.88333333,1,2,2,4,1,2,0,0,1,1,3,5,8,8,10.6
2023-24,202403060POR,3/6/2024,POR vs OKC,Ashton Hagans,haganas01,11,POR,1,OKC,2,1,4,0,0,3,13.98333333,1,0,1,2,0,1,0,0,1,0,5,6,3,7,6.2
2023-24,202403060HOU,3/6/2024,HOU vs LAC,Ivica Zubac,zubaciv01,49,LAC,0,HOU,3,5,1,0,2,1,14.76666667,2,3,1,4,0,0,1,2,1,2,6,4,8,9,15.5
2023-24,202403060ATL,3/6/2024,ATL vs CLE,Craig Porter Jr.,portecr01,38,CLE,0,ATL,13,4,2,1,0,1,14.93333333,2,2,6,8,0,1,1,1,0,1,6,15,17,19,22.8
2023-24,202403060UTA,3/6/2024,UTA vs CHI,Julian Phillips,phillju01,36,CHI,0,UTA,6,4,0,1,0,1,14.96666667,1,3,2,3,2,3,0,0,2,1,4,6,10,10,12.8
2023-24,202403060LAL,3/6/2024,LAL vs SAC,Taurean Prince,princta02,62,LAL,1,SAC,6,2,0,0,2,1,15.43333333,0,2,2,3,2,3,0,0,0,2,2,6,8,8,13.4
2023-24,202403060LAL,3/6/2024,LAL vs SAC,Harrison Barnes,barneha02,61,SAC,0,LAL,11,0,0,0,1,2,15.45,0,0,5,7,1,3,0,0,2,1,0,11,11,11,12
2023-24,202403060PHI,3/6/2024,PHI vs MEM,Lamar Stevens,stevela01,29,MEM,0,PHI,8,6,0,0,0,2,15.53333333,1,5,3,4,0,0,2,2,0,0,6,8,14,14,13.2
2023-24,202403060UTA,3/6/2024,UTA vs CHI,Omer Yurtseven,yurtsom01,34,UTA,1,CHI,10,5,3,1,3,0,15.78333333,4,1,5,6,0,1,0,0,2,4,8,13,15,18,32.5
2023-24,202403060GSW,3/6/2024,GSW vs MIL,Gary Payton II,paytoga02,27,GSW,1,MIL,9,3,0,1,1,0,15.91666667,0,3,4,4,1,1,0,0,2,2,3,9,12,12,18.6
2023-24,202403060WAS,3/6/2024,WAS vs ORL,Landry Shamet,shamela01,45,WAS,1,ORL,2,1,2,0,1,1,15.95,0,1,1,2,0,1,0,0,2,1,3,4,3,5,8.2
2023-24,202403060POR,3/6/2024,POR vs OKC,Isaiah Joe,joeis01,58,OKC,0,POR,0,1,2,1,1,0,16,0,1,0,1,0,1,0,0,2,2,3,2,1,3,10.2
2023-24,202403060POR,3/6/2024,POR vs OKC,Aaron Wiggins,wiggiaa01,59,OKC,0,POR,2,3,0,1,0,0,16.75,2,1,1,2,0,1,0,0,2,1,3,2,5,5,8.6
2023-24,202403060POR,3/6/2024,POR vs OKC,Cason Wallace,wallaca01,62,OKC,0,POR,2,2,0,0,1,1,16.95,1,1,1,3,0,1,0,0,0,1,2,2,4,4,6.4
2023-24,202403060ATL,3/6/2024,ATL vs CLE,Garrison Mathews,mathega01,46,ATL,1,CLE,3,1,0,0,0,0,17.08333333,1,0,1,1,1,1,0,0,2,0,1,3,4,4,4.2
2023-24,202403060UTA,3/6/2024,UTA vs CHI,Andre Drummond,drumman01,62,CHI,0,UTA,10,6,0,0,0,0,17.15,3,3,4,7,0,0,2,4,1,0,6,10,16,16,17.2
2023-24,202403060GSW,3/6/2024,GSW vs MIL,Patrick Beverley,beverpa01,58,MIL,0,GSW,2,4,0,1,2,2,17.2,0,4,0,2,0,0,2,3,2,3,4,2,6,6,13.8
2023-24,202403060GSW,3/6/2024,GSW vs MIL,Jae Crowder,crowdja01,32,MIL,0,GSW,4,6,1,1,0,0,17.4,1,5,2,6,0,1,0,0,0,1,7,5,10,11,15.7
2023-24,202403060HOU,3/6/2024,HOU vs LAC,Amen Thompson,thompam01,43,HOU,1,LAC,6,3,2,1,0,0,17.68333333,2,1,3,6,0,0,0,0,3,1,5,8,9,11,15.6
2023-24,202403060ATL,3/6/2024,ATL vs CLE,Sam Merrill,merrisa01,44,CLE,0,ATL,1,3,2,0,0,0,18.01666667,0,3,0,9,0,9,1,1,1,0,5,3,4,6,7.6
2023-24,202403060POR,3/6/2024,POR vs OKC,Gordon Hayward,haywago01,33,OKC,0,POR,10,2,0,2,0,2,18.05,0,2,3,3,1,1,3,5,0,2,2,10,12,12,16.4
2023-24,202403060WAS,3/6/2024,WAS vs ORL,Johnny Davis,davisjo06,31,WAS,1,ORL,8,2,1,0,0,0,18.06666667,1,1,2,7,2,4,2,2,0,0,3,9,10,11,11.9
2023-24,202403060LAL,3/6/2024,LAL vs SAC,Davion Mitchell,mitchda01,51,SAC,0,LAL,12,1,1,0,0,0,18.26666667,0,1,4,4,4,4,0,0,2,0,2,13,13,14,14.7
2023-24,202403060POR,3/6/2024,POR vs OKC,Rayan Rupert,ruperra01,20,POR,1,OKC,3,1,2,1,0,0,18.28333333,0,1,1,6,1,4,0,0,3,1,3,5,4,6,10.2
2023-24,202403060GSW,3/6/2024,GSW vs MIL,Trayce Jackson-Davis,jackstr02,48,GSW,1,MIL,15,6,0,1,4,1,18.56666667,2,4,7,8,0,0,1,2,1,5,6,15,21,21,36.2
2023-24,202403060POR,3/6/2024,POR vs OKC,Jabari Walker,walkeja01,57,POR,1,OKC,9,6,2,1,0,0,18.7,2,4,4,7,0,0,1,1,6,1,8,11,15,17,22.2
2023-24,202403060WAS,3/6/2024,WAS vs ORL,Corey Kispert,kispeco01,60,WAS,1,ORL,8,1,2,1,0,2,19.36666667,0,1,2,6,1,3,3,4,4,1,3,10,9,11,13.2
2023-24,202403060ATL,3/6/2024,ATL vs CLE,Jalen Johnson,johnsja05,48,ATL,1,CLE,7,4,4,0,1,1,19.41666667,0,4,3,5,1,2,0,0,1,1,8,11,11,15,19.8
2023-24,202403060WAS,3/6/2024,WAS vs ORL,Markelle Fultz,fultzma01,26,ORL,0,WAS,6,2,1,0,0,0,19.45,1,1,3,8,0,0,0,0,0,0,3,7,8,9,9.9
2023-24,202403060UTA,3/6/2024,UTA vs CHI,Luka Samanic,samanlu01,31,UTA,1,CHI,7,3,1,0,0,2,19.48333333,2,1,3,9,1,4,0,0,2,0,4,8,10,11,10.1
2023-24,202403060UTA,3/6/2024,UTA vs CHI,Jevon Carter,carteje01,59,CHI,0,UTA,7,0,1,0,0,0,19.63333333,0,0,3,5,1,3,0,0,1,0,1,8,7,8,8.5
2023-24,202403060GSW,3/6/2024,GSW vs MIL,Chris Paul,paulch01,37,GSW,1,MIL,6,2,9,3,0,2,19.86666667,0,2,2,5,2,5,0,0,1,3,11,15,8,17,28.9
2023-24,202403060HOU,3/6/2024,HOU vs LAC,Mason Plumlee,plumlma01,28,LAC,0,HOU,8,11,0,0,3,1,19.93333333,4,7,4,5,0,0,0,2,5,3,11,8,19,19,29.2
2023-24,202403060UTA,3/6/2024,UTA vs CHI,Johnny Juzang,juzanjo01,5,UTA,1,CHI,2,3,1,0,0,1,20.33333333,1,2,1,5,0,3,0,0,0,0,4,3,5,6,6.1
2023-24,202403060PHI,3/6/2024,PHI vs MEM,KJ Martin,martike04,45,PHI,1,MEM,7,4,3,0,1,1,20.48333333,1,3,2,2,1,1,2,2,6,1,7,10,11,14,18.3
2023-24,202403060GSW,3/6/2024,GSW vs MIL,Moses Moody,moodymo01,47,GSW,1,MIL,6,4,1,1,1,0,20.75,1,3,3,7,0,0,0,0,0,2,5,7,10,11,18.3
2023-24,202403060GSW,3/6/2024,GSW vs MIL,Klay Thompson,thompkl01,58,GSW,1,MIL,10,2,4,0,0,0,21.13333333,0,2,4,7,2,5,0,0,1,0,6,14,12,16,18.4
2023-24,202403060WAS,3/6/2024,WAS vs ORL,Moritz Wagner,wagnemo01,61,ORL,0,WAS,16,6,0,0,0,2,21.2,2,4,6,7,1,1,3,3,4,0,6,16,22,22,21.2
2023-24,202403060PHI,3/6/2024,PHI vs MEM,GG Jackson II,jacksgg01,30,MEM,0,PHI,6,6,1,0,0,0,21.66666667,2,4,3,10,0,5,0,0,0,0,7,7,12,13,14.7
2023-24,202403060WAS,3/6/2024,WAS vs ORL,Anthony Black,blackan01,57,ORL,0,WAS,8,1,2,2,0,0,21.88333333,1,0,3,5,2,3,0,0,1,2,3,10,9,11,18.2
2023-24,202403060GSW,3/6/2024,GSW vs MIL,Pat Connaughton,connapa01,57,MIL,0,GSW,6,2,3,0,0,0,22.4,0,2,2,4,2,3,0,0,0,0,5,9,8,11,12.9
2023-24,202403060ATL,3/6/2024,ATL vs CLE,Clint Capela,capelca01,54,ATL,1,CLE,8,9,3,0,0,0,22.85,2,7,4,6,0,0,0,0,3,0,12,11,17,20,23.3
2023-24,202403060POR,3/6/2024,POR vs OKC,Kris Murray,murrakr01,41,POR,1,OKC,12,3,1,1,0,1,23.11666667,0,3,4,5,1,1,3,4,6,1,4,13,15,16,19.1
2023-24,202403060HOU,3/6/2024,HOU vs LAC,Cam Whitmore,whitmca01,36,HOU,1,LAC,17,2,1,0,0,0,23.65,0,2,7,15,3,7,0,0,1,0,3,18,19,20,20.9
2023-24,202403060GSW,3/6/2024,GSW vs MIL,Bobby Portis,portibo01,63,MIL,0,GSW,20,6,1,0,0,5,23.78333333,0,6,8,13,2,4,2,2,5,0,7,21,26,27,23.7
2023-24,202403060PHI,3/6/2024,PHI vs MEM,Jeff Dowtin,dowtije01,2,PHI,1,MEM,10,3,6,3,1,0,23.96666667,0,3,4,7,2,4,0,0,0,4,9,16,13,19,34.6
2023-24,202403060UTA,3/6/2024,UTA vs CHI,Talen Horton-Tucker,hortota01,40,UTA,1,CHI,8,3,5,0,2,1,24.03333333,0,3,2,8,2,5,2,2,1,2,8,13,11,16,24.1
2023-24,202403060LAL,3/6/2024,LAL vs SAC,Spencer Dinwiddie,dinwisp01,58,LAL,1,SAC,8,2,1,0,0,1,24.26666667,0,2,2,3,2,3,2,4,3,0,3,9,10,11,10.9
2023-24,202403060PHI,3/6/2024,PHI vs MEM,Paul Reed,reedpa01,62,PHI,1,MEM,17,11,3,1,3,1,24.45,5,6,8,17,1,2,0,0,6,4,14,20,28,31,45.7
2023-24,202403060WAS,3/6/2024,WAS vs ORL,Cole Anthony,anthoco01,62,ORL,0,WAS,11,7,0,0,1,2,24.63333333,0,7,5,12,0,3,1,1,0,1,7,11,18,18,20.4
2023-24,202403060WAS,3/6/2024,WAS vs ORL,Goga Bitadze,bitadgo01,51,ORL,0,WAS,6,8,2,1,1,3,24.96666667,2,6,2,3,0,0,2,2,0,2,10,8,14,16,21.6
2023-24,202403060WAS,3/6/2024,WAS vs ORL,Richaun Holmes,holmeri01,32,WAS,1,ORL,12,5,2,2,0,0,25,3,2,5,6,0,0,2,2,3,2,7,14,17,19,27
2023-24,202403060GSW,3/6/2024,GSW vs MIL,Jonathan Kuminga,kuminjo01,60,GSW,1,MIL,20,4,2,2,3,2,25,1,3,9,14,2,4,0,0,2,5,6,22,24,26,40.8
2023-24,202403060GSW,3/6/2024,GSW vs MIL,Draymond Green,greendr01,37,GSW,1,MIL,12,6,6,0,2,3,25.08333333,0,6,5,11,2,4,0,1,4,2,12,18,18,24,31.2
2023-24,202403060ATL,3/6/2024,ATL vs CLE,Bruno Fernando,fernabr01,25,ATL,1,CLE,7,10,2,2,1,0,25.15,1,9,3,6,0,0,1,2,3,3,12,9,17,19,31
2023-24,202403060ATL,3/6/2024,ATL vs CLE,De'Andre Hunter,huntede01,38,ATL,1,CLE,17,3,2,1,0,1,25.55,0,3,6,12,2,5,3,4,3,1,5,19,20,22,25.6
2023-24,202403060POR,3/6/2024,POR vs OKC,Matisse Thybulle,thybuma01,58,POR,1,OKC,16,6,3,3,0,1,25.93333333,0,6,5,6,3,4,3,3,2,3,9,19,22,25,35.7
2023-24,202403060ATL,3/6/2024,ATL vs CLE,Georges Niang,niangge01,62,CLE,0,ATL,13,3,4,3,0,2,25.96666667,0,3,5,8,3,4,0,0,4,3,7,17,16,20,29.6
2023-24,202403060GSW,3/6/2024,GSW vs MIL,Brandin Podziemski,podzibr01,53,GSW,1,MIL,8,7,3,0,1,1,26.26666667,1,6,3,7,2,5,0,0,1,1,10,11,15,18,22.9
2023-24,202403060HOU,3/6/2024,HOU vs LAC,Terance Mann,mannte01,55,LAC,0,HOU,15,2,0,0,0,0,27.05,0,2,5,5,3,3,2,2,2,0,2,15,17,17,17.4
2023-24,202403060WAS,3/6/2024,WAS vs ORL,Tyus Jones,jonesty01,62,WAS,1,ORL,7,3,6,0,1,2,27.36666667,1,2,3,8,1,4,0,0,0,1,9,13,10,16,20.6
2023-24,202403060GSW,3/6/2024,GSW vs MIL,Brook Lopez,lopezbr01,60,MIL,0,GSW,9,4,0,1,0,0,27.51666667,2,2,4,11,1,4,0,0,1,1,4,9,13,13,16.8
2023-24,202403060PHI,3/6/2024,PHI vs MEM,John Konchar,konchjo01,48,MEM,0,PHI,3,4,1,0,2,2,27.71666667,1,3,1,3,1,3,0,0,4,2,5,4,7,8,13.3
2023-24,202403060PHI,3/6/2024,PHI vs MEM,Luke Kennard,kennalu01,32,MEM,0,PHI,15,2,2,0,0,1,27.78333333,0,2,5,10,3,6,2,2,1,0,4,17,17,19,19.4
2023-24,202403060PHI,3/6/2024,PHI vs MEM,Cameron Payne,payneca01,58,PHI,1,MEM,16,5,4,1,0,0,28.1,3,2,6,17,2,6,2,2,2,1,9,20,21,25,31
2023-24,202403060WAS,3/6/2024,WAS vs ORL,Bilal Coulibaly,coulibi01,58,WAS,1,ORL,7,4,1,1,1,0,28.21666667,0,4,2,7,0,4,3,3,3,2,5,8,11,12,19.3
2023-24,202403060HOU,3/6/2024,HOU vs LAC,Jabari Smith Jr.,smithja05,57,HOU,1,LAC,19,2,1,0,2,0,28.51666667,1,1,6,11,4,6,3,4,5,2,3,20,21,22,28.9
2023-24,202403060HOU,3/6/2024,HOU vs LAC,Norman Powell,powelno01,60,LAC,0,HOU,12,2,0,1,0,0,28.61666667,0,2,4,9,3,5,1,2,0,1,2,12,14,14,17.4
2023-24,202403060POR,3/6/2024,POR vs OKC,Dalano Banton,bantoda01,34,POR,1,OKC,13,5,5,0,1,1,29.31666667,1,4,5,13,2,6,1,2,2,1,10,18,18,23,28.5
2023-24,202403060UTA,3/6/2024,UTA vs CHI,Kris Dunn,dunnkr01,55,UTA,1,CHI,11,2,5,1,0,1,29.35,2,0,5,6,1,1,0,0,1,1,7,16,13,18,22.9
2023-24,202403060PHI,3/6/2024,PHI vs MEM,Nicolas Batum,batumni01,42,PHI,1,MEM,10,6,1,1,1,1,29.61666667,3,3,3,6,1,2,3,3,3,2,7,11,16,17,23.7
2023-24,202403060POR,3/6/2024,POR vs OKC,Luguentz Dort,dortlu01,60,OKC,0,POR,6,1,1,1,0,1,29.71666667,0,1,2,5,2,3,0,0,4,1,2,7,7,8,10.7
2023-24,202403060UTA,3/6/2024,UTA vs CHI,Brice Sensabaugh,sensabr01,13,UTA,1,CHI,15,12,1,0,0,1,29.73333333,3,9,5,8,2,4,3,3,2,0,13,16,27,28,29.9
2023-24,202403060ATL,3/6/2024,ATL vs CLE,Dean Wade,wadede01,53,CLE,0,ATL,9,4,0,0,0,0,30.1,0,4,3,8,1,6,2,3,1,0,4,9,13,13,13.8
2023-24,202403060LAL,3/6/2024,LAL vs SAC,Trey Lyles,lylestr01,46,SAC,0,LAL,7,6,1,0,0,0,30.35,1,5,3,5,0,2,1,1,1,0,7,8,13,14,15.7
2023-24,202403060POR,3/6/2024,POR vs OKC,Duop Reath,reathdu01,47,POR,1,OKC,16,5,1,1,0,1,30.61666667,3,2,5,12,0,5,6,7,3,1,6,17,21,22,25.5
2023-24,202403060GSW,3/6/2024,GSW vs MIL,Stephen Curry,curryst01,58,GSW,1,MIL,29,8,5,0,0,2,30.76666667,2,6,10,18,6,10,3,4,1,0,13,34,37,42,44.1
2023-24,202403060UTA,3/6/2024,UTA vs CHI,Nikola Vucevic,vucevni01,57,CHI,0,UTA,23,12,2,0,0,1,30.85,3,9,11,18,1,3,0,0,1,0,14,25,35,37,39.4
2023-24,202403060PHI,3/6/2024,PHI vs MEM,Buddy Hield,hieldbu01,65,PHI,1,MEM,15,5,3,3,1,1,30.93333333,1,4,6,17,3,7,0,0,1,4,8,18,20,23,36.5
2023-24,202403060LAL,3/6/2024,LAL vs SAC,Keegan Murray,murrake02,57,SAC,0,LAL,7,3,3,0,1,0,31.03333333,1,2,3,8,1,6,0,0,3,1,6,10,10,13,18.1
2023-24,202403060WAS,3/6/2024,WAS vs ORL,Kyle Kuzma,kuzmaky01,60,WAS,1,ORL,25,5,4,1,1,1,31.45,0,5,10,19,3,6,2,3,0,2,9,29,30,34,42
2023-24,202403060HOU,3/6/2024,HOU vs LAC,Jalen Green,greenja05,62,HOU,1,LAC,15,3,2,1,0,3,31.68333333,1,2,6,14,2,6,1,1,4,1,5,17,18,20,21.6
2023-24,202403060LAL,3/6/2024,LAL vs SAC,Malik Monk,monkma01,60,SAC,0,LAL,26,5,8,2,0,3,31.86666667,1,4,10,19,3,5,3,3,2,2,13,34,31,39,47
2023-24,202403060WAS,3/6/2024,WAS vs ORL,Jalen Suggs,suggsja01,58,ORL,0,WAS,19,6,4,1,0,2,31.91666667,2,4,6,12,5,10,2,2,1,1,10,23,25,29,33.2
2023-24,202403060PHI,3/6/2024,PHI vs MEM,Jake LaRavia,laravja01,18,MEM,0,PHI,19,13,0,0,3,3,31.95,5,8,7,15,2,4,3,4,3,3,13,19,32,32,40.6
2023-24,202403060ATL,3/6/2024,ATL vs CLE,Darius Garland,garlada01,38,CLE,0,ATL,15,1,7,0,0,2,32.06666667,0,1,5,14,3,11,2,3,4,0,8,22,16,23,24.7
2023-24,202403060UTA,3/6/2024,UTA vs CHI,John Collins,collijo01,59,UTA,1,CHI,25,13,0,1,2,0,32.21666667,2,11,11,20,2,9,1,2,1,3,13,25,38,38,49.6
2023-24,202403060POR,3/6/2024,POR vs OKC,Josh Giddey,giddejo01,61,OKC,0,POR,19,6,7,1,0,5,32.21666667,1,5,8,9,1,2,2,2,3,1,13,26,25,32,34.7
2023-24,202403060GSW,3/6/2024,GSW vs MIL,Malik Beasley,beaslma01,61,MIL,0,GSW,4,3,1,1,1,1,32.35,1,2,2,10,0,6,0,0,1,2,4,5,7,8,14.1
2023-24,202403060WAS,3/6/2024,WAS vs ORL,Jordan Poole,poolejo01,60,WAS,1,ORL,26,4,5,0,0,3,32.36666667,1,3,9,19,4,12,4,4,4,0,9,31,30,35,35.3
2023-24,202403060POR,3/6/2024,POR vs OKC,Jalen Williams,willija06,56,OKC,0,POR,31,4,3,3,1,2,32.4,0,4,9,17,4,5,9,10,3,4,7,34,35,38,50.3
2023-24,202403060GSW,3/6/2024,GSW vs MIL,Giannis Antetokounmpo,antetgi01,60,MIL,0,GSW,23,7,6,0,1,2,32.56666667,2,5,8,15,1,3,6,9,1,1,13,29,30,36,41.4
2023-24,202403060LAL,3/6/2024,LAL vs SAC,Rui Hachimura,hachiru01,51,LAL,1,SAC,29,2,0,2,1,0,32.65,0,2,13,17,3,5,0,0,0,3,2,29,31,31,40.4
2023-24,202403060POR,3/6/2024,POR vs OKC,Chet Holmgren,holmgch01,62,OKC,0,POR,21,14,5,0,1,1,33.18333333,2,12,6,9,1,4,8,10,1,1,19,26,35,40,47.3
2023-24,202403060GSW,3/6/2024,GSW vs MIL,Damian Lillard,lillada01,58,MIL,0,GSW,20,1,6,1,1,2,33.33333333,0,1,7,16,5,10,1,1,0,2,7,26,21,27,34.2
2023-24,202403060ATL,3/6/2024,ATL vs CLE,Bogdan Bogdanovic,bogdabo01,60,ATL,1,CLE,23,2,6,1,0,2,33.7,0,2,8,15,3,8,4,4,1,1,8,29,25,31,35.4
2023-24,202403060LAL,3/6/2024,LAL vs SAC,Anthony Davis,davisan02,61,LAL,1,SAC,14,11,3,0,1,2,34.1,1,10,5,13,0,1,4,5,4,1,14,17,25,28,32.7
2023-24,202403060UTA,3/6/2024,UTA vs CHI,Jordan Clarkson,clarkjo01,52,UTA,1,CHI,15,0,5,1,0,2,34.33333333,0,0,5,17,2,9,3,3,3,1,5,20,15,20,23.5
2023-24,202403060UTA,3/6/2024,UTA vs CHI,Alex Caruso,carusal01,53,CHI,0,UTA,11,3,4,4,3,0,34.41666667,0,3,4,9,3,7,0,0,3,7,7,15,14,18,41.6
2023-24,202403060PHI,3/6/2024,PHI vs MEM,Kelly Oubre Jr.,oubreke01,49,PHI,1,MEM,25,4,1,2,1,5,34.46666667,2,2,7,21,2,7,9,9,2,3,5,26,29,30,35.3
2023-24,202403060PHI,3/6/2024,PHI vs MEM,Tobias Harris,harrito02,56,PHI,1,MEM,8,6,3,0,1,1,34.53333333,1,5,3,12,1,4,1,1,0,1,9,11,14,17,21.7
2023-24,202403060UTA,3/6/2024,UTA vs CHI,Collin Sexton,sextoco01,63,UTA,1,CHI,24,4,7,0,0,2,34.73333333,0,4,7,17,5,11,5,6,2,0,11,31,28,35,37.3
2023-24,202403060ATL,3/6/2024,ATL vs CLE,Isaac Okoro,okorois01,53,CLE,0,ATL,17,2,2,1,1,1,35.05,0,2,7,13,1,5,2,2,4,2,4,19,19,21,27.4
2023-24,202403060PHI,3/6/2024,PHI vs MEM,Santi Aldama,aldamsa01,51,MEM,0,PHI,17,4,7,1,3,1,35.35,1,3,6,13,3,8,2,2,0,4,11,24,21,28,43.3
2023-24,202403060LAL,3/6/2024,LAL vs SAC,D'Angelo Russell,russeda01,60,LAL,1,SAC,10,1,3,1,0,3,35.48333333,0,1,3,10,2,6,2,2,1,1,4,13,11,14,15.7
2023-24,202403060WAS,3/6/2024,WAS vs ORL,Deni Avdija,avdijde01,59,WAS,1,ORL,14,7,3,2,0,0,35.56666667,2,5,6,13,1,4,1,2,3,2,10,17,21,24,32.9
2023-24,202403060LAL,3/6/2024,LAL vs SAC,Austin Reaves,reaveau01,65,LAL,1,SAC,18,4,4,0,0,2,35.75,1,3,6,15,4,7,2,2,2,0,8,22,22,26,26.8
2023-24,202403060ATL,3/6/2024,ATL vs CLE,Caris LeVert,leverca01,50,CLE,0,ATL,13,4,7,0,1,4,35.86666667,1,3,5,17,2,8,1,2,1,1,11,20,17,24,27.3
2023-24,202403060POR,3/6/2024,POR vs OKC,Shai Gilgeous-Alexander,gilgesh01,61,OKC,0,POR,37,3,5,1,1,4,35.95,0,3,13,23,0,3,11,12,2,2,8,42,40,45,50.1
2023-24,202403060LAL,3/6/2024,LAL vs SAC,LeBron James,jamesle01,57,LAL,1,SAC,31,5,13,1,0,3,36.13333333,0,5,10,16,1,4,10,10,0,1,18,44,36,49,56.5
2023-24,202403060UTA,3/6/2024,UTA vs CHI,Ayo Dosunmu,dosunay01,60,CHI,0,UTA,8,2,9,1,0,2,36.33333333,0,2,2,11,1,6,3,4,2,1,11,17,10,19,24.9
2023-24,202403060PHI,3/6/2024,PHI vs MEM,Vince Williams Jr.,willivi01,51,MEM,0,PHI,17,7,9,2,1,3,36.7,1,6,6,9,2,3,3,3,2,3,16,26,24,33,44.9
2023-24,202403060PHI,3/6/2024,PHI vs MEM,Jaren Jackson Jr.,jacksja02,55,MEM,0,PHI,30,11,1,0,6,3,37.1,3,8,10,25,2,7,8,10,4,6,12,31,41,42,59.7
2023-24,202403060ATL,3/6/2024,ATL vs CLE,Jarrett Allen,allenja01,57,CLE,0,ATL,18,19,3,0,1,3,37.11666667,6,13,7,11,0,0,4,5,0,1,22,21,37,40,45.3
2023-24,202403060HOU,3/6/2024,HOU vs LAC,Dillon Brooks,brookdi01,53,HOU,1,LAC,11,2,3,0,0,0,37.96666667,1,1,5,10,1,6,0,0,1,0,5,14,13,16,17.9
2023-24,202403060LAL,3/6/2024,LAL vs SAC,Domantas Sabonis,sabondo01,61,SAC,0,LAL,16,20,12,2,0,3,38.2,4,16,7,13,0,1,2,3,2,2,32,28,36,48,61
2023-24,202403060UTA,3/6/2024,UTA vs CHI,DeMar DeRozan,derozde01,60,CHI,0,UTA,29,6,7,1,0,2,38.35,0,6,10,21,2,5,7,7,1,1,13,36,35,42,47.7
2023-24,202403060HOU,3/6/2024,HOU vs LAC,Paul George,georgpa01,56,LAC,0,HOU,21,7,2,1,1,2,38.66666667,1,6,7,15,4,9,3,3,0,2,9,23,28,30,36.4
2023-24,202403060ATL,3/6/2024,ATL vs CLE,Dejounte Murray,murrade01,59,ATL,1,CLE,18,2,9,2,0,3,38.73333333,0,2,7,21,1,7,3,4,1,2,11,27,20,29,36.9
2023-24,202403060WAS,3/6/2024,WAS vs ORL,Paolo Banchero,banchpa01,61,ORL,0,WAS,25,6,10,0,1,4,38.81666667,1,5,10,19,1,2,4,5,3,1,16,35,31,41,46.2
2023-24,202403060WAS,3/6/2024,WAS vs ORL,Franz Wagner,wagnefr01,55,ORL,0,WAS,28,5,2,0,2,1,38.98333333,0,5,9,15,3,7,7,8,4,2,7,30,33,35,42
2023-24,202403060HOU,3/6/2024,HOU vs LAC,Kawhi Leonard,leonaka01,56,LAC,0,HOU,28,6,7,2,0,0,39.01666667,1,5,11,18,1,4,5,5,1,2,13,35,34,41,51.7
2023-24,202403060HOU,3/6/2024,HOU vs LAC,Fred VanVleet,vanvlfr01,55,HOU,1,LAC,15,4,8,2,0,0,39.03333333,1,3,5,14,4,9,1,2,2,2,12,23,19,27,37.8
2023-24,202403060HOU,3/6/2024,HOU vs LAC,James Harden,hardeja01,56,LAC,0,HOU,21,5,7,1,1,2,39.2,0,5,6,13,1,5,8,8,2,2,12,28,26,33,41.5
2023-24,202403060LAL,3/6/2024,LAL vs SAC,De'Aaron Fox,foxde01,53,SAC,0,LAL,44,4,4,2,0,3,39.45,0,4,19,32,2,6,4,5,3,2,8,48,48,52,57.8
2023-24,202403060POR,3/6/2024,POR vs OKC,Anfernee Simons,simonan01,38,POR,1,OKC,29,3,5,1,0,4,39.73333333,0,3,10,19,5,10,4,4,2,1,8,34,32,37,39.1
2023-24,202403060POR,3/6/2024,POR vs OKC,Jerami Grant,grantje01,53,POR,1,OKC,20,2,4,2,1,6,40.31666667,0,2,6,11,2,3,6,6,3,3,6,24,22,26,31.4
2023-24,202403060ATL,3/6/2024,ATL vs CLE,Saddiq Bey,beysa01,61,ATL,1,CLE,23,8,0,1,1,2,40.5,3,5,8,14,3,7,4,6,1,2,8,23,31,31,36.6
2023-24,202403060UTA,3/6/2024,UTA vs CHI,Coby White,whiteco01,62,CHI,0,UTA,25,6,6,0,1,1,41.85,0,6,9,15,7,11,0,0,1,1,12,31,31,37,43.2
2023-24,202403060HOU,3/6/2024,HOU vs LAC,Alperen Sengun,sengual01,61,HOU,1,LAC,23,19,14,2,0,3,42.43333333,6,13,10,19,0,0,3,8,4,2,33,37,42,56,69.8
2023-24,202403050HOU,3/5/2024,HOU vs SAS,Julian Champagnie,champju02,54,SAS,0,HOU,0,2,0,0,0,1,10.43333333,0,2,0,1,0,1,0,0,0,0,2,0,2,2,1.4
2023-24,202403050NYK,3/5/2024,NYK vs ATL,Trent Forrest,forretr01,23,ATL,0,NYK,5,1,4,0,0,0,11.03333333,0,1,2,2,0,0,1,2,2,0,5,9,6,10,12.2
2023-24,202403050HOU,3/5/2024,HOU vs SAS,Jock Landale,landajo01,35,HOU,1,SAS,2,8,0,1,0,0,11.03333333,3,5,1,4,0,1,0,0,3,1,8,2,10,10,14.6
2023-24,202403050BRK,3/5/2024,BRK vs PHI,KJ Martin,martike04,44,PHI,0,BRK,6,3,0,1,0,1,11.36666667,2,1,3,4,0,0,0,0,3,1,3,6,9,9,11.6
2023-24,202403050MIA,3/5/2024,MIA vs DET,Haywood Highsmith,highsha01,45,MIA,1,DET,3,3,1,0,1,0,11.4,1,2,1,2,1,2,0,0,1,1,4,4,6,7,11.1
2023-24,202403050DAL,3/5/2024,DAL vs IND,Derrick Jones Jr.,jonesde02,57,DAL,1,IND,2,0,1,0,1,1,11.66666667,0,0,1,1,0,0,0,0,1,1,1,3,2,3,5.5
2023-24,202403050NYK,3/5/2024,NYK vs ATL,Alec Burks,burksal01,53,NYK,1,ATL,11,2,1,1,0,0,11.7,1,1,5,14,1,7,0,1,0,1,3,12,13,14,17.9
2023-24,202403050BRK,3/5/2024,BRK vs PHI,Mo Bamba,bambamo01,39,PHI,0,BRK,4,3,0,0,1,2,11.76666667,1,2,2,5,0,0,0,0,4,1,3,4,7,7,8.6
2023-24,202403050HOU,3/5/2024,HOU vs SAS,Blake Wesley,weslebl01,41,SAS,0,HOU,0,0,5,0,0,0,12.43333333,0,0,0,2,0,2,0,0,1,0,5,5,0,5,7.5
2023-24,202403050TOR,3/5/2024,TOR vs NOP,D.J. Carton,cartodj01,4,TOR,1,NOP,1,2,0,1,0,0,12.5,1,1,0,2,0,1,1,2,0,1,2,1,3,3,6.4
2023-24,202403050DEN,3/5/2024,DEN vs PHO,Bol Bol,bolbo01,24,PHO,0,DEN,2,4,1,0,1,0,12.51666667,1,3,1,2,0,0,0,0,2,1,5,3,6,7,11.3
2023-24,202403050DEN,3/5/2024,DEN vs PHO,Saben Lee,leesa01,19,PHO,0,DEN,4,3,2,0,0,0,12.68333333,1,2,1,3,0,0,2,2,0,0,5,6,7,9,10.6
2023-24,202403050BRK,3/5/2024,BRK vs PHI,Trendon Watford,watfotr01,44,BRK,1,PHI,2,5,0,0,2,0,12.81666667,1,4,1,6,0,2,0,0,1,2,5,2,7,7,14
2023-24,202403050CLE,3/5/2024,CLE vs BOS,Payton Pritchard,pritcpa01,61,BOS,0,CLE,2,5,1,0,0,2,12.83333333,1,4,1,3,0,1,0,0,1,0,6,3,7,8,7.5
2023-24,202403050DAL,3/5/2024,DAL vs IND,Tim Hardaway Jr.,hardati02,59,DAL,1,IND,6,1,1,0,0,0,12.96666667,1,0,2,8,2,5,0,0,1,0,2,7,7,8,8.7
2023-24,202403050CLE,3/5/2024,CLE vs BOS,Sam Hauser,hausesa01,60,BOS,0,CLE,5,5,1,1,0,0,14.06666667,1,4,2,5,1,3,0,0,1,1,6,6,10,11,15.5
2023-24,202403050MIA,3/5/2024,MIA vs DET,Marcus Sasser,sassema01,52,DET,0,MIA,0,1,3,2,0,0,14.1,0,1,0,3,0,3,0,0,1,2,4,3,1,4,11.7
2023-24,202403050NYK,3/5/2024,NYK vs ATL,Garrison Mathews,mathega01,45,ATL,0,NYK,3,3,0,0,0,0,14.38333333,1,2,0,1,0,1,3,3,1,0,3,3,6,6,6.6
2023-24,202403050MIA,3/5/2024,MIA vs DET,Evan Fournier,fournev01,12,DET,0,MIA,7,2,1,0,0,0,14.78333333,0,2,2,10,2,8,1,1,3,0,3,8,9,10,10.9
2023-24,202403050HOU,3/5/2024,HOU vs SAS,Cedi Osman,osmande01,62,SAS,0,HOU,6,4,0,1,0,0,15.18333333,1,3,3,4,0,1,0,0,0,1,4,6,10,10,13.8
2023-24,202403050DAL,3/5/2024,DAL vs IND,Maxi Kleber,klebima01,25,DAL,1,IND,0,1,0,0,0,0,15.43333333,0,1,0,3,0,3,0,0,3,0,1,0,1,1,1.2
2023-24,202403050DAL,3/5/2024,DAL vs IND,Dereck Lively II,livelde01,44,DAL,1,IND,0,1,0,0,0,1,15.5,1,0,0,2,0,0,0,0,3,0,1,0,1,1,0.2
2023-24,202403050TOR,3/5/2024,TOR vs NOP,Ochai Agbaji,agbajoc01,61,TOR,1,NOP,3,3,0,0,0,0,15.51666667,1,2,1,4,1,3,0,0,0,0,3,3,6,6,6.6
2023-24,202403050DAL,3/5/2024,DAL vs IND,Dante Exum,exumda01,36,DAL,1,IND,4,2,2,1,0,0,15.53333333,0,2,1,1,0,0,2,2,2,1,4,6,6,8,12.4
2023-24,202403050TOR,3/5/2024,TOR vs NOP,Larry Nance Jr.,nancela02,44,NOP,0,TOR,6,6,2,1,1,1,15.56666667,2,4,3,5,0,0,0,0,3,2,8,8,12,14,21.2
2023-24,202403050CLE,3/5/2024,CLE vs BOS,Luke Kornet,kornelu01,44,BOS,0,CLE,4,3,1,0,2,0,15.63333333,0,3,2,4,0,0,0,0,1,2,4,5,7,8,15.1
2023-24,202403050DEN,3/5/2024,DEN vs PHO,Reggie Jackson,jacksre01,62,DEN,1,PHO,3,2,0,0,0,0,15.86666667,0,2,1,6,1,3,0,0,1,0,2,3,5,5,5.4
2023-24,202403050MIA,3/5/2024,MIA vs DET,James Wiseman,wisemja01,42,DET,0,MIA,6,7,1,0,0,2,16.08333333,3,4,3,4,0,0,0,0,2,0,8,7,13,14,13.9
2023-24,202403050TOR,3/5/2024,TOR vs NOP,Jontay Porter,portejo01,19,TOR,1,NOP,5,3,2,0,1,3,16.4,0,3,2,5,1,3,0,0,1,1,5,7,8,10,11.6
2023-24,202403050CHO,3/5/2024,CHO vs ORL,Joe Ingles,inglejo01,48,ORL,0,CHO,0,2,8,0,0,0,17.15,1,1,0,1,0,1,0,0,1,0,10,8,2,10,14.4
2023-24,202403050DAL,3/5/2024,DAL vs IND,Obi Toppin,toppiob01,64,IND,0,DAL,14,2,0,0,0,1,17.18333333,0,2,5,6,2,3,2,2,1,0,2,14,16,16,15.4
2023-24,202403050HOU,3/5/2024,HOU vs SAS,Zach Collins,colliza01,50,SAS,0,HOU,6,6,1,0,2,3,17.5,2,4,2,4,1,1,1,2,1,2,7,7,12,13,17.7
2023-24,202403050CHO,3/5/2024,CHO vs ORL,Bryce McGowens,mcgowbr01,49,CHO,1,ORL,0,0,1,0,0,1,17.51666667,0,0,0,0,0,0,0,0,1,0,1,1,0,1,0.5
2023-24,202403050CHO,3/5/2024,CHO vs ORL,Jonathan Isaac,isaacjo01,42,ORL,0,CHO,11,6,0,1,1,0,17.53333333,1,5,4,4,1,1,2,3,0,2,6,11,17,17,24.2
2023-24,202403050TOR,3/5/2024,TOR vs NOP,Javon Freeman-Liberty,freemja01,4,TOR,1,NOP,13,3,1,0,0,0,17.63333333,0,3,4,7,1,3,4,5,0,0,4,14,16,17,18.1
2023-24,202403050DAL,3/5/2024,DAL vs IND,T.J. McConnell,mccontj01,53,IND,0,DAL,13,2,7,1,0,1,17.91666667,0,2,5,10,2,2,1,1,4,1,9,20,15,22,27.9
2023-24,202403050CHO,3/5/2024,CHO vs ORL,Moritz Wagner,wagnemo01,60,ORL,0,CHO,11,4,2,0,0,2,18.25,0,4,5,8,1,3,0,0,1,0,6,13,15,17,16.8
2023-24,202403050DAL,3/5/2024,DAL vs IND,Jalen Smith,smithja04,44,IND,0,DAL,11,5,1,0,0,1,18.33333333,2,3,4,7,1,2,2,5,1,0,6,12,16,17,17.5
2023-24,202403050DEN,3/5/2024,DEN vs PHO,Christian Braun,braunch01,62,DEN,1,PHO,7,4,1,1,2,0,18.85,1,3,3,3,0,0,1,2,2,3,5,8,11,12,22.3
2023-24,202403050BRK,3/5/2024,BRK vs PHI,Paul Reed,reedpa01,61,PHI,0,BRK,5,2,2,2,0,0,18.93333333,1,1,2,3,0,0,1,2,1,2,4,7,7,9,16.4
2023-24,202403050HOU,3/5/2024,HOU vs SAS,Amen Thompson,thompam01,42,HOU,1,SAS,2,6,1,1,2,1,19.25,1,5,0,4,0,2,2,4,2,3,7,3,8,9,18.7
2023-24,202403050TOR,3/5/2024,TOR vs NOP,Jordan Nwora,nworajo01,33,TOR,1,NOP,9,6,1,0,1,0,19.8,3,3,4,15,1,6,0,0,0,1,7,10,15,16,20.7
2023-24,202403050CLE,3/5/2024,CLE vs BOS,Al Horford,horfoal01,51,BOS,0,CLE,7,5,0,1,0,1,19.83333333,2,3,3,8,1,4,0,0,1,1,5,7,12,12,15
2023-24,202403050TOR,3/5/2024,TOR vs NOP,Jonas Valanciunas,valanjo01,62,NOP,0,TOR,10,10,1,0,1,2,20.05,1,9,3,6,2,2,2,2,2,1,11,11,20,21,24.5
2023-24,202403050HOU,3/5/2024,HOU vs SAS,Cam Whitmore,whitmca01,35,HOU,1,SAS,19,8,1,1,0,1,20.33333333,4,4,9,16,1,4,0,0,0,1,9,20,27,28,32.1
2023-24,202403050NYK,3/5/2024,NYK vs ATL,Isaiah Hartenstein,harteis01,56,NYK,1,ATL,5,6,2,1,2,0,20.41666667,3,3,2,6,0,0,1,2,2,3,8,7,11,13,24.2
2023-24,202403050TOR,3/5/2024,TOR vs NOP,Naji Marshall,marshna01,50,NOP,0,TOR,11,7,4,1,0,1,20.41666667,3,4,5,10,1,4,0,0,2,1,11,15,18,22,27.4
2023-24,202403050CHO,3/5/2024,CHO vs ORL,Jalen Suggs,suggsja01,57,ORL,0,CHO,4,4,3,1,0,1,20.43333333,0,4,2,4,0,2,0,1,4,1,7,7,8,11,15.3
2023-24,202403050HOU,3/5/2024,HOU vs SAS,Tre Jones,jonestr01,57,SAS,0,HOU,4,4,5,0,0,1,20.85,1,3,2,7,0,3,0,0,0,0,9,9,8,13,15.3
2023-24,202403050DAL,3/5/2024,DAL vs IND,Daniel Gafford,gaffoda01,55,DAL,1,IND,16,10,2,1,3,0,21.05,3,7,7,7,0,0,2,5,2,4,12,18,26,28,43
2023-24,202403050CLE,3/5/2024,CLE vs BOS,Dean Wade,wadede01,52,CLE,1,BOS,23,8,1,2,0,0,21.11666667,2,6,8,11,6,9,1,2,0,2,9,24,31,32,40.1
2023-24,202403050MIA,3/5/2024,MIA vs DET,Nikola Jovic,jovicni01,27,MIA,1,DET,8,4,2,2,0,0,21.36666667,0,4,3,5,1,2,1,2,2,2,6,10,12,14,21.8
2023-24,202403050DEN,3/5/2024,DEN vs PHO,Eric Gordon,gordoer01,51,PHO,0,DEN,4,1,2,2,0,1,21.68333333,1,0,1,7,0,4,2,4,0,2,3,6,5,7,13.2
2023-24,202403050CHO,3/5/2024,CHO vs ORL,Gary Harris,harriga01,39,ORL,0,CHO,9,0,0,3,0,1,21.68333333,0,0,3,4,2,2,1,2,3,3,0,9,9,9,17
2023-24,202403050DAL,3/5/2024,DAL vs IND,Ben Sheppard,sheppbe01,39,IND,0,DAL,12,7,0,1,0,0,21.76666667,1,6,4,7,4,6,0,0,3,1,7,12,19,19,23.4
2023-24,202403050DAL,3/5/2024,DAL vs IND,Aaron Nesmith,nesmiaa01,55,IND,0,DAL,6,1,2,0,0,0,22.18333333,0,1,1,3,1,2,3,4,4,0,3,8,7,9,10.2
2023-24,202403050TOR,3/5/2024,TOR vs NOP,CJ McCollum,mccolcj01,46,NOP,0,TOR,11,4,4,0,0,1,22.5,0,4,4,11,3,9,0,0,2,0,8,15,15,19,20.8
2023-24,202403050NYK,3/5/2024,NYK vs ATL,Bruno Fernando,fernabr01,24,ATL,0,NYK,4,7,0,0,2,7,22.51666667,3,4,2,4,0,0,0,0,4,2,7,4,11,11,11.4
2023-24,202403050BRK,3/5/2024,BRK vs PHI,Cameron Payne,payneca01,57,PHI,0,BRK,15,3,1,1,0,1,22.58333333,0,3,5,10,3,7,2,2,3,1,4,16,18,19,22.1
2023-24,202403050CHO,3/5/2024,CHO vs ORL,Cole Anthony,anthoco01,61,ORL,0,CHO,14,3,3,2,0,2,22.8,0,3,5,11,2,8,2,2,3,2,6,17,17,20,26.1
2023-24,202403050DEN,3/5/2024,DEN vs PHO,Peyton Watson,watsope01,60,DEN,1,PHO,4,4,4,1,2,0,22.88333333,1,3,2,8,0,5,0,0,2,3,8,8,8,12,23.8
2023-24,202403050CLE,3/5/2024,CLE vs BOS,Evan Mobley,mobleev01,38,CLE,1,BOS,4,6,4,2,0,2,22.91666667,1,5,2,8,0,1,0,0,2,2,10,8,10,14,21.2
2023-24,202403050DEN,3/5/2024,DEN vs PHO,Drew Eubanks,eubandr01,56,PHO,0,DEN,10,8,0,0,2,0,23.1,4,4,3,3,0,0,4,4,3,2,8,10,18,18,25.6
2023-24,202403050BRK,3/5/2024,BRK vs PHI,Jalen Wilson,wilsoja03,24,BRK,1,PHI,4,6,2,0,0,0,23.33333333,4,2,2,9,0,4,0,0,0,0,8,6,10,12,14.2
2023-24,202403050TOR,3/5/2024,TOR vs NOP,Jose Alvarado,alvarjo01,41,NOP,0,TOR,5,2,6,3,0,2,23.51666667,0,2,2,7,1,4,0,0,1,3,8,11,7,13,23.4
2023-24,202403050NYK,3/5/2024,NYK vs ATL,Precious Achiuwa,achiupr01,55,NYK,1,ATL,15,6,2,1,1,0,23.71666667,1,5,7,8,0,0,1,1,1,2,8,17,21,23,31.2
2023-24,202403050BRK,3/5/2024,BRK vs PHI,Dennis Smith Jr.,smithde03,46,BRK,1,PHI,7,1,6,3,0,2,23.78333333,0,1,3,6,0,2,1,3,3,3,7,13,8,14,24.2
2023-24,202403050DAL,3/5/2024,DAL vs IND,Andrew Nembhard,nembhan01,49,IND,0,DAL,10,3,5,1,0,1,24.66666667,0,3,4,4,2,2,0,0,2,1,8,15,13,18,23.1
2023-24,202403050DAL,3/5/2024,DAL vs IND,Bennedict Mathurin,mathube01,60,IND,0,DAL,19,0,0,0,0,1,24.96666667,0,0,7,16,2,7,3,3,3,0,0,19,19,19,18
2023-24,202403050NYK,3/5/2024,NYK vs ATL,De'Andre Hunter,huntede01,37,ATL,0,NYK,22,3,0,1,0,0,25.05,0,3,9,14,2,5,2,4,0,1,3,22,25,25,28.6
2023-24,202403050TOR,3/5/2024,TOR vs NOP,Brandon Ingram,ingrabr01,56,NOP,0,TOR,12,3,6,0,0,2,25.1,1,2,5,7,0,1,2,2,3,0,9,18,15,21,22.6
2023-24,202403050HOU,3/5/2024,HOU vs SAS,Jabari Smith Jr.,smithja05,56,HOU,1,SAS,2,3,1,0,1,0,25.23333333,2,1,1,6,0,3,0,0,2,1,4,3,5,6,10.1
2023-24,202403050TOR,3/5/2024,TOR vs NOP,Herbert Jones,joneshe01,57,NOP,0,TOR,17,2,3,2,0,1,25.31666667,0,2,6,10,5,8,0,0,3,2,5,20,19,22,28.9
2023-24,202403050NYK,3/5/2024,NYK vs ATL,Clint Capela,capelca01,53,ATL,0,NYK,13,9,3,0,1,1,25.48333333,3,6,5,11,0,0,3,4,2,1,12,16,22,25,30.3
2023-24,202403050CHO,3/5/2024,CHO vs ORL,Davis Bertans,bertada01,24,CHO,1,ORL,14,6,1,0,0,0,25.55,0,6,5,11,4,10,0,0,0,0,7,15,20,21,22.7
2023-24,202403050DAL,3/5/2024,DAL vs IND,Josh Green,greenjo02,49,DAL,1,IND,6,2,0,1,1,2,25.56666667,1,1,3,7,0,1,0,0,3,2,2,6,8,8,12.4
2023-24,202403050NYK,3/5/2024,NYK vs ATL,Jericho Sims,simsje01,35,NYK,1,ATL,4,9,1,1,0,1,25.71666667,6,3,2,2,0,0,0,0,1,1,10,5,13,14,18.3
2023-24,202403050TOR,3/5/2024,TOR vs NOP,Zion Williamson,willizi01,51,NOP,0,TOR,16,8,9,1,2,1,25.98333333,2,6,7,11,0,0,2,2,0,3,17,25,24,33,47.1
2023-24,202403050HOU,3/5/2024,HOU vs SAS,Malaki Branham,branhma01,57,SAS,0,HOU,20,1,2,0,0,1,26.31666667,0,1,8,14,4,7,0,0,2,0,3,22,21,23,23.2
2023-24,202403050MIA,3/5/2024,MIA vs DET,Jaime Jaquez Jr.,jaqueja01,55,MIA,1,DET,11,6,2,0,0,0,26.61666667,1,5,4,7,1,2,2,2,1,0,8,13,17,19,21.2
2023-24,202403050CLE,3/5/2024,CLE vs BOS,Georges Niang,niangge01,61,CLE,1,BOS,9,1,1,0,0,1,26.88333333,0,1,3,4,3,4,0,0,3,0,2,10,10,11,10.7
2023-24,202403050TOR,3/5/2024,TOR vs NOP,Gradey Dick,dickgr01,41,TOR,1,NOP,2,2,0,1,0,2,27.06666667,1,1,1,7,0,5,0,0,1,1,2,2,4,4,5.4
2023-24,202403050CHO,3/5/2024,CHO vs ORL,Nick Richards,richani01,52,CHO,1,ORL,2,4,0,0,1,2,27.25,0,4,1,2,0,0,0,0,2,1,4,2,6,6,7.8
2023-24,202403050CHO,3/5/2024,CHO vs ORL,Anthony Black,blackan01,56,ORL,0,CHO,10,5,1,0,0,1,27.56666667,1,4,3,5,3,4,1,4,1,0,6,11,15,16,16.5
2023-24,202403050BRK,3/5/2024,BRK vs PHI,Buddy Hield,hieldbu01,64,PHI,0,BRK,13,3,4,1,0,0,27.63333333,0,3,3,9,2,3,5,5,1,1,7,17,16,20,25.6
2023-24,202403050MIA,3/5/2024,MIA vs DET,Caleb Martin,martica02,44,MIA,1,DET,15,6,1,1,0,1,27.65,0,6,5,9,3,6,2,2,2,1,7,16,21,22,25.7
2023-24,202403050DAL,3/5/2024,DAL vs IND,Myles Turner,turnemy01,60,IND,0,DAL,20,4,2,0,0,0,27.65,0,4,7,14,1,5,5,6,1,0,6,22,24,26,27.8
2023-24,202403050TOR,3/5/2024,TOR vs NOP,Kelly Olynyk,olynyke01,60,TOR,1,NOP,15,6,7,2,2,1,28.21666667,2,4,4,9,1,3,6,7,2,4,13,22,21,28,43.7
2023-24,202403050CHO,3/5/2024,CHO vs ORL,Vasilije Micic,micicva01,41,CHO,1,ORL,21,5,4,2,0,4,28.95,2,3,8,15,1,4,4,4,2,2,9,25,26,30,35
2023-24,202403050CHO,3/5/2024,CHO vs ORL,Wendell Carter Jr.,cartewe01,36,ORL,0,CHO,12,9,1,1,0,1,28.98333333,4,5,5,7,2,4,0,0,1,1,10,13,21,22,26.3
2023-24,202403050TOR,3/5/2024,TOR vs NOP,Gary Trent Jr.,trentga02,57,TOR,1,NOP,16,3,1,1,0,1,29.06666667,0,3,6,12,4,10,0,0,1,1,4,17,19,20,23.1
2023-24,202403050MIA,3/5/2024,MIA vs DET,Simone Fontecchio,fontesi01,60,DET,0,MIA,22,4,2,1,0,1,29.18333333,0,4,7,16,5,12,3,3,1,1,6,24,26,28,31.8
2023-24,202403050MIA,3/5/2024,MIA vs DET,Jaden Ivey,iveyja01,57,DET,0,MIA,16,2,4,1,1,2,29.23333333,0,2,6,15,0,5,4,5,1,2,6,20,18,22,28.4
2023-24,202403050TOR,3/5/2024,TOR vs NOP,Trey Murphy III,murphtr02,37,NOP,0,TOR,34,6,1,1,0,0,29.25,2,4,11,17,10,14,2,4,0,1,7,35,40,41,45.7
2023-24,202403050BRK,3/5/2024,BRK vs PHI,Lonnie Walker IV,walkelo01,42,BRK,1,PHI,19,4,1,1,0,1,29.7,0,4,7,14,4,6,1,2,4,1,5,20,23,24,27.3
2023-24,202403050CLE,3/5/2024,CLE vs BOS,Caris LeVert,leverca01,49,CLE,1,BOS,10,4,5,3,0,2,29.8,0,4,4,10,2,5,0,0,1,3,9,15,14,19,29.3
2023-24,202403050DEN,3/5/2024,DEN vs PHO,Jusuf Nurkic,nurkiju01,58,PHO,0,DEN,7,12,6,2,2,3,29.9,1,11,3,4,0,0,1,2,6,4,18,13,19,25,39.4
2023-24,202403050CHO,3/5/2024,CHO vs ORL,Franz Wagner,wagnefr01,54,ORL,0,CHO,8,3,2,1,0,4,30.08333333,1,2,4,11,0,5,0,1,1,1,5,10,11,13,13.6
2023-24,202403050CLE,3/5/2024,CLE vs BOS,Sam Merrill,merrisa01,43,CLE,1,BOS,6,4,1,1,0,0,30.4,0,4,2,7,2,6,0,0,1,1,5,7,10,11,15.3
2023-24,202403050NYK,3/5/2024,NYK vs ATL,Bogdan Bogdanovic,bogdabo01,59,ATL,0,NYK,5,1,4,2,1,3,30.43333333,0,1,1,6,1,6,2,2,0,3,5,9,6,10,18.2
2023-24,202403050HOU,3/5/2024,HOU vs SAS,Victor Wembanyama,wembavi01,56,SAS,0,HOU,10,11,3,0,7,6,30.5,2,9,4,10,2,5,0,0,4,7,14,13,21,24,42.7
2023-24,202403050NYK,3/5/2024,NYK vs ATL,Bojan Bogdanovic,bogdabo02,37,NYK,1,ATL,19,3,0,0,0,2,30.96666667,1,2,6,18,4,11,3,3,5,0,3,19,22,22,20.6
2023-24,202403050BRK,3/5/2024,BRK vs PHI,Dorian Finney-Smith,finnedo01,53,BRK,1,PHI,20,8,2,0,0,1,31.2,3,5,8,11,4,7,0,0,0,0,10,22,28,30,31.6
2023-24,202403050CLE,3/5/2024,CLE vs BOS,Isaac Okoro,okorois01,52,CLE,1,BOS,16,4,1,1,2,0,31.33333333,0,4,5,11,4,8,2,4,1,3,5,17,20,21,31.3
2023-24,202403050DAL,3/5/2024,DAL vs IND,Tyrese Haliburton,halibty01,51,IND,0,DAL,19,6,11,0,1,2,31.6,1,5,8,15,3,10,0,0,2,1,17,30,25,36,43.7
2023-24,202403050MIA,3/5/2024,MIA vs DET,Jalen Duren,durenja01,46,DET,0,MIA,14,10,3,0,0,2,31.91666667,4,6,5,5,0,0,4,4,5,0,13,17,24,27,28.5
2023-24,202403050DAL,3/5/2024,DAL vs IND,Pascal Siakam,siakapa01,61,IND,0,DAL,13,13,6,0,1,1,31.93333333,5,8,5,11,0,0,3,3,0,1,19,19,26,32,39.6
2023-24,202403050TOR,3/5/2024,TOR vs NOP,RJ Barrett,barrerj01,51,TOR,1,NOP,15,6,1,0,2,3,31.98333333,0,6,7,14,0,2,1,5,3,2,7,16,21,22,26.7
2023-24,202403050MIA,3/5/2024,MIA vs DET,Terry Rozier,roziete01,44,MIA,1,DET,17,2,7,0,0,3,32.01666667,0,2,7,17,3,6,0,0,2,0,9,24,19,26,26.9
2023-24,202403050CLE,3/5/2024,CLE vs BOS,Kristaps Porzingis,porzikr01,45,BOS,0,CLE,24,9,3,2,3,1,32.03333333,2,7,9,18,3,6,3,3,2,5,12,27,33,36,53.3
2023-24,202403050BRK,3/5/2024,BRK vs PHI,Nicolas Batum,batumni01,41,PHI,0,BRK,2,7,4,0,1,1,32.31666667,2,5,1,6,0,3,0,0,2,1,11,6,9,13,18.4
2023-24,202403050BRK,3/5/2024,BRK vs PHI,Nic Claxton,claxtni01,52,BRK,1,PHI,17,10,2,0,4,2,32.63333333,0,10,6,8,0,0,5,6,3,4,12,19,27,29,42
2023-24,202403050CHO,3/5/2024,CHO vs ORL,Grant Williams,willigr01,58,CHO,1,ORL,9,2,3,0,0,3,32.78333333,0,2,2,4,0,1,5,5,5,0,5,12,11,14,12.9
2023-24,202403050TOR,3/5/2024,TOR vs NOP,Immanuel Quickley,quickim01,57,TOR,1,NOP,17,7,7,1,0,1,33.18333333,1,6,6,14,4,7,1,3,2,1,14,24,24,31,37.9
2023-24,202403050CHO,3/5/2024,CHO vs ORL,Paolo Banchero,banchpa01,60,ORL,0,CHO,22,5,3,0,0,5,33.21666667,0,5,9,19,2,5,2,2,1,0,8,25,27,30,27.5
2023-24,202403050HOU,3/5/2024,HOU vs SAS,Keldon Johnson,johnske04,58,SAS,0,HOU,18,6,2,0,0,1,33.58333333,1,5,5,12,3,5,5,6,1,0,8,20,24,26,27.2
2023-24,202403050HOU,3/5/2024,HOU vs SAS,Jeremy Sochan,sochaje01,62,SAS,0,HOU,15,8,3,0,0,2,33.6,3,5,5,14,1,6,4,4,2,0,11,18,23,26,27.1
2023-24,202403050MIA,3/5/2024,MIA vs DET,Cade Cunningham,cunnica01,51,DET,0,MIA,23,4,8,0,0,3,33.9,1,3,8,20,4,8,3,3,2,0,12,31,27,35,36.8
2023-24,202403050DEN,3/5/2024,DEN vs PHO,Aaron Gordon,gordoaa01,56,DEN,1,PHO,7,3,3,0,0,1,34.15,1,2,3,10,1,3,0,1,2,0,6,10,10,13,14.1
2023-24,202403050BRK,3/5/2024,BRK vs PHI,Dennis Schroder,schrode01,62,BRK,1,PHI,20,2,8,0,1,5,34.18333333,1,1,7,12,1,3,5,7,2,1,10,28,22,30,32.4
2023-24,202403050CHO,3/5/2024,CHO vs ORL,Tre Mann,manntr01,24,CHO,1,ORL,18,6,4,2,0,2,34.41666667,0,6,7,9,2,4,2,2,2,2,10,22,24,28,35.2
2023-24,202403050MIA,3/5/2024,MIA vs DET,Ausar Thompson,thompau01,61,DET,0,MIA,9,6,2,0,2,0,34.41666667,0,6,3,7,0,2,3,4,0,2,8,11,15,17,25.2
2023-24,202403050MIA,3/5/2024,MIA vs DET,Bam Adebayo,adebaba01,51,MIA,1,DET,18,7,1,1,1,1,35.18333333,2,5,8,17,0,0,2,3,2,2,8,19,25,26,32.9
2023-24,202403050CLE,3/5/2024,CLE vs BOS,Jarrett Allen,allenja01,56,CLE,1,BOS,21,12,2,0,1,0,35.28333333,4,8,9,16,0,0,3,3,0,1,14,23,33,35,41.4
2023-24,202403050CLE,3/5/2024,CLE vs BOS,Derrick White,whitede01,57,BOS,0,CLE,3,6,7,0,4,2,35.28333333,2,4,1,5,0,2,1,1,0,4,13,10,9,16,30.7
2023-24,202403050NYK,3/5/2024,NYK vs ATL,Saddiq Bey,beysa01,60,ATL,0,NYK,17,9,2,1,1,1,35.9,4,5,6,15,1,7,4,4,0,2,11,19,26,28,35.8
2023-24,202403050CHO,3/5/2024,CHO vs ORL,Miles Bridges,bridgmi02,51,CHO,1,ORL,7,3,3,2,0,3,35.96666667,1,2,3,16,1,6,0,0,4,2,6,10,10,13,18.1
2023-24,202403050BRK,3/5/2024,BRK vs PHI,Kyle Lowry,lowryky01,43,PHI,0,BRK,14,2,5,1,0,3,36.01666667,0,2,5,9,4,7,0,0,6,1,7,19,16,21,23.9
2023-24,202403050BRK,3/5/2024,BRK vs PHI,Kelly Oubre Jr.,oubreke01,48,PHI,0,BRK,30,6,4,0,0,1,36.08333333,1,5,11,20,2,5,6,8,4,0,10,34,36,40,42.2
2023-24,202403050CLE,3/5/2024,CLE vs BOS,Jrue Holiday,holidjr01,56,BOS,0,CLE,12,4,5,2,0,4,36.21666667,2,2,5,9,2,6,0,0,1,2,9,17,16,21,26.3
2023-24,202403050DEN,3/5/2024,DEN vs PHO,Bradley Beal,bealbr01,33,PHO,0,DEN,16,6,6,2,0,2,36.23333333,1,5,6,18,2,5,2,2,4,2,12,22,22,28,36.2
2023-24,202403050HOU,3/5/2024,HOU vs SAS,Dillon Brooks,brookdi01,52,HOU,1,SAS,0,3,2,2,0,0,36.26666667,0,3,0,3,0,2,0,0,2,2,5,2,3,5,12.6
2023-24,202403050MIA,3/5/2024,MIA vs DET,Duncan Robinson,robindu01,56,MIA,1,DET,18,3,4,1,1,0,36.28333333,0,3,6,11,4,9,2,2,3,2,7,22,21,25,33.6
2023-24,202403050CLE,3/5/2024,CLE vs BOS,Darius Garland,garlada01,37,CLE,1,BOS,16,1,11,2,0,3,36.31666667,0,1,6,20,3,8,1,2,2,2,12,27,17,28,36.7
2023-24,202403050DAL,3/5/2024,DAL vs IND,Kyrie Irving,irvinky01,40,DAL,1,IND,23,7,3,0,0,0,36.36666667,2,5,8,19,3,9,4,4,3,0,10,26,30,33,35.9
2023-24,202403050MIA,3/5/2024,MIA vs DET,Isaiah Stewart,stewais01,39,DET,0,MIA,13,6,2,1,0,0,36.36666667,2,4,5,9,1,4,2,2,1,1,8,15,19,21,26.2
2023-24,202403050CLE,3/5/2024,CLE vs BOS,Jaylen Brown,brownja02,56,BOS,0,CLE,21,3,4,0,0,1,36.58333333,2,1,8,20,3,7,2,2,3,0,7,25,24,28,29.6
2023-24,202403050MIA,3/5/2024,MIA vs DET,Jimmy Butler,butleji01,42,MIA,1,DET,26,6,8,2,0,2,36.66666667,2,4,7,13,1,3,11,12,1,2,14,34,32,40,49.2
2023-24,202403050HOU,3/5/2024,HOU vs SAS,Alperen Sengun,sengual01,60,HOU,1,SAS,45,16,3,5,1,2,36.95,6,10,19,32,2,3,5,7,3,6,19,48,61,64,84.7
2023-24,202403050NYK,3/5/2024,NYK vs ATL,Dejounte Murray,murrade01,58,ATL,0,NYK,21,9,6,1,0,1,36.96666667,1,8,7,17,4,9,3,4,0,1,15,27,30,36,42.8
2023-24,202403050DAL,3/5/2024,DAL vs IND,P.J. Washington,washipj01,54,DAL,1,IND,20,7,3,1,1,0,37.06666667,1,6,7,12,4,8,2,2,1,2,10,23,27,30,38.9
2023-24,202403050BRK,3/5/2024,BRK vs PHI,Tobias Harris,harrito02,55,PHI,0,BRK,18,9,4,0,0,2,37.38333333,1,8,8,16,1,3,1,2,0,0,13,22,27,31,32.8
2023-24,202403050CLE,3/5/2024,CLE vs BOS,Jayson Tatum,tatumja01,58,BOS,0,CLE,26,13,2,0,0,2,37.51666667,2,11,8,21,5,9,5,6,3,0,15,28,39,41,42.6
2023-24,202403050CHO,3/5/2024,CHO vs ORL,Brandon Miller,millebr02,55,CHO,1,ORL,18,5,3,1,0,4,37.56666667,0,5,7,15,4,8,0,0,3,1,8,21,23,26,27.5
2023-24,202403050HOU,3/5/2024,HOU vs SAS,Fred VanVleet,vanvlfr01,54,HOU,1,SAS,21,4,10,4,0,1,37.61666667,0,4,8,15,5,9,0,0,1,4,14,31,25,35,51.8
2023-24,202403050BRK,3/5/2024,BRK vs PHI,Mikal Bridges,bridgmi01,62,BRK,1,PHI,15,6,4,0,0,1,38.16666667,0,6,4,12,2,3,5,5,2,0,10,19,21,25,27.2
2023-24,202403050NYK,3/5/2024,NYK vs ATL,Jalen Johnson,johnsja05,47,ATL,0,NYK,26,9,7,1,0,1,38.23333333,1,8,12,17,2,3,0,0,4,1,16,33,35,42,49.3
2023-24,202403050DEN,3/5/2024,DEN vs PHO,Kentavious Caldwell-Pope,caldwke01,56,DEN,1,PHO,11,5,3,2,2,1,38.35,0,5,4,6,3,3,0,0,2,4,8,14,16,19,32.5
2023-24,202403050NYK,3/5/2024,NYK vs ATL,Donte DiVincenzo,divindo01,61,NYK,1,ATL,21,4,6,2,0,4,38.66666667,0,4,7,24,5,17,2,2,2,2,10,27,25,31,36.8
2023-24,202403050HOU,3/5/2024,HOU vs SAS,Jalen Green,greenja05,61,HOU,1,SAS,23,2,3,1,0,0,38.78333333,0,2,11,23,1,10,0,0,1,1,5,26,25,28,32.9
2023-24,202403050DEN,3/5/2024,DEN vs PHO,Royce O'Neale,onealro01,59,PHO,0,DEN,8,5,6,0,0,1,39.03333333,1,4,3,9,2,5,0,0,2,0,11,14,13,19,22
2023-24,202403050HOU,3/5/2024,HOU vs SAS,Devin Vassell,vassede01,57,SAS,0,HOU,22,8,3,0,1,3,39.6,2,6,9,19,1,5,3,4,1,1,11,25,30,33,36.1
2023-24,202403050DEN,3/5/2024,DEN vs PHO,Michael Porter Jr.,portemi01,61,DEN,1,PHO,20,7,0,1,0,2,39.7,0,7,8,18,4,12,0,0,3,1,7,20,27,27,29.4
2023-24,202403050DEN,3/5/2024,DEN vs PHO,Grayson Allen,allengr01,56,PHO,0,DEN,28,5,4,3,0,0,40.63333333,1,4,9,15,8,12,2,2,1,3,9,32,33,37,49
2023-24,202403050DEN,3/5/2024,DEN vs PHO,Jamal Murray,murraja01,46,DEN,1,PHO,28,7,9,1,0,3,42.2,3,4,12,25,2,6,2,2,0,1,16,37,35,44,49.9
2023-24,202403050DAL,3/5/2024,DAL vs IND,Luka Doncic,doncilu01,54,DAL,1,IND,39,10,11,0,0,5,42.8,0,10,15,30,4,13,5,6,4,0,21,50,49,60,62.5
2023-24,202403050NYK,3/5/2024,NYK vs ATL,Josh Hart,hartjo01,61,NYK,1,ATL,14,8,6,1,2,3,43.18333333,3,5,5,12,3,7,1,2,2,3,14,20,22,28,38.6
2023-24,202403050DEN,3/5/2024,DEN vs PHO,Kevin Durant,duranke01,55,PHO,0,DEN,35,8,5,0,2,2,43.78333333,0,8,14,34,3,8,4,5,1,2,13,40,43,48,56.1
2023-24,202403050DEN,3/5/2024,DEN vs PHO,Nikola Jokic,jokicni01,60,DEN,1,PHO,25,16,5,0,0,7,44.26666667,3,13,8,18,4,7,5,7,2,0,21,30,41,46,44.7
2023-24,202403050NYK,3/5/2024,NYK vs ATL,Miles McBride,mcbrimi01,49,NYK,1,ATL,11,2,9,1,1,1,45.63333333,2,0,4,15,3,10,0,0,5,2,11,20,13,22,31.9
2023-24,202403040MIL,3/4/2024,MIL vs LAC,Bones Hyland,hylanbo01,22,LAC,0,MIL,5,1,1,0,0,1,10.78333333,0,1,2,4,1,2,0,0,1,0,2,6,6,7,6.7
2023-24,202403040SAC,3/4/2024,SAC vs CHI,Jevon Carter,carteje01,58,CHI,0,SAC,0,1,2,0,0,0,11.41666667,0,1,0,3,0,1,0,0,0,0,3,2,1,3,4.2
2023-24,202403040LAL,3/4/2024,LAL vs OKC,Mike Muscala,muscami01,38,OKC,0,LAL,5,3,0,0,0,0,11.48333333,0,3,2,5,1,3,0,0,0,0,3,5,8,8,8.6
2023-24,202403040BRK,3/4/2024,BRK vs MEM,Jalen Wilson,wilsoja03,23,BRK,1,MEM,5,5,1,0,0,1,11.78333333,2,3,1,1,1,1,2,2,2,0,6,6,10,11,11.5
2023-24,202403040SAC,3/4/2024,SAC vs CHI,Onuralp Bitim,bitimon01,5,CHI,0,SAC,1,1,1,0,1,1,12.68333333,1,0,0,3,0,2,1,2,1,1,2,2,2,3,5.7
2023-24,202403040SAC,3/4/2024,SAC vs CHI,Chris Duarte,duartch01,43,SAC,1,CHI,8,5,0,0,0,0,12.83333333,1,4,3,4,2,3,0,0,2,0,5,8,13,13,14
2023-24,202403040LAL,3/4/2024,LAL vs OKC,Cam Reddish,reddica01,40,LAL,1,OKC,0,2,0,0,0,0,13,0,2,0,1,0,0,0,0,1,0,2,0,2,2,2.4
2023-24,202403040LAL,3/4/2024,LAL vs OKC,Isaiah Joe,joeis01,57,OKC,0,LAL,0,2,0,0,1,0,13.68333333,0,2,0,4,0,3,0,0,0,1,2,0,2,2,5.4
2023-24,202403040BRK,3/4/2024,BRK vs MEM,Lonnie Walker IV,walkelo01,41,BRK,1,MEM,13,1,1,1,2,0,13.7,0,1,5,10,3,6,0,0,3,3,2,14,14,15,24.7
2023-24,202403040BRK,3/4/2024,BRK vs MEM,Day'Ron Sharpe,sharpda01,46,BRK,1,MEM,4,3,1,1,0,1,13.91666667,1,2,1,3,0,1,2,4,1,1,4,5,7,8,11.1
2023-24,202403040UTA,3/4/2024,UTA vs WAS,Taylor Hendricks,hendrita0,23,UTA,1,WAS,8,2,1,0,0,0,14.21666667,0,2,3,3,2,2,0,0,3,0,3,9,10,11,11.9
2023-24,202403040SAC,3/4/2024,SAC vs CHI,Julian Phillips,phillju01,35,CHI,0,SAC,6,1,0,0,0,1,14.28333333,0,1,2,4,0,1,2,2,0,0,1,6,7,7,6.2
2023-24,202403040LAL,3/4/2024,LAL vs OKC,Gordon Hayward,haywago01,32,OKC,0,LAL,2,1,2,0,0,0,14.48333333,0,1,1,5,0,1,0,0,2,0,3,4,3,5,6.2
2023-24,202403040MIL,3/4/2024,MIL vs LAC,Daniel Theis,theisda01,45,LAC,0,MIL,7,6,1,0,0,0,15.31666667,0,6,3,6,1,2,0,0,0,0,7,8,13,14,15.7
2023-24,202403040UTA,3/4/2024,UTA vs WAS,Talen Horton-Tucker,hortota01,39,UTA,1,WAS,9,1,3,0,0,0,15.46666667,0,1,4,9,1,3,0,1,0,0,4,12,10,13,14.7
2023-24,202403040UTA,3/4/2024,UTA vs WAS,Corey Kispert,kispeco01,59,WAS,0,UTA,5,4,1,0,0,3,16.11666667,0,4,2,9,1,6,0,0,1,0,5,6,9,10,8.3
2023-24,202403040SAC,3/4/2024,SAC vs CHI,Andre Drummond,drumman01,61,CHI,0,SAC,4,6,0,0,0,0,16.23333333,0,6,2,5,0,0,0,0,5,0,6,4,10,10,11.2
2023-24,202403040LAL,3/4/2024,LAL vs OKC,Aaron Wiggins,wiggiaa01,58,OKC,0,LAL,12,1,1,1,1,1,16.46666667,1,0,4,8,2,3,2,2,1,2,2,13,13,14,19.7
2023-24,202403040MIL,3/4/2024,MIL vs LAC,Danilo Gallinari,gallida01,38,MIL,1,LAC,4,2,3,0,0,1,16.56666667,1,1,1,2,0,1,2,2,1,0,5,7,6,9,9.9
2023-24,202403040BRK,3/4/2024,BRK vs MEM,Dennis Smith Jr.,smithde03,45,BRK,1,MEM,5,1,0,2,1,1,17.23333333,1,0,2,5,1,3,0,0,1,3,1,5,6,6,14.2
2023-24,202403040MIL,3/4/2024,MIL vs LAC,Pat Connaughton,connapa01,56,MIL,1,LAC,8,1,0,0,0,1,17.36666667,0,1,2,3,1,2,3,4,1,0,1,8,9,9,8.2
2023-24,202403040LAL,3/4/2024,LAL vs OKC,Jaxson Hayes,hayesja02,53,LAL,1,OKC,4,6,2,1,1,1,17.78333333,4,2,2,3,0,1,0,0,0,2,8,6,10,12,19.2
2023-24,202403040UTA,3/4/2024,UTA vs WAS,Landry Shamet,shamela01,44,WAS,0,UTA,2,1,0,0,0,1,17.8,0,1,1,2,0,1,0,0,1,0,1,2,3,3,2.2
2023-24,202403040MIL,3/4/2024,MIL vs LAC,Jae Crowder,crowdja01,31,MIL,1,LAC,3,2,1,0,0,0,18.05,2,0,1,4,1,3,0,0,1,0,3,4,5,6,6.9
2023-24,202403040BRK,3/4/2024,BRK vs MEM,Trey Jemison,jemistr01,11,MEM,0,BRK,10,7,0,0,1,1,18.81666667,1,6,5,6,0,0,0,0,6,1,7,10,17,17,20.4
2023-24,202403040MIL,3/4/2024,MIL vs LAC,Terance Mann,mannte01,54,LAC,0,MIL,4,3,1,0,0,1,19.21666667,0,3,1,4,0,0,2,2,3,0,4,5,7,8,8.1
2023-24,202403040MIN,3/4/2024,MIN vs POR,Monte Morris,morrimo01,16,MIN,1,POR,5,1,7,1,0,1,19.28333333,1,0,2,8,0,2,1,1,0,1,8,12,6,13,18.7
2023-24,202403040MIN,3/4/2024,MIN vs POR,Ashton Hagans,haganas01,10,POR,0,MIN,0,3,4,3,0,3,19.7,0,3,0,1,0,0,0,0,4,3,7,4,3,7,15.6
2023-24,202403040UTA,3/4/2024,UTA vs WAS,Johnny Juzang,juzanjo01,4,UTA,1,WAS,10,4,1,0,0,0,20.15,1,3,4,8,2,5,0,0,1,0,5,11,14,15,16.3
2023-24,202403040SAC,3/4/2024,SAC vs CHI,Trey Lyles,lylestr01,45,SAC,1,CHI,9,3,1,0,1,1,20.9,1,2,3,10,1,6,2,2,3,1,4,10,12,13,16.1
2023-24,202403040UTA,3/4/2024,UTA vs WAS,Brice Sensabaugh,sensabr01,12,UTA,1,WAS,7,2,2,0,0,1,20.96666667,0,2,3,9,1,5,0,0,1,0,4,9,9,11,11.4
2023-24,202403040BRK,3/4/2024,BRK vs MEM,Matthew Hurt,hurtma01,7,MEM,0,BRK,5,5,0,1,0,1,21.16666667,3,2,2,7,1,6,0,0,2,1,5,5,10,10,13
2023-24,202403040MIN,3/4/2024,MIN vs POR,Karl-Anthony Towns,townska01,60,MIN,1,POR,14,4,1,0,2,1,21.31666667,2,2,5,12,0,3,4,6,4,2,5,15,18,19,25.3
2023-24,202403040MIN,3/4/2024,MIN vs POR,Nickeil Alexander-Walker,alexani01,62,MIN,1,POR,13,1,1,2,0,0,21.36666667,0,1,4,6,3,5,2,2,1,2,2,14,14,15,21.7
2023-24,202403040LAL,3/4/2024,LAL vs OKC,Rui Hachimura,hachiru01,50,LAL,1,OKC,7,1,1,0,0,2,21.56666667,1,0,3,8,1,3,0,2,3,0,2,8,8,9,7.7
2023-24,202403040LAL,3/4/2024,LAL vs OKC,Taurean Prince,princta02,61,LAL,1,OKC,14,6,1,0,1,1,21.85,0,6,5,7,4,6,0,0,4,1,7,15,20,21,24.7
2023-24,202403040LAL,3/4/2024,LAL vs OKC,Cason Wallace,wallaca01,61,OKC,0,LAL,7,4,1,3,0,1,22.03333333,2,2,3,8,1,4,0,0,1,3,5,8,11,12,21.3
2023-24,202403040MIL,3/4/2024,MIL vs LAC,A.J. Green,greenaj01,41,MIL,1,LAC,6,2,3,0,0,1,22.28333333,0,2,2,4,2,4,0,0,0,0,5,9,8,11,11.9
2023-24,202403040MIN,3/4/2024,MIN vs POR,Naz Reid,reidna01,62,MIN,1,POR,12,5,0,0,1,1,22.98333333,0,5,4,5,4,4,0,2,0,1,5,12,17,17,20
2023-24,202403040UTA,3/4/2024,UTA vs WAS,Luka Samanic,samanlu01,30,UTA,1,WAS,5,2,2,1,2,0,23.01666667,0,2,2,9,1,5,0,0,0,3,4,7,7,9,19.4
2023-24,202403040SAC,3/4/2024,SAC vs CHI,Kevin Huerter,huertke01,58,SAC,1,CHI,12,3,2,1,0,2,23.05,2,1,5,9,2,3,0,0,1,1,5,14,15,17,19.6
2023-24,202403040UTA,3/4/2024,UTA vs WAS,Marvin Bagley III,baglema01,44,WAS,0,UTA,6,9,4,1,0,2,23.06666667,2,7,2,7,0,0,2,2,0,1,13,10,15,19,23.8
2023-24,202403040MIN,3/4/2024,MIN vs POR,Rayan Rupert,ruperra01,19,POR,0,MIN,13,6,0,0,0,1,23.36666667,1,5,5,7,3,3,0,0,3,0,6,13,19,19,19.2
2023-24,202403040LAL,3/4/2024,LAL vs OKC,Luguentz Dort,dortlu01,59,OKC,0,LAL,15,2,2,1,0,0,23.68333333,1,1,5,9,5,7,0,0,3,1,4,17,17,19,23.4
2023-24,202403040MIL,3/4/2024,MIL vs LAC,Ivica Zubac,zubaciv01,48,LAC,0,MIL,6,11,4,0,0,2,23.68333333,4,7,2,4,0,0,2,2,3,0,15,10,17,21,23.2
2023-24,202403040MIN,3/4/2024,MIN vs POR,Jaden McDaniels,mcdanja02,52,MIN,1,POR,9,4,1,0,0,0,23.78333333,2,2,3,7,0,3,3,6,2,0,5,10,13,14,15.3
2023-24,202403040BRK,3/4/2024,BRK vs MEM,GG Jackson II,jacksgg01,29,MEM,0,BRK,7,2,1,0,1,2,24.03333333,1,1,2,9,1,4,2,2,1,1,3,8,9,10,11.9
2023-24,202403040BRK,3/4/2024,BRK vs MEM,Lamar Stevens,stevela01,28,MEM,0,BRK,13,6,1,0,1,0,24.18333333,2,4,6,12,0,3,1,3,2,1,7,14,19,20,24.7
2023-24,202403040LAL,3/4/2024,LAL vs OKC,Spencer Dinwiddie,dinwisp01,57,LAL,1,OKC,2,2,3,0,1,1,24.28333333,0,2,1,4,0,2,0,0,0,1,5,5,4,7,10.9
2023-24,202403040SAC,3/4/2024,SAC vs CHI,Harrison Barnes,barneha02,60,SAC,1,CHI,10,1,1,1,0,0,24.71666667,1,0,3,7,1,4,3,4,0,1,2,11,11,12,15.7
2023-24,202403040MIL,3/4/2024,MIL vs LAC,Amir Coffey,coffeam01,48,LAC,0,MIL,4,1,1,1,0,1,26.11666667,0,1,2,6,0,2,0,0,2,1,2,5,5,6,8.7
2023-24,202403040LAL,3/4/2024,LAL vs OKC,Jalen Williams,willija06,55,OKC,0,LAL,7,2,3,1,0,1,26.15,0,2,2,9,1,3,2,2,2,1,5,10,9,12,15.9
2023-24,202403040BRK,3/4/2024,BRK vs MEM,Luke Kennard,kennalu01,31,MEM,0,BRK,25,2,7,0,0,5,26.8,0,2,8,11,6,9,3,3,0,0,9,32,27,34,32.9
2023-24,202403040UTA,3/4/2024,UTA vs WAS,Kris Dunn,dunnkr01,54,UTA,1,WAS,4,5,4,2,1,3,27.88333333,1,4,2,5,0,2,0,0,2,3,9,8,9,13,22
2023-24,202403040LAL,3/4/2024,LAL vs OKC,Chet Holmgren,holmgch01,61,OKC,0,LAL,15,7,1,0,1,0,28.16666667,3,4,6,14,2,6,1,1,0,1,8,16,22,23,27.9
2023-24,202403040MIN,3/4/2024,MIN vs POR,Jabari Walker,walkeja01,56,POR,0,MIN,4,8,1,0,0,0,28.38333333,1,7,2,9,0,3,0,0,5,0,9,5,12,13,15.1
2023-24,202403040BRK,3/4/2024,BRK vs MEM,Jake LaRavia,laravja01,17,MEM,0,BRK,14,10,3,2,0,3,28.63333333,4,6,4,12,0,4,6,8,4,2,13,17,24,27,33.5
2023-24,202403040MIN,3/4/2024,MIN vs POR,Mike Conley,conlemi01,57,MIN,1,POR,19,2,7,3,0,2,28.71666667,2,0,6,13,2,6,5,5,1,3,9,26,21,28,38.9
2023-24,202403040LAL,3/4/2024,LAL vs OKC,Josh Giddey,giddejo01,60,OKC,0,LAL,13,5,4,1,1,3,28.81666667,2,3,6,10,1,2,0,0,2,2,9,17,18,22,28
2023-24,202403040MIN,3/4/2024,MIN vs POR,Kyle Anderson,anderky01,60,MIN,1,POR,9,3,5,1,1,1,28.83333333,0,3,3,8,1,2,2,2,1,2,8,14,12,17,25.1
2023-24,202403040UTA,3/4/2024,UTA vs WAS,Jordan Poole,poolejo01,59,WAS,0,UTA,32,1,2,2,1,3,28.86666667,0,1,11,18,6,10,4,4,2,3,3,34,33,35,42.2
2023-24,202403040LAL,3/4/2024,LAL vs OKC,Austin Reaves,reaveau01,64,LAL,1,OKC,16,6,7,1,0,5,29.11666667,1,5,6,8,4,5,0,0,1,1,13,23,22,29,31.7
2023-24,202403040MIL,3/4/2024,MIL vs LAC,Malik Beasley,beaslma01,60,MIL,1,LAC,5,4,2,3,0,1,29.16666667,1,3,2,11,1,7,0,0,5,3,6,7,9,11,20.8
2023-24,202403040LAL,3/4/2024,LAL vs OKC,Shai Gilgeous-Alexander,gilgesh01,60,OKC,0,LAL,20,7,4,4,2,4,29.6,2,5,5,13,1,2,9,9,3,6,11,24,27,31,48.4
2023-24,202403040MIL,3/4/2024,MIL vs LAC,Bobby Portis,portibo01,62,MIL,1,LAC,28,16,2,0,0,1,29.95,1,15,12,18,2,3,2,2,4,0,18,30,44,46,49.2
2023-24,202403040UTA,3/4/2024,UTA vs WAS,Tyus Jones,jonesty01,61,WAS,0,UTA,21,5,6,1,0,0,30,1,4,8,11,5,8,0,0,1,1,11,27,26,32,39
2023-24,202403040LAL,3/4/2024,LAL vs OKC,Anthony Davis,davisan02,60,LAL,1,OKC,24,12,4,1,3,2,30.21666667,4,8,7,12,0,0,10,11,1,4,16,28,36,40,54.4
2023-24,202403040SAC,3/4/2024,SAC vs CHI,Malik Monk,monkma01,59,SAC,1,CHI,11,4,6,0,0,1,30.36666667,1,3,4,12,2,7,1,1,3,0,10,17,15,21,23.8
2023-24,202403040BRK,3/4/2024,BRK vs MEM,John Konchar,konchjo01,47,MEM,0,BRK,9,8,4,1,0,2,30.68333333,2,6,2,3,1,1,4,4,3,1,12,13,17,21,25.6
2023-24,202403040MIL,3/4/2024,MIL vs LAC,Brook Lopez,lopezbr01,59,MIL,1,LAC,6,6,3,0,2,0,30.75,1,5,1,4,1,2,3,6,3,2,9,9,12,15,23.7
2023-24,202403040LAL,3/4/2024,LAL vs OKC,LeBron James,jamesle01,56,LAL,1,OKC,19,11,8,1,0,3,30.98333333,1,10,7,14,1,3,4,5,1,1,19,27,30,38,44.2
2023-24,202403040SAC,3/4/2024,SAC vs CHI,Domantas Sabonis,sabondo01,60,SAC,1,CHI,18,21,4,2,0,5,31.6,10,11,7,19,0,1,4,4,6,2,25,22,39,43,50.2
2023-24,202403040BRK,3/4/2024,BRK vs MEM,Santi Aldama,aldamsa01,50,MEM,0,BRK,12,5,4,0,0,2,31.73333333,1,4,5,11,2,6,0,0,1,0,9,16,17,21,22
2023-24,202403040SAC,3/4/2024,SAC vs CHI,Nikola Vucevic,vucevni01,56,CHI,0,SAC,10,13,2,1,1,2,31.76666667,5,8,4,13,2,5,0,0,4,2,15,12,23,25,32.6
2023-24,202403040UTA,3/4/2024,UTA vs WAS,Bilal Coulibaly,coulibi01,57,WAS,0,UTA,7,4,1,0,1,0,33.21666667,1,3,2,7,1,2,2,2,3,1,5,8,11,12,16.3
2023-24,202403040MIN,3/4/2024,MIN vs POR,Dalano Banton,bantoda01,33,POR,0,MIN,18,7,4,0,0,1,33.28333333,3,4,7,20,1,6,3,5,1,0,11,22,25,29,31.4
2023-24,202403040BRK,3/4/2024,BRK vs MEM,Nic Claxton,claxtni01,51,BRK,1,MEM,21,6,2,0,1,1,33.45,1,5,8,10,0,0,5,8,2,1,8,23,27,29,33.2
2023-24,202403040LAL,3/4/2024,LAL vs OKC,D'Angelo Russell,russeda01,59,LAL,1,OKC,26,6,3,4,1,3,33.5,1,5,9,17,5,11,3,5,3,5,9,29,32,35,49.7
2023-24,202403040SAC,3/4/2024,SAC vs CHI,Alex Caruso,carusal01,52,CHI,0,SAC,2,3,7,4,0,0,33.7,0,3,1,10,0,6,0,1,1,4,10,9,5,12,28.1
2023-24,202403040UTA,3/4/2024,UTA vs WAS,Collin Sexton,sextoco01,62,UTA,1,WAS,29,3,7,2,0,1,33.76666667,2,1,11,19,4,7,3,3,2,2,10,36,32,39,48.1
2023-24,202403040BRK,3/4/2024,BRK vs MEM,Vince Williams Jr.,willivi01,50,MEM,0,BRK,11,5,6,2,0,2,33.95,1,4,4,11,1,4,2,2,3,2,11,17,16,22,30
2023-24,202403040MIL,3/4/2024,MIL vs LAC,Norman Powell,powelno01,59,LAC,0,MIL,6,3,3,2,1,1,34.28333333,0,3,2,8,1,6,1,2,3,3,6,9,9,12,22.1
2023-24,202403040MIL,3/4/2024,MIL vs LAC,Patrick Beverley,beverpa01,57,MIL,1,LAC,12,9,2,4,1,2,34.35,1,8,4,10,3,7,1,1,2,5,11,14,21,23,38.8
2023-24,202403040UTA,3/4/2024,UTA vs WAS,John Collins,collijo01,58,UTA,1,WAS,17,15,1,0,6,3,34.6,3,12,7,11,1,2,2,2,5,6,16,18,32,33,51.5
2023-24,202403040MIN,3/4/2024,MIN vs POR,Anthony Edwards,edwaran01,59,MIN,1,POR,13,4,6,1,0,2,34.7,0,4,4,10,1,3,4,6,2,1,10,19,17,23,27.8
2023-24,202403040UTA,3/4/2024,UTA vs WAS,Deni Avdija,avdijde01,58,WAS,0,UTA,16,11,2,1,0,5,35.05,5,6,6,18,0,4,4,4,2,1,13,18,27,29,30.2
2023-24,202403040MIN,3/4/2024,MIN vs POR,Kris Murray,murrakr01,40,POR,0,MIN,14,5,2,1,1,0,35.05,4,1,6,11,1,5,1,1,1,2,7,16,19,21,29
2023-24,202403040UTA,3/4/2024,UTA vs WAS,Kyle Kuzma,kuzmaky01,59,WAS,0,UTA,23,5,8,0,0,1,35.36666667,0,5,7,18,2,6,7,11,3,0,13,31,28,36,40
2023-24,202403040MIL,3/4/2024,MIL vs LAC,Paul George,georgpa01,55,LAC,0,MIL,29,5,1,2,0,3,36.11666667,1,4,10,17,6,10,3,7,5,2,6,30,34,35,39.5
2023-24,202403040UTA,3/4/2024,UTA vs WAS,Jordan Clarkson,clarkjo01,51,UTA,1,WAS,38,10,7,1,0,1,36.31666667,2,8,13,26,4,9,8,9,1,1,17,45,48,55,62.5
2023-24,202403040BRK,3/4/2024,BRK vs MEM,Dorian Finney-Smith,finnedo01,52,BRK,1,MEM,9,5,5,1,1,3,36.51666667,4,1,3,8,3,6,0,0,4,2,10,14,14,19,25.5
2023-24,202403040BRK,3/4/2024,BRK vs MEM,Cameron Johnson,johnsca02,48,BRK,1,MEM,18,5,3,2,1,3,36.98333333,0,5,6,15,3,10,3,4,4,3,8,21,23,26,34.5
2023-24,202403040MIL,3/4/2024,MIL vs LAC,James Harden,hardeja01,55,LAC,0,MIL,29,4,8,0,1,3,37.2,0,4,9,16,5,10,6,9,2,1,12,37,33,41,45.8
2023-24,202403040MIL,3/4/2024,MIL vs LAC,Kawhi Leonard,leonaka01,55,LAC,0,MIL,16,4,5,4,1,1,37.28333333,0,4,6,19,2,8,2,3,2,5,9,21,20,25,42.3
2023-24,202403040BRK,3/4/2024,BRK vs MEM,Dennis Schroder,schrode01,61,BRK,1,MEM,13,2,9,1,0,0,37.36666667,2,0,5,13,2,7,1,3,2,1,11,22,15,24,31.9
2023-24,202403040SAC,3/4/2024,SAC vs CHI,DeMar DeRozan,derozde01,59,CHI,0,SAC,33,0,4,2,0,2,37.81666667,0,0,10,12,2,3,11,12,1,2,4,37,33,37,43
2023-24,202403040SAC,3/4/2024,SAC vs CHI,Ayo Dosunmu,dosunay01,59,CHI,0,SAC,20,2,5,1,0,0,38.56666667,1,1,9,15,2,5,0,0,2,1,7,25,22,27,32.9
2023-24,202403040SAC,3/4/2024,SAC vs CHI,Keegan Murray,murrake02,56,SAC,1,CHI,11,6,4,1,3,0,38.73333333,2,4,3,8,1,5,4,4,5,4,10,15,17,21,36.2
2023-24,202403040SAC,3/4/2024,SAC vs CHI,De'Aaron Fox,foxde01,52,SAC,1,CHI,20,1,10,1,0,5,38.83333333,0,1,8,16,2,7,2,3,0,1,11,30,21,31,34.2
2023-24,202403040MIN,3/4/2024,MIN vs POR,Duop Reath,reathdu01,46,POR,0,MIN,26,3,1,1,1,3,38.91666667,2,1,10,14,5,6,1,2,4,2,4,27,29,30,34.1
2023-24,202403040MIN,3/4/2024,MIN vs POR,Rudy Gobert,goberru01,60,MIN,1,POR,25,16,0,1,3,3,39.01666667,5,11,9,10,0,0,7,7,6,4,16,25,41,41,53.2
2023-24,202403040BRK,3/4/2024,BRK vs MEM,Mikal Bridges,bridgmi01,61,BRK,1,MEM,14,5,5,2,0,3,39.05,1,4,4,14,2,8,4,9,1,2,10,19,19,24,30.5
2023-24,202403040MIL,3/4/2024,MIL vs LAC,Damian Lillard,lillada01,57,MIL,1,LAC,41,4,4,1,0,4,41.51666667,0,4,12,22,4,9,13,13,3,1,8,45,45,49,50.8
2023-24,202403040MIN,3/4/2024,MIN vs POR,Anfernee Simons,simonan01,37,POR,0,MIN,34,5,14,0,0,4,43.01666667,0,5,13,26,5,13,3,3,4,0,19,48,39,53,57
2023-24,202403040SAC,3/4/2024,SAC vs CHI,Coby White,whiteco01,61,CHI,0,SAC,37,5,7,1,0,3,43.53333333,0,5,14,19,5,9,4,5,3,1,12,44,42,49,53.5
2023-24,202403030BOS,3/3/2024,BOS vs GSW,Luke Kornet,kornelu01,43,BOS,1,GSW,2,3,0,0,1,0,10.55,1,2,1,2,0,0,0,0,0,1,3,2,5,5,8.6
2023-24,202403030BOS,3/3/2024,BOS vs GSW,Kevon Looney,looneke01,60,GSW,0,BOS,3,2,1,0,0,1,10.78333333,1,1,0,4,0,0,3,4,2,0,3,4,5,6,5.9
2023-24,202403030MIN,3/3/2024,MIN vs LAC,Monte Morris,morrimo01,15,MIN,1,LAC,6,1,0,0,0,0,11,1,0,2,4,2,2,0,0,0,0,1,6,7,7,7.2
2023-24,202403030PHO,3/3/2024,PHO vs OKC,Drew Eubanks,eubandr01,55,PHO,1,OKC,6,3,1,0,0,0,11.1,0,3,2,3,0,0,2,2,0,0,4,7,9,10,11.1
2023-24,202403030CLE,3/3/2024,CLE vs NYK,Alec Burks,burksal01,52,NYK,0,CLE,8,1,1,0,0,0,11.33333333,0,1,2,6,1,3,3,4,0,0,2,9,9,10,10.7
2023-24,202403030SAS,3/3/2024,SAS vs IND,Jalen Smith,smithja04,43,IND,0,SAS,4,7,0,0,0,1,11.96666667,2,5,1,3,0,2,2,2,0,0,7,4,11,11,11.4
2023-24,202403030BOS,3/3/2024,BOS vs GSW,Jaden Springer,sprinja01,37,BOS,1,GSW,2,2,1,0,0,1,12,1,1,1,4,0,1,0,0,1,0,3,3,4,5,4.9
2023-24,202403030TOR,3/3/2024,TOR vs CHO,D.J. Carton,cartodj01,3,TOR,1,CHO,2,1,1,0,0,1,12.45,1,0,1,3,0,1,0,0,1,0,2,3,3,4,3.7
2023-24,202403030BOS,3/3/2024,BOS vs GSW,Klay Thompson,thompkl01,57,GSW,0,BOS,6,2,1,0,0,1,12.48333333,0,2,2,4,1,3,1,1,1,0,3,7,8,9,8.9
2023-24,202403030BOS,3/3/2024,BOS vs GSW,Dario Saric,saricda01,58,GSW,0,BOS,4,2,0,0,0,1,12.7,0,2,2,4,0,2,0,1,0,0,2,4,6,6,5.4
2023-24,202403030ORL,3/3/2024,ORL vs DET,Jonathan Isaac,isaacjo01,41,ORL,1,DET,2,2,1,0,0,1,12.71666667,0,2,1,2,0,0,0,0,0,0,3,3,4,5,4.9
2023-24,202403030DAL,3/3/2024,DAL vs PHI,Daniel Gafford,gaffoda01,54,DAL,1,PHI,0,4,0,2,0,0,13.03333333,1,3,0,1,0,0,0,0,3,2,4,0,4,4,10.8
2023-24,202403030BOS,3/3/2024,BOS vs GSW,Draymond Green,greendr01,36,GSW,0,BOS,6,4,2,0,0,0,13.61666667,0,4,2,2,0,0,2,2,2,0,6,8,10,12,13.8
2023-24,202403030MIN,3/3/2024,MIN vs LAC,Bones Hyland,hylanbo01,21,LAC,0,MIN,0,0,2,0,0,0,13.61666667,0,0,0,3,0,0,0,0,0,0,2,2,0,2,3
2023-24,202403030ORL,3/3/2024,ORL vs DET,Moritz Wagner,wagnemo01,59,ORL,1,DET,6,3,2,1,0,1,13.61666667,1,2,3,5,0,2,0,0,1,1,5,8,9,11,14.6
2023-24,202403030ORL,3/3/2024,ORL vs DET,Cole Anthony,anthoco01,60,ORL,1,DET,2,6,1,0,0,2,14.08333333,0,6,1,4,0,2,0,0,3,0,7,3,8,9,8.7
2023-24,202403030DAL,3/3/2024,DAL vs PHI,Mo Bamba,bambamo01,38,PHI,0,DAL,8,5,1,0,0,0,14.35,3,2,2,3,0,0,4,4,1,0,6,9,13,14,15.5
2023-24,202403030MIN,3/3/2024,MIN vs LAC,Kyle Anderson,anderky01,59,MIN,1,LAC,8,3,3,0,1,1,14.45,0,3,2,5,0,1,4,4,2,1,6,11,11,14,18.1
2023-24,202403030SAS,3/3/2024,SAS vs IND,Cedi Osman,osmande01,61,SAS,1,IND,0,4,2,1,0,0,14.48333333,1,3,0,1,0,1,0,0,2,1,6,2,4,6,10.8
2023-24,202403030DAL,3/3/2024,DAL vs PHI,Tim Hardaway Jr.,hardati02,58,DAL,1,PHI,2,0,1,0,0,0,14.51666667,0,0,1,8,0,6,0,0,0,0,1,3,2,3,3.5
2023-24,202403030PHO,3/3/2024,PHO vs OKC,Isaiah Joe,joeis01,56,OKC,0,PHO,8,1,0,0,1,0,14.51666667,0,1,3,9,2,8,0,0,0,1,1,8,9,9,12.2
2023-24,202403030TOR,3/3/2024,TOR vs CHO,Jakob Poeltl,poeltja01,50,TOR,1,CHO,8,2,3,0,1,1,14.81666667,1,1,4,6,0,0,0,0,2,1,5,11,10,13,16.9
2023-24,202403030ORL,3/3/2024,ORL vs DET,James Wiseman,wisemja01,41,DET,0,ORL,8,3,0,1,0,1,15.43333333,0,3,4,5,0,0,0,1,2,1,3,8,11,11,13.6
2023-24,202403030PHO,3/3/2024,PHO vs OKC,Saben Lee,leesa01,18,PHO,1,OKC,5,2,2,0,0,0,15.5,0,2,2,6,1,3,0,0,3,0,4,7,7,9,10.4
2023-24,202403030SAS,3/3/2024,SAS vs IND,Zach Collins,colliza01,49,SAS,1,IND,11,2,2,0,0,2,15.7,1,1,5,8,0,0,1,2,2,0,4,13,13,15,14.4
2023-24,202403030PHO,3/3/2024,PHO vs OKC,Gordon Hayward,haywago01,31,OKC,0,PHO,2,3,1,0,0,0,15.78333333,2,1,1,3,0,0,0,0,0,0,4,3,5,6,7.1
2023-24,202403030CLE,3/3/2024,CLE vs NYK,Georges Niang,niangge01,60,CLE,1,NYK,0,2,1,0,0,1,15.88333333,1,1,0,6,0,4,0,0,1,0,3,1,2,3,2.9
2023-24,202403030ORL,3/3/2024,ORL vs DET,Joe Ingles,inglejo01,47,ORL,1,DET,2,0,2,1,0,3,15.96666667,0,0,1,4,0,2,0,0,1,1,2,4,2,4,5
2023-24,202403030SAS,3/3/2024,SAS vs IND,Obi Toppin,toppiob01,63,IND,0,SAS,2,2,0,0,0,0,16.08333333,0,2,1,3,0,1,0,0,2,0,2,2,4,4,4.4
2023-24,202403030TOR,3/3/2024,TOR vs CHO,Bryce McGowens,mcgowbr01,48,CHO,0,TOR,8,1,2,1,0,0,16.11666667,0,1,3,3,0,0,2,3,2,1,3,10,9,11,15.2
2023-24,202403030ORL,3/3/2024,ORL vs DET,Markelle Fultz,fultzma01,25,ORL,1,DET,16,3,1,0,1,2,16.38333333,1,2,8,8,0,0,0,0,1,1,4,17,19,20,22.1
2023-24,202403030BOS,3/3/2024,BOS vs GSW,Stephen Curry,curryst01,57,GSW,0,BOS,4,1,3,0,0,2,16.68333333,0,1,2,13,0,9,0,0,0,0,4,7,5,8,7.7
2023-24,202403030BOS,3/3/2024,BOS vs GSW,Jerome Robinson,robinje01,14,GSW,0,BOS,10,0,1,0,1,0,17.3,0,0,4,10,1,6,1,2,1,1,1,11,10,11,14.5
2023-24,202403030PHO,3/3/2024,PHO vs OKC,Cason Wallace,wallaca01,60,OKC,0,PHO,5,2,1,0,0,0,17.7,0,2,2,3,1,1,0,0,1,0,3,6,7,8,8.9
2023-24,202403030BOS,3/3/2024,BOS vs GSW,Xavier Tillman Sr.,tillmxa01,37,BOS,1,GSW,7,4,0,1,0,0,17.85,0,4,2,4,1,2,2,2,1,1,4,7,11,11,14.8
2023-24,202403030TOR,3/3/2024,TOR vs CHO,Jordan Nwora,nworajo01,32,TOR,1,CHO,11,4,0,0,0,1,17.91666667,1,3,5,8,1,3,0,0,2,0,4,11,15,15,14.8
2023-24,202403030DAL,3/3/2024,DAL vs PHI,Dereck Lively II,livelde01,43,DAL,1,PHI,4,3,0,0,1,1,18.36666667,2,1,2,3,0,0,0,0,5,1,3,4,7,7,9.6
2023-24,202403030SAS,3/3/2024,SAS vs IND,Blake Wesley,weslebl01,40,SAS,1,IND,9,1,2,1,0,1,18.65,0,1,3,3,0,0,3,4,3,1,3,11,10,12,15.2
2023-24,202403030MIN,3/3/2024,MIN vs LAC,Ivica Zubac,zubaciv01,47,LAC,0,MIN,2,2,1,0,0,1,18.8,0,2,1,2,0,0,0,0,0,0,3,3,4,5,4.9
2023-24,202403030MIN,3/3/2024,MIN vs LAC,Terance Mann,mannte01,53,LAC,0,MIN,6,4,1,0,0,0,19.2,2,2,2,3,0,1,2,2,4,0,5,7,10,11,12.3
2023-24,202403030BOS,3/3/2024,BOS vs GSW,Oshae Brissett,brissos01,40,BOS,1,GSW,6,8,2,2,1,2,19.26666667,1,7,3,7,0,1,0,2,2,3,10,8,14,16,25.6
2023-24,202403030BOS,3/3/2024,BOS vs GSW,Svi Mykhailiuk,mykhasv01,26,BOS,1,GSW,8,4,2,1,0,0,19.26666667,2,2,3,8,2,6,0,0,0,1,6,10,12,14,18.8
2023-24,202403030BOS,3/3/2024,BOS vs GSW,Gui Santos,santogu01,15,GSW,0,BOS,5,9,3,0,0,3,19.26666667,3,6,2,4,1,2,0,0,0,0,12,8,14,17,17.3
2023-24,202403030BOS,3/3/2024,BOS vs GSW,Moses Moody,moodymo01,46,GSW,0,BOS,11,4,0,0,0,1,19.28333333,1,3,5,9,1,4,0,0,1,0,4,11,15,15,14.8
2023-24,202403030PHO,3/3/2024,PHO vs OKC,Josh Giddey,giddejo01,59,OKC,0,PHO,10,1,2,2,2,1,19.41666667,0,1,4,9,2,4,0,0,2,4,3,12,11,13,25.2
2023-24,202403030BOS,3/3/2024,BOS vs GSW,Sam Hauser,hausesa01,59,BOS,1,GSW,12,5,0,0,1,1,19.63333333,0,5,4,9,4,9,0,0,3,1,5,12,17,17,20
2023-24,202403030BOS,3/3/2024,BOS vs GSW,Jonathan Kuminga,kuminjo01,59,GSW,0,BOS,6,2,3,0,0,1,19.66666667,0,2,2,9,0,2,2,2,1,0,5,9,8,11,11.9
2023-24,202403030BOS,3/3/2024,BOS vs GSW,Derrick White,whitede01,56,BOS,1,GSW,14,3,8,1,0,0,19.68333333,0,3,5,6,4,5,0,0,1,1,11,22,17,25,32.6
2023-24,202403030DAL,3/3/2024,DAL vs PHI,Josh Green,greenjo02,48,DAL,1,PHI,7,6,1,1,0,2,19.93333333,2,4,3,6,1,2,0,0,1,1,7,8,13,14,16.7
2023-24,202403030CLE,3/3/2024,CLE vs NYK,Dean Wade,wadede01,51,CLE,1,NYK,0,3,2,0,2,1,20,0,3,0,4,0,4,0,0,0,2,5,2,3,5,11.6
2023-24,202403030MIN,3/3/2024,MIN vs LAC,Nickeil Alexander-Walker,alexani01,61,MIN,1,LAC,8,0,1,0,1,1,20.6,0,0,3,6,2,3,0,0,0,1,1,9,8,9,11.5
2023-24,202403030BOS,3/3/2024,BOS vs GSW,Al Horford,horfoal01,50,BOS,1,GSW,7,4,4,1,0,0,20.65,0,4,3,5,1,2,0,0,2,1,8,11,11,15,20.8
2023-24,202403030SAS,3/3/2024,SAS vs IND,Andrew Nembhard,nembhan01,48,IND,0,SAS,7,3,1,3,0,2,21.16666667,2,1,3,7,1,2,0,0,1,3,4,8,10,11,19.1
2023-24,202403030MIN,3/3/2024,MIN vs LAC,Naz Reid,reidna01,61,MIN,1,LAC,3,11,2,0,1,2,21.18333333,3,8,0,7,0,3,3,4,1,1,13,5,14,16,20.2
2023-24,202403030BOS,3/3/2024,BOS vs GSW,Chris Paul,paulch01,36,GSW,0,BOS,2,3,7,1,0,2,21.23333333,0,3,1,6,0,3,0,0,0,1,10,9,5,12,17.1
2023-24,202403030CLE,3/3/2024,CLE vs NYK,Jericho Sims,simsje01,34,NYK,0,CLE,0,6,1,1,2,0,21.36666667,3,3,0,0,0,0,0,0,1,3,7,1,6,7,17.7
2023-24,202403030CLE,3/3/2024,CLE vs NYK,Precious Achiuwa,achiupr01,54,NYK,0,CLE,14,4,0,2,3,2,21.53333333,3,1,6,8,1,1,1,3,3,5,4,14,18,18,31.8
2023-24,202403030BOS,3/3/2024,BOS vs GSW,Trayce Jackson-Davis,jackstr02,47,GSW,0,BOS,8,8,2,0,2,1,21.63333333,4,4,4,6,0,0,0,0,1,2,10,10,16,18,25.6
2023-24,202403030PHO,3/3/2024,PHO vs OKC,Aaron Wiggins,wiggiaa01,57,OKC,0,PHO,7,3,0,4,1,0,21.96666667,0,3,3,6,0,2,1,2,0,5,3,7,10,10,25.6
2023-24,202403030BOS,3/3/2024,BOS vs GSW,Gary Payton II,paytoga02,26,GSW,0,BOS,6,4,1,1,0,3,22.15,2,2,3,5,0,0,0,1,1,1,5,7,10,11,12.3
2023-24,202403030BOS,3/3/2024,BOS vs GSW,Jaylen Brown,brownja02,55,BOS,1,GSW,29,3,3,1,0,1,22.38333333,1,2,11,19,5,10,2,2,2,1,6,32,32,35,39.1
2023-24,202403030ORL,3/3/2024,ORL vs DET,Cade Cunningham,cunnica01,50,DET,0,ORL,9,2,7,1,0,1,22.91666667,0,2,4,12,1,4,0,0,2,1,9,16,11,18,23.9
2023-24,202403030CLE,3/3/2024,CLE vs NYK,Isaiah Hartenstein,harteis01,55,NYK,0,CLE,8,7,8,0,1,1,22.91666667,2,5,4,7,0,0,0,0,1,1,15,16,15,23,30.4
2023-24,202403030TOR,3/3/2024,TOR vs CHO,Gradey Dick,dickgr01,40,TOR,1,CHO,11,4,0,1,0,0,24.08333333,1,3,4,7,3,5,0,0,3,1,4,11,15,15,18.8
2023-24,202403030ORL,3/3/2024,ORL vs DET,Jaden Ivey,iveyja01,56,DET,0,ORL,10,1,0,0,0,0,24.55,1,0,3,11,0,5,4,4,3,0,1,10,11,11,11.2
2023-24,202403030ORL,3/3/2024,ORL vs DET,Jalen Duren,durenja01,45,DET,0,ORL,11,4,2,1,0,3,24.56666667,1,3,4,9,0,0,3,3,3,1,6,13,15,17,18.8
2023-24,202403030ORL,3/3/2024,ORL vs DET,Marcus Sasser,sassema01,51,DET,0,ORL,3,3,4,2,0,2,25.08333333,0,3,1,8,0,5,1,1,0,2,7,7,6,10,16.6
2023-24,202403030MIN,3/3/2024,MIN vs LAC,Amir Coffey,coffeam01,47,LAC,0,MIN,2,4,0,2,1,0,25.1,0,4,1,5,0,0,0,0,1,3,4,2,6,6,15.8
2023-24,202403030BOS,3/3/2024,BOS vs GSW,Jayson Tatum,tatumja01,57,BOS,1,GSW,27,3,5,1,1,0,25.2,0,3,9,13,4,5,5,5,2,2,8,32,30,35,44.1
2023-24,202403030DAL,3/3/2024,DAL vs PHI,Maxi Kleber,klebima01,24,DAL,1,PHI,2,5,2,0,0,0,25.65,0,5,0,2,0,2,2,2,4,0,7,4,7,9,11
2023-24,202403030TOR,3/3/2024,TOR vs CHO,Davis Bertans,bertada01,23,CHO,0,TOR,14,3,0,1,2,1,25.76666667,0,3,5,11,4,9,0,0,3,3,3,14,17,17,25.6
2023-24,202403030DAL,3/3/2024,DAL vs PHI,Kelly Oubre Jr.,oubreke01,47,PHI,0,DAL,21,5,4,0,1,0,25.93333333,3,2,7,17,1,7,6,7,4,1,9,25,26,30,36
2023-24,202403030TOR,3/3/2024,TOR vs CHO,Kelly Olynyk,olynyke01,59,TOR,1,CHO,4,4,4,2,2,2,26.03333333,1,3,0,4,0,2,4,4,1,4,8,8,8,12,24.8
2023-24,202403030DAL,3/3/2024,DAL vs PHI,Derrick Jones Jr.,jonesde02,56,DAL,1,PHI,21,7,0,0,1,0,26.1,3,4,7,9,5,5,2,4,1,1,7,21,28,28,32.4
2023-24,202403030ORL,3/3/2024,ORL vs DET,Evan Fournier,fournev01,11,DET,0,ORL,17,1,5,1,0,0,26.11666667,1,0,6,13,3,8,2,2,2,1,6,22,18,23,28.7
2023-24,202403030BOS,3/3/2024,BOS vs GSW,Jrue Holiday,holidjr01,55,BOS,1,GSW,7,6,4,0,1,0,26.16666667,1,5,3,7,1,3,0,0,2,1,10,11,13,17,23.2
2023-24,202403030SAS,3/3/2024,SAS vs IND,T.J. McConnell,mccontj01,52,IND,0,SAS,26,2,5,3,0,1,26.83333333,1,1,13,15,0,0,0,0,0,3,7,31,28,33,43.9
2023-24,202403030ORL,3/3/2024,ORL vs DET,Isaiah Stewart,stewais01,38,DET,0,ORL,10,4,2,0,1,2,27.06666667,1,3,4,7,1,3,1,2,2,1,6,12,14,16,18.8
2023-24,202403030MIN,3/3/2024,MIN vs LAC,Norman Powell,powelno01,58,LAC,0,MIN,24,3,0,1,0,1,27.2,0,3,9,13,6,8,0,0,4,1,3,24,27,27,29.6
2023-24,202403030BOS,3/3/2024,BOS vs GSW,Payton Pritchard,pritcpa01,60,BOS,1,GSW,19,6,6,2,0,2,27.35,0,6,8,12,3,5,0,0,3,2,12,25,25,31,39.2
2023-24,202403030SAS,3/3/2024,SAS vs IND,Keldon Johnson,johnske04,57,SAS,1,IND,17,4,2,0,0,1,27.4,2,2,7,13,3,7,0,0,4,0,6,19,21,23,23.8
2023-24,202403030SAS,3/3/2024,SAS vs IND,Aaron Nesmith,nesmiaa01,54,IND,0,SAS,4,1,2,1,0,2,27.6,0,1,1,7,0,4,2,2,2,1,3,6,5,7,9.2
2023-24,202403030MIN,3/3/2024,MIN vs LAC,Mike Conley,conlemi01,56,MIN,1,LAC,0,7,5,0,0,3,27.9,1,6,0,4,0,3,0,0,2,0,12,5,7,12,12.9
2023-24,202403030DAL,3/3/2024,DAL vs PHI,Paul Reed,reedpa01,60,PHI,0,DAL,13,7,3,1,1,2,27.96666667,2,5,5,6,1,1,2,2,3,2,10,16,20,23,29.9
2023-24,202403030CLE,3/3/2024,CLE vs NYK,Evan Mobley,mobleev01,37,CLE,1,NYK,13,13,6,0,1,2,27.98333333,4,9,6,11,0,1,1,3,3,1,19,19,26,32,38.6
2023-24,202403030DAL,3/3/2024,DAL vs PHI,Buddy Hield,hieldbu01,63,PHI,0,DAL,11,3,4,1,1,1,28.25,1,2,4,11,3,8,0,0,2,2,7,15,14,18,25.6
2023-24,202403030CLE,3/3/2024,CLE vs NYK,Sam Merrill,merrisa01,42,CLE,1,NYK,21,3,2,0,0,0,28.65,1,2,7,13,7,13,0,0,3,0,5,23,24,26,27.6
2023-24,202403030ORL,3/3/2024,ORL vs DET,Franz Wagner,wagnefr01,53,ORL,1,DET,13,8,1,0,2,3,28.81666667,0,8,5,10,0,1,3,5,3,2,9,14,21,22,27.1
2023-24,202403030MIN,3/3/2024,MIN vs LAC,Daniel Theis,theisda01,44,LAC,0,MIN,4,13,1,0,0,1,28.98333333,4,9,2,7,0,4,0,0,1,0,14,5,17,18,20.1
2023-24,202403030ORL,3/3/2024,ORL vs DET,Gary Harris,harriga01,38,ORL,1,DET,8,2,4,2,0,0,29.33333333,0,2,3,5,2,4,0,0,1,2,6,12,10,14,22.4
2023-24,202403030CLE,3/3/2024,CLE vs NYK,Max Strus,strusma01,60,CLE,1,NYK,6,1,3,1,0,2,29.53333333,0,1,2,9,2,6,0,0,1,1,4,9,7,10,12.7
2023-24,202403030SAS,3/3/2024,SAS vs IND,Tre Jones,jonestr01,56,SAS,1,IND,2,1,4,0,1,0,29.75,0,1,0,2,0,0,2,2,0,1,5,6,3,7,12.2
2023-24,202403030ORL,3/3/2024,ORL vs DET,Jalen Suggs,suggsja01,56,ORL,1,DET,11,5,3,1,1,3,29.75,0,5,5,8,1,3,0,0,4,2,8,14,16,19,24.5
2023-24,202403030TOR,3/3/2024,TOR vs CHO,Tre Mann,manntr01,23,CHO,0,TOR,6,4,4,2,0,1,29.95,0,4,3,8,0,0,0,0,2,2,8,10,10,14,21.8
2023-24,202403030CLE,3/3/2024,CLE vs NYK,Bojan Bogdanovic,bogdabo02,36,NYK,0,CLE,20,3,3,0,0,3,30.18333333,0,3,8,15,1,6,3,3,2,0,6,23,23,26,25.1
2023-24,202403030SAS,3/3/2024,SAS vs IND,Myles Turner,turnemy01,59,IND,0,SAS,16,10,0,0,1,2,30.31666667,3,7,6,17,4,9,0,0,2,1,10,16,26,26,29
2023-24,202403030PHO,3/3/2024,PHO vs OKC,Eric Gordon,gordoer01,50,PHO,1,OKC,15,0,3,0,0,1,30.33333333,0,0,6,15,3,8,0,0,0,0,3,18,15,18,18.5
2023-24,202403030SAS,3/3/2024,SAS vs IND,Malaki Branham,branhma01,56,SAS,1,IND,18,4,6,1,0,2,30.53333333,1,3,7,13,2,6,2,2,1,1,10,24,22,28,32.8
2023-24,202403030ORL,3/3/2024,ORL vs DET,Wendell Carter Jr.,cartewe01,35,ORL,1,DET,19,8,3,1,2,0,31.16666667,2,6,5,7,2,3,7,7,1,3,11,22,27,30,42.1
2023-24,202403030SAS,3/3/2024,SAS vs IND,Victor Wembanyama,wembavi01,55,SAS,1,IND,31,12,6,1,6,3,31.4,2,10,11,17,3,4,6,7,2,7,18,37,43,49,72.4
2023-24,202403030PHO,3/3/2024,PHO vs OKC,Luguentz Dort,dortlu01,58,OKC,0,PHO,13,5,0,3,1,1,31.45,1,4,5,13,3,7,0,0,3,4,5,13,18,18,30
2023-24,202403030SAS,3/3/2024,SAS vs IND,Bennedict Mathurin,mathube01,59,IND,0,SAS,13,3,3,1,2,0,31.48333333,0,3,2,8,0,2,9,13,2,3,6,16,16,19,30.1
2023-24,202403030DAL,3/3/2024,DAL vs PHI,Nicolas Batum,batumni01,40,PHI,0,DAL,7,11,3,3,1,0,31.5,2,9,2,8,1,5,2,2,1,4,14,10,18,21,36.7
2023-24,202403030PHO,3/3/2024,PHO vs OKC,Chet Holmgren,holmgch01,60,OKC,0,PHO,14,9,2,1,0,1,31.58333333,4,5,5,10,0,1,4,5,1,1,11,16,23,25,29.8
2023-24,202403030ORL,3/3/2024,ORL vs DET,Paolo Banchero,banchpa01,59,ORL,1,DET,29,8,5,0,0,4,32.06666667,2,6,10,16,1,4,8,9,1,0,13,34,37,42,42.1
2023-24,202403030PHO,3/3/2024,PHO vs OKC,Jusuf Nurkic,nurkiju01,57,PHO,1,OKC,14,31,4,0,1,5,32.35,13,18,7,16,0,2,0,0,3,1,35,18,45,49,55.2
2023-24,202403030TOR,3/3/2024,TOR vs CHO,Ochai Agbaji,agbajoc01,60,TOR,1,CHO,13,9,1,0,2,0,32.65,4,5,6,20,1,7,0,1,2,2,10,14,22,23,31.3
2023-24,202403030ORL,3/3/2024,ORL vs DET,Simone Fontecchio,fontesi01,59,DET,0,ORL,15,4,4,2,0,1,32.65,0,4,5,10,2,5,3,3,2,2,8,19,19,23,30.8
2023-24,202403030PHO,3/3/2024,PHO vs OKC,Jalen Williams,willija06,54,OKC,0,PHO,22,4,2,3,0,1,32.86666667,1,3,10,19,1,3,1,1,3,3,6,24,26,28,37.8
2023-24,202403030ORL,3/3/2024,ORL vs DET,Ausar Thompson,thompau01,60,DET,0,ORL,8,6,1,3,1,2,33.06666667,1,5,2,10,1,6,3,4,3,4,7,9,14,15,26.7
2023-24,202403030DAL,3/3/2024,DAL vs PHI,Kyle Lowry,lowryky01,42,PHI,0,DAL,8,4,7,1,1,0,33.1,1,3,1,9,1,5,5,5,0,2,11,15,12,19,29.3
2023-24,202403030BOS,3/3/2024,BOS vs GSW,Lester Quinones,quinole01,26,GSW,0,BOS,17,5,0,0,0,1,33.2,1,4,7,16,3,10,0,0,3,0,5,17,22,22,22
2023-24,202403030PHO,3/3/2024,PHO vs OKC,Royce O'Neale,onealro01,58,PHO,1,OKC,9,3,4,0,2,2,33.31666667,0,3,3,10,3,8,0,0,2,2,7,13,12,16,22.6
2023-24,202403030MIN,3/3/2024,MIN vs LAC,Jaden McDaniels,mcdanja02,51,MIN,1,LAC,6,2,1,1,1,1,33.33333333,0,2,3,9,0,4,0,0,0,2,3,7,8,9,14.9
2023-24,202403030PHO,3/3/2024,PHO vs OKC,Bradley Beal,bealbr01,32,PHO,1,OKC,31,4,6,0,1,7,33.63333333,2,2,10,14,3,5,8,10,2,1,10,37,35,41,40.8
2023-24,202403030SAS,3/3/2024,SAS vs IND,Jeremy Sochan,sochaje01,61,SAS,1,IND,12,8,4,0,1,1,34.03333333,2,6,6,8,0,0,0,0,2,1,12,16,20,24,29.6
2023-24,202403030PHO,3/3/2024,PHO vs OKC,Grayson Allen,allengr01,55,PHO,1,OKC,8,2,3,1,2,0,34.28333333,0,2,3,9,2,7,0,0,2,3,5,11,10,13,23.9
2023-24,202403030MIN,3/3/2024,MIN vs LAC,Karl-Anthony Towns,townska01,59,MIN,1,LAC,18,9,8,0,0,3,34.36666667,4,5,7,18,2,7,2,2,5,0,17,26,27,35,37.8
2023-24,202403030MIN,3/3/2024,MIN vs LAC,James Harden,hardeja01,54,LAC,0,MIN,4,5,10,1,2,1,34.38333333,0,5,0,10,0,6,4,4,1,3,15,14,9,19,33
2023-24,202403030MIN,3/3/2024,MIN vs LAC,Paul George,georgpa01,54,LAC,0,MIN,15,4,1,1,1,3,34.4,0,4,5,16,3,11,2,3,0,2,5,16,19,20,24.3
2023-24,202403030TOR,3/3/2024,TOR vs CHO,Gary Trent Jr.,trentga02,56,TOR,1,CHO,17,5,0,3,1,0,34.4,1,4,6,13,3,6,2,3,0,4,5,17,22,22,35
2023-24,202403030CLE,3/3/2024,CLE vs NYK,Isaac Okoro,okorois01,51,CLE,1,NYK,17,5,4,2,1,1,34.41666667,2,3,7,13,3,8,0,1,1,3,9,21,22,26,37
2023-24,202403030TOR,3/3/2024,TOR vs CHO,RJ Barrett,barrerj01,50,TOR,1,CHO,23,8,5,2,0,5,34.95,1,7,10,15,3,6,0,2,2,2,13,28,31,36,41.1
2023-24,202403030DAL,3/3/2024,DAL vs PHI,Tobias Harris,harrito02,54,PHI,0,DAL,28,5,1,1,0,1,35.2,1,4,11,19,3,6,3,4,4,1,6,29,33,34,37.5
2023-24,202403030DAL,3/3/2024,DAL vs PHI,P.J. Washington,washipj01,53,DAL,1,PHI,13,4,2,1,0,2,35.48333333,2,2,3,10,1,7,6,6,2,1,6,15,17,19,21.8
2023-24,202403030CLE,3/3/2024,CLE vs NYK,Jarrett Allen,allenja01,55,CLE,1,NYK,18,7,6,1,1,1,35.51666667,1,6,8,13,0,0,2,4,1,2,13,24,25,31,40.4
2023-24,202403030TOR,3/3/2024,TOR vs CHO,Vasilije Micic,micicva01,40,CHO,0,TOR,12,2,6,2,0,4,35.53333333,1,1,5,13,0,2,2,3,1,2,8,18,14,20,25.4
2023-24,202403030TOR,3/3/2024,TOR vs CHO,Immanuel Quickley,quickim01,56,TOR,1,CHO,22,7,11,0,0,3,35.55,0,7,6,14,2,7,8,8,2,0,18,33,29,40,43.9
2023-24,202403030PHO,3/3/2024,PHO vs OKC,Kevin Durant,duranke01,54,PHO,1,OKC,20,4,3,1,1,5,35.63333333,0,4,6,15,2,4,6,6,2,2,7,23,24,27,30.3
2023-24,202403030SAS,3/3/2024,SAS vs IND,Tyrese Haliburton,halibty01,50,IND,0,SAS,12,6,8,0,1,1,36.15,3,3,4,16,0,6,4,4,0,1,14,20,18,26,33.2
2023-24,202403030TOR,3/3/2024,TOR vs CHO,Brandon Miller,millebr02,54,CHO,0,TOR,26,10,3,0,1,2,36.63333333,3,7,11,21,4,8,0,1,1,1,13,29,36,39,43.5
2023-24,202403030MIN,3/3/2024,MIN vs LAC,Anthony Edwards,edwaran01,58,MIN,1,LAC,27,5,2,3,0,3,36.71666667,0,5,9,20,3,10,6,6,1,3,7,29,32,34,42
2023-24,202403030SAS,3/3/2024,SAS vs IND,Devin Vassell,vassede01,56,SAS,1,IND,17,9,5,2,0,4,36.95,1,8,7,20,2,7,1,2,1,2,14,22,26,31,37.3
2023-24,202403030SAS,3/3/2024,SAS vs IND,Pascal Siakam,siakapa01,60,IND,0,SAS,21,8,1,1,0,1,37.63333333,3,5,10,17,1,4,0,0,5,1,9,22,29,30,34.1
2023-24,202403030DAL,3/3/2024,DAL vs PHI,Kyrie Irving,irvinky01,39,DAL,1,PHI,28,5,4,1,0,4,38.28333333,0,5,10,20,5,9,3,3,0,1,9,32,33,37,39
2023-24,202403030PHO,3/3/2024,PHO vs OKC,Shai Gilgeous-Alexander,gilgesh01,59,OKC,0,PHO,35,8,9,3,3,1,38.3,0,8,15,27,0,5,5,7,4,6,17,44,43,52,75.1
2023-24,202403030MIN,3/3/2024,MIN vs LAC,Kawhi Leonard,leonaka01,54,LAC,0,MIN,32,5,1,2,1,2,38.31666667,1,4,12,26,1,4,7,8,1,3,6,33,37,38,46.5
2023-24,202403030CLE,3/3/2024,CLE vs NYK,Donte DiVincenzo,divindo01,60,NYK,0,CLE,28,6,4,3,1,1,39.3,1,5,11,22,6,14,0,0,2,4,10,32,34,38,52.2
2023-24,202403030DAL,3/3/2024,DAL vs PHI,Tyrese Maxey,maxeyty01,55,PHI,0,DAL,24,2,3,2,0,4,39.3,0,2,8,15,1,5,7,7,4,2,5,27,26,29,32.9
2023-24,202403030CLE,3/3/2024,CLE vs NYK,Darius Garland,garlada01,36,CLE,1,NYK,19,4,5,2,0,2,39.56666667,1,3,7,14,5,8,0,0,1,2,9,24,23,28,35.3
2023-24,202403030TOR,3/3/2024,TOR vs CHO,Miles Bridges,bridgmi02,50,CHO,0,TOR,20,9,4,1,1,1,39.76666667,0,9,9,19,0,3,2,2,0,2,13,24,29,33,41.8
2023-24,202403030TOR,3/3/2024,TOR vs CHO,Grant Williams,willigr01,57,CHO,0,TOR,18,13,5,1,1,6,40.26666667,6,7,6,13,0,3,6,7,5,2,18,23,31,36,41.1
2023-24,202403030DAL,3/3/2024,DAL vs PHI,Luka Doncic,doncilu01,53,DAL,1,PHI,38,11,10,1,0,7,40.28333333,2,9,14,27,4,10,6,6,2,1,21,48,49,59,62.2
2023-24,202403030MIN,3/3/2024,MIN vs LAC,Rudy Gobert,goberru01,59,MIN,1,LAC,12,16,2,0,3,1,40.45,3,13,5,7,0,0,2,2,3,3,18,14,28,30,42.2
2023-24,202403030CLE,3/3/2024,CLE vs NYK,Josh Hart,hartjo01,60,NYK,0,CLE,13,19,10,2,2,2,45.36666667,1,18,5,12,3,6,0,0,2,4,29,23,32,42,60.8
2023-24,202403030CLE,3/3/2024,CLE vs NYK,Miles McBride,mcbrimi01,48,NYK,0,CLE,16,1,5,0,0,0,47.21666667,0,1,6,15,4,9,0,0,2,0,6,21,17,22,24.7
2023-24,202403020MIA,3/2/2024,MIA vs UTA,Kris Dunn,dunnkr01,53,UTA,0,MIA,0,1,2,1,0,0,10.08333333,1,0,0,1,0,1,0,0,4,1,3,2,1,3,7.2
2023-24,202403020PHO,3/2/2024,PHO vs HOU,Jeff Green,greenje02,58,HOU,0,PHO,1,2,0,0,0,0,10.18333333,0,2,0,3,0,2,1,2,2,0,2,1,3,3,3.4
2023-24,202403020PHO,3/2/2024,PHO vs HOU,Cam Whitmore,whitmca01,34,HOU,0,PHO,4,4,1,1,0,3,10.25,2,2,1,6,0,2,2,4,3,1,5,5,8,9,10.3
2023-24,202403020PHO,3/2/2024,PHO vs HOU,Jock Landale,landajo01,34,HOU,0,PHO,0,2,1,0,0,0,10.5,0,2,0,1,0,0,0,0,0,0,3,1,2,3,3.9
2023-24,202403020PHO,3/2/2024,PHO vs HOU,Bol Bol,bolbo01,22,PHO,1,HOU,5,5,0,0,1,0,11,2,3,2,8,1,5,0,0,2,1,5,5,10,10,14
2023-24,202403020BRK,3/2/2024,BRK vs ATL,Lonnie Walker IV,walkelo01,40,BRK,1,ATL,2,1,0,0,0,1,11.08333333,0,1,1,7,0,3,0,0,1,0,1,2,3,3,2.2
2023-24,202403020LAL,3/2/2024,LAL vs DEN,Reggie Jackson,jacksre01,61,DEN,0,LAL,0,1,2,0,0,0,11.11666667,0,1,0,1,0,0,0,0,1,0,3,2,1,3,4.2
2023-24,202403020LAL,3/2/2024,LAL vs DEN,Taurean Prince,princta02,60,LAL,1,DEN,2,1,0,0,0,0,12.03333333,0,1,1,6,0,2,0,0,0,0,1,2,3,3,3.2
2023-24,202403020MIA,3/2/2024,MIA vs UTA,Brice Sensabaugh,sensabr01,11,UTA,0,MIA,6,0,0,0,0,2,12.51666667,0,0,2,4,2,3,0,0,1,0,0,6,6,6,4
2023-24,202403020MEM,3/2/2024,MEM vs POR,Dalano Banton,bantoda01,32,POR,0,MEM,10,3,0,1,0,3,12.66666667,2,1,4,8,0,2,2,2,5,1,3,10,13,13,13.6
2023-24,202403020BRK,3/2/2024,BRK vs ATL,Garrison Mathews,mathega01,44,ATL,0,BRK,0,0,0,0,0,0,13.13333333,0,0,0,1,0,1,0,0,2,0,0,0,0,0,0
2023-24,202403020MEM,3/2/2024,MEM vs POR,Jake LaRavia,laravja01,16,MEM,1,POR,6,2,0,0,0,1,13.73333333,0,2,0,3,0,2,6,8,1,0,2,6,8,8,7.4
2023-24,202403020MIA,3/2/2024,MIA vs UTA,Orlando Robinson,robinor01,26,MIA,1,UTA,0,4,0,1,0,0,13.78333333,1,3,0,2,0,1,0,0,4,1,4,0,4,4,7.8
2023-24,202403020BRK,3/2/2024,BRK vs ATL,Day'Ron Sharpe,sharpda01,45,BRK,1,ATL,6,5,1,0,2,1,13.98333333,3,2,2,4,0,0,2,4,1,2,6,7,11,12,18.5
2023-24,202403020BRK,3/2/2024,BRK vs ATL,Kobe Bufkin,bufkiko01,9,ATL,0,BRK,3,2,3,0,0,1,14.03333333,0,2,1,5,0,1,1,2,2,0,5,6,5,8,8.9
2023-24,202403020PHO,3/2/2024,PHO vs HOU,Drew Eubanks,eubandr01,54,PHO,1,HOU,2,2,1,0,0,1,14.25,0,2,1,3,0,0,0,0,2,0,3,3,4,5,4.9
2023-24,202403020MEM,3/2/2024,MEM vs POR,Jerami Grant,grantje01,52,POR,0,MEM,5,0,1,1,0,1,14.6,0,0,1,5,1,4,2,2,1,1,1,6,5,6,8.5
2023-24,202403020MIA,3/2/2024,MIA vs UTA,Omer Yurtseven,yurtsom01,32,UTA,0,MIA,7,5,0,0,0,0,14.83333333,2,3,3,4,0,0,1,2,0,0,5,7,12,12,13
2023-24,202403020LAL,3/2/2024,LAL vs DEN,Peyton Watson,watsope01,59,DEN,0,LAL,7,2,0,0,3,0,15.91666667,1,1,3,5,0,1,1,2,0,3,2,7,9,9,18.4
2023-24,202403020BRK,3/2/2024,BRK vs ATL,Jalen Wilson,wilsoja03,22,BRK,1,ATL,3,4,1,0,0,0,16.35,2,2,1,3,1,2,0,0,3,0,5,4,7,8,9.3
2023-24,202403020PHO,3/2/2024,PHO vs HOU,Josh Okogie,okogijo01,54,PHO,1,HOU,7,3,2,1,0,1,16.53333333,1,2,2,3,0,1,3,3,1,1,5,9,10,12,15.6
2023-24,202403020MEM,3/2/2024,MEM vs POR,Lamar Stevens,stevela01,27,MEM,1,POR,7,3,0,2,1,1,16.58333333,0,3,3,11,1,2,0,0,2,3,3,7,10,10,18.6
2023-24,202403020PHO,3/2/2024,PHO vs HOU,Jusuf Nurkic,nurkiju01,56,PHO,1,HOU,7,10,5,1,1,1,17.06666667,1,9,3,5,0,0,1,2,1,2,15,12,17,22,31.5
2023-24,202403020MEM,3/2/2024,MEM vs POR,Matthew Hurt,hurtma01,6,MEM,1,POR,7,1,1,2,1,1,18.08333333,0,1,3,5,1,2,0,0,3,3,2,8,8,9,17.7
2023-24,202403020MEM,3/2/2024,MEM vs POR,John Konchar,konchjo01,46,MEM,1,POR,3,4,1,2,2,1,18.08333333,2,2,1,5,1,4,0,0,0,4,5,4,7,8,20.3
2023-24,202403020BRK,3/2/2024,BRK vs ATL,Bruno Fernando,fernabr01,23,ATL,0,BRK,10,4,1,0,3,0,18.53333333,2,2,4,5,0,0,2,2,4,3,5,11,14,15,25.3
2023-24,202403020LAL,3/2/2024,LAL vs DEN,Cam Reddish,reddica01,39,LAL,1,DEN,3,2,0,1,0,1,18.81666667,2,0,1,3,1,2,0,0,1,1,2,3,5,5,7.4
2023-24,202403020MIA,3/2/2024,MIA vs UTA,Haywood Highsmith,highsha01,44,MIA,1,UTA,2,1,0,0,1,0,18.83333333,0,1,1,5,0,4,0,0,1,1,1,2,3,3,6.2
2023-24,202403020MIA,3/2/2024,MIA vs UTA,Nikola Jovic,jovicni01,26,MIA,1,UTA,8,3,4,1,0,0,18.86666667,1,2,3,6,2,5,0,0,3,1,7,12,11,15,20.6
2023-24,202403020MEM,3/2/2024,MEM vs POR,Matisse Thybulle,thybuma01,57,POR,0,MEM,2,4,1,2,0,2,19.25,0,4,1,5,0,3,0,0,2,2,5,3,6,7,12.3
2023-24,202403020MIA,3/2/2024,MIA vs UTA,Talen Horton-Tucker,hortota01,38,UTA,0,MIA,7,8,3,0,1,0,19.78333333,1,7,1,7,1,2,4,4,4,1,11,10,15,18,24.1
2023-24,202403020LAL,3/2/2024,LAL vs DEN,Spencer Dinwiddie,dinwisp01,56,LAL,1,DEN,3,1,3,0,0,1,19.95,1,0,1,4,1,3,0,0,0,0,4,6,4,7,7.7
2023-24,202403020PHO,3/2/2024,PHO vs HOU,Bradley Beal,bealbr01,31,PHO,1,HOU,7,2,2,0,0,2,20.23333333,1,1,3,6,1,1,0,0,0,0,4,9,9,11,10.4
2023-24,202403020PHO,3/2/2024,PHO vs HOU,Amen Thompson,thompam01,41,HOU,0,PHO,9,5,3,4,0,0,20.6,2,3,3,5,0,0,3,3,2,4,8,12,14,17,31.5
2023-24,202403020BRK,3/2/2024,BRK vs ATL,Dennis Smith Jr.,smithde03,44,BRK,1,ATL,3,6,6,0,1,0,21.33333333,1,5,1,6,1,3,0,0,2,1,12,9,9,15,22.2
2023-24,202403020MIA,3/2/2024,MIA vs UTA,Caleb Martin,martica02,43,MIA,1,UTA,18,5,4,0,3,0,22.8,0,5,5,9,4,6,4,4,2,3,9,22,23,27,39
2023-24,202403020LAL,3/2/2024,LAL vs DEN,Christian Braun,braunch01,61,DEN,0,LAL,2,5,2,1,2,2,23.96666667,1,4,1,3,0,1,0,0,1,3,7,4,7,9,18
2023-24,202403020BRK,3/2/2024,BRK vs ATL,Clint Capela,capelca01,52,ATL,0,BRK,11,10,2,1,0,1,24,5,5,4,7,0,0,3,4,2,1,12,13,21,23,28
2023-24,202403020MEM,3/2/2024,MEM vs POR,Duop Reath,reathdu01,45,POR,0,MEM,12,6,1,0,3,2,24.06666667,1,5,5,9,1,4,1,4,4,3,7,13,18,19,27.7
2023-24,202403020PHO,3/2/2024,PHO vs HOU,Royce O'Neale,onealro01,57,PHO,1,HOU,20,10,2,1,1,0,27.46666667,1,9,7,13,4,8,2,2,2,2,12,22,30,32,41
2023-24,202403020MEM,3/2/2024,MEM vs POR,Luke Kennard,kennalu01,30,MEM,1,POR,5,2,5,1,0,1,27.6,0,2,1,2,1,2,2,2,1,1,7,10,7,12,16.9
2023-24,202403020MIA,3/2/2024,MIA vs UTA,Taylor Hendricks,hendrita0,22,UTA,0,MIA,8,13,1,0,2,1,28.83333333,4,9,4,7,0,2,0,0,3,2,14,9,21,22,30.1
2023-24,202403020MIA,3/2/2024,MIA vs UTA,Jaime Jaquez Jr.,jaqueja01,54,MIA,1,UTA,12,4,1,1,0,1,29.03333333,2,2,5,10,1,3,1,2,3,1,5,13,16,17,20.3
2023-24,202403020BRK,3/2/2024,BRK vs ATL,De'Andre Hunter,huntede01,36,ATL,0,BRK,15,2,1,0,0,2,29.23333333,0,2,5,11,4,6,1,2,3,0,3,16,17,18,16.9
2023-24,202403020MEM,3/2/2024,MEM vs POR,Jordan Goodwin,goodwjo01,45,MEM,1,POR,4,5,8,3,1,3,30.28333333,2,3,2,6,0,2,0,2,2,4,13,12,9,17,31
2023-24,202403020LAL,3/2/2024,LAL vs DEN,D'Angelo Russell,russeda01,58,LAL,1,DEN,17,3,3,0,0,0,30.73333333,0,3,6,13,2,7,3,3,1,0,6,20,20,23,25.1
2023-24,202403020BRK,3/2/2024,BRK vs ATL,Cameron Johnson,johnsca02,47,BRK,1,ATL,23,5,1,1,0,1,30.8,1,4,6,12,4,7,7,7,2,1,6,24,28,29,32.5
2023-24,202403020LAL,3/2/2024,LAL vs DEN,Justin Holiday,holidju01,38,DEN,0,LAL,13,2,3,1,0,0,31,0,2,5,7,3,5,0,0,0,1,5,16,15,18,22.9
2023-24,202403020MEM,3/2/2024,MEM vs POR,Jabari Walker,walkeja01,55,POR,0,MEM,18,12,2,1,0,2,31.18333333,5,7,8,16,0,1,2,2,3,1,14,20,30,32,36.4
2023-24,202403020MEM,3/2/2024,MEM vs POR,GG Jackson II,jacksgg01,28,MEM,1,POR,17,6,1,2,0,4,31.28333333,2,4,4,15,1,5,8,10,0,2,7,18,23,24,27.7
2023-24,202403020MIA,3/2/2024,MIA vs UTA,Collin Sexton,sextoco01,61,UTA,0,MIA,18,1,5,0,0,0,31.48333333,0,1,7,13,0,1,4,4,0,0,6,23,19,24,26.7
2023-24,202403020MIA,3/2/2024,MIA vs UTA,Terry Rozier,roziete01,43,MIA,1,UTA,14,2,8,1,0,2,32.51666667,1,1,5,9,1,3,3,4,2,1,10,22,16,24,29.4
2023-24,202403020MEM,3/2/2024,MEM vs POR,Ashton Hagans,haganas01,9,POR,0,MEM,13,5,8,2,1,6,32.53333333,0,5,4,9,2,4,3,3,4,3,13,21,18,26,34
2023-24,202403020PHO,3/2/2024,PHO vs HOU,Alperen Sengun,sengual01,59,HOU,0,PHO,21,10,2,2,1,3,32.95,5,5,9,21,0,2,3,4,4,3,12,23,31,33,42
2023-24,202403020PHO,3/2/2024,PHO vs HOU,Dillon Brooks,brookdi01,51,HOU,0,PHO,11,6,3,2,1,0,33.05,1,5,4,10,2,6,1,2,2,3,9,14,17,20,31.7
2023-24,202403020MIA,3/2/2024,MIA vs UTA,John Collins,collijo01,57,UTA,0,MIA,18,6,3,0,1,1,33.16666667,2,4,8,13,1,3,1,2,3,1,9,21,24,27,31.7
2023-24,202403020BRK,3/2/2024,BRK vs ATL,Nic Claxton,claxtni01,50,BRK,1,ATL,12,13,4,2,2,2,33.81666667,1,12,6,9,0,0,0,2,2,4,17,16,25,29,43.6
2023-24,202403020MEM,3/2/2024,MEM vs POR,Ziaire Williams,willizi02,51,MEM,1,POR,9,6,0,1,0,3,33.9,0,6,2,7,1,5,4,4,1,1,6,9,15,15,16.2
2023-24,202403020MIA,3/2/2024,MIA vs UTA,Duncan Robinson,robindu01,55,MIA,1,UTA,12,5,6,1,1,1,34.13333333,0,5,5,13,2,9,0,0,2,2,11,18,17,23,32
2023-24,202403020BRK,3/2/2024,BRK vs ATL,Dennis Schroder,schrode01,60,BRK,1,ATL,14,2,8,0,2,2,34.15,0,2,4,13,3,4,3,4,4,2,10,22,16,24,32.4
2023-24,202403020MIA,3/2/2024,MIA vs UTA,Bam Adebayo,adebaba01,50,MIA,1,UTA,23,7,3,0,0,0,34.21666667,2,5,10,15,0,0,3,4,2,0,10,26,30,33,35.9
2023-24,202403020BRK,3/2/2024,BRK vs ATL,Jalen Johnson,johnsja05,46,ATL,0,BRK,7,9,1,0,0,1,34.6,2,7,3,12,0,4,1,2,1,0,10,8,16,17,18.3
2023-24,202403020BRK,3/2/2024,BRK vs ATL,Dejounte Murray,murrade01,57,ATL,0,BRK,20,6,11,2,1,2,34.68333333,0,6,8,19,2,8,2,4,2,3,17,31,26,37,50.7
2023-24,202403020LAL,3/2/2024,LAL vs DEN,Aaron Gordon,gordoaa01,55,DEN,0,LAL,18,9,5,1,0,1,34.7,5,4,8,16,1,4,1,1,2,1,14,23,27,32,38.3
2023-24,202403020BRK,3/2/2024,BRK vs ATL,Saddiq Bey,beysa01,59,ATL,0,BRK,23,3,2,0,0,0,34.9,1,2,8,14,2,6,5,5,2,0,5,25,26,28,29.6
2023-24,202403020BRK,3/2/2024,BRK vs ATL,Bogdan Bogdanovic,bogdabo01,58,ATL,0,BRK,13,6,1,1,0,4,35.13333333,2,4,4,13,3,8,2,2,1,1,7,14,19,20,20.7
2023-24,202403020BRK,3/2/2024,BRK vs ATL,Dorian Finney-Smith,finnedo01,51,BRK,1,ATL,11,4,5,1,0,1,35.33333333,2,2,5,7,1,3,0,0,2,1,9,16,15,20,25.3
2023-24,202403020MIA,3/2/2024,MIA vs UTA,Jimmy Butler,butleji01,41,MIA,1,UTA,37,3,7,1,1,2,35.81666667,1,2,12,19,3,3,10,11,1,2,10,44,40,47,55.1
2023-24,202403020MEM,3/2/2024,MEM vs POR,Toumani Camara,camarto01,58,POR,0,MEM,15,7,1,1,1,1,36.16666667,3,4,5,10,3,4,2,4,2,2,8,16,22,23,29.9
2023-24,202403020LAL,3/2/2024,LAL vs DEN,Austin Reaves,reaveau01,63,LAL,1,DEN,19,2,14,0,0,2,36.71666667,0,2,7,12,3,6,2,2,1,0,16,33,21,35,40.4
2023-24,202403020PHO,3/2/2024,PHO vs HOU,Jabari Smith Jr.,smithja05,55,HOU,0,PHO,14,5,1,1,1,0,36.75,1,4,5,11,2,7,2,4,1,2,6,15,19,20,27.5
2023-24,202403020LAL,3/2/2024,LAL vs DEN,Rui Hachimura,hachiru01,49,LAL,1,DEN,23,3,2,0,0,0,36.83333333,0,3,10,15,3,4,0,0,2,0,5,25,26,28,29.6
2023-24,202403020LAL,3/2/2024,LAL vs DEN,Michael Porter Jr.,portemi01,60,DEN,0,LAL,25,10,4,1,1,1,37.08333333,0,10,10,10,5,5,0,0,0,2,14,29,35,39,48
2023-24,202403020LAL,3/2/2024,LAL vs DEN,LeBron James,jamesle01,55,LAL,1,DEN,26,4,9,3,0,3,37.11666667,0,4,12,20,2,5,0,2,1,3,13,35,30,39,50.3
2023-24,202403020PHO,3/2/2024,PHO vs HOU,Grayson Allen,allengr01,54,PHO,1,HOU,2,2,3,2,0,3,37.21666667,0,2,0,7,0,6,2,2,2,2,5,5,4,7,11.9
2023-24,202403020MEM,3/2/2024,MEM vs POR,Santi Aldama,aldamsa01,49,MEM,1,POR,21,8,3,0,1,3,37.36666667,2,6,7,15,5,9,2,3,3,1,11,24,29,32,35.1
2023-24,202403020PHO,3/2/2024,PHO vs HOU,Jalen Green,greenja05,60,HOU,0,PHO,34,9,4,2,0,3,37.71666667,1,8,12,23,6,12,4,4,2,2,13,38,43,47,53.8
2023-24,202403020MEM,3/2/2024,MEM vs POR,Vince Williams Jr.,willivi01,49,MEM,1,POR,21,8,2,2,3,4,38.08333333,1,7,7,14,4,7,3,4,4,5,10,23,29,31,44.6
2023-24,202403020PHO,3/2/2024,PHO vs HOU,Devin Booker,bookede01,50,PHO,1,HOU,24,2,5,1,0,5,38.35,0,2,7,17,2,4,8,8,5,1,7,29,26,31,31.9
2023-24,202403020LAL,3/2/2024,LAL vs DEN,Jamal Murray,murraja01,45,DEN,0,LAL,24,6,11,1,0,2,38.43333333,0,6,11,23,1,5,1,2,2,1,17,35,30,41,48.7
2023-24,202403020BRK,3/2/2024,BRK vs ATL,Mikal Bridges,bridgmi01,60,BRK,1,ATL,38,5,2,2,1,2,38.55,2,3,14,26,5,10,5,5,2,3,7,40,43,45,54
2023-24,202403020MEM,3/2/2024,MEM vs POR,Kris Murray,murrakr01,39,POR,0,MEM,2,5,2,0,0,1,38.76666667,0,5,1,6,0,3,0,0,2,0,7,4,7,9,10
2023-24,202403020LAL,3/2/2024,LAL vs DEN,Anthony Davis,davisan02,59,LAL,1,DEN,17,11,2,0,3,0,38.91666667,2,9,7,13,0,0,3,4,3,3,13,19,28,30,42.2
2023-24,202403020LAL,3/2/2024,LAL vs DEN,Nikola Jokic,jokicni01,59,DEN,0,LAL,35,10,7,0,1,3,38.93333333,2,8,16,25,1,5,2,2,1,1,17,42,45,52,57.5
2023-24,202403020PHO,3/2/2024,PHO vs HOU,Kevin Durant,duranke01,53,PHO,1,HOU,30,9,2,0,3,6,39.35,2,7,12,19,1,4,5,8,1,3,11,32,39,41,46.8
2023-24,202403020MIA,3/2/2024,MIA vs UTA,Lauri Markkanen,markkla01,51,UTA,0,MIA,25,4,6,2,1,1,40.95,2,2,5,15,4,9,11,12,4,3,10,31,29,35,46.8
2023-24,202403020PHO,3/2/2024,PHO vs HOU,Fred VanVleet,vanvlfr01,53,HOU,0,PHO,24,5,11,1,0,2,41.53333333,1,4,8,15,6,11,2,3,3,1,16,35,29,40,47.5
2023-24,202403020MIA,3/2/2024,MIA vs UTA,Keyonte George,georgke01,55,UTA,0,MIA,31,4,4,0,0,5,43.13333333,0,4,12,23,6,14,1,2,0,0,8,35,35,39,36.8
2023-24,202403020MEM,3/2/2024,MEM vs POR,Anfernee Simons,simonan01,36,POR,0,MEM,30,7,7,0,0,4,44.91666667,1,6,10,23,4,9,6,7,1,0,14,37,37,44,44.9
2023-24,202403010LAC,3/1/2024,LAC vs WAS,Russell Westbrook,westbru01,58,LAC,1,WAS,6,0,1,0,0,0,10.38333333,0,0,2,3,0,0,2,2,1,0,1,7,6,7,7.5
2023-24,202403010NOP,3/1/2024,NOP vs IND,Jalen Smith,smithja04,42,IND,0,NOP,9,3,0,0,0,1,11.36666667,2,1,4,6,1,2,0,0,1,0,3,9,12,12,11.6
2023-24,202403010DET,3/1/2024,DET vs CLE,Craig Porter Jr.,portecr01,35,CLE,0,DET,4,3,0,0,0,1,11.43333333,0,3,1,2,0,0,2,2,3,0,3,4,7,7,6.6
2023-24,202403010MIN,3/1/2024,MIN vs SAC,Jordan McLaughlin,mclaujo01,37,MIN,1,SAC,4,1,4,0,1,1,11.91666667,0,1,2,2,0,0,0,0,2,1,5,8,5,9,13.2
2023-24,202403010CHI,3/1/2024,CHI vs MIL,Terry Taylor,taylote01,23,CHI,1,MIL,4,3,0,0,0,0,12.01666667,1,2,1,2,1,1,1,2,1,0,3,4,7,7,7.6
2023-24,202403010DET,3/1/2024,DET vs CLE,James Wiseman,wisemja01,40,DET,1,CLE,4,6,0,0,0,0,12.03333333,2,4,2,4,0,0,0,0,3,0,6,4,10,10,11.2
2023-24,202403010LAC,3/1/2024,LAC vs WAS,Eugene Omoruyi,omorueu01,28,WAS,0,LAC,8,0,0,0,0,1,12.75,0,0,4,7,0,1,0,1,2,0,0,8,8,8,7
2023-24,202403010CHI,3/1/2024,CHI vs MIL,Julian Phillips,phillju01,34,CHI,1,MIL,0,1,2,1,0,0,13.25,0,1,0,2,0,1,0,0,1,1,3,2,1,3,7.2
2023-24,202403010TOR,3/1/2024,TOR vs GSW,Gary Payton II,paytoga02,25,GSW,0,TOR,4,4,1,1,0,0,14.06666667,3,1,2,4,0,1,0,0,0,1,5,5,8,9,13.3
2023-24,202403010DET,3/1/2024,DET vs CLE,Quentin Grimes,grimequ01,49,DET,1,CLE,2,0,0,1,0,1,14.11666667,0,0,1,6,0,3,0,0,0,1,0,2,2,2,4
2023-24,202403010MIN,3/1/2024,MIN vs SAC,Monte Morris,morrimo01,14,MIN,1,SAC,5,0,2,0,0,0,14.53333333,0,0,2,4,1,2,0,0,1,0,2,7,5,7,8
2023-24,202403010DET,3/1/2024,DET vs CLE,Evan Fournier,fournev01,10,DET,1,CLE,3,2,1,1,0,0,14.55,0,2,0,2,0,1,3,3,1,1,3,4,5,6,9.9
2023-24,202403010BOS,3/1/2024,BOS vs DAL,Dante Exum,exumda01,34,DAL,0,BOS,4,2,1,0,0,0,14.65,0,2,1,5,0,1,2,2,1,0,3,5,6,7,7.9
2023-24,202403010BOS,3/1/2024,BOS vs DAL,Xavier Tillman Sr.,tillmxa01,36,BOS,1,DAL,6,1,2,0,1,0,15.1,0,1,3,3,0,0,0,0,1,1,3,8,7,9,13.2
2023-24,202403010LAC,3/1/2024,LAC vs WAS,Jared Butler,butleja02,22,WAS,0,LAC,8,2,7,1,0,1,15.15,1,1,3,6,0,1,2,2,0,1,9,15,10,17,22.9
2023-24,202403010BOS,3/1/2024,BOS vs DAL,Sam Hauser,hausesa01,58,BOS,1,DAL,0,4,1,0,0,0,15.18333333,0,4,0,3,0,3,0,0,1,0,5,1,4,5,6.3
2023-24,202403010NOP,3/1/2024,NOP vs IND,Larry Nance Jr.,nancela02,43,NOP,1,IND,4,3,3,0,0,0,15.26666667,1,2,2,2,0,0,0,0,1,0,6,7,7,10,12.1
2023-24,202403010NOP,3/1/2024,NOP vs IND,Obi Toppin,toppiob01,62,IND,0,NOP,5,2,0,1,0,1,15.63333333,1,1,2,5,1,3,0,0,3,1,2,5,7,7,9.4
2023-24,202403010TOR,3/1/2024,TOR vs GSW,Scottie Barnes,barnesc01,60,TOR,1,GSW,10,6,3,1,0,2,15.66666667,0,6,4,7,2,5,0,0,1,1,9,13,16,19,22.7
2023-24,202403010BOS,3/1/2024,BOS vs DAL,Payton Pritchard,pritcpa01,59,BOS,1,DAL,10,2,1,0,0,1,16.01666667,1,1,4,7,2,4,0,0,2,0,3,11,12,13,12.9
2023-24,202403010TOR,3/1/2024,TOR vs GSW,Trayce Jackson-Davis,jackstr02,46,GSW,0,TOR,9,4,0,0,0,0,16.06666667,2,2,3,4,0,0,3,4,3,0,4,9,13,13,13.8
2023-24,202403010CHI,3/1/2024,CHI vs MIL,Onuralp Bitim,bitimon01,4,CHI,1,MIL,6,4,1,0,0,0,16.16666667,0,4,2,7,2,5,0,0,2,0,5,7,10,11,12.3
2023-24,202403010LAC,3/1/2024,LAC vs WAS,Bones Hyland,hylanbo01,20,LAC,1,WAS,2,0,7,0,1,1,16.43333333,0,0,1,7,0,4,0,0,0,1,7,9,2,9,14.5
2023-24,202403010PHI,3/1/2024,PHI vs CHO,Cameron Payne,payneca01,56,PHI,1,CHO,5,0,7,0,0,2,16.66666667,0,0,2,6,1,4,0,0,4,0,7,12,5,12,13.5
2023-24,202403010NOP,3/1/2024,NOP vs IND,T.J. McConnell,mccontj01,51,IND,0,NOP,8,4,3,1,0,2,17,2,2,4,8,0,0,0,0,1,1,7,11,12,15,18.3
2023-24,202403010MEM,3/1/2024,MEM vs POR,Yuta Watanabe,watanyu01,34,MEM,1,POR,0,1,0,1,0,2,17.06666667,0,1,0,1,0,0,0,2,2,1,1,0,1,1,2.2
2023-24,202403010LAC,3/1/2024,LAC vs WAS,Landry Shamet,shamela01,43,WAS,0,LAC,8,1,0,1,0,1,17.23333333,0,1,2,6,2,6,2,2,2,1,1,8,9,9,11.2
2023-24,202403010NOP,3/1/2024,NOP vs IND,Isaiah Jackson,jacksis01,47,IND,0,NOP,13,11,1,2,0,2,17.95,7,4,6,9,0,0,1,2,1,2,12,14,24,25,31.7
2023-24,202403010CHI,3/1/2024,CHI vs MIL,Patrick Beverley,beverpa01,56,MIL,0,CHI,14,4,2,0,1,0,18.28333333,1,3,5,8,2,5,2,2,1,1,6,16,18,20,24.8
2023-24,202403010MIN,3/1/2024,MIN vs SAC,Keon Ellis,elliske01,35,SAC,0,MIN,2,2,7,4,1,0,18.5,2,0,1,2,0,1,0,0,4,5,9,9,4,11,29.9
2023-24,202403010NOP,3/1/2024,NOP vs IND,Myles Turner,turnemy01,58,IND,0,NOP,12,5,0,0,3,2,18.68333333,2,3,5,10,0,1,2,4,3,3,5,12,17,17,25
2023-24,202403010DET,3/1/2024,DET vs CLE,Dean Wade,wadede01,50,CLE,0,DET,6,2,0,1,2,0,18.68333333,0,2,2,4,2,4,0,0,4,3,2,6,8,8,17.4
2023-24,202403010MIN,3/1/2024,MIN vs SAC,Anthony Edwards,edwaran01,57,MIN,1,SAC,11,2,2,0,1,1,18.8,0,2,2,11,1,3,6,6,0,1,4,13,13,15,18.4
2023-24,202403010MIN,3/1/2024,MIN vs SAC,Trey Lyles,lylestr01,44,SAC,0,MIN,3,5,2,0,1,0,19.21666667,2,3,1,3,0,2,1,2,4,1,7,5,8,10,15
2023-24,202403010PHI,3/1/2024,PHI vs CHO,Mo Bamba,bambamo01,37,PHI,1,CHO,2,8,1,1,2,2,19.46666667,2,6,1,4,0,1,0,0,2,3,9,3,10,11,20.1
2023-24,202403010DET,3/1/2024,DET vs CLE,Georges Niang,niangge01,59,CLE,0,DET,2,4,3,1,0,1,19.48333333,0,4,1,7,0,3,0,0,0,1,7,5,6,9,13.3
2023-24,202403010PHI,3/1/2024,PHI vs CHO,Davis Bertans,bertada01,22,CHO,0,PHI,14,1,2,0,0,0,19.66666667,0,1,5,12,4,10,0,0,1,0,3,16,15,17,18.2
2023-24,202403010LAC,3/1/2024,LAC vs WAS,Mason Plumlee,plumlma01,27,LAC,1,WAS,4,10,1,1,1,2,19.75,1,9,2,5,0,0,0,0,2,2,11,5,14,15,21.5
2023-24,202403010BOS,3/1/2024,BOS vs DAL,Tim Hardaway Jr.,hardati02,57,DAL,0,BOS,10,5,0,0,0,1,20,0,5,3,6,2,4,2,2,1,0,5,10,15,15,15
2023-24,202403010BOS,3/1/2024,BOS vs DAL,Maxi Kleber,klebima01,23,DAL,0,BOS,1,2,2,0,0,1,20.23333333,0,2,0,1,0,1,1,2,1,0,4,3,3,5,5.4
2023-24,202403010MEM,3/1/2024,MEM vs POR,Dalano Banton,bantoda01,31,POR,0,MEM,19,7,3,1,2,1,20.25,2,5,8,15,3,5,0,0,1,3,10,22,26,29,39.9
2023-24,202403010NOP,3/1/2024,NOP vs IND,Bennedict Mathurin,mathube01,58,IND,0,NOP,13,2,1,0,0,2,20.28333333,1,1,4,10,1,3,4,4,1,0,3,14,15,16,14.9
2023-24,202403010NOP,3/1/2024,NOP vs IND,Pascal Siakam,siakapa01,59,IND,0,NOP,12,2,3,0,0,2,20.36666667,0,2,5,10,1,2,1,2,1,0,5,15,14,17,16.9
2023-24,202403010LAC,3/1/2024,LAC vs WAS,Daniel Theis,theisda01,43,LAC,1,WAS,9,8,1,0,0,0,20.36666667,0,8,4,5,1,1,0,0,2,0,9,10,17,18,20.1
2023-24,202403010NOP,3/1/2024,NOP vs IND,Aaron Nesmith,nesmiaa01,53,IND,0,NOP,9,3,3,0,0,0,20.58333333,0,3,3,5,2,3,1,2,2,0,6,12,12,15,17.1
2023-24,202403010MEM,3/1/2024,MEM vs POR,Toumani Camara,camarto01,57,POR,0,MEM,4,7,1,1,0,0,20.81666667,2,5,2,5,0,0,0,0,1,1,8,5,11,12,16.9
2023-24,202403010MEM,3/1/2024,MEM vs POR,Lamar Stevens,stevela01,26,MEM,1,POR,19,1,2,1,0,1,20.96666667,1,0,7,12,1,1,4,4,2,1,3,21,20,22,25.2
2023-24,202403010LAC,3/1/2024,LAC vs WAS,Jordan Poole,poolejo01,58,WAS,0,LAC,16,4,4,0,0,1,21.4,0,4,7,15,1,4,1,1,4,0,8,20,20,24,25.8
2023-24,202403010NOP,3/1/2024,NOP vs IND,Zion Williamson,willizi01,50,NOP,1,IND,8,3,7,0,0,5,21.45,1,2,3,6,0,0,2,4,0,0,10,15,11,18,17.1
2023-24,202403010NOP,3/1/2024,NOP vs IND,Naji Marshall,marshna01,49,NOP,1,IND,1,3,1,1,0,0,21.61666667,0,3,0,1,0,0,1,2,0,1,4,2,4,5,9.1
2023-24,202403010LAC,3/1/2024,LAC vs WAS,Norman Powell,powelno01,57,LAC,1,WAS,9,3,4,1,0,0,21.8,0,3,4,8,1,3,0,1,1,1,7,13,12,16,21.6
2023-24,202403010LAC,3/1/2024,LAC vs WAS,Terance Mann,mannte01,52,LAC,1,WAS,12,3,0,0,0,0,22,1,2,6,7,0,0,0,0,0,0,3,12,15,15,15.6
2023-24,202403010MEM,3/1/2024,MEM vs POR,Jabari Walker,walkeja01,54,POR,0,MEM,19,10,2,2,1,2,22.06666667,3,7,7,9,1,1,4,4,3,3,12,21,29,31,41
2023-24,202403010LAC,3/1/2024,LAC vs WAS,Amir Coffey,coffeam01,46,LAC,1,WAS,10,0,3,1,0,0,22.08333333,0,0,4,4,1,1,1,2,1,1,3,13,10,13,17.5
2023-24,202403010TOR,3/1/2024,TOR vs GSW,Lester Quinones,quinole01,25,GSW,0,TOR,6,4,1,0,0,0,22.58333333,1,3,2,6,1,5,1,2,0,0,5,7,10,11,12.3
2023-24,202403010LAC,3/1/2024,LAC vs WAS,Corey Kispert,kispeco01,58,WAS,0,LAC,9,2,0,0,1,0,22.6,0,2,4,7,1,3,0,1,2,1,2,9,11,11,14.4
2023-24,202403010NOP,3/1/2024,NOP vs IND,Tyrese Haliburton,halibty01,49,IND,0,NOP,0,3,3,0,0,1,22.68333333,0,3,0,7,0,6,0,0,0,0,6,3,3,6,7.1
2023-24,202403010MEM,3/1/2024,MEM vs POR,GG Jackson II,jacksgg01,27,MEM,1,POR,11,1,0,0,0,2,22.71666667,0,1,4,8,2,3,1,2,1,0,1,11,12,12,10.2
2023-24,202403010LAC,3/1/2024,LAC vs WAS,Tyus Jones,jonesty01,60,WAS,0,LAC,2,0,9,1,0,1,22.75,0,0,1,7,0,4,0,0,0,1,9,11,2,11,17.5
2023-24,202403010PHI,3/1/2024,PHI vs CHO,Seth Curry,curryse01,44,CHO,0,PHI,5,2,2,1,0,0,22.86666667,1,1,2,8,1,3,0,0,2,1,4,7,7,9,13.4
2023-24,202403010TOR,3/1/2024,TOR vs GSW,Bruce Brown,brownbr01,53,TOR,1,GSW,4,2,1,0,0,2,22.95,0,2,2,5,0,2,0,0,1,0,3,5,6,7,5.9
2023-24,202403010MEM,3/1/2024,MEM vs POR,Duop Reath,reathdu01,44,POR,0,MEM,18,5,1,2,2,1,23.15,3,2,8,16,2,8,0,1,3,4,6,19,23,24,36.5
2023-24,202403010BOS,3/1/2024,BOS vs DAL,Dereck Lively II,livelde01,42,DAL,0,BOS,15,4,1,2,1,0,23.43333333,2,2,7,7,0,0,1,2,0,3,5,16,19,20,30.3
2023-24,202403010PHI,3/1/2024,PHI vs CHO,Paul Reed,reedpa01,59,PHI,1,CHO,11,8,3,0,2,1,23.5,5,3,5,6,0,0,1,1,2,2,11,14,19,22,30.1
2023-24,202403010CHI,3/1/2024,CHI vs MIL,Jae Crowder,crowdja01,30,MIL,0,CHI,3,3,0,2,0,0,23.88333333,0,3,1,2,1,2,0,0,3,2,3,3,6,6,12.6
2023-24,202403010CHI,3/1/2024,CHI vs MIL,Andre Drummond,drumman01,60,CHI,1,MIL,9,10,0,1,1,3,24.08333333,3,7,4,11,0,0,1,1,4,2,10,9,19,19,24
2023-24,202403010MEM,3/1/2024,MEM vs POR,Kris Murray,murrakr01,38,POR,0,MEM,14,2,2,3,0,0,24.1,1,1,5,8,2,3,2,2,1,3,4,16,16,18,28.4
2023-24,202403010TOR,3/1/2024,TOR vs GSW,Chris Paul,paulch01,35,GSW,0,TOR,13,4,5,2,0,0,24.3,0,4,5,10,3,6,0,0,2,2,9,18,17,22,31.3
2023-24,202403010LAC,3/1/2024,LAC vs WAS,Johnny Davis,davisjo06,29,WAS,0,LAC,2,2,2,1,0,0,24.33333333,0,2,1,4,0,1,0,0,1,1,4,4,4,6,10.4
2023-24,202403010MEM,3/1/2024,MEM vs POR,Ashton Hagans,haganas01,8,POR,0,MEM,6,2,5,1,3,1,24.43333333,1,1,2,5,0,0,2,2,4,4,7,11,8,13,26.9
2023-24,202403010CHI,3/1/2024,CHI vs MIL,Pat Connaughton,connapa01,55,MIL,0,CHI,0,1,1,1,1,1,24.51666667,0,1,0,3,0,3,0,0,3,2,2,1,1,2,7.7
2023-24,202403010NOP,3/1/2024,NOP vs IND,Jose Alvarado,alvarjo01,40,NOP,1,IND,9,3,2,1,0,2,24.58333333,0,3,4,7,1,4,0,0,2,1,5,11,12,14,16.6
2023-24,202403010DET,3/1/2024,DET vs CLE,Isaac Okoro,okorois01,50,CLE,0,DET,12,0,4,1,1,2,24.71666667,0,0,4,9,2,5,2,2,2,2,4,16,12,16,22
2023-24,202403010TOR,3/1/2024,TOR vs GSW,Jakob Poeltl,poeltja01,49,TOR,1,GSW,10,14,2,1,1,2,24.83333333,5,9,5,10,0,0,0,2,5,2,16,12,24,26,33.8
2023-24,202403010MIN,3/1/2024,MIN vs SAC,Nickeil Alexander-Walker,alexani01,60,MIN,1,SAC,7,2,3,0,0,1,24.86666667,1,1,2,5,2,4,1,2,0,0,5,10,9,12,12.9
2023-24,202403010LAC,3/1/2024,LAC vs WAS,James Harden,hardeja01,53,LAC,1,WAS,28,4,8,0,3,3,25.01666667,1,3,9,13,6,9,4,4,1,3,12,36,32,40,50.8
2023-24,202403010DET,3/1/2024,DET vs CLE,Simone Fontecchio,fontesi01,58,DET,1,CLE,7,2,1,2,0,3,25.13333333,0,2,2,8,1,3,2,3,3,2,3,8,9,10,13.9
2023-24,202403010NOP,3/1/2024,NOP vs IND,CJ McCollum,mccolcj01,45,NOP,1,IND,14,4,1,2,2,0,25.33333333,0,4,5,11,4,7,0,0,2,4,5,15,18,19,32.3
2023-24,202403010MIN,3/1/2024,MIN vs SAC,Davion Mitchell,mitchda01,49,SAC,0,MIN,16,2,2,0,0,1,25.43333333,0,2,7,8,0,1,2,2,4,0,4,18,18,20,20.4
2023-24,202403010DET,3/1/2024,DET vs CLE,Sam Merrill,merrisa01,41,CLE,0,DET,12,3,1,0,0,1,25.45,1,2,4,9,4,9,0,0,0,0,4,13,15,16,16.1
2023-24,202403010NOP,3/1/2024,NOP vs IND,Jonas Valanciunas,valanjo01,61,NOP,1,IND,15,9,3,0,2,4,25.56666667,3,6,7,11,1,1,0,0,2,2,12,18,24,27,32.3
2023-24,202403010MEM,3/1/2024,MEM vs POR,Anfernee Simons,simonan01,35,POR,0,MEM,7,5,8,0,0,2,25.71666667,2,3,3,9,1,4,0,0,0,0,13,15,12,20,23
2023-24,202403010MEM,3/1/2024,MEM vs POR,Ziaire Williams,willizi02,50,MEM,1,POR,9,5,2,1,0,1,25.81666667,0,5,4,10,1,3,0,0,1,1,7,11,14,16,20
2023-24,202403010CHI,3/1/2024,CHI vs MIL,Alex Caruso,carusal01,51,CHI,1,MIL,11,4,2,1,0,2,25.83333333,0,4,3,7,3,6,2,2,2,1,6,13,15,17,19.8
2023-24,202403010MEM,3/1/2024,MEM vs POR,Matisse Thybulle,thybuma01,56,POR,0,MEM,13,3,2,3,0,4,26,1,2,5,10,1,4,2,2,2,3,5,15,16,18,24.6
2023-24,202403010MEM,3/1/2024,MEM vs POR,Jake LaRavia,laravja01,15,MEM,1,POR,21,2,2,1,0,3,26.15,0,2,7,13,3,7,4,5,2,1,4,23,23,25,26.4
2023-24,202403010CHI,3/1/2024,CHI vs MIL,Bobby Portis,portibo01,61,MIL,0,CHI,11,9,1,2,1,0,26.16666667,3,6,4,13,1,5,2,4,1,3,10,12,20,21,32.3
2023-24,202403010LAC,3/1/2024,LAC vs WAS,Deni Avdija,avdijde01,57,WAS,0,LAC,14,5,5,0,0,2,26.35,0,5,4,11,2,4,4,5,2,0,10,19,19,24,25.5
2023-24,202403010NOP,3/1/2024,NOP vs IND,Herbert Jones,joneshe01,56,NOP,1,IND,6,1,1,2,0,0,26.4,0,1,3,4,0,0,0,0,2,2,2,7,7,8,14.7
2023-24,202403010TOR,3/1/2024,TOR vs GSW,Gradey Dick,dickgr01,39,TOR,1,GSW,12,2,3,1,0,0,26.68333333,0,2,5,11,2,6,0,0,1,1,5,15,14,17,21.9
2023-24,202403010NOP,3/1/2024,NOP vs IND,Jarace Walker,walkeja02,21,IND,0,NOP,6,7,6,3,3,2,26.68333333,0,7,2,9,2,4,0,0,1,6,13,12,13,19,39.4
2023-24,202403010BOS,3/1/2024,BOS vs DAL,Jrue Holiday,holidjr01,54,BOS,1,DAL,11,2,7,2,1,0,26.83333333,0,2,4,6,3,3,0,0,1,3,9,18,13,20,32.9
2023-24,202403010PHI,3/1/2024,PHI vs CHO,Nicolas Batum,batumni01,39,PHI,1,CHO,8,4,2,0,1,0,27.06666667,2,2,3,7,2,6,0,0,1,1,6,10,12,14,18.8
2023-24,202403010TOR,3/1/2024,TOR vs GSW,Jonathan Kuminga,kuminjo01,58,GSW,0,TOR,24,6,2,0,0,2,27.26666667,2,4,9,19,0,2,6,6,1,0,8,26,30,32,32.2
2023-24,202403010PHI,3/1/2024,PHI vs CHO,Grant Williams,willigr01,56,CHO,0,PHI,13,6,2,1,1,1,27.3,2,4,6,6,1,1,0,1,4,2,8,15,19,21,28.2
2023-24,202403010MEM,3/1/2024,MEM vs POR,Santi Aldama,aldamsa01,48,MEM,1,POR,6,8,1,0,1,4,27.55,3,5,3,10,0,4,0,0,1,1,9,7,14,15,16.1
2023-24,202403010NOP,3/1/2024,NOP vs IND,Trey Murphy III,murphtr02,36,NOP,1,IND,28,7,1,2,0,0,27.7,1,6,8,14,6,12,6,9,2,2,8,29,35,36,43.9
2023-24,202403010BOS,3/1/2024,BOS vs DAL,Al Horford,horfoal01,49,BOS,1,DAL,12,8,3,0,2,1,27.73333333,1,7,5,8,2,5,0,0,1,2,11,15,20,23,31.1
2023-24,202403010TOR,3/1/2024,TOR vs GSW,Draymond Green,greendr01,35,GSW,0,TOR,6,13,5,1,2,3,27.8,2,11,1,4,0,0,4,4,2,3,18,11,19,24,35.1
2023-24,202403010LAC,3/1/2024,LAC vs WAS,Marvin Bagley III,baglema01,43,WAS,0,LAC,10,10,0,0,0,0,27.83333333,6,4,5,9,0,0,0,0,2,0,10,10,20,20,22
2023-24,202403010CHI,3/1/2024,CHI vs MIL,Malik Beasley,beaslma01,59,MIL,0,CHI,4,6,2,1,0,1,28.01666667,0,6,1,7,1,7,1,2,0,1,8,6,10,12,16.2
2023-24,202403010PHI,3/1/2024,PHI vs CHO,Vasilije Micic,micicva01,39,CHO,0,PHI,13,0,7,2,0,2,28.1,0,0,4,9,1,2,4,4,0,2,7,20,13,20,27.5
2023-24,202403010BOS,3/1/2024,BOS vs DAL,Josh Green,greenjo02,47,DAL,0,BOS,2,3,2,0,0,0,28.18333333,1,2,1,5,0,2,0,0,2,0,5,4,5,7,8.6
2023-24,202403010TOR,3/1/2024,TOR vs GSW,Kelly Olynyk,olynyke01,58,TOR,1,GSW,16,10,3,3,0,2,28.41666667,5,5,5,10,1,3,5,7,3,3,13,19,26,29,39.5
2023-24,202403010MEM,3/1/2024,MEM vs POR,Vince Williams Jr.,willivi01,48,MEM,1,POR,8,2,5,0,2,4,28.66666667,0,2,3,7,0,0,2,5,2,2,7,13,10,15,19.9
2023-24,202403010CHI,3/1/2024,CHI vs MIL,Brook Lopez,lopezbr01,58,MIL,0,CHI,12,3,1,0,0,1,29.11666667,2,1,4,8,4,8,0,0,2,0,4,13,15,16,16.1
2023-24,202403010LAC,3/1/2024,LAC vs WAS,Kyle Kuzma,kuzmaky01,58,WAS,0,LAC,32,7,1,1,0,1,29.15,0,7,13,19,5,7,1,1,2,1,8,33,39,40,43.9
2023-24,202403010LAC,3/1/2024,LAC vs WAS,Kawhi Leonard,leonaka01,53,LAC,1,WAS,27,9,4,1,1,1,29.41666667,4,5,9,20,2,8,7,7,2,2,13,31,36,40,48.8
2023-24,202403010BOS,3/1/2024,BOS vs DAL,Kristaps Porzingis,porzikr01,44,BOS,1,DAL,24,6,2,0,1,0,29.41666667,3,3,8,14,4,8,4,4,2,1,8,26,30,32,37.2
2023-24,202403010PHI,3/1/2024,PHI vs CHO,Nick Richards,richani01,51,CHO,0,PHI,19,4,1,0,2,0,29.56666667,2,2,8,9,0,0,3,4,1,2,5,20,23,24,31.3
2023-24,202403010TOR,3/1/2024,TOR vs GSW,Klay Thompson,thompkl01,56,GSW,0,TOR,14,6,1,3,0,2,29.7,1,5,5,13,4,9,0,0,2,3,7,15,20,21,29.7
2023-24,202403010TOR,3/1/2024,TOR vs GSW,Stephen Curry,curryst01,56,GSW,0,TOR,25,6,6,0,0,4,30.1,2,4,9,22,7,15,0,0,2,0,12,31,31,37,37.2
2023-24,202403010MEM,3/1/2024,MEM vs POR,Trey Jemison,jemistr01,10,MEM,1,POR,5,6,1,0,0,1,30.1,2,4,2,3,0,0,1,2,5,0,7,6,11,12,12.7
2023-24,202403010TOR,3/1/2024,TOR vs GSW,Gary Trent Jr.,trentga02,55,TOR,1,GSW,9,3,2,2,0,0,30.13333333,1,2,4,14,1,8,0,0,0,2,5,11,12,14,21.6
2023-24,202403010NOP,3/1/2024,NOP vs IND,Andrew Nembhard,nembhan01,47,IND,0,NOP,10,0,4,2,0,1,30.15,0,0,4,12,2,8,0,0,3,2,4,14,10,14,21
2023-24,202403010LAC,3/1/2024,LAC vs WAS,Paul George,georgpa01,53,LAC,1,WAS,22,6,3,0,0,0,30.38333333,0,6,8,15,2,6,4,5,1,0,9,25,28,31,33.7
2023-24,202403010NOP,3/1/2024,NOP vs IND,Brandon Ingram,ingrabr01,55,NOP,1,IND,34,8,6,1,0,2,30.46666667,1,7,13,21,1,2,7,9,3,1,14,40,42,48,53.6
2023-24,202403010BOS,3/1/2024,BOS vs DAL,Jaylen Brown,brownja02,54,BOS,1,DAL,25,7,5,1,0,0,30.78333333,1,6,11,20,2,5,1,1,3,1,12,30,32,37,43.9
2023-24,202403010DET,3/1/2024,DET vs CLE,Jalen Duren,durenja01,44,DET,1,CLE,14,10,2,0,1,1,30.86666667,4,6,4,7,0,0,6,7,5,1,12,16,24,26,31
2023-24,202403010TOR,3/1/2024,TOR vs GSW,RJ Barrett,barrerj01,49,TOR,1,GSW,23,2,4,0,0,2,31.26666667,0,2,9,15,2,4,3,4,1,0,6,27,25,29,29.4
2023-24,202403010DET,3/1/2024,DET vs CLE,Jaden Ivey,iveyja01,55,DET,1,CLE,18,3,4,0,1,1,31.45,1,2,6,17,1,9,5,6,6,1,7,22,21,25,29.6
2023-24,202403010TOR,3/1/2024,TOR vs GSW,Moses Moody,moodymo01,45,GSW,0,TOR,17,5,1,2,2,1,31.56666667,1,4,7,13,3,5,0,0,1,4,6,18,22,23,35.5
2023-24,202403010PHI,3/1/2024,PHI vs CHO,Buddy Hield,hieldbu01,62,PHI,1,CHO,13,3,6,2,0,0,31.93333333,1,2,5,11,3,8,0,0,2,2,9,19,16,22,31.6
2023-24,202403010PHI,3/1/2024,PHI vs CHO,Cody Martin,martico01,28,CHO,0,PHI,12,4,2,0,2,1,32.13333333,1,3,4,9,1,4,3,3,2,2,6,14,16,18,24.8
2023-24,202403010PHI,3/1/2024,PHI vs CHO,Tre Mann,manntr01,22,CHO,0,PHI,9,3,6,0,0,0,32.15,0,3,3,10,1,4,2,2,2,0,9,15,12,18,21.6
2023-24,202403010BOS,3/1/2024,BOS vs DAL,Derrick White,whitede01,55,BOS,1,DAL,13,7,8,1,2,2,32.36666667,1,6,5,10,3,6,0,0,2,3,15,21,20,28,40.4
2023-24,202403010CHI,3/1/2024,CHI vs MIL,DeMar DeRozan,derozde01,58,CHI,1,MIL,12,4,9,0,1,0,32.73333333,1,3,5,13,0,0,2,2,3,1,13,21,16,25,33.3
2023-24,202403010MIN,3/1/2024,MIN vs SAC,Kevin Huerter,huertke01,57,SAC,0,MIN,8,6,4,0,0,1,32.81666667,2,4,3,12,2,7,0,0,3,0,10,12,14,18,20.2
2023-24,202403010DET,3/1/2024,DET vs CLE,Isaiah Stewart,stewais01,37,DET,1,CLE,16,9,3,0,3,0,33.03333333,1,8,6,12,4,7,0,0,1,3,12,19,25,28,40.3
2023-24,202403010MIN,3/1/2024,MIN vs SAC,Malik Monk,monkma01,58,SAC,0,MIN,39,4,4,1,0,2,33.23333333,0,4,16,29,5,8,2,4,3,1,8,43,43,47,50.8
2023-24,202403010MEM,3/1/2024,MEM vs POR,Jerami Grant,grantje01,51,POR,0,MEM,10,2,5,0,0,1,33.31666667,0,2,4,10,2,5,0,0,1,0,7,15,12,17,18.9
2023-24,202403010CHI,3/1/2024,CHI vs MIL,Damian Lillard,lillada01,56,MIL,0,CHI,16,3,7,0,0,3,33.43333333,0,3,4,18,3,10,5,5,2,0,10,23,19,26,27.1
2023-24,202403010MEM,3/1/2024,MEM vs POR,Jordan Goodwin,goodwjo01,44,MEM,1,POR,10,3,2,2,4,3,33.73333333,2,1,4,13,1,5,1,2,1,6,5,12,13,15,31.6
2023-24,202403010CHI,3/1/2024,CHI vs MIL,Nikola Vucevic,vucevni01,55,CHI,1,MIL,17,9,3,0,0,1,34.06666667,2,7,8,18,1,3,0,0,3,0,12,20,26,29,31.3
2023-24,202403010DET,3/1/2024,DET vs CLE,Jarrett Allen,allenja01,54,CLE,0,DET,9,15,2,1,1,2,34.56666667,4,11,1,7,0,0,7,8,1,2,17,11,24,26,34
2023-24,202403010DET,3/1/2024,DET vs CLE,Max Strus,strusma01,59,CLE,0,DET,14,4,4,0,0,2,34.6,2,2,4,11,2,7,4,4,3,0,8,18,18,22,22.8
2023-24,202403010DET,3/1/2024,DET vs CLE,Evan Mobley,mobleev01,36,CLE,0,DET,22,17,7,2,2,1,34.93333333,4,13,7,13,0,1,8,11,3,4,24,29,39,46,63.9
2023-24,202403010BOS,3/1/2024,BOS vs DAL,P.J. Washington,washipj01,52,DAL,0,BOS,17,7,0,0,1,0,35.21666667,2,5,7,16,3,9,0,0,2,1,7,17,24,24,28.4
2023-24,202403010MIN,3/1/2024,MIN vs SAC,Mike Conley,conlemi01,55,MIN,1,SAC,14,3,8,2,0,3,35.55,0,3,4,8,1,3,5,6,3,2,11,22,17,25,32.6
2023-24,202403010TOR,3/1/2024,TOR vs GSW,Immanuel Quickley,quickim01,55,TOR,1,GSW,12,5,11,1,1,3,36.06666667,0,5,4,15,3,11,1,2,0,2,16,23,17,28,37.5
2023-24,202403010DET,3/1/2024,DET vs CLE,Darius Garland,garlada01,35,CLE,0,DET,29,5,4,1,0,5,36.13333333,1,4,9,21,8,12,3,3,4,1,9,33,34,38,39
2023-24,202403010MIN,3/1/2024,MIN vs SAC,Naz Reid,reidna01,60,MIN,1,SAC,18,7,3,1,0,1,36.13333333,2,5,8,18,1,6,1,1,0,1,10,21,25,28,32.9
2023-24,202403010PHI,3/1/2024,PHI vs CHO,Kyle Lowry,lowryky01,41,PHI,1,CHO,15,6,10,0,0,2,36.45,1,5,5,9,3,6,2,2,3,0,16,25,21,31,35.2
2023-24,202403010MIN,3/1/2024,MIN vs SAC,Karl-Anthony Towns,townska01,58,MIN,1,SAC,19,6,5,1,0,3,36.51666667,2,4,7,17,1,6,4,5,6,1,11,24,25,30,33.7
2023-24,202403010BOS,3/1/2024,BOS vs DAL,Luka Doncic,doncilu01,52,DAL,0,BOS,37,12,11,0,0,2,36.55,3,9,14,25,3,9,6,8,3,0,23,48,49,60,65.9
2023-24,202403010DET,3/1/2024,DET vs CLE,Ausar Thompson,thompau01,59,DET,1,CLE,15,7,3,5,2,1,36.66666667,1,6,6,11,2,3,1,2,0,7,10,18,22,25,47.9
2023-24,202403010BOS,3/1/2024,BOS vs DAL,Kyrie Irving,irvinky01,38,DAL,0,BOS,19,4,2,0,0,1,36.81666667,2,2,9,23,1,7,0,0,1,0,6,21,23,25,25.8
2023-24,202403010DET,3/1/2024,DET vs CLE,Cade Cunningham,cunnica01,49,DET,1,CLE,21,3,10,1,0,1,36.83333333,0,3,6,19,2,8,7,7,3,1,13,31,24,34,41.6
2023-24,202403010BOS,3/1/2024,BOS vs DAL,Jayson Tatum,tatumja01,56,BOS,1,DAL,32,8,3,0,0,4,37.16666667,0,8,10,19,5,9,7,7,2,0,11,35,40,43,42.1
2023-24,202403010CHI,3/1/2024,CHI vs MIL,Giannis Antetokounmpo,antetgi01,59,MIL,0,CHI,46,16,6,1,1,1,37.31666667,5,11,16,22,2,3,12,16,3,2,22,52,62,68,79.2
2023-24,202403010CHI,3/1/2024,CHI vs MIL,Ayo Dosunmu,dosunay01,58,CHI,1,MIL,15,5,6,0,0,3,37.95,0,5,6,12,2,6,1,1,2,0,11,21,20,26,27
2023-24,202403010CHI,3/1/2024,CHI vs MIL,Coby White,whiteco01,60,CHI,1,MIL,22,3,2,0,0,2,38.01666667,0,3,7,14,2,5,6,6,2,0,5,24,25,27,26.6
2023-24,202403010PHI,3/1/2024,PHI vs CHO,Miles Bridges,bridgmi02,49,CHO,0,PHI,27,11,2,0,0,1,39.13333333,1,10,10,18,5,7,2,2,0,0,13,29,38,40,42.2
2023-24,202403010PHI,3/1/2024,PHI vs CHO,Tyrese Maxey,maxeyty01,54,PHI,1,CHO,33,6,5,0,1,0,39.13333333,2,4,11,29,5,10,6,6,1,1,11,38,39,44,50.7
2023-24,202403010PHI,3/1/2024,PHI vs CHO,Tobias Harris,harrito02,53,PHI,1,CHO,31,12,4,2,1,0,40.36666667,2,10,13,19,5,8,0,0,2,3,16,35,43,47,60.4
2023-24,202403010MIN,3/1/2024,MIN vs SAC,Harrison Barnes,barneha02,59,SAC,0,MIN,14,2,0,1,0,1,40.7,0,2,6,12,2,5,0,2,3,1,2,14,16,16,18.4
2023-24,202403010MIN,3/1/2024,MIN vs SAC,Domantas Sabonis,sabondo01,59,SAC,0,MIN,21,15,8,0,3,1,40.91666667,5,10,7,14,1,2,6,10,6,3,23,29,36,44,59
2023-24,202403010MIN,3/1/2024,MIN vs SAC,Rudy Gobert,goberru01,58,MIN,1,SAC,16,16,1,0,3,1,42.05,2,14,6,9,0,0,4,8,5,3,17,17,32,33,44.7
2023-24,202403010MIN,3/1/2024,MIN vs SAC,Keegan Murray,murrake02,55,SAC,0,MIN,17,5,1,2,1,1,42.81666667,1,4,7,15,1,3,2,2,1,3,6,18,22,23,32.5
2023-24,202403010MIN,3/1/2024,MIN vs SAC,Jaden McDaniels,mcdanja02,50,MIN,1,SAC,26,7,1,0,0,1,44.58333333,1,6,9,11,5,7,3,4,5,0,8,27,33,34,34.9
2023-24,202402290PHO,2/29/2024,PHO vs HOU,Jock Landale,landajo01,33,HOU,0,PHO,8,6,0,0,2,0,10,5,1,2,4,0,0,4,5,3,2,6,8,14,14,21.2
2023-24,202402290SAS,2/29/2024,SAS vs OKC,Kenrich Williams,willike04,48,OKC,0,SAS,0,1,1,0,0,1,10.58333333,1,0,0,1,0,1,0,0,0,0,2,1,1,2,1.7
2023-24,202402290NYK,2/29/2024,NYK vs GSW,Dario Saric,saricda01,56,GSW,0,NYK,0,3,3,0,0,0,10.68333333,3,0,0,3,0,3,0,0,1,0,6,3,3,6,8.1
2023-24,202402290BRK,2/29/2024,BRK vs ATL,Garrison Mathews,mathega01,43,ATL,0,BRK,0,3,1,0,0,0,10.76666667,1,2,0,4,0,3,0,0,0,0,4,1,3,4,5.1
2023-24,202402290LAL,2/29/2024,LAL vs WAS,Jaxson Hayes,hayesja02,51,LAL,1,WAS,6,5,0,0,0,0,10.91666667,1,4,3,4,0,0,0,0,0,0,5,6,11,11,12
2023-24,202402290NYK,2/29/2024,NYK vs GSW,Alec Burks,burksal01,51,NYK,1,GSW,5,2,1,0,0,0,11.21666667,1,1,2,6,1,3,0,0,0,0,3,6,7,8,8.9
2023-24,202402290PHO,2/29/2024,PHO vs HOU,Josh Okogie,okogijo01,53,PHO,1,HOU,3,2,0,1,0,0,11.3,2,0,1,4,1,2,0,0,0,1,2,3,5,5,8.4
2023-24,202402290NYK,2/29/2024,NYK vs GSW,Trayce Jackson-Davis,jackstr02,45,GSW,0,NYK,6,1,1,0,0,1,11.46666667,0,1,3,4,0,0,0,2,2,0,2,7,7,8,7.7
2023-24,202402290ORL,2/29/2024,ORL vs UTA,Luka Samanic,samanlu01,28,UTA,0,ORL,8,4,0,0,0,0,11.5,0,4,3,6,1,3,1,1,2,0,4,8,12,12,12.8
2023-24,202402290SAS,2/29/2024,SAS vs OKC,Jaylin Williams,willija07,50,OKC,0,SAS,6,2,0,0,0,1,11.76666667,1,1,2,6,1,3,1,1,1,0,2,6,8,8,7.4
2023-24,202402290SAS,2/29/2024,SAS vs OKC,Aaron Wiggins,wiggiaa01,56,OKC,0,SAS,4,3,1,0,0,2,11.83333333,1,2,2,3,0,0,0,0,1,0,4,5,7,8,7.1
2023-24,202402290PHO,2/29/2024,PHO vs HOU,Jeff Green,greenje02,57,HOU,0,PHO,3,1,0,1,0,0,12.3,1,0,1,4,1,1,0,2,0,1,1,3,4,4,7.2
2023-24,202402290DEN,2/29/2024,DEN vs MIA,Orlando Robinson,robinor01,25,MIA,0,DEN,0,3,1,0,0,1,12.31666667,1,2,0,0,0,0,0,0,0,0,4,1,3,4,4.1
2023-24,202402290CHO,2/29/2024,CHO vs MIL,Danilo Gallinari,gallida01,36,MIL,0,CHO,2,1,1,0,0,0,12.4,1,0,1,3,0,1,0,0,1,0,2,3,3,4,4.7
2023-24,202402290SAS,2/29/2024,SAS vs OKC,Gordon Hayward,haywago01,30,OKC,0,SAS,0,1,1,0,0,0,12.43333333,0,1,0,3,0,0,0,0,1,0,2,1,1,2,2.7
2023-24,202402290BRK,2/29/2024,BRK vs ATL,Wesley Matthews,matthwe02,22,ATL,0,BRK,5,5,0,0,2,0,13.56666667,0,5,2,2,1,1,0,1,1,2,5,5,10,10,17
2023-24,202402290ORL,2/29/2024,ORL vs UTA,Caleb Houstan,houstca01,43,ORL,1,UTA,3,2,1,0,2,0,13.68333333,0,2,1,4,1,4,0,0,3,2,3,4,5,6,12.9
2023-24,202402290ORL,2/29/2024,ORL vs UTA,Brice Sensabaugh,sensabr01,10,UTA,0,ORL,2,1,1,0,0,3,13.8,0,1,0,2,0,2,2,2,4,0,2,3,3,4,1.7
2023-24,202402290LAL,2/29/2024,LAL vs WAS,Richaun Holmes,holmeri01,29,WAS,0,LAL,7,3,0,0,0,1,13.93333333,2,1,3,4,1,1,0,0,4,0,3,7,10,10,9.6
2023-24,202402290DEN,2/29/2024,DEN vs MIA,Jamal Murray,murraja01,44,DEN,1,MIA,6,1,3,0,0,1,14.11666667,0,1,2,6,2,3,0,0,1,0,4,9,7,10,10.7
2023-24,202402290ORL,2/29/2024,ORL vs UTA,Joe Ingles,inglejo01,46,ORL,1,UTA,5,0,2,0,0,0,14.18333333,0,0,2,4,1,2,0,0,0,0,2,7,5,7,8
2023-24,202402290CHO,2/29/2024,CHO vs MIL,Davis Bertans,bertada01,21,CHO,1,MIL,8,0,0,0,0,0,14.51666667,0,0,2,3,2,3,2,3,1,0,0,8,8,8,8
2023-24,202402290SAS,2/29/2024,SAS vs OKC,Cedi Osman,osmande01,60,SAS,1,OKC,3,0,3,2,0,1,14.55,0,0,1,4,1,3,0,0,3,2,3,6,3,6,12.5
2023-24,202402290DEN,2/29/2024,DEN vs MIA,Peyton Watson,watsope01,58,DEN,1,MIA,0,0,0,1,0,1,15.01666667,0,0,0,4,0,1,0,0,1,1,0,0,0,0,2
2023-24,202402290CHO,2/29/2024,CHO vs MIL,Vasilije Micic,micicva01,38,CHO,1,MIL,2,1,7,0,0,1,15.46666667,0,1,1,5,0,4,0,0,0,0,8,9,3,10,12.7
2023-24,202402290SAS,2/29/2024,SAS vs OKC,Cason Wallace,wallaca01,59,OKC,0,SAS,3,3,3,4,0,0,15.48333333,1,2,1,3,0,1,1,1,1,4,6,6,6,9,23.1
2023-24,202402290BRK,2/29/2024,BRK vs ATL,Lonnie Walker IV,walkelo01,39,BRK,1,ATL,11,2,0,1,0,1,15.5,0,2,4,9,3,6,0,0,5,1,2,11,13,13,15.4
2023-24,202402290SAS,2/29/2024,SAS vs OKC,Zach Collins,colliza01,48,SAS,1,OKC,13,5,5,0,1,1,15.63333333,3,2,5,7,1,1,2,3,1,1,10,18,18,23,28.5
2023-24,202402290PHO,2/29/2024,PHO vs HOU,Drew Eubanks,eubandr01,53,PHO,1,HOU,4,7,0,0,1,2,15.78333333,1,6,1,2,0,0,2,2,0,1,7,4,11,11,13.4
2023-24,202402290CHO,2/29/2024,CHO vs MIL,Seth Curry,curryse01,43,CHO,1,MIL,13,2,1,1,0,2,16.33333333,0,2,5,7,2,3,1,1,2,1,3,14,15,16,17.9
2023-24,202402290LAL,2/29/2024,LAL vs WAS,Landry Shamet,shamela01,42,WAS,0,LAL,4,1,1,0,0,1,16.48333333,0,1,2,7,0,4,0,0,0,0,2,5,5,6,5.7
2023-24,202402290LAL,2/29/2024,LAL vs WAS,Johnny Davis,davisjo06,28,WAS,0,LAL,0,2,0,0,0,0,16.68333333,1,1,0,3,0,0,0,0,0,0,2,0,2,2,2.4
2023-24,202402290LAL,2/29/2024,LAL vs WAS,Taurean Prince,princta02,59,LAL,1,WAS,2,2,3,0,0,1,17.35,0,2,1,2,0,0,0,0,1,0,5,5,4,7,7.9
2023-24,202402290BRK,2/29/2024,BRK vs ATL,Bruno Fernando,fernabr01,22,ATL,0,BRK,2,3,1,2,0,1,18.1,1,2,1,3,0,0,0,0,2,2,4,3,5,6,12.1
2023-24,202402290ORL,2/29/2024,ORL vs UTA,Markelle Fultz,fultzma01,24,ORL,1,UTA,7,3,3,2,0,0,18.1,1,2,1,4,0,0,5,6,2,2,6,10,10,13,21.1
2023-24,202402290NYK,2/29/2024,NYK vs GSW,Bojan Bogdanovic,bogdabo02,35,NYK,1,GSW,4,3,1,0,0,1,18.46666667,0,3,0,7,0,4,4,4,0,0,4,5,7,8,8.1
2023-24,202402290SAS,2/29/2024,SAS vs OKC,Josh Giddey,giddejo01,58,OKC,0,SAS,2,2,2,0,0,1,18.48333333,0,2,1,5,0,3,0,0,1,0,4,4,4,6,6.4
2023-24,202402290BRK,2/29/2024,BRK vs ATL,Kobe Bufkin,bufkiko01,8,ATL,0,BRK,12,3,3,0,0,2,18.66666667,0,3,5,11,2,5,0,0,1,0,6,15,15,18,18.1
2023-24,202402290SAS,2/29/2024,SAS vs OKC,Julian Champagnie,champju02,53,SAS,1,OKC,6,2,1,0,0,0,18.66666667,0,2,1,3,1,3,3,3,1,0,3,7,8,9,9.9
2023-24,202402290SAS,2/29/2024,SAS vs OKC,Malaki Branham,branhma01,55,SAS,1,OKC,6,2,2,0,0,2,19.43333333,0,2,3,7,0,1,0,0,3,0,4,8,8,10,9.4
2023-24,202402290NYK,2/29/2024,NYK vs GSW,Isaiah Hartenstein,harteis01,54,NYK,1,GSW,6,6,2,1,0,2,19.75,0,6,2,5,0,0,2,2,2,1,8,8,12,14,17.2
2023-24,202402290BRK,2/29/2024,BRK vs ATL,Day'Ron Sharpe,sharpda01,44,BRK,1,ATL,12,8,4,1,1,1,19.85,1,7,5,7,2,2,0,0,2,2,12,16,20,24,32.6
2023-24,202402290DEN,2/29/2024,DEN vs MIA,Christian Braun,braunch01,60,DEN,1,MIA,2,2,1,1,1,0,20.23333333,1,1,1,2,0,0,0,1,3,2,3,3,4,5,11.9
2023-24,202402290BRK,2/29/2024,BRK vs ATL,Dennis Smith Jr.,smithde03,43,BRK,1,ATL,10,0,5,1,0,0,20.9,0,0,4,7,1,3,1,2,2,1,5,15,10,15,20.5
2023-24,202402290BRK,2/29/2024,BRK vs ATL,Clint Capela,capelca01,51,ATL,0,BRK,7,6,1,0,4,4,21.15,2,4,3,4,0,0,1,1,4,4,7,8,13,14,23.7
2023-24,202402290ORL,2/29/2024,ORL vs UTA,Kris Dunn,dunnkr01,52,UTA,0,ORL,7,1,2,1,0,1,21.5,0,1,3,7,1,4,0,0,3,1,3,9,8,10,13.2
2023-24,202402290ORL,2/29/2024,ORL vs UTA,Wendell Carter Jr.,cartewe01,34,ORL,1,UTA,6,5,1,0,0,0,22,1,4,2,6,0,0,2,5,2,0,6,7,11,12,13.5
2023-24,202402290NYK,2/29/2024,NYK vs GSW,Jericho Sims,simsje01,33,NYK,1,GSW,10,5,3,0,0,0,22.05,2,3,3,3,0,0,4,5,1,0,8,13,15,18,20.5
2023-24,202402290NYK,2/29/2024,NYK vs GSW,Miles McBride,mcbrimi01,47,NYK,1,GSW,14,2,1,3,0,0,22.31666667,0,2,6,8,2,3,0,0,2,3,3,15,16,17,26.9
2023-24,202402290CHO,2/29/2024,CHO vs MIL,Jae Crowder,crowdja01,29,MIL,0,CHO,4,2,1,2,0,1,22.61666667,0,2,2,5,0,2,0,0,4,2,3,5,6,7,12.9
2023-24,202402290PHO,2/29/2024,PHO vs HOU,Alperen Sengun,sengual01,58,HOU,0,PHO,8,3,4,0,0,1,22.7,1,2,3,7,0,1,2,2,6,0,7,12,11,15,16.6
2023-24,202402290SAS,2/29/2024,SAS vs OKC,Isaiah Joe,joeis01,55,OKC,0,SAS,15,1,0,0,0,1,22.91666667,1,0,5,8,4,7,1,1,0,0,1,15,16,16,15.2
2023-24,202402290CHO,2/29/2024,CHO vs MIL,Patrick Beverley,beverpa01,55,MIL,0,CHO,9,8,3,0,0,1,23.85,3,5,3,7,1,2,2,2,1,0,11,12,17,20,22.1
2023-24,202402290ORL,2/29/2024,ORL vs UTA,Gary Harris,harriga01,37,ORL,1,UTA,13,4,1,1,1,0,23.86666667,0,4,5,8,3,6,0,0,0,2,5,14,17,18,25.3
2023-24,202402290ORL,2/29/2024,ORL vs UTA,Cole Anthony,anthoco01,59,ORL,1,UTA,9,7,4,1,0,0,24,3,4,4,9,0,2,1,2,3,1,11,13,16,20,26.4
2023-24,202402290CHO,2/29/2024,CHO vs MIL,Pat Connaughton,connapa01,54,MIL,0,CHO,11,1,1,2,0,0,24.33333333,0,1,3,9,2,7,3,3,2,2,2,12,12,13,19.7
2023-24,202402290BRK,2/29/2024,BRK vs ATL,Jalen Wilson,wilsoja03,21,BRK,1,ATL,6,5,2,0,0,1,24.51666667,1,4,2,7,0,2,2,2,2,0,7,8,11,13,14
2023-24,202402290DEN,2/29/2024,DEN vs MIA,Nikola Jovic,jovicni01,25,MIA,0,DEN,7,6,1,2,0,3,24.58333333,0,6,3,8,1,4,0,0,0,2,7,8,13,14,18.7
2023-24,202402290CHO,2/29/2024,CHO vs MIL,Brook Lopez,lopezbr01,57,MIL,0,CHO,11,3,4,0,3,0,24.58333333,0,3,3,9,3,7,2,2,2,3,7,15,14,18,29.6
2023-24,202402290NYK,2/29/2024,NYK vs GSW,Moses Moody,moodymo01,44,GSW,0,NYK,8,4,1,1,1,0,25.56666667,0,4,3,9,0,4,2,4,1,2,5,9,12,13,20.3
2023-24,202402290NYK,2/29/2024,NYK vs GSW,Chris Paul,paulch01,34,GSW,0,NYK,11,4,6,3,0,1,25.56666667,0,4,3,8,2,4,3,4,2,3,10,17,15,21,32.8
2023-24,202402290PHO,2/29/2024,PHO vs HOU,Bol Bol,bolbo01,21,PHO,1,HOU,7,4,0,0,0,0,25.63333333,1,3,3,6,0,2,1,2,3,0,4,7,11,11,11.8
2023-24,202402290NYK,2/29/2024,NYK vs GSW,Precious Achiuwa,achiupr01,53,NYK,1,GSW,3,8,1,0,2,2,25.7,4,4,1,3,0,1,1,4,2,2,9,4,11,12,18.1
2023-24,202402290LAL,2/29/2024,LAL vs WAS,Spencer Dinwiddie,dinwisp01,55,LAL,1,WAS,10,0,3,0,0,1,25.71666667,0,0,3,5,2,3,2,3,2,0,3,13,10,13,13.5
2023-24,202402290BRK,2/29/2024,BRK vs ATL,De'Andre Hunter,huntede01,35,ATL,0,BRK,12,0,0,1,0,0,25.76666667,0,0,4,8,1,3,3,4,1,1,0,12,12,12,15
2023-24,202402290ORL,2/29/2024,ORL vs UTA,Moritz Wagner,wagnemo01,58,ORL,1,UTA,14,10,1,1,0,2,26,2,8,6,7,0,1,2,3,1,1,11,15,24,25,28.5
2023-24,202402290PHO,2/29/2024,PHO vs HOU,Cam Whitmore,whitmca01,33,HOU,0,PHO,14,8,0,0,1,2,26.71666667,3,5,5,14,0,5,4,4,1,1,8,14,22,22,24.6
2023-24,202402290BRK,2/29/2024,BRK vs ATL,Dorian Finney-Smith,finnedo01,50,BRK,1,ATL,7,3,1,0,0,1,26.75,0,3,3,8,1,6,0,0,0,0,4,8,10,11,11.1
2023-24,202402290DEN,2/29/2024,DEN vs MIA,Jaime Jaquez Jr.,jaqueja01,53,MIA,0,DEN,3,4,5,2,0,3,26.76666667,1,3,1,5,0,1,1,2,1,2,9,8,7,12,18.3
2023-24,202402290NYK,2/29/2024,NYK vs GSW,Draymond Green,greendr01,34,GSW,0,NYK,7,10,6,0,1,2,26.8,4,6,3,4,0,0,1,2,3,1,16,13,17,23,29
2023-24,202402290NYK,2/29/2024,NYK vs GSW,Klay Thompson,thompkl01,55,GSW,0,NYK,16,5,0,0,0,2,26.81666667,1,4,6,16,4,10,0,0,1,0,5,16,21,21,20
2023-24,202402290CHO,2/29/2024,CHO vs MIL,Nick Richards,richani01,50,CHO,1,MIL,9,8,0,0,0,1,26.83333333,2,6,3,4,0,1,3,4,3,0,8,9,17,17,17.6
2023-24,202402290PHO,2/29/2024,PHO vs HOU,Jusuf Nurkic,nurkiju01,55,PHO,1,HOU,16,13,2,1,3,7,27.08333333,5,8,4,10,0,1,8,16,6,4,15,18,29,31,39.6
2023-24,202402290BRK,2/29/2024,BRK vs ATL,Dennis Schroder,schrode01,59,BRK,1,ATL,23,8,7,0,0,2,27.1,1,7,9,15,5,7,0,0,0,0,15,30,31,38,41.1
2023-24,202402290ORL,2/29/2024,ORL vs UTA,Taylor Hendricks,hendrita0,21,UTA,0,ORL,10,7,1,1,1,1,27.43333333,2,5,3,6,2,4,2,2,4,2,8,11,17,18,24.9
2023-24,202402290LAL,2/29/2024,LAL vs WAS,Corey Kispert,kispeco01,57,WAS,0,LAL,20,6,6,1,0,2,27.45,2,4,8,15,2,7,2,2,2,1,12,26,26,32,37.2
2023-24,202402290CHO,2/29/2024,CHO vs MIL,Bobby Portis,portibo01,60,MIL,0,CHO,14,10,4,3,0,1,27.98333333,1,9,5,11,0,3,4,5,0,3,14,18,24,28,40
2023-24,202402290CHO,2/29/2024,CHO vs MIL,Malik Beasley,beaslma01,58,MIL,0,CHO,19,2,0,0,0,0,28.08333333,0,2,7,12,5,9,0,0,1,0,2,19,21,21,21.4
2023-24,202402290BRK,2/29/2024,BRK vs ATL,Nic Claxton,claxtni01,49,BRK,1,ATL,5,8,2,0,1,0,28.15,2,6,1,6,0,0,3,4,1,1,10,7,13,15,20.6
2023-24,202402290DEN,2/29/2024,DEN vs MIA,Caleb Martin,martica02,42,MIA,0,DEN,13,9,1,0,1,2,28.28333333,3,6,5,10,2,3,1,1,4,1,10,14,22,23,26.3
2023-24,202402290CHO,2/29/2024,CHO vs MIL,Cody Martin,martico01,27,CHO,1,MIL,5,2,5,0,2,1,28.66666667,1,1,2,6,1,3,0,0,3,2,7,10,7,12,19.9
2023-24,202402290ORL,2/29/2024,ORL vs UTA,Jalen Suggs,suggsja01,55,ORL,1,UTA,15,2,2,1,1,3,29.08333333,0,2,5,8,4,7,1,2,6,2,4,17,17,19,23.4
2023-24,202402290DEN,2/29/2024,DEN vs MIA,Reggie Jackson,jacksre01,60,DEN,1,MIA,6,2,2,1,0,1,29.35,0,2,3,10,0,5,0,0,5,1,4,8,8,10,13.4
2023-24,202402290CHO,2/29/2024,CHO vs MIL,Tre Mann,manntr01,21,CHO,1,MIL,9,7,4,2,0,1,29.36666667,1,6,4,10,1,5,0,0,1,2,11,13,16,20,28.4
2023-24,202402290ORL,2/29/2024,ORL vs UTA,Collin Sexton,sextoco01,60,UTA,0,ORL,19,3,4,1,0,1,29.81666667,0,3,5,12,3,5,6,10,0,1,7,23,22,26,30.6
2023-24,202402290CHO,2/29/2024,CHO vs MIL,Grant Williams,willigr01,55,CHO,1,MIL,17,5,3,0,1,2,29.93333333,1,4,5,8,3,6,4,6,3,1,8,20,22,25,28.5
2023-24,202402290BRK,2/29/2024,BRK vs ATL,Saddiq Bey,beysa01,58,ATL,0,BRK,6,5,3,0,0,0,30.03333333,3,2,2,9,0,2,2,2,1,0,8,9,11,14,16.5
2023-24,202402290NYK,2/29/2024,NYK vs GSW,Jonathan Kuminga,kuminjo01,57,GSW,0,NYK,25,8,2,2,2,1,30.11666667,5,3,12,19,0,1,1,2,3,4,10,27,33,35,48.6
2023-24,202402290BRK,2/29/2024,BRK vs ATL,Cameron Johnson,johnsca02,46,BRK,1,ATL,29,1,4,2,0,2,30.3,1,0,10,15,7,11,2,3,0,2,5,33,30,34,40.2
2023-24,202402290PHO,2/29/2024,PHO vs HOU,Dillon Brooks,brookdi01,50,HOU,0,PHO,6,8,1,1,0,2,30.7,3,5,3,11,0,6,0,0,1,1,9,7,14,15,18.1
2023-24,202402290ORL,2/29/2024,ORL vs UTA,Keyonte George,georgke01,54,UTA,0,ORL,19,3,9,1,0,2,31.11666667,0,3,5,12,2,4,7,7,0,1,12,28,22,31,37.1
2023-24,202402290SAS,2/29/2024,SAS vs OKC,Keldon Johnson,johnske04,56,SAS,1,OKC,10,2,4,0,0,1,31.2,1,1,3,10,2,7,2,2,3,0,6,14,12,16,17.4
2023-24,202402290NYK,2/29/2024,NYK vs GSW,Stephen Curry,curryst01,55,GSW,0,NYK,31,11,1,1,0,3,31.56666667,2,9,11,26,8,18,1,1,0,1,12,32,42,43,45.7
2023-24,202402290BRK,2/29/2024,BRK vs ATL,Dejounte Murray,murrade01,56,ATL,0,BRK,28,6,5,0,0,2,31.83333333,0,6,11,19,2,5,4,7,1,0,11,33,34,39,40.7
2023-24,202402290SAS,2/29/2024,SAS vs OKC,Jeremy Sochan,sochaje01,60,SAS,1,OKC,21,10,0,0,0,1,31.98333333,2,8,8,14,3,6,2,2,4,0,10,21,31,31,32
2023-24,202402290NYK,2/29/2024,NYK vs GSW,Brandin Podziemski,podzibr01,52,GSW,0,NYK,2,3,4,1,0,0,32.21666667,1,2,1,6,0,4,0,1,1,1,7,6,5,9,14.6
2023-24,202402290BRK,2/29/2024,BRK vs ATL,Bogdan Bogdanovic,bogdabo01,57,ATL,0,BRK,11,3,3,0,0,0,32.3,0,3,4,13,1,5,2,2,2,0,6,14,14,17,19.1
2023-24,202402290SAS,2/29/2024,SAS vs OKC,Victor Wembanyama,wembavi01,54,SAS,1,OKC,28,13,7,2,5,2,32.36666667,3,10,9,17,5,7,5,7,2,7,20,35,41,48,73.1
2023-24,202402290BRK,2/29/2024,BRK vs ATL,Jalen Johnson,johnsja05,45,ATL,0,BRK,14,5,0,0,2,2,32.63333333,1,4,5,12,1,4,3,4,1,2,5,14,19,19,24
2023-24,202402290DEN,2/29/2024,DEN vs MIA,Terry Rozier,roziete01,42,MIA,0,DEN,19,5,4,1,0,3,32.76666667,0,5,6,15,1,8,6,6,1,1,9,23,24,28,31
2023-24,202402290SAS,2/29/2024,SAS vs OKC,Jalen Williams,willija06,53,OKC,0,SAS,26,6,3,1,0,1,32.9,0,6,10,18,1,5,5,5,2,1,9,29,32,35,39.7
2023-24,202402290SAS,2/29/2024,SAS vs OKC,Chet Holmgren,holmgch01,59,OKC,0,SAS,23,7,5,0,1,1,33.13333333,0,7,8,12,1,4,6,6,1,1,12,28,30,35,40.9
2023-24,202402290SAS,2/29/2024,SAS vs OKC,Luguentz Dort,dortlu01,57,OKC,0,SAS,8,4,0,0,0,0,33.16666667,1,3,3,8,1,6,1,1,3,0,4,8,12,12,12.8
2023-24,202402290SAS,2/29/2024,SAS vs OKC,Tre Jones,jonestr01,55,SAS,1,OKC,17,6,8,1,0,0,33.18333333,1,5,6,9,3,5,2,2,2,1,14,25,23,31,39.2
2023-24,202402290CHO,2/29/2024,CHO vs MIL,Giannis Antetokounmpo,antetgi01,58,MIL,0,CHO,24,10,5,0,0,1,33.45,2,8,10,15,2,2,2,3,3,0,15,29,34,39,42.5
2023-24,202402290ORL,2/29/2024,ORL vs UTA,Lauri Markkanen,markkla01,50,UTA,0,ORL,18,3,0,1,0,1,33.58333333,2,1,6,15,4,7,2,2,2,1,3,18,21,21,23.6
2023-24,202402290LAL,2/29/2024,LAL vs WAS,Marvin Bagley III,baglema01,42,WAS,0,LAL,23,4,1,0,2,1,33.68333333,1,3,11,14,1,1,0,1,3,2,5,24,27,28,34.3
2023-24,202402290BRK,2/29/2024,BRK vs ATL,Mikal Bridges,bridgmi01,59,BRK,1,ATL,15,7,5,1,1,0,33.85,2,5,6,14,3,9,0,0,1,2,12,20,22,27,36.9
2023-24,202402290ORL,2/29/2024,ORL vs UTA,Franz Wagner,wagnefr01,52,ORL,1,UTA,14,3,6,2,2,4,34.03333333,2,1,6,11,0,4,2,2,2,4,9,20,17,23,34.6
2023-24,202402290CHO,2/29/2024,CHO vs MIL,Damian Lillard,lillada01,55,MIL,0,CHO,17,6,2,2,0,2,34.08333333,1,5,5,14,3,6,4,5,2,2,8,19,23,25,31.2
2023-24,202402290DEN,2/29/2024,DEN vs MIA,Kentavious Caldwell-Pope,caldwke01,55,DEN,1,MIA,18,2,2,1,1,1,34.35,1,1,5,11,4,8,4,4,4,2,4,20,20,22,28.4
2023-24,202402290SAS,2/29/2024,SAS vs OKC,Shai Gilgeous-Alexander,gilgesh01,58,OKC,0,SAS,31,6,3,1,1,1,34.81666667,1,5,12,22,1,1,6,7,4,2,9,34,37,40,47.7
2023-24,202402290ORL,2/29/2024,ORL vs UTA,Paolo Banchero,banchpa01,58,ORL,1,UTA,29,9,6,1,0,6,35.05,1,8,10,16,1,4,8,11,1,1,15,35,38,44,45.8
2023-24,202402290LAL,2/29/2024,LAL vs WAS,Rui Hachimura,hachiru01,48,LAL,1,WAS,8,7,1,2,0,0,35.15,2,5,4,11,0,2,0,0,3,2,8,9,15,16,23.9
2023-24,202402290ORL,2/29/2024,ORL vs UTA,John Collins,collijo01,56,UTA,0,ORL,19,10,1,1,0,2,35.61666667,3,7,7,10,2,3,3,4,5,1,11,20,29,30,33.5
2023-24,202402290ORL,2/29/2024,ORL vs UTA,Jordan Clarkson,clarkjo01,50,UTA,0,ORL,5,5,7,2,0,2,35.63333333,0,5,2,10,1,5,0,0,2,2,12,12,10,17,25.5
2023-24,202402290DEN,2/29/2024,DEN vs MIA,Bam Adebayo,adebaba01,49,MIA,0,DEN,22,8,3,1,0,1,35.68333333,1,7,8,18,0,0,6,6,5,1,11,25,30,33,38.1
2023-24,202402290PHO,2/29/2024,PHO vs HOU,Grayson Allen,allengr01,53,PHO,1,HOU,6,4,0,0,0,0,35.9,0,4,2,9,2,9,0,0,4,0,4,6,10,10,10.8
2023-24,202402290DEN,2/29/2024,DEN vs MIA,Duncan Robinson,robindu01,54,MIA,0,DEN,12,3,3,3,0,1,35.96666667,0,3,5,9,2,6,0,0,4,3,6,15,15,18,28.1
2023-24,202402290NYK,2/29/2024,NYK vs GSW,Donte DiVincenzo,divindo01,59,NYK,1,GSW,16,7,2,1,1,3,36.13333333,5,2,6,21,2,12,2,4,2,2,9,18,23,25,30.4
2023-24,202402290LAL,2/29/2024,LAL vs WAS,Tyus Jones,jonesty01,59,WAS,0,LAL,8,1,11,2,0,3,36.65,0,1,3,7,1,3,1,1,0,2,12,19,9,20,28.7
2023-24,202402290PHO,2/29/2024,PHO vs HOU,Royce O'Neale,onealro01,56,PHO,1,HOU,11,6,7,3,1,1,37.06666667,1,5,3,10,3,9,2,2,3,4,13,18,17,24,39.7
2023-24,202402290NYK,2/29/2024,NYK vs GSW,Jalen Brunson,brunsja01,56,NYK,1,GSW,27,5,5,0,0,4,37.18333333,1,4,11,25,4,7,1,1,4,0,10,32,32,37,36.5
2023-24,202402290PHO,2/29/2024,PHO vs HOU,Jabari Smith Jr.,smithja05,54,HOU,0,PHO,11,16,0,1,1,0,37.21666667,3,13,3,11,1,6,4,4,5,2,16,11,27,27,36.2
2023-24,202402290LAL,2/29/2024,LAL vs WAS,Kyle Kuzma,kuzmaky01,57,WAS,0,LAL,20,10,4,1,3,2,37.25,2,8,7,16,4,8,2,2,3,4,14,24,30,34,48
2023-24,202402290DEN,2/29/2024,DEN vs MIA,Aaron Gordon,gordoaa01,54,DEN,1,MIA,16,9,3,3,1,4,37.26666667,2,7,5,8,0,0,6,6,2,4,12,19,25,28,39.3
2023-24,202402290DEN,2/29/2024,DEN vs MIA,Nikola Jokic,jokicni01,58,DEN,1,MIA,18,11,7,1,2,4,38,2,9,6,15,0,3,6,6,4,3,18,25,29,36,46.7
2023-24,202402290LAL,2/29/2024,LAL vs WAS,Jordan Poole,poolejo01,57,WAS,0,LAL,34,3,7,1,1,3,38.1,0,3,13,26,5,12,3,4,4,2,10,41,37,44,51.1
2023-24,202402290SAS,2/29/2024,SAS vs OKC,Devin Vassell,vassede01,55,SAS,1,OKC,28,3,9,1,2,1,38.11666667,1,2,12,20,3,6,1,1,1,3,12,37,31,40,53.1
2023-24,202402290DEN,2/29/2024,DEN vs MIA,Michael Porter Jr.,portemi01,59,DEN,1,MIA,30,11,3,2,2,2,38.25,2,9,12,23,4,10,2,2,2,4,14,33,41,44,57.7
2023-24,202402290PHO,2/29/2024,PHO vs HOU,Fred VanVleet,vanvlfr01,52,HOU,0,PHO,21,6,5,0,1,2,38.55,1,5,6,16,2,8,7,7,4,1,11,26,27,32,36.7
2023-24,202402290LAL,2/29/2024,LAL vs WAS,LeBron James,jamesle01,54,LAL,1,WAS,31,4,9,1,1,4,38.73333333,0,4,12,24,2,5,5,7,1,2,13,40,35,44,51.3
2023-24,202402290PHO,2/29/2024,PHO vs HOU,Jalen Green,greenja05,59,HOU,0,PHO,34,5,2,3,0,4,39.13333333,0,5,10,28,7,17,7,7,2,3,7,36,39,41,48
2023-24,202402290PHO,2/29/2024,PHO vs HOU,Devin Booker,bookede01,49,PHO,1,HOU,35,7,3,1,1,1,39.23333333,1,6,13,27,6,11,3,3,4,2,10,38,42,45,52.9
2023-24,202402290CHO,2/29/2024,CHO vs MIL,Miles Bridges,bridgmi02,48,CHO,1,MIL,15,10,3,0,0,4,39.23333333,3,7,6,18,1,7,2,3,3,0,13,18,25,28,27.5
2023-24,202402290LAL,2/29/2024,LAL vs WAS,Austin Reaves,reaveau01,62,LAL,1,WAS,12,6,4,1,1,1,39.4,1,5,6,11,0,2,0,0,3,2,10,16,18,22,30.2
2023-24,202402290CHO,2/29/2024,CHO vs MIL,Brandon Miller,millebr02,53,CHO,1,MIL,21,7,1,0,0,1,39.65,1,6,8,21,2,7,3,3,2,0,8,22,28,29,29.9
2023-24,202402290DEN,2/29/2024,DEN vs MIA,Jimmy Butler,butleji01,40,MIA,0,DEN,21,7,3,1,0,0,40.28333333,3,4,7,17,1,4,6,9,1,1,10,24,28,31,36.9
2023-24,202402290PHO,2/29/2024,PHO vs HOU,Kevin Durant,duranke01,52,PHO,1,HOU,24,7,6,0,0,3,40.41666667,2,5,8,19,1,3,7,10,1,0,13,30,31,37,38.4
2023-24,202402290LAL,2/29/2024,LAL vs WAS,Anthony Davis,davisan02,58,LAL,1,WAS,40,15,4,1,3,1,41.25,3,12,14,22,0,0,12,13,2,4,19,44,55,59,75
2023-24,202402290LAL,2/29/2024,LAL vs WAS,Deni Avdija,avdijde01,56,WAS,0,LAL,15,15,5,1,0,2,43.28333333,2,13,5,10,3,5,2,2,3,1,20,20,30,35,41.5
2023-24,202402290LAL,2/29/2024,LAL vs WAS,D'Angelo Russell,russeda01,57,LAL,1,WAS,22,6,5,1,1,3,43.8,0,6,9,21,4,11,0,0,4,2,11,27,28,33,39.7
2023-24,202402290NYK,2/29/2024,NYK vs GSW,Josh Hart,hartjo01,59,NYK,1,GSW,14,18,7,2,0,0,47.16666667,4,14,4,17,3,9,3,4,2,2,25,21,32,39,52.1
2023-24,202402280DEN,2/28/2024,DEN vs SAC,Kessler Edwards,edwarke02,39,SAC,0,DEN,1,2,0,0,0,0,10.08333333,0,2,0,2,0,0,1,2,1,0,2,1,3,3,3.4
2023-24,202402280LAC,2/28/2024,LAC vs LAL,Jaxson Hayes,hayesja02,50,LAL,0,LAC,0,2,0,0,0,0,10.61666667,0,2,0,0,0,0,0,0,1,0,2,0,2,2,2.4
2023-24,202402280LAC,2/28/2024,LAC vs LAL,P.J. Tucker,tuckepj01,18,LAC,1,LAL,0,2,0,0,0,1,11.11666667,0,2,0,0,0,0,0,0,1,0,2,0,2,2,1.4
2023-24,202402280CHI,2/28/2024,CHI vs CLE,Georges Niang,niangge01,58,CLE,0,CHI,2,1,0,0,0,1,11.13333333,0,1,1,5,0,3,0,0,0,0,1,2,3,3,2.2
2023-24,202402280DEN,2/28/2024,DEN vs SAC,Justin Holiday,holidju01,36,DEN,1,SAC,2,1,0,1,0,1,12.31666667,0,1,1,2,0,1,0,0,0,1,1,2,3,3,5.2
2023-24,202402280DEN,2/28/2024,DEN vs SAC,Mason Jones,jonesma05,1,SAC,0,DEN,1,4,4,0,0,0,13,1,3,0,3,0,2,1,2,0,0,8,5,5,9,11.8
2023-24,202402280CHI,2/28/2024,CHI vs CLE,Jevon Carter,carteje01,56,CHI,1,CLE,4,1,0,1,0,0,13.25,1,0,2,3,0,0,0,0,0,1,1,4,5,5,8.2
2023-24,202402280CHI,2/28/2024,CHI vs CLE,Julian Phillips,phillju01,33,CHI,1,CLE,7,5,2,1,0,0,13.7,3,2,2,6,1,2,2,3,1,1,7,9,12,14,19
2023-24,202402280DEN,2/28/2024,DEN vs SAC,Zeke Nnaji,nnajize01,44,DEN,1,SAC,0,2,0,1,3,0,13.73333333,0,2,0,4,0,1,0,0,2,4,2,0,2,2,14.4
2023-24,202402280CHI,2/28/2024,CHI vs CLE,Dean Wade,wadede01,49,CLE,0,CHI,5,2,1,0,2,0,13.86666667,0,2,1,2,1,2,2,2,1,2,3,6,7,8,14.9
2023-24,202402280TOR,2/28/2024,TOR vs DAL,Derrick Jones Jr.,jonesde02,54,DAL,0,TOR,5,6,1,0,0,0,15.45,0,6,2,5,1,4,0,0,1,0,7,6,11,12,13.7
2023-24,202402280DEN,2/28/2024,DEN vs SAC,Davion Mitchell,mitchda01,48,SAC,0,DEN,5,1,3,1,0,1,15.58333333,0,1,2,5,1,3,0,0,1,1,4,8,6,9,12.7
2023-24,202402280DEN,2/28/2024,DEN vs SAC,Alex Len,lenal01,24,SAC,0,DEN,4,2,0,2,2,1,15.85,2,0,2,4,0,0,0,0,0,4,2,4,6,6,17.4
2023-24,202402280LAC,2/28/2024,LAC vs LAL,Mason Plumlee,plumlma01,26,LAC,1,LAL,8,4,2,1,0,2,15.95,2,2,3,3,0,0,2,4,1,1,6,10,12,14,16.8
2023-24,202402280TOR,2/28/2024,TOR vs DAL,Dante Exum,exumda01,33,DAL,0,TOR,4,3,5,0,0,0,16.68333333,0,3,1,2,1,1,1,2,2,0,8,9,7,12,15.1
2023-24,202402280LAC,2/28/2024,LAC vs LAL,Taurean Prince,princta02,58,LAL,0,LAC,2,2,1,1,0,2,16.93333333,1,1,1,4,0,1,0,0,2,1,3,3,4,5,6.9
2023-24,202402280LAC,2/28/2024,LAC vs LAL,Russell Westbrook,westbru01,57,LAC,1,LAL,8,2,3,3,0,1,17.38333333,1,1,3,9,0,2,2,2,5,3,5,11,10,13,22.9
2023-24,202402280IND,2/28/2024,IND vs NOP,Jordan Hawkins,hawkijo01,53,NOP,0,IND,7,0,2,0,0,1,17.65,0,0,3,5,1,3,0,0,1,0,2,9,7,9,9
2023-24,202402280TOR,2/28/2024,TOR vs DAL,Kelly Olynyk,olynyke01,57,TOR,1,DAL,13,0,2,1,0,3,17.88333333,0,0,5,10,1,2,2,2,4,1,2,15,13,15,16
2023-24,202402280DEN,2/28/2024,DEN vs SAC,Kevin Huerter,huertke01,56,SAC,0,DEN,4,1,2,0,0,3,18.35,0,1,2,5,0,2,0,2,2,0,3,6,5,7,5.2
2023-24,202402280IND,2/28/2024,IND vs NOP,Jalen Smith,smithja04,41,IND,1,NOP,9,7,1,0,1,2,18.36666667,2,5,4,9,0,3,1,1,3,1,8,10,16,17,19.9
2023-24,202402280DEN,2/28/2024,DEN vs SAC,Reggie Jackson,jacksre01,59,DEN,1,SAC,5,1,4,0,0,1,18.63333333,0,1,2,6,1,2,0,0,0,0,5,9,6,10,11.2
2023-24,202402280MIN,2/28/2024,MIN vs MEM,Jake LaRavia,laravja01,14,MEM,0,MIN,5,5,2,0,0,0,18.88333333,1,4,1,4,1,4,2,2,1,0,7,7,10,12,14
2023-24,202402280TOR,2/28/2024,TOR vs DAL,Gradey Dick,dickgr01,38,TOR,1,DAL,7,3,0,0,0,1,18.9,0,3,3,6,1,3,0,0,2,0,3,7,10,10,9.6
2023-24,202402280IND,2/28/2024,IND vs NOP,T.J. McConnell,mccontj01,50,IND,1,NOP,8,4,9,0,0,0,19.06666667,3,1,4,8,0,0,0,0,0,0,13,17,12,21,26.3
2023-24,202402280DEN,2/28/2024,DEN vs SAC,Harrison Barnes,barneha02,58,SAC,0,DEN,7,4,3,0,0,0,19.48333333,1,3,2,6,1,4,2,2,0,0,7,10,11,14,16.3
2023-24,202402280LAC,2/28/2024,LAC vs LAL,Cam Reddish,reddica01,37,LAL,0,LAC,5,3,0,1,0,0,19.61666667,1,2,2,4,1,2,0,0,2,1,3,5,8,8,11.6
2023-24,202402280DEN,2/28/2024,DEN vs SAC,Christian Braun,braunch01,59,DEN,1,SAC,5,3,0,1,0,0,19.98333333,0,3,2,8,1,6,0,0,2,1,3,5,8,8,11.6
2023-24,202402280LAC,2/28/2024,LAC vs LAL,Spencer Dinwiddie,dinwisp01,54,LAL,0,LAC,7,2,6,0,0,2,19.98333333,0,2,3,6,1,4,0,0,0,0,8,13,9,15,16.4
2023-24,202402280DEN,2/28/2024,DEN vs SAC,Peyton Watson,watsope01,57,DEN,1,SAC,6,2,1,0,1,2,20.03333333,1,1,3,6,0,1,0,0,2,1,3,7,8,9,10.9
2023-24,202402280TOR,2/28/2024,TOR vs DAL,Bruce Brown,brownbr01,52,TOR,1,DAL,5,8,3,0,0,0,21.13333333,3,5,0,5,0,2,5,5,2,0,11,8,13,16,19.1
2023-24,202402280MIN,2/28/2024,MIN vs MEM,Monte Morris,morrimo01,13,MIN,1,MEM,5,4,5,0,0,0,21.21666667,0,4,2,7,1,3,0,1,1,0,9,10,9,14,17.3
2023-24,202402280IND,2/28/2024,IND vs NOP,Larry Nance Jr.,nancela02,42,NOP,0,IND,6,6,1,0,1,2,22.55,1,5,3,3,0,0,0,0,1,1,7,7,12,13,15.7
2023-24,202402280DEN,2/28/2024,DEN vs SAC,Trey Lyles,lylestr01,43,SAC,0,DEN,8,5,2,0,0,2,23.33333333,1,4,3,7,1,2,1,1,2,0,7,10,13,15,15
2023-24,202402280TOR,2/28/2024,TOR vs DAL,Dereck Lively II,livelde01,41,DAL,0,TOR,9,4,1,2,5,0,23.4,1,3,4,4,0,0,1,2,1,7,5,10,13,14,36.3
2023-24,202402280MIN,2/28/2024,MIN vs MEM,Nickeil Alexander-Walker,alexani01,59,MIN,1,MEM,12,1,5,0,4,0,23.73333333,0,1,5,10,1,3,1,1,1,4,6,17,13,18,32.7
2023-24,202402280IND,2/28/2024,IND vs NOP,Obi Toppin,toppiob01,61,IND,1,NOP,16,6,2,0,2,0,23.85,2,4,6,9,2,4,2,2,0,2,8,18,22,24,32.2
2023-24,202402280CHI,2/28/2024,CHI vs CLE,Isaac Okoro,okorois01,49,CLE,0,CHI,13,0,2,1,1,0,24.13333333,0,0,5,8,3,5,0,0,1,2,2,15,13,15,22
2023-24,202402280DEN,2/28/2024,DEN vs SAC,Aaron Gordon,gordoaa01,53,DEN,1,SAC,17,6,6,0,0,0,24.4,1,5,7,8,0,1,3,4,0,0,12,23,23,29,33.2
2023-24,202402280DEN,2/28/2024,DEN vs SAC,Michael Porter Jr.,portemi01,58,DEN,1,SAC,14,5,1,0,1,3,24.45,0,5,5,11,2,6,2,2,3,1,6,15,19,20,21.5
2023-24,202402280DEN,2/28/2024,DEN vs SAC,Malik Monk,monkma01,57,SAC,0,DEN,14,5,5,1,0,1,24.56666667,1,4,6,16,2,5,0,0,2,1,10,19,19,24,29.5
2023-24,202402280TOR,2/28/2024,TOR vs DAL,Daniel Gafford,gaffoda01,52,DAL,0,TOR,13,7,1,1,1,4,24.6,4,3,6,7,0,0,1,1,4,2,8,14,20,21,24.9
2023-24,202402280LAC,2/28/2024,LAC vs LAL,Amir Coffey,coffeam01,45,LAC,1,LAL,8,3,3,2,0,1,25.06666667,1,2,3,8,2,6,0,0,3,2,6,11,11,14,21.1
2023-24,202402280TOR,2/28/2024,TOR vs DAL,Tim Hardaway Jr.,hardati02,56,DAL,0,TOR,16,4,4,0,0,0,25.1,0,4,5,13,4,10,2,2,3,0,8,20,20,24,26.8
2023-24,202402280MIN,2/28/2024,MIN vs MEM,Naz Reid,reidna01,59,MIN,1,MEM,19,6,2,0,2,0,25.5,1,5,6,11,4,6,3,3,5,2,8,21,25,27,35.2
2023-24,202402280DEN,2/28/2024,DEN vs SAC,Chris Duarte,duartch01,41,SAC,0,DEN,18,3,1,2,2,0,25.8,0,3,7,14,4,8,0,0,1,4,4,19,21,22,35.1
2023-24,202402280IND,2/28/2024,IND vs NOP,Myles Turner,turnemy01,57,IND,1,NOP,14,10,0,1,2,0,26.55,2,8,5,11,0,2,4,4,5,3,10,14,24,24,35
2023-24,202402280IND,2/28/2024,IND vs NOP,Ben Sheppard,sheppbe01,38,IND,1,NOP,11,1,1,2,1,0,26.61666667,0,1,4,8,3,7,0,0,4,3,2,12,12,13,22.7
2023-24,202402280MIN,2/28/2024,MIN vs MEM,GG Jackson II,jacksgg01,26,MEM,0,MIN,14,3,0,0,0,2,26.83333333,2,1,5,7,2,4,2,2,1,0,3,14,17,17,15.6
2023-24,202402280MIN,2/28/2024,MIN vs MEM,Rudy Gobert,goberru01,57,MIN,1,MEM,8,8,0,1,2,3,27.2,2,6,3,4,0,0,2,4,2,3,8,8,16,16,23.6
2023-24,202402280CHI,2/28/2024,CHI vs CLE,Onuralp Bitim,bitimon01,3,CHI,1,CLE,10,6,0,0,0,2,27.55,0,6,3,4,2,2,2,2,1,0,6,10,16,16,15.2
2023-24,202402280MIN,2/28/2024,MIN vs MEM,Mike Conley,conlemi01,54,MIN,1,MEM,4,5,7,0,0,2,27.95,1,4,1,4,1,4,1,2,1,0,12,11,9,16,18.5
2023-24,202402280IND,2/28/2024,IND vs NOP,Naji Marshall,marshna01,48,NOP,0,IND,0,8,4,1,2,4,28.01666667,0,8,0,0,0,0,0,0,0,3,12,4,8,12,20.6
2023-24,202402280IND,2/28/2024,IND vs NOP,Brandon Ingram,ingrabr01,54,NOP,0,IND,30,6,4,0,0,1,28.56666667,1,5,8,20,1,5,13,13,1,0,10,34,36,40,42.2
2023-24,202402280IND,2/28/2024,IND vs NOP,Andrew Nembhard,nembhan01,46,IND,1,NOP,8,4,1,1,0,1,28.93333333,1,3,3,7,2,2,0,0,1,1,5,9,12,13,16.3
2023-24,202402280DEN,2/28/2024,DEN vs SAC,Kentavious Caldwell-Pope,caldwke01,54,DEN,1,SAC,16,2,4,3,0,0,28.95,1,1,6,10,4,6,0,0,3,3,6,20,18,22,33.4
2023-24,202402280TOR,2/28/2024,TOR vs DAL,Jakob Poeltl,poeltja01,48,TOR,1,DAL,16,7,6,4,2,0,29.16666667,3,4,7,12,0,0,2,3,4,6,13,22,23,29,51.4
2023-24,202402280LAC,2/28/2024,LAC vs LAL,Rui Hachimura,hachiru01,47,LAL,0,LAC,17,2,0,1,0,2,29.45,1,1,8,15,1,5,0,0,2,1,2,17,19,19,20.4
2023-24,202402280IND,2/28/2024,IND vs NOP,Bennedict Mathurin,mathube01,57,IND,1,NOP,16,4,2,0,0,2,29.81666667,2,2,6,17,4,9,0,0,5,0,6,18,20,22,21.8
2023-24,202402280LAC,2/28/2024,LAC vs LAL,Norman Powell,powelno01,56,LAC,1,LAL,14,4,2,1,0,1,30.33333333,0,4,6,15,2,9,0,0,2,1,6,16,18,20,23.8
2023-24,202402280LAC,2/28/2024,LAC vs LAL,Terance Mann,mannte01,51,LAC,1,LAL,16,6,2,1,0,0,30.38333333,1,5,7,9,0,1,2,2,2,1,8,18,22,24,29.2
2023-24,202402280LAC,2/28/2024,LAC vs LAL,Daniel Theis,theisda01,42,LAC,1,LAL,9,5,2,0,1,1,30.81666667,1,4,4,10,1,4,0,0,1,1,7,11,14,16,20
2023-24,202402280TOR,2/28/2024,TOR vs DAL,Josh Green,greenjo02,46,DAL,0,TOR,5,6,1,0,0,2,30.9,2,4,2,4,1,3,0,0,1,0,7,6,11,12,11.7
2023-24,202402280MIN,2/28/2024,MIN vs MEM,Vince Williams Jr.,willivi01,47,MEM,0,MIN,11,6,6,1,1,3,30.93333333,2,4,4,15,1,5,2,2,3,2,12,17,17,23,30.2
2023-24,202402280IND,2/28/2024,IND vs NOP,Trey Murphy III,murphtr02,35,NOP,0,IND,11,4,7,1,0,0,31.28333333,1,3,4,11,2,8,1,1,0,1,11,18,15,22,29.3
2023-24,202402280MIN,2/28/2024,MIN vs MEM,Jordan Goodwin,goodwjo01,43,MEM,0,MIN,5,8,8,2,0,2,31.4,3,5,1,8,1,3,2,2,2,2,16,13,13,21,30.6
2023-24,202402280TOR,2/28/2024,TOR vs DAL,P.J. Washington,washipj01,51,DAL,0,TOR,23,6,0,0,3,2,31.48333333,2,4,9,16,5,10,0,0,1,3,6,23,29,29,37.2
2023-24,202402280IND,2/28/2024,IND vs NOP,Zion Williamson,willizi01,49,NOP,0,IND,23,3,4,0,0,1,31.98333333,1,2,10,20,1,2,2,5,2,0,7,27,26,30,31.6
2023-24,202402280DEN,2/28/2024,DEN vs SAC,Domantas Sabonis,sabondo01,58,SAC,0,DEN,13,10,7,1,0,3,32.13333333,5,5,5,14,0,1,3,4,0,1,17,20,23,30,35.5
2023-24,202402280DEN,2/28/2024,DEN vs SAC,Nikola Jokic,jokicni01,57,DEN,1,SAC,14,14,11,3,1,2,32.31666667,1,13,5,9,0,0,4,4,3,4,25,25,28,39,57.3
2023-24,202402280DEN,2/28/2024,DEN vs SAC,Jamal Murray,murraja01,43,DEN,1,SAC,32,3,6,1,0,5,32.51666667,0,3,13,15,5,6,1,1,0,1,9,38,35,41,42.6
2023-24,202402280TOR,2/28/2024,TOR vs DAL,Gary Trent Jr.,trentga02,54,TOR,1,DAL,11,4,0,1,0,0,32.86666667,0,4,3,8,2,5,3,4,1,1,4,11,15,15,18.8
2023-24,202402280IND,2/28/2024,IND vs NOP,Pascal Siakam,siakapa01,58,IND,1,NOP,24,11,5,0,2,2,32.93333333,2,9,11,18,0,3,2,2,3,2,16,29,35,40,48.7
2023-24,202402280DEN,2/28/2024,DEN vs SAC,Keegan Murray,murrake02,54,SAC,0,DEN,21,4,0,1,1,2,33.45,2,2,9,17,3,7,0,0,4,2,4,21,25,25,29.8
2023-24,202402280MIN,2/28/2024,MIN vs MEM,Jaden McDaniels,mcdanja02,49,MIN,1,MEM,12,2,3,0,3,1,33.55,0,2,5,7,2,4,0,0,5,3,5,15,14,17,26.9
2023-24,202402280IND,2/28/2024,IND vs NOP,Tyrese Haliburton,halibty01,48,IND,1,NOP,17,3,13,1,1,1,33.86666667,0,3,7,15,3,8,0,0,0,2,16,30,20,33,45.1
2023-24,202402280CHI,2/28/2024,CHI vs CLE,Jarrett Allen,allenja01,53,CLE,0,CHI,11,4,4,1,2,0,34.2,1,3,5,12,0,0,1,2,3,3,8,15,15,19,30.8
2023-24,202402280IND,2/28/2024,IND vs NOP,CJ McCollum,mccolcj01,44,NOP,0,IND,23,6,3,0,0,1,34.36666667,2,4,9,21,5,8,0,0,3,0,9,26,29,32,33.7
2023-24,202402280LAC,2/28/2024,LAC vs LAL,D'Angelo Russell,russeda01,56,LAL,0,LAC,18,2,6,0,0,3,34.38333333,0,2,6,10,3,6,3,4,0,0,8,24,20,26,26.4
2023-24,202402280TOR,2/28/2024,TOR vs DAL,RJ Barrett,barrerj01,48,TOR,1,DAL,26,5,6,0,0,1,34.53333333,0,5,9,16,4,6,4,9,0,0,11,32,31,37,40
2023-24,202402280TOR,2/28/2024,TOR vs DAL,Kyrie Irving,irvinky01,37,DAL,0,TOR,29,1,3,2,1,1,35.46666667,0,1,11,20,2,6,5,5,4,3,4,32,30,33,42.7
2023-24,202402280MIN,2/28/2024,MIN vs MEM,Santi Aldama,aldamsa01,47,MEM,0,MIN,11,5,1,2,2,2,35.6,1,4,5,13,1,3,0,0,2,4,6,12,16,17,28.5
2023-24,202402280TOR,2/28/2024,TOR vs DAL,Luka Doncic,doncilu01,51,DAL,0,TOR,30,12,16,2,0,5,35.61666667,1,11,11,23,1,8,7,9,3,2,28,46,42,58,69.4
2023-24,202402280MIN,2/28/2024,MIN vs MEM,Ziaire Williams,willizi02,49,MEM,0,MIN,16,8,2,0,0,1,35.68333333,3,5,6,14,2,6,2,2,2,0,10,18,24,26,27.6
2023-24,202402280LAC,2/28/2024,LAC vs LAL,Austin Reaves,reaveau01,61,LAL,0,LAC,13,8,5,1,0,1,35.83333333,1,7,6,11,1,4,0,0,1,1,13,18,21,26,32.1
2023-24,202402280LAC,2/28/2024,LAC vs LAL,Anthony Davis,davisan02,57,LAL,0,LAC,20,12,2,2,3,2,36.08333333,3,9,8,15,0,2,4,5,2,5,14,22,32,34,50.4
2023-24,202402280CHI,2/28/2024,CHI vs CLE,Andre Drummond,drumman01,59,CHI,1,CLE,17,26,1,0,3,3,36.15,9,17,8,12,0,0,1,2,3,3,27,18,43,44,55.7
2023-24,202402280CHI,2/28/2024,CHI vs CLE,Max Strus,strusma01,58,CLE,0,CHI,11,5,6,1,0,1,36.91666667,2,3,4,13,3,10,0,0,5,1,11,17,16,22,28
2023-24,202402280LAC,2/28/2024,LAC vs LAL,LeBron James,jamesle01,53,LAL,0,LAC,34,6,8,0,2,3,37.01666667,1,5,13,21,7,12,1,1,2,2,14,42,40,48,56.2
2023-24,202402280MIN,2/28/2024,MIN vs MEM,Karl-Anthony Towns,townska01,57,MIN,1,MEM,13,11,2,3,1,4,37.38333333,1,10,5,13,3,7,0,0,1,4,13,15,24,26,37.2
2023-24,202402280MIN,2/28/2024,MIN vs MEM,Jaren Jackson Jr.,jacksja02,54,MEM,0,MIN,33,13,1,3,1,2,37.96666667,4,9,11,23,3,10,8,10,5,4,14,34,46,47,60.1
2023-24,202402280TOR,2/28/2024,TOR vs DAL,Immanuel Quickley,quickim01,54,TOR,1,DAL,28,5,9,2,0,1,38.1,0,5,10,18,5,11,3,4,3,2,14,37,33,42,52.5
2023-24,202402280IND,2/28/2024,IND vs NOP,Herbert Jones,joneshe01,55,NOP,0,IND,14,4,1,0,1,0,38.46666667,1,3,5,9,1,3,3,4,4,1,5,15,18,19,23.3
2023-24,202402280TOR,2/28/2024,TOR vs DAL,Scottie Barnes,barnesc01,59,TOR,1,DAL,19,11,7,3,1,4,38.93333333,5,6,9,22,0,5,1,3,2,4,18,26,30,37,50.7
2023-24,202402280CHI,2/28/2024,CHI vs CLE,Caris LeVert,leverca01,48,CLE,0,CHI,14,7,15,2,2,2,39.06666667,0,7,5,12,3,7,1,2,4,4,22,29,21,36,54.9
2023-24,202402280LAC,2/28/2024,LAC vs LAL,Kawhi Leonard,leonaka01,52,LAC,1,LAL,26,7,6,1,0,1,39.28333333,2,5,11,19,3,6,1,2,1,1,13,32,33,39,45.4
2023-24,202402280MIN,2/28/2024,MIN vs MEM,Anthony Edwards,edwaran01,56,MIN,1,MEM,34,2,4,0,1,3,39.53333333,0,2,11,21,1,6,11,11,3,1,6,38,36,40,42.4
2023-24,202402280LAC,2/28/2024,LAC vs LAL,James Harden,hardeja01,52,LAC,1,LAL,23,3,9,1,0,4,39.66666667,1,2,8,16,2,9,5,6,1,1,12,32,26,35,39.1
2023-24,202402280CHI,2/28/2024,CHI vs CLE,Nikola Vucevic,vucevni01,54,CHI,1,CLE,24,13,5,2,2,4,40.13333333,6,7,10,23,2,6,2,4,6,4,18,29,37,42,55.1
2023-24,202402280CHI,2/28/2024,CHI vs CLE,Evan Mobley,mobleev01,35,CLE,0,CHI,25,13,1,1,4,2,42.2,2,11,11,17,1,4,2,6,2,5,14,26,38,39,55.1
2023-24,202402280CHI,2/28/2024,CHI vs CLE,Darius Garland,garlada01,34,CLE,0,CHI,23,2,5,1,0,1,44.08333333,0,2,8,22,7,14,0,0,4,1,7,28,25,30,34.9
2023-24,202402280CHI,2/28/2024,CHI vs CLE,Donovan Mitchell,mitchdo01,47,CLE,0,CHI,19,5,3,0,0,5,44.4,0,5,5,13,4,9,5,7,5,0,8,22,24,27,24.5
2023-24,202402280CHI,2/28/2024,CHI vs CLE,Ayo Dosunmu,dosunay01,57,CHI,1,CLE,21,3,4,1,1,4,47.5,1,2,6,14,4,9,5,6,0,2,7,25,24,28,32.6
2023-24,202402280CHI,2/28/2024,CHI vs CLE,DeMar DeRozan,derozde01,57,CHI,1,CLE,35,10,5,0,1,0,48.58333333,2,8,8,26,2,5,17,19,4,1,15,40,45,50,57.5
2023-24,202402280CHI,2/28/2024,CHI vs CLE,Coby White,whiteco01,59,CHI,1,CLE,14,8,12,1,1,3,50.05,3,5,5,20,2,13,2,2,2,2,20,26,22,34,44.6
2023-24,202402270ATL,2/27/2024,ATL vs UTA,Talen Horton-Tucker,hortota01,37,UTA,0,ATL,9,3,1,1,1,0,10.11666667,2,1,2,6,0,2,5,5,0,2,4,10,12,13,20.1
2023-24,202402270WAS,2/27/2024,WAS vs GSW,Kevon Looney,looneke01,57,GSW,0,WAS,2,5,1,0,2,0,10.3,0,5,1,2,0,0,0,0,0,2,6,3,7,8,15.5
2023-24,202402270WAS,2/27/2024,WAS vs GSW,Jared Butler,butleja02,21,WAS,1,GSW,2,1,2,0,0,3,10.83333333,1,0,1,1,0,0,0,0,2,0,3,4,3,5,3.2
2023-24,202402270POR,2/27/2024,POR vs MIA,Ashton Hagans,haganas01,7,POR,1,MIA,2,3,1,0,1,1,10.85,1,2,1,2,0,0,0,0,2,1,4,3,5,6,9.1
2023-24,202402270BOS,2/27/2024,BOS vs PHI,Luke Kornet,kornelu01,42,BOS,1,PHI,2,1,0,0,0,0,11.1,0,1,0,0,0,0,2,2,3,0,1,2,3,3,3.2
2023-24,202402270OKC,2/27/2024,OKC vs HOU,Kenrich Williams,willike04,47,OKC,1,HOU,0,5,0,0,0,0,11.61666667,0,5,0,2,0,2,0,0,0,0,5,0,5,5,6
2023-24,202402270WAS,2/27/2024,WAS vs GSW,Richaun Holmes,holmeri01,28,WAS,1,GSW,1,3,0,0,0,0,11.78333333,2,1,0,3,0,0,1,2,0,0,3,1,4,4,4.6
2023-24,202402270CHI,2/27/2024,CHI vs DET,Malachi Flynn,flynnma01,51,DET,0,CHI,7,2,1,0,0,2,11.91666667,0,2,3,8,1,4,0,0,0,0,3,8,9,10,8.9
2023-24,202402270NYK,2/27/2024,NYK vs NOP,Matt Ryan,ryanma01,17,NOP,0,NYK,6,1,1,0,0,0,11.96666667,0,1,2,2,2,2,0,0,0,0,2,7,7,8,8.7
2023-24,202402270MIL,2/27/2024,MIL vs CHO,Thanasis Antetokounmpo,antetth01,25,MIL,1,CHO,0,1,1,0,0,1,12,1,0,0,2,0,0,0,2,1,0,2,1,1,2,1.7
2023-24,202402270MIN,2/27/2024,MIN vs SAS,Blake Wesley,weslebl01,38,SAS,0,MIN,2,0,1,0,0,0,12.05,0,0,0,3,0,1,2,2,1,0,1,3,2,3,3.5
2023-24,202402270CHI,2/27/2024,CHI vs DET,Jevon Carter,carteje01,55,CHI,1,DET,0,1,1,1,1,0,12.06666667,0,1,0,4,0,2,0,0,0,2,2,1,1,2,8.7
2023-24,202402270POR,2/27/2024,POR vs MIA,Duop Reath,reathdu01,43,POR,1,MIA,0,3,0,0,0,1,12.58333333,2,1,0,4,0,3,0,0,3,0,3,0,3,3,2.6
2023-24,202402270MIL,2/27/2024,MIL vs CHO,A.J. Green,greenaj01,38,MIL,1,CHO,8,1,0,0,0,0,12.95,0,1,3,5,2,4,0,0,0,0,1,8,9,9,9.2
2023-24,202402270WAS,2/27/2024,WAS vs GSW,Dario Saric,saricda01,55,GSW,0,WAS,5,0,1,0,0,3,13.66666667,0,0,2,5,1,2,0,0,0,0,1,6,5,6,3.5
2023-24,202402270MIN,2/27/2024,MIN vs SAS,Zach Collins,colliza01,47,SAS,0,MIN,5,1,3,0,0,3,13.75,0,1,2,5,1,2,0,0,2,0,4,8,6,9,7.7
2023-24,202402270BOS,2/27/2024,BOS vs PHI,Paul Reed,reedpa01,58,PHI,0,BOS,0,3,0,0,0,0,13.9,0,3,0,3,0,0,0,0,1,0,3,0,3,3,3.6
2023-24,202402270ORL,2/27/2024,ORL vs BRK,Day'Ron Sharpe,sharpda01,43,BRK,0,ORL,4,6,1,0,0,0,14.18333333,1,5,2,2,0,0,0,0,2,0,7,5,10,11,12.7
2023-24,202402270CHI,2/27/2024,CHI vs DET,Quentin Grimes,grimequ01,48,DET,0,CHI,0,3,2,0,0,1,14.21666667,0,3,0,5,0,5,0,0,1,0,5,2,3,5,5.6
2023-24,202402270POR,2/27/2024,POR vs MIA,Kevin Love,loveke01,47,MIA,0,POR,8,2,2,0,1,2,14.25,1,1,3,6,2,5,0,0,2,1,4,10,10,12,14.4
2023-24,202402270OKC,2/27/2024,OKC vs HOU,Cason Wallace,wallaca01,58,OKC,1,HOU,2,2,1,1,0,0,14.26666667,0,2,1,3,0,2,0,2,0,1,3,3,4,5,8.9
2023-24,202402270CHI,2/27/2024,CHI vs DET,Dalen Terry,terryda01,38,CHI,1,DET,3,1,2,1,0,0,15.11666667,1,0,1,3,1,2,0,0,1,1,3,5,4,6,10.2
2023-24,202402270MIL,2/27/2024,MIL vs CHO,Danilo Gallinari,gallida01,35,MIL,1,CHO,8,2,0,0,0,1,15.16666667,1,1,2,4,0,1,4,4,1,0,2,8,10,10,9.4
2023-24,202402270MIL,2/27/2024,MIL vs CHO,Davis Bertans,bertada01,20,CHO,0,MIL,12,0,0,0,0,0,15.18333333,0,0,4,8,4,8,0,0,1,0,0,12,12,12,12
2023-24,202402270POR,2/27/2024,POR vs MIA,Nikola Jovic,jovicni01,24,MIA,0,POR,8,2,0,0,0,0,15.18333333,0,2,3,5,2,4,0,2,1,0,2,8,10,10,10.4
2023-24,202402270MIN,2/27/2024,MIN vs SAS,Kyle Anderson,anderky01,58,MIN,1,SAS,2,2,4,2,0,2,15.3,0,2,1,4,0,0,0,0,1,2,6,6,4,8,14.4
2023-24,202402270MIL,2/27/2024,MIL vs CHO,Patrick Beverley,beverpa01,54,MIL,1,CHO,7,3,3,1,1,0,15.53333333,1,2,3,8,1,2,0,0,1,2,6,10,10,13,21.1
2023-24,202402270OKC,2/27/2024,OKC vs HOU,Aaron Wiggins,wiggiaa01,55,OKC,1,HOU,6,2,0,0,1,0,15.75,2,0,2,6,0,1,2,2,1,1,2,6,8,8,11.4
2023-24,202402270ATL,2/27/2024,ATL vs UTA,Kris Dunn,dunnkr01,51,UTA,0,ATL,2,2,3,0,0,2,15.78333333,0,2,1,5,0,1,0,0,1,0,5,5,4,7,6.9
2023-24,202402270ORL,2/27/2024,ORL vs BRK,Jalen Suggs,suggsja01,54,ORL,1,BRK,9,1,2,2,0,2,15.88333333,0,1,3,5,1,2,2,2,3,2,3,11,10,12,17.2
2023-24,202402270OKC,2/27/2024,OKC vs HOU,Aaron Holiday,holidaa01,55,HOU,0,OKC,10,1,0,0,1,0,15.9,1,0,4,10,2,5,0,0,1,1,1,10,11,11,14.2
2023-24,202402270MIN,2/27/2024,MIN vs SAS,Jordan McLaughlin,mclaujo01,35,MIN,1,SAS,9,2,3,2,0,1,15.96666667,0,2,3,4,3,4,0,0,1,2,5,12,11,14,20.9
2023-24,202402270OKC,2/27/2024,OKC vs HOU,Cam Whitmore,whitmca01,32,HOU,0,OKC,9,1,1,1,0,0,15.96666667,0,1,4,9,1,3,0,0,0,1,2,10,10,11,14.7
2023-24,202402270MIN,2/27/2024,MIN vs SAS,Jeremy Sochan,sochaje01,59,SAS,0,MIN,0,0,1,0,0,0,15.98333333,0,0,0,2,0,1,0,0,1,0,1,1,0,1,1.5
2023-24,202402270OKC,2/27/2024,OKC vs HOU,Isaiah Joe,joeis01,54,OKC,1,HOU,2,2,1,0,0,2,16.05,1,1,1,2,0,0,0,0,0,0,3,3,4,5,3.9
2023-24,202402270BOS,2/27/2024,BOS vs PHI,Cameron Payne,payneca01,55,PHI,0,BOS,13,0,2,0,1,2,16.06666667,0,0,5,9,3,5,0,0,2,1,2,15,13,15,17
2023-24,202402270BOS,2/27/2024,BOS vs PHI,Payton Pritchard,pritcpa01,58,BOS,1,PHI,2,2,0,1,0,1,16.2,0,2,1,4,0,3,0,0,1,1,2,2,4,4,6.4
2023-24,202402270NYK,2/27/2024,NYK vs NOP,Alec Burks,burksal01,50,NYK,1,NOP,2,2,1,0,1,0,16.33333333,0,2,1,7,0,2,0,0,0,1,3,3,4,5,8.9
2023-24,202402270MIL,2/27/2024,MIL vs CHO,Vasilije Micic,micicva01,37,CHO,0,MIL,2,0,3,0,0,2,16.53333333,0,0,1,4,0,2,0,0,1,0,3,5,2,5,4.5
2023-24,202402270OKC,2/27/2024,OKC vs HOU,Jeff Green,greenje02,56,HOU,0,OKC,5,0,3,0,2,1,16.56666667,0,0,2,3,1,2,0,0,1,2,3,8,5,8,14.5
2023-24,202402270CHI,2/27/2024,CHI vs DET,James Wiseman,wisemja01,39,DET,0,CHI,2,5,0,0,0,0,16.7,2,3,1,2,0,0,0,0,5,0,5,2,7,7,8
2023-24,202402270NYK,2/27/2024,NYK vs NOP,Jordan Hawkins,hawkijo01,52,NOP,0,NYK,3,4,0,0,1,0,16.86666667,0,4,1,5,1,4,0,0,0,1,4,3,7,7,10.8
2023-24,202402270POR,2/27/2024,POR vs MIA,Delon Wright,wrighde01,35,MIA,0,POR,2,2,4,1,0,0,16.9,1,1,1,3,0,0,0,0,1,1,6,6,4,8,13.4
2023-24,202402270ATL,2/27/2024,ATL vs UTA,Garrison Mathews,mathega01,42,ATL,1,UTA,6,5,1,1,0,0,17.15,0,5,2,4,2,3,0,0,3,1,6,7,11,12,16.5
2023-24,202402270OKC,2/27/2024,OKC vs HOU,Amen Thompson,thompam01,39,HOU,0,OKC,2,8,0,0,1,2,17.36666667,4,4,1,5,0,2,0,0,1,1,8,2,10,10,12.6
2023-24,202402270ATL,2/27/2024,ATL vs UTA,Brice Sensabaugh,sensabr01,9,UTA,0,ATL,6,1,0,0,0,1,17.4,0,1,2,5,2,4,0,0,3,0,1,6,7,7,6.2
2023-24,202402270WAS,2/27/2024,WAS vs GSW,Gary Payton II,paytoga02,23,GSW,0,WAS,13,4,2,3,1,1,18,4,0,6,10,1,1,0,0,1,4,6,15,17,19,31.8
2023-24,202402270BOS,2/27/2024,BOS vs PHI,Mo Bamba,bambamo01,36,PHI,0,BOS,10,6,0,0,1,1,18.2,3,3,4,8,2,3,0,0,4,1,6,10,16,16,19.2
2023-24,202402270ATL,2/27/2024,ATL vs UTA,Bruno Fernando,fernabr01,21,ATL,1,UTA,8,3,1,0,0,1,18.31666667,3,0,4,4,0,0,0,0,2,0,4,9,11,12,12.1
2023-24,202402270ORL,2/27/2024,ORL vs BRK,Joe Ingles,inglejo01,45,ORL,1,BRK,0,2,2,2,0,2,18.43333333,0,2,0,2,0,2,0,0,2,2,4,2,2,4,9.4
2023-24,202402270POR,2/27/2024,POR vs MIA,Deandre Ayton,aytonde01,40,POR,1,MIA,12,10,2,2,1,2,18.56666667,3,7,6,9,0,0,0,0,1,3,12,14,22,24,34
2023-24,202402270ORL,2/27/2024,ORL vs BRK,Moritz Wagner,wagnemo01,57,ORL,1,BRK,16,5,2,1,0,1,18.7,1,4,4,7,0,0,8,9,3,1,7,18,21,23,27
2023-24,202402270OKC,2/27/2024,OKC vs HOU,Jaylin Williams,willija07,49,OKC,1,HOU,5,3,2,1,1,0,18.86666667,0,3,2,2,1,1,0,0,2,2,5,7,8,10,17.6
2023-24,202402270MIN,2/27/2024,MIN vs SAS,Julian Champagnie,champju02,52,SAS,0,MIN,7,3,1,1,2,0,18.9,1,2,3,6,1,3,0,0,0,3,4,8,10,11,21.1
2023-24,202402270OKC,2/27/2024,OKC vs HOU,Gordon Hayward,haywago01,29,OKC,1,HOU,5,4,0,0,0,0,18.91666667,1,3,2,5,0,0,1,1,1,0,4,5,9,9,9.8
2023-24,202402270BOS,2/27/2024,BOS vs PHI,Ricky Council IV,councri01,18,PHI,0,BOS,16,4,1,0,0,1,19.08333333,1,3,6,8,0,0,4,4,0,0,5,17,20,21,21.3
2023-24,202402270NYK,2/27/2024,NYK vs NOP,Larry Nance Jr.,nancela02,41,NOP,0,NYK,4,6,3,0,0,1,19.08333333,3,3,2,3,0,1,0,1,4,0,9,7,10,13,14.7
2023-24,202402270ORL,2/27/2024,ORL vs BRK,Trendon Watford,watfotr01,41,BRK,0,ORL,14,7,0,0,0,5,19.15,3,4,4,10,0,2,6,6,3,0,7,14,21,21,17.4
2023-24,202402270POR,2/27/2024,POR vs MIA,Jabari Walker,walkeja01,53,POR,1,MIA,7,2,2,0,0,0,19.21666667,0,2,2,4,0,0,3,4,0,0,4,9,9,11,12.4
2023-24,202402270MIN,2/27/2024,MIN vs SAS,Mike Conley,conlemi01,53,MIN,1,SAS,16,0,1,1,0,0,19.75,0,0,6,10,4,6,0,0,1,1,1,17,16,17,20.5
2023-24,202402270ORL,2/27/2024,ORL vs BRK,Dennis Smith Jr.,smithde03,42,BRK,0,ORL,7,3,5,1,0,3,19.8,1,2,3,6,1,3,0,0,2,1,8,12,10,15,18.1
2023-24,202402270MIL,2/27/2024,MIL vs CHO,Seth Curry,curryse01,42,CHO,0,MIL,8,4,4,0,1,1,19.83333333,0,4,1,6,1,3,5,5,1,1,8,12,12,16,20.8
2023-24,202402270BOS,2/27/2024,BOS vs PHI,Nicolas Batum,batumni01,38,PHI,0,BOS,3,3,1,1,1,2,20.01666667,1,2,1,4,1,3,0,0,4,2,4,4,6,7,12.1
2023-24,202402270OKC,2/27/2024,OKC vs HOU,Josh Giddey,giddejo01,57,OKC,1,HOU,14,7,4,0,0,3,20.21666667,1,6,6,11,1,3,1,2,1,0,11,18,21,25,25.4
2023-24,202402270MIL,2/27/2024,MIL vs CHO,Nick Richards,richani01,49,CHO,0,MIL,6,7,0,1,0,1,20.33333333,3,4,3,7,0,0,0,0,4,1,7,6,13,13,16.4
2023-24,202402270MIL,2/27/2024,MIL vs CHO,Bobby Portis,portibo01,59,MIL,1,CHO,21,8,3,0,0,1,20.4,3,5,9,16,2,4,1,1,2,0,11,24,29,32,34.1
2023-24,202402270CLE,2/27/2024,CLE vs DAL,Georges Niang,niangge01,57,CLE,1,DAL,10,5,0,0,0,0,20.63333333,0,5,4,6,2,4,0,0,1,0,5,10,15,15,16
2023-24,202402270MIN,2/27/2024,MIN vs SAS,Malaki Branham,branhma01,54,SAS,0,MIN,12,2,0,1,1,2,20.76666667,0,2,4,5,2,3,2,2,1,2,2,12,14,14,18.4
2023-24,202402270ORL,2/27/2024,ORL vs BRK,Lonnie Walker IV,walkelo01,38,BRK,0,ORL,4,1,0,1,0,0,20.95,0,1,1,9,1,4,1,1,3,1,1,4,5,5,8.2
2023-24,202402270ATL,2/27/2024,ATL vs UTA,Kobe Bufkin,bufkiko01,7,ATL,1,UTA,7,2,5,2,0,0,21.1,0,2,3,7,1,2,0,0,1,2,7,12,9,14,22.9
2023-24,202402270BOS,2/27/2024,BOS vs PHI,Sam Hauser,hausesa01,57,BOS,1,PHI,3,5,0,0,1,1,21.18333333,0,5,1,2,1,2,0,0,4,1,5,3,8,8,11
2023-24,202402270BOS,2/27/2024,BOS vs PHI,Al Horford,horfoal01,48,BOS,1,PHI,8,5,1,1,1,0,21.18333333,0,5,4,6,0,2,0,0,1,2,6,9,13,14,21.5
2023-24,202402270CHI,2/27/2024,CHI vs DET,Simone Fontecchio,fontesi01,57,DET,0,CHI,17,3,1,1,0,0,21.31666667,2,1,6,12,5,9,0,0,0,1,4,18,20,21,25.1
2023-24,202402270ORL,2/27/2024,ORL vs BRK,Dorian Finney-Smith,finnedo01,49,BRK,0,ORL,3,4,2,2,1,3,21.38333333,1,3,1,2,1,1,0,0,2,3,6,5,7,9,16.8
2023-24,202402270ORL,2/27/2024,ORL vs BRK,Gary Harris,harriga01,36,ORL,1,BRK,8,2,2,0,0,0,21.48333333,0,2,3,6,2,4,0,0,1,0,4,10,10,12,13.4
2023-24,202402270OKC,2/27/2024,OKC vs HOU,Luguentz Dort,dortlu01,56,OKC,1,HOU,3,3,1,0,1,1,21.55,0,3,1,9,1,5,0,0,2,1,4,4,6,7,10.1
2023-24,202402270WAS,2/27/2024,WAS vs GSW,Chris Paul,paulch01,33,GSW,0,WAS,9,4,6,4,0,2,21.66666667,1,3,3,6,3,5,0,0,1,4,10,15,13,19,32.8
2023-24,202402270BOS,2/27/2024,BOS vs PHI,Kelly Oubre Jr.,oubreke01,46,PHI,0,BOS,3,1,1,1,0,0,21.76666667,0,1,1,6,0,2,1,2,3,1,2,4,4,5,8.7
2023-24,202402270ORL,2/27/2024,ORL vs BRK,Anthony Black,blackan01,54,ORL,1,BRK,8,4,1,2,0,1,21.93333333,0,4,2,4,1,2,3,4,0,2,5,9,12,13,19.3
2023-24,202402270ORL,2/27/2024,ORL vs BRK,Wendell Carter Jr.,cartewe01,33,ORL,1,BRK,10,7,2,0,1,2,22.1,2,5,5,9,0,2,0,0,3,1,9,12,17,19,22.4
2023-24,202402270CLE,2/27/2024,CLE vs DAL,Dereck Lively II,livelde01,40,DAL,0,CLE,9,6,0,0,2,0,22.15,2,4,4,4,0,0,1,4,1,2,6,9,15,15,22.2
2023-24,202402270MIL,2/27/2024,MIL vs CHO,Cody Martin,martico01,26,CHO,0,MIL,2,6,7,0,0,1,22.2,0,6,1,7,0,3,0,0,2,0,13,9,8,15,18.7
2023-24,202402270ATL,2/27/2024,ATL vs UTA,John Collins,collijo01,55,UTA,0,ATL,5,10,2,0,1,5,22.38333333,3,7,2,8,0,3,1,1,4,1,12,7,15,17,18
2023-24,202402270MIN,2/27/2024,MIN vs SAS,Cedi Osman,osmande01,59,SAS,0,MIN,10,2,1,0,0,0,22.4,1,1,4,8,2,4,0,0,0,0,3,11,12,13,13.9
2023-24,202402270WAS,2/27/2024,WAS vs GSW,Moses Moody,moodymo01,43,GSW,0,WAS,12,3,1,2,0,2,22.51666667,0,3,4,7,4,7,0,0,1,2,4,13,15,16,21.1
2023-24,202402270NYK,2/27/2024,NYK vs NOP,Jonas Valanciunas,valanjo01,59,NOP,0,NYK,7,9,1,0,0,0,23.08333333,2,7,2,6,0,0,3,4,1,0,10,8,16,17,19.3
2023-24,202402270MIL,2/27/2024,MIL vs CHO,Jae Crowder,crowdja01,28,MIL,1,CHO,10,7,2,0,0,0,23.13333333,2,5,4,5,2,3,0,0,1,0,9,12,17,19,21.4
2023-24,202402270BOS,2/27/2024,BOS vs PHI,Kyle Lowry,lowryky01,40,PHI,0,BOS,3,2,4,2,0,0,23.2,0,2,1,3,0,1,1,1,0,2,6,7,5,9,17.4
2023-24,202402270ORL,2/27/2024,ORL vs BRK,Jalen Wilson,wilsoja03,20,BRK,0,ORL,5,3,1,1,0,0,23.28333333,0,3,2,5,1,4,0,0,1,1,4,6,8,9,13.1
2023-24,202402270MIL,2/27/2024,MIL vs CHO,Brook Lopez,lopezbr01,56,MIL,1,CHO,0,1,1,2,2,0,23.35,0,1,0,2,0,2,0,0,0,4,2,1,1,2,14.7
2023-24,202402270MIL,2/27/2024,MIL vs CHO,Giannis Antetokounmpo,antetgi01,57,MIL,1,CHO,24,8,1,0,0,1,24.25,3,5,8,13,1,1,7,8,1,0,9,25,32,33,34.1
2023-24,202402270ATL,2/27/2024,ATL vs UTA,Clint Capela,capelca01,50,ATL,1,UTA,9,13,0,1,3,1,24.53333333,5,8,4,9,0,0,1,2,3,4,13,9,22,22,35.6
2023-24,202402270ORL,2/27/2024,ORL vs BRK,Markelle Fultz,fultzma01,23,ORL,1,BRK,12,3,1,0,0,4,24.55,1,2,6,12,0,1,0,1,1,0,4,13,15,16,13.1
2023-24,202402270CHI,2/27/2024,CHI vs DET,Alex Caruso,carusal01,50,CHI,1,DET,4,2,1,5,0,1,24.6,1,1,2,9,0,5,0,0,4,5,3,5,6,7,21.9
2023-24,202402270MIL,2/27/2024,MIL vs CHO,Damian Lillard,lillada01,54,MIL,1,CHO,23,9,7,0,0,3,24.83333333,0,9,8,14,4,9,3,3,3,0,16,30,32,39,41.3
2023-24,202402270CLE,2/27/2024,CLE vs DAL,Isaac Okoro,okorois01,48,CLE,1,DAL,9,6,5,1,0,1,25.01666667,0,6,3,5,2,4,1,2,1,1,11,14,15,20,25.7
2023-24,202402270ORL,2/27/2024,ORL vs BRK,Dennis Schroder,schrode01,58,BRK,0,ORL,15,1,2,3,0,2,25.23333333,0,1,6,10,3,4,0,0,2,3,3,17,16,18,26.2
2023-24,202402270CLE,2/27/2024,CLE vs DAL,Max Strus,strusma01,57,CLE,1,DAL,21,4,4,0,2,2,25.55,0,4,7,12,7,10,0,0,2,2,8,25,25,29,35.8
2023-24,202402270ORL,2/27/2024,ORL vs BRK,Cole Anthony,anthoco01,58,ORL,1,BRK,12,2,1,3,0,0,25.9,0,2,4,12,2,5,2,2,2,3,3,13,14,15,24.9
2023-24,202402270ATL,2/27/2024,ATL vs UTA,Lauri Markkanen,markkla01,49,UTA,0,ATL,11,4,0,0,0,2,26.05,2,2,4,13,0,6,3,4,0,0,4,11,15,15,13.8
2023-24,202402270MIL,2/27/2024,MIL vs CHO,Malik Beasley,beaslma01,57,MIL,1,CHO,6,4,4,1,0,0,26.18333333,0,4,2,6,2,6,0,0,2,1,8,10,10,14,19.8
2023-24,202402270CLE,2/27/2024,CLE vs DAL,Tim Hardaway Jr.,hardati02,55,DAL,0,CLE,4,3,1,0,1,0,26.26666667,1,2,2,5,0,1,0,0,1,1,4,5,7,8,12.1
2023-24,202402270MIL,2/27/2024,MIL vs CHO,Pat Connaughton,connapa01,53,MIL,1,CHO,9,3,5,3,0,1,26.43333333,0,3,4,9,1,5,0,0,1,3,8,14,12,17,28.1
2023-24,202402270MIN,2/27/2024,MIN vs SAS,Jaden McDaniels,mcdanja02,48,MIN,1,SAS,2,5,1,3,2,3,26.45,1,4,1,5,0,1,0,0,4,5,6,3,7,8,21.5
2023-24,202402270CLE,2/27/2024,CLE vs DAL,Maxi Kleber,klebima01,22,DAL,0,CLE,4,7,1,0,1,0,26.8,1,6,1,3,1,2,1,2,2,1,8,5,11,12,16.9
2023-24,202402270POR,2/27/2024,POR vs MIA,Caleb Martin,martica02,41,MIA,0,POR,8,3,1,0,1,3,26.93333333,0,3,3,6,2,2,0,0,1,1,4,9,11,12,13.1
2023-24,202402270MIN,2/27/2024,MIN vs SAS,Monte Morris,morrimo01,12,MIN,1,SAS,8,4,4,2,0,0,26.98333333,1,3,2,8,1,2,3,4,1,2,8,12,12,16,24.8
2023-24,202402270ATL,2/27/2024,ATL vs UTA,Jordan Clarkson,clarkjo01,49,UTA,0,ATL,6,1,8,1,0,1,27,1,0,2,10,0,3,2,2,1,1,9,14,7,15,21.2
2023-24,202402270ORL,2/27/2024,ORL vs BRK,Nic Claxton,claxtni01,48,BRK,0,ORL,10,5,1,0,0,2,27.3,2,3,4,6,0,0,2,4,3,0,6,11,15,16,15.5
2023-24,202402270WAS,2/27/2024,WAS vs GSW,Klay Thompson,thompkl01,54,GSW,0,WAS,25,3,4,0,0,2,27.3,0,3,9,16,6,11,1,1,2,0,7,29,28,32,32.6
2023-24,202402270MIL,2/27/2024,MIL vs CHO,Grant Williams,willigr01,54,CHO,0,MIL,4,7,2,0,0,1,27.53333333,2,5,2,7,0,3,0,0,3,0,9,6,11,13,14.4
2023-24,202402270CHI,2/27/2024,CHI vs DET,Andre Drummond,drumman01,58,CHI,1,DET,20,11,0,0,1,1,27.76666667,6,5,9,14,0,0,2,2,2,1,11,20,31,31,35.2
2023-24,202402270OKC,2/27/2024,OKC vs HOU,Jalen Green,greenja05,58,HOU,0,OKC,16,6,3,0,0,3,27.93333333,1,5,6,17,2,6,2,2,2,0,9,19,22,25,24.7
2023-24,202402270ATL,2/27/2024,ATL vs UTA,De'Andre Hunter,huntede01,34,ATL,1,UTA,20,5,0,0,1,0,27.95,1,4,6,10,1,3,7,9,1,1,5,20,25,25,29
2023-24,202402270ORL,2/27/2024,ORL vs BRK,Franz Wagner,wagnefr01,51,ORL,1,BRK,21,5,5,0,1,3,28,0,5,8,11,0,2,5,5,1,1,10,26,26,31,34.5
2023-24,202402270WAS,2/27/2024,WAS vs GSW,Brandin Podziemski,podzibr01,51,GSW,0,WAS,7,4,4,2,1,2,28.06666667,2,2,3,8,1,2,0,0,2,3,8,11,11,15,24.8
2023-24,202402270CLE,2/27/2024,CLE vs DAL,Caris LeVert,leverca01,47,CLE,1,DAL,11,4,6,0,0,2,28.08333333,0,4,5,10,1,3,0,0,2,0,10,17,15,21,22.8
2023-24,202402270WAS,2/27/2024,WAS vs GSW,Jonathan Kuminga,kuminjo01,56,GSW,0,WAS,21,6,5,0,0,1,28.18333333,1,5,10,13,0,0,1,2,1,0,11,26,27,32,34.7
2023-24,202402270NYK,2/27/2024,NYK vs NOP,Naji Marshall,marshna01,47,NOP,0,NYK,3,4,3,1,0,1,28.21666667,1,3,1,4,1,3,0,0,0,1,7,6,7,10,14.3
2023-24,202402270CLE,2/27/2024,CLE vs DAL,Evan Mobley,mobleev01,34,CLE,1,DAL,12,9,7,1,0,1,28.31666667,3,6,5,11,0,3,2,2,2,1,16,19,21,28,35.3
2023-24,202402270ATL,2/27/2024,ATL vs UTA,Taylor Hendricks,hendrita0,20,UTA,0,ATL,8,8,1,2,0,0,28.63333333,0,8,3,8,2,4,0,0,3,2,9,9,16,17,25.1
2023-24,202402270WAS,2/27/2024,WAS vs GSW,Draymond Green,greendr01,33,GSW,0,WAS,6,8,8,0,0,2,28.88333333,0,8,1,4,1,2,3,4,1,0,16,14,14,22,25.6
2023-24,202402270MIN,2/27/2024,MIN vs SAS,Tre Jones,jonestr01,54,SAS,0,MIN,11,8,6,1,0,6,28.93333333,1,7,5,5,1,1,0,1,0,1,14,17,19,25,26.6
2023-24,202402270CLE,2/27/2024,CLE vs DAL,Josh Green,greenjo02,45,DAL,0,CLE,7,1,1,4,0,0,28.96666667,0,1,3,8,1,5,0,0,1,4,2,8,8,9,21.7
2023-24,202402270NYK,2/27/2024,NYK vs NOP,Bojan Bogdanovic,bogdabo02,34,NYK,1,NOP,20,4,5,1,0,4,29.05,3,1,6,14,4,10,4,4,4,1,9,25,24,29,31.3
2023-24,202402270BOS,2/27/2024,BOS vs PHI,Tobias Harris,harrito02,52,PHI,0,BOS,13,2,0,0,0,1,29.08333333,2,0,5,19,2,7,1,1,3,0,2,13,15,15,14.4
2023-24,202402270ORL,2/27/2024,ORL vs BRK,Cameron Johnson,johnsca02,45,BRK,0,ORL,9,1,2,1,0,1,29.1,0,1,4,11,1,4,0,0,2,1,3,11,10,12,15.2
2023-24,202402270BOS,2/27/2024,BOS vs PHI,Buddy Hield,hieldbu01,61,PHI,0,BOS,6,2,4,0,0,1,29.26666667,0,2,2,8,2,7,0,0,4,0,6,10,8,12,13.4
2023-24,202402270ORL,2/27/2024,ORL vs BRK,Mikal Bridges,bridgmi01,58,BRK,0,ORL,4,2,2,1,0,3,29.28333333,0,2,2,13,0,7,0,1,1,1,4,6,6,8,9.4
2023-24,202402270ATL,2/27/2024,ATL vs UTA,Collin Sexton,sextoco01,59,UTA,0,ATL,22,1,3,6,0,3,29.28333333,0,1,8,16,3,6,3,5,2,6,4,25,23,26,42.7
2023-24,202402270POR,2/27/2024,POR vs MIA,Jaime Jaquez Jr.,jaqueja01,52,MIA,0,POR,7,3,4,0,0,1,29.35,2,1,2,5,1,2,2,2,3,0,7,11,10,14,15.6
2023-24,202402270WAS,2/27/2024,WAS vs GSW,Jordan Poole,poolejo01,56,WAS,1,GSW,12,3,5,2,0,6,29.36666667,1,2,5,17,2,8,0,0,3,2,8,17,15,20,23.1
2023-24,202402270NYK,2/27/2024,NYK vs NOP,Zion Williamson,willizi01,48,NOP,0,NYK,21,5,4,0,2,6,29.4,2,3,7,15,0,0,7,8,6,2,9,25,26,30,33
2023-24,202402270WAS,2/27/2024,WAS vs GSW,Stephen Curry,curryst01,54,GSW,0,WAS,18,5,6,1,1,3,29.63333333,0,5,6,21,4,16,2,2,1,2,11,24,23,29,36
2023-24,202402270NYK,2/27/2024,NYK vs NOP,Jericho Sims,simsje01,32,NYK,1,NOP,7,7,3,0,2,2,29.76666667,2,5,3,3,0,0,1,3,3,2,10,10,14,17,23.9
2023-24,202402270MIN,2/27/2024,MIN vs SAS,Nickeil Alexander-Walker,alexani01,58,MIN,1,SAS,8,4,6,0,0,1,29.81666667,0,4,3,11,0,5,2,2,2,0,10,14,12,18,20.8
2023-24,202402270ATL,2/27/2024,ATL vs UTA,Walker Kessler,kesslwa01,51,UTA,0,ATL,14,12,0,1,2,1,29.85,4,8,6,8,0,0,2,2,0,3,12,14,26,26,36.4
2023-24,202402270POR,2/27/2024,POR vs MIA,Kris Murray,murrakr01,37,POR,1,MIA,0,3,2,2,0,3,29.9,1,2,0,6,0,5,0,0,3,2,5,2,3,5,9.6
2023-24,202402270BOS,2/27/2024,BOS vs PHI,Derrick White,whitede01,54,BOS,1,PHI,6,6,6,2,3,2,29.98333333,0,6,2,6,0,2,2,2,0,5,12,12,12,18,35.2
2023-24,202402270POR,2/27/2024,POR vs MIA,Terry Rozier,roziete01,41,MIA,0,POR,19,4,4,1,2,2,30.31666667,0,4,7,14,2,4,3,3,0,3,8,23,23,27,36.8
2023-24,202402270POR,2/27/2024,POR vs MIA,Matisse Thybulle,thybuma01,55,POR,1,MIA,8,1,3,2,1,0,30.38333333,1,0,3,6,1,3,1,2,2,3,4,11,9,12,22.7
2023-24,202402270ATL,2/27/2024,ATL vs UTA,Saddiq Bey,beysa01,57,ATL,1,UTA,16,7,0,0,0,1,30.48333333,3,4,4,11,2,6,6,6,0,0,7,16,23,23,23.4
2023-24,202402270ORL,2/27/2024,ORL vs BRK,Caleb Houstan,houstca01,42,ORL,1,BRK,9,6,1,2,0,1,30.96666667,1,5,3,4,3,4,0,0,3,2,7,10,15,16,22.7
2023-24,202402270CHI,2/27/2024,CHI vs DET,Jalen Duren,durenja01,43,DET,0,CHI,14,10,5,1,3,5,31.3,2,8,5,9,0,0,4,4,4,4,15,19,24,29,40.5
2023-24,202402270BOS,2/27/2024,BOS vs PHI,Kristaps Porzingis,porzikr01,43,BOS,1,PHI,23,12,1,1,1,1,31.31666667,4,8,5,12,1,2,12,12,1,2,13,24,35,36,43.9
2023-24,202402270OKC,2/27/2024,OKC vs HOU,Dillon Brooks,brookdi01,49,HOU,0,OKC,7,4,1,0,0,0,31.55,1,3,3,9,1,6,0,0,2,0,5,8,11,12,13.3
2023-24,202402270OKC,2/27/2024,OKC vs HOU,Shai Gilgeous-Alexander,gilgesh01,57,OKC,1,HOU,31,8,3,1,0,2,31.85,2,6,11,21,4,6,5,6,2,1,11,34,39,42,46.1
2023-24,202402270ATL,2/27/2024,ATL vs UTA,Dejounte Murray,murrade01,55,ATL,1,UTA,17,4,11,1,2,5,31.91666667,2,2,7,19,1,6,2,2,0,3,15,28,21,32,42.3
2023-24,202402270CLE,2/27/2024,CLE vs DAL,Darius Garland,garlada01,33,CLE,1,DAL,8,1,7,0,0,2,32.06666667,1,0,2,10,1,5,3,5,1,0,8,15,9,16,17.7
2023-24,202402270WAS,2/27/2024,WAS vs GSW,Landry Shamet,shamela01,41,WAS,1,GSW,16,0,1,0,0,0,32.16666667,0,0,6,13,3,9,1,1,2,0,1,17,16,17,17.5
2023-24,202402270POR,2/27/2024,POR vs MIA,Toumani Camara,camarto01,56,POR,1,MIA,17,10,3,0,0,3,32.46666667,6,4,6,12,2,2,3,3,6,0,13,20,27,30,30.5
2023-24,202402270MIL,2/27/2024,MIL vs CHO,Tre Mann,manntr01,20,CHO,0,MIL,16,4,3,2,0,2,32.7,0,4,6,12,2,5,2,5,1,2,7,19,20,23,29.3
2023-24,202402270MIL,2/27/2024,MIL vs CHO,Brandon Miller,millebr02,52,CHO,0,MIL,14,2,2,1,0,1,32.71666667,0,2,6,14,2,7,0,0,0,1,4,16,16,18,21.4
2023-24,202402270MIN,2/27/2024,MIN vs SAS,Naz Reid,reidna01,58,MIN,1,SAS,22,6,1,2,1,2,32.88333333,2,4,8,10,1,2,5,5,2,3,7,23,28,29,37.7
2023-24,202402270CLE,2/27/2024,CLE vs DAL,Jarrett Allen,allenja01,52,CLE,1,DAL,19,9,0,0,1,1,32.93333333,4,5,7,9,0,0,5,6,0,1,9,19,28,28,31.8
2023-24,202402270WAS,2/27/2024,WAS vs GSW,Marvin Bagley III,baglema01,41,WAS,1,GSW,20,9,2,1,2,1,32.93333333,3,6,8,11,1,1,3,3,2,3,11,22,29,31,41.8
2023-24,202402270MIN,2/27/2024,MIN vs SAS,Anthony Edwards,edwaran01,55,MIN,1,SAS,34,5,5,4,1,4,33.08333333,1,4,13,29,4,10,4,4,0,5,10,39,39,44,58.5
2023-24,202402270ATL,2/27/2024,ATL vs UTA,Bogdan Bogdanovic,bogdabo01,56,ATL,1,UTA,19,3,3,2,2,4,33.16666667,1,2,7,15,3,8,2,2,2,4,6,22,22,25,35.1
2023-24,202402270POR,2/27/2024,POR vs MIA,Jimmy Butler,butleji01,39,MIA,0,POR,22,4,9,4,2,1,33.2,1,3,7,12,1,2,7,9,3,6,13,31,26,35,57.3
2023-24,202402270WAS,2/27/2024,WAS vs GSW,Corey Kispert,kispeco01,56,WAS,1,GSW,20,3,5,0,2,3,33.36666667,0,3,8,15,4,9,0,1,2,2,8,25,23,28,34.1
2023-24,202402270ATL,2/27/2024,ATL vs UTA,Keyonte George,georgke01,53,UTA,0,ATL,14,1,6,0,0,2,33.5,0,1,5,15,4,9,0,0,1,0,7,20,15,21,22.2
2023-24,202402270OKC,2/27/2024,OKC vs HOU,Chet Holmgren,holmgch01,58,OKC,1,HOU,18,13,2,1,3,2,33.58333333,2,11,6,13,1,4,5,5,4,4,15,20,31,33,46.6
2023-24,202402270NYK,2/27/2024,NYK vs NOP,Herbert Jones,joneshe01,54,NOP,0,NYK,15,1,1,2,0,1,33.61666667,0,1,4,6,3,4,4,4,3,2,2,16,16,17,22.7
2023-24,202402270POR,2/27/2024,POR vs MIA,Bam Adebayo,adebaba01,48,MIA,0,POR,13,9,2,0,1,6,33.75,1,8,5,9,0,0,3,7,3,1,11,15,22,24,23.8
2023-24,202402270CHI,2/27/2024,CHI vs DET,Jaden Ivey,iveyja01,54,DET,0,CHI,15,2,5,1,1,4,33.78333333,0,2,4,7,1,3,6,8,3,2,7,20,17,22,26.9
2023-24,202402270NYK,2/27/2024,NYK vs NOP,Brandon Ingram,ingrabr01,53,NOP,0,NYK,24,6,5,0,2,5,33.81666667,0,6,9,18,3,7,3,3,3,2,11,29,30,35,39.7
2023-24,202402270MIN,2/27/2024,MIN vs SAS,Keldon Johnson,johnske04,55,SAS,0,MIN,20,6,4,1,0,3,33.98333333,3,3,7,17,5,11,1,2,3,1,10,24,26,30,33.2
2023-24,202402270CHI,2/27/2024,CHI vs DET,Isaiah Stewart,stewais01,36,DET,0,CHI,11,9,0,0,1,2,34.2,1,8,4,9,2,6,1,2,2,1,9,11,20,20,22.8
2023-24,202402270POR,2/27/2024,POR vs MIA,Duncan Robinson,robindu01,53,MIA,0,POR,17,3,3,2,0,2,34.23333333,0,3,5,8,4,6,3,3,3,2,6,20,20,23,29.1
2023-24,202402270MIN,2/27/2024,MIN vs SAS,Victor Wembanyama,wembavi01,53,SAS,0,MIN,17,13,5,2,4,5,34.25,1,12,5,13,2,7,5,5,5,6,18,22,30,35,53.1
2023-24,202402270BOS,2/27/2024,BOS vs PHI,Jaylen Brown,brownja02,53,BOS,1,PHI,31,6,1,1,0,4,34.68333333,1,5,11,14,1,2,8,10,4,1,7,32,37,38,38.7
2023-24,202402270BOS,2/27/2024,BOS vs PHI,Jayson Tatum,tatumja01,55,BOS,1,PHI,29,11,8,0,1,1,34.75,0,11,9,20,1,7,10,11,1,1,19,37,40,48,56.2
2023-24,202402270OKC,2/27/2024,OKC vs HOU,Jalen Williams,willija06,52,OKC,1,HOU,24,5,5,2,2,3,34.85,2,3,11,17,2,3,0,0,1,4,10,29,29,34,46.5
2023-24,202402270BOS,2/27/2024,BOS vs PHI,Jrue Holiday,holidjr01,53,BOS,1,PHI,13,7,4,1,2,4,34.96666667,3,4,6,8,1,1,0,0,0,3,11,17,20,24,32.4
2023-24,202402270CHI,2/27/2024,CHI vs DET,Ausar Thompson,thompau01,58,DET,0,CHI,13,8,3,0,1,1,34.96666667,0,8,5,8,2,4,1,2,4,1,11,16,21,24,29.1
2023-24,202402270OKC,2/27/2024,OKC vs HOU,Jabari Smith Jr.,smithja05,53,HOU,0,OKC,18,13,2,1,1,1,35.3,2,11,7,16,1,6,3,4,1,2,15,20,31,33,41.6
2023-24,202402270ATL,2/27/2024,ATL vs UTA,Jalen Johnson,johnsja05,44,ATL,1,UTA,22,13,6,1,0,5,35.38333333,0,13,9,14,2,4,2,2,3,1,19,28,35,41,44.6
2023-24,202402270CLE,2/27/2024,CLE vs DAL,P.J. Washington,washipj01,50,DAL,0,CLE,11,2,2,3,1,0,35.43333333,0,2,5,8,1,3,0,1,2,4,4,13,13,15,28.4
2023-24,202402270OKC,2/27/2024,OKC vs HOU,Alperen Sengun,sengual01,57,HOU,0,OKC,23,11,6,2,2,5,35.78333333,3,8,8,13,0,1,7,12,2,4,17,29,34,40,52.2
2023-24,202402270NYK,2/27/2024,NYK vs NOP,Trey Murphy III,murphtr02,34,NOP,0,NYK,26,7,4,1,0,0,36,2,5,9,14,6,11,2,3,3,1,11,30,33,37,43.4
2023-24,202402270CHI,2/27/2024,CHI vs DET,Cade Cunningham,cunnica01,48,DET,0,CHI,26,5,5,0,1,3,36.08333333,1,4,9,13,3,5,5,7,0,1,10,31,31,36,39.5
2023-24,202402270OKC,2/27/2024,OKC vs HOU,Fred VanVleet,vanvlfr01,51,HOU,0,OKC,5,1,5,1,0,2,36.18333333,0,1,2,11,1,7,0,0,5,1,6,10,6,11,14.7
2023-24,202402270WAS,2/27/2024,WAS vs GSW,Tyus Jones,jonesty01,58,WAS,1,GSW,14,6,17,2,0,1,36.38333333,1,5,6,11,1,4,1,1,0,2,23,31,20,37,51.7
2023-24,202402270NYK,2/27/2024,NYK vs NOP,Donte DiVincenzo,divindo01,58,NYK,1,NOP,23,4,2,2,0,3,36.53333333,1,3,8,21,7,18,0,0,3,2,6,25,27,29,33.8
2023-24,202402270BOS,2/27/2024,BOS vs PHI,Tyrese Maxey,maxeyty01,53,PHI,0,BOS,32,3,5,2,1,1,36.58333333,1,2,12,24,4,12,4,4,1,3,8,37,35,40,51.1
2023-24,202402270MIL,2/27/2024,MIL vs CHO,Miles Bridges,bridgmi02,47,CHO,0,MIL,17,3,0,2,0,3,36.86666667,0,3,6,15,2,9,3,3,3,2,3,17,20,20,23.6
2023-24,202402270CHI,2/27/2024,CHI vs DET,Nikola Vucevic,vucevni01,53,CHI,1,DET,25,10,2,0,1,1,37.18333333,3,7,12,23,1,7,0,1,4,1,12,27,35,37,42
2023-24,202402270WAS,2/27/2024,WAS vs GSW,Kyle Kuzma,kuzmaky01,56,WAS,1,GSW,27,12,2,0,1,6,37.78333333,1,11,12,21,1,4,2,2,0,1,14,29,39,41,41.4
2023-24,202402270CLE,2/27/2024,CLE vs DAL,Donovan Mitchell,mitchdo01,46,CLE,1,DAL,31,7,6,0,1,7,38.15,0,7,11,20,7,11,2,3,3,1,13,37,38,44,44.4
2023-24,202402270CHI,2/27/2024,CHI vs DET,Ayo Dosunmu,dosunay01,56,CHI,1,DET,8,6,6,3,0,2,38.5,3,3,4,14,0,5,0,0,2,3,12,14,14,20,31.2
2023-24,202402270CLE,2/27/2024,CLE vs DAL,Kyrie Irving,irvinky01,36,DAL,0,CLE,30,6,3,1,1,3,38.81666667,1,5,12,24,5,8,1,1,1,2,9,33,36,39,44.7
2023-24,202402270MIN,2/27/2024,MIN vs SAS,Devin Vassell,vassede01,54,SAS,0,MIN,21,6,6,3,0,3,38.98333333,0,6,9,18,2,8,1,3,2,3,12,27,27,33,43.2
2023-24,202402270MIN,2/27/2024,MIN vs SAS,Rudy Gobert,goberru01,56,MIN,1,SAS,13,17,3,0,4,1,39.13333333,6,11,6,12,0,1,1,2,2,4,20,16,30,33,48.9
2023-24,202402270NYK,2/27/2024,NYK vs NOP,Precious Achiuwa,achiupr01,52,NYK,1,NOP,15,7,2,0,1,1,39.71666667,3,4,4,10,0,3,7,8,3,1,9,17,22,24,28.4
2023-24,202402270CHI,2/27/2024,CHI vs DET,DeMar DeRozan,derozde01,56,CHI,1,DET,25,3,4,1,0,0,39.73333333,0,3,9,16,0,2,7,7,2,1,7,29,28,32,37.6
2023-24,202402270NYK,2/27/2024,NYK vs NOP,Josh Hart,hartjo01,58,NYK,1,NOP,15,10,5,2,0,1,40.16666667,3,7,6,15,1,4,2,6,4,2,15,20,25,30,39.5
2023-24,202402270POR,2/27/2024,POR vs MIA,Jerami Grant,grantje01,50,POR,1,MIA,24,7,6,3,0,3,40.4,1,6,7,15,3,5,7,8,4,3,13,30,31,37,47.4
2023-24,202402270NYK,2/27/2024,NYK vs NOP,Miles McBride,mcbrimi01,46,NYK,1,NOP,10,3,8,1,1,0,40.48333333,1,2,3,11,2,7,2,2,3,2,11,18,13,21,31.6
2023-24,202402270POR,2/27/2024,POR vs MIA,Anfernee Simons,simonan01,34,POR,1,MIA,26,1,4,0,0,4,40.56666667,0,1,10,26,4,11,2,2,3,0,5,30,27,31,29.2
2023-24,202402270CLE,2/27/2024,CLE vs DAL,Luka Doncic,doncilu01,50,DAL,0,CLE,45,9,14,3,0,1,41.26666667,0,9,17,29,6,11,5,5,1,3,23,59,54,68,84.8
2023-24,202402270CHI,2/27/2024,CHI vs DET,Coby White,whiteco01,58,CHI,1,DET,10,5,6,0,0,1,41.45,1,4,2,14,0,5,6,8,2,0,11,16,15,21,24
2023-24,202402260NYK,2/26/2024,NYK vs DET,Miles McBride,mcbrimi01,45,NYK,1,DET,2,0,0,0,0,0,10.45,0,0,1,2,0,1,0,0,1,0,0,2,2,2,2
2023-24,202402260NYK,2/26/2024,NYK vs DET,Malachi Flynn,flynnma01,50,DET,0,NYK,8,3,2,0,0,0,11.95,0,3,3,6,1,2,1,2,1,0,5,10,11,13,14.6
2023-24,202402260MEM,2/26/2024,MEM vs BRK,Dennis Smith Jr.,smithde03,41,BRK,0,MEM,0,2,3,0,0,0,13.81666667,2,0,0,3,0,1,0,2,2,0,5,3,2,5,6.9
2023-24,202402260NYK,2/26/2024,NYK vs DET,Alec Burks,burksal01,49,NYK,1,DET,7,1,1,1,0,2,14,1,0,3,9,1,3,0,1,1,1,2,8,8,9,10.7
2023-24,202402260MEM,2/26/2024,MEM vs BRK,Ben Simmons,simmobe01,15,BRK,0,MEM,4,6,3,0,0,0,14.16666667,2,4,2,2,0,0,0,0,3,0,9,7,10,13,15.7
2023-24,202402260IND,2/26/2024,IND vs TOR,Jalen Smith,smithja04,40,IND,1,TOR,9,5,2,0,1,0,14.25,3,2,4,7,1,2,0,0,0,1,7,11,14,16,21
2023-24,202402260MEM,2/26/2024,MEM vs BRK,Day'Ron Sharpe,sharpda01,42,BRK,0,MEM,8,8,2,0,0,1,15.15,3,5,4,7,0,1,0,0,2,0,10,10,16,18,19.6
2023-24,202402260SAC,2/26/2024,SAC vs MIA,Kevin Love,loveke01,46,MIA,0,SAC,19,7,1,0,0,1,15.23333333,1,6,6,9,2,3,5,6,1,0,8,20,26,27,27.9
2023-24,202402260MEM,2/26/2024,MEM vs BRK,Derrick Rose,rosede01,23,MEM,1,BRK,6,2,4,0,0,2,15.26666667,0,2,3,4,0,1,0,0,0,0,6,10,8,12,12.4
2023-24,202402260IND,2/26/2024,IND vs TOR,Bruce Brown,brownbr01,51,TOR,0,IND,2,1,1,0,0,1,16.38333333,0,1,1,4,0,1,0,0,1,0,2,3,3,4,3.7
2023-24,202402260NYK,2/26/2024,NYK vs DET,James Wiseman,wisemja01,38,DET,0,NYK,4,6,1,1,0,1,16.66666667,2,4,2,4,0,0,0,0,1,1,7,5,10,11,14.7
2023-24,202402260SAC,2/26/2024,SAC vs MIA,Chris Duarte,duartch01,40,SAC,1,MIA,0,1,1,1,1,0,16.76666667,1,0,0,2,0,2,0,0,0,2,2,1,1,2,8.7
2023-24,202402260IND,2/26/2024,IND vs TOR,Ben Sheppard,sheppbe01,37,IND,1,TOR,2,0,0,0,0,0,17.06666667,0,0,1,4,0,3,0,0,2,0,0,2,2,2,2
2023-24,202402260IND,2/26/2024,IND vs TOR,Obi Toppin,toppiob01,60,IND,1,TOR,4,3,0,2,0,1,18.73333333,0,3,2,8,0,5,0,0,2,2,3,4,7,7,12.6
2023-24,202402260MEM,2/26/2024,MEM vs BRK,Lonnie Walker IV,walkelo01,37,BRK,0,MEM,13,6,2,0,0,0,18.76666667,0,6,4,11,3,8,2,2,0,0,8,15,19,21,23.2
2023-24,202402260NYK,2/26/2024,NYK vs DET,Evan Fournier,fournev01,8,DET,0,NYK,7,0,1,2,0,2,19.61666667,0,0,3,5,1,3,0,0,3,2,1,8,7,8,12.5
2023-24,202402260MEM,2/26/2024,MEM vs BRK,Santi Aldama,aldamsa01,46,MEM,1,BRK,7,5,1,1,0,2,19.63333333,2,3,3,5,1,2,0,0,2,1,6,8,12,13,15.5
2023-24,202402260IND,2/26/2024,IND vs TOR,T.J. McConnell,mccontj01,49,IND,1,TOR,10,4,4,1,0,0,19.71666667,1,3,5,8,0,0,0,0,1,1,8,14,14,18,23.8
2023-24,202402260SAC,2/26/2024,SAC vs MIA,Harrison Barnes,barneha02,57,SAC,1,MIA,10,2,0,1,0,1,19.8,1,1,3,7,2,3,2,2,1,1,2,10,12,12,14.4
2023-24,202402260IND,2/26/2024,IND vs TOR,Ochai Agbaji,agbajoc01,57,TOR,0,IND,13,2,2,0,0,0,19.88333333,0,2,4,7,1,2,4,4,0,0,4,15,15,17,18.4
2023-24,202402260NYK,2/26/2024,NYK vs DET,Jericho Sims,simsje01,31,NYK,1,DET,2,6,2,0,0,1,20.03333333,4,2,1,2,0,0,0,0,0,0,8,4,8,10,11.2
2023-24,202402260SAC,2/26/2024,SAC vs MIA,Malik Monk,monkma01,56,SAC,1,MIA,8,2,7,2,0,1,20.68333333,0,2,4,10,0,4,0,2,3,2,9,15,10,17,25.9
2023-24,202402260SAC,2/26/2024,SAC vs MIA,Trey Lyles,lylestr01,42,SAC,1,MIA,5,3,0,0,1,1,20.78333333,1,2,2,3,1,1,0,0,5,1,3,5,8,8,10.6
2023-24,202402260MEM,2/26/2024,MEM vs BRK,Nic Claxton,claxtni01,47,BRK,0,MEM,10,4,3,1,3,1,21.3,0,4,5,5,0,0,0,0,4,4,7,13,14,17,30.3
2023-24,202402260IND,2/26/2024,IND vs TOR,Jakob Poeltl,poeltja01,47,TOR,0,IND,15,10,4,0,1,0,21.63333333,5,5,7,10,0,0,1,1,3,1,14,19,25,29,36
2023-24,202402260MEM,2/26/2024,MEM vs BRK,Yuta Watanabe,watanyu01,32,MEM,1,BRK,2,4,1,0,0,0,21.65,0,4,1,3,0,1,0,0,1,0,5,3,6,7,8.3
2023-24,202402260NYK,2/26/2024,NYK vs DET,Bojan Bogdanovic,bogdabo02,33,NYK,1,DET,13,6,1,0,0,1,21.78333333,0,6,5,11,3,8,0,0,3,0,7,14,19,20,20.7
2023-24,202402260IND,2/26/2024,IND vs TOR,Gradey Dick,dickgr01,37,TOR,0,IND,18,5,2,1,0,0,22.8,2,3,7,9,4,4,0,0,0,1,7,20,23,25,30
2023-24,202402260MEM,2/26/2024,MEM vs BRK,GG Jackson II,jacksgg01,25,MEM,1,BRK,6,5,0,0,0,0,23.25,0,5,1,13,0,6,4,4,1,0,5,6,11,11,12
2023-24,202402260IND,2/26/2024,IND vs TOR,Kelly Olynyk,olynyke01,56,TOR,0,IND,7,2,5,1,0,1,23.26666667,1,1,2,4,1,2,2,4,3,1,7,12,9,14,18.9
2023-24,202402260MEM,2/26/2024,MEM vs BRK,Lamar Stevens,stevela01,24,MEM,1,BRK,17,6,2,0,1,1,23.46666667,2,4,8,9,1,1,0,0,0,1,8,19,23,25,29.2
2023-24,202402260NYK,2/26/2024,NYK vs DET,Quentin Grimes,grimequ01,47,DET,0,NYK,14,3,2,1,3,2,23.96666667,0,3,4,9,3,6,3,3,2,4,5,16,17,19,30.6
2023-24,202402260NYK,2/26/2024,NYK vs DET,Jaden Ivey,iveyja01,53,DET,0,NYK,14,2,3,1,0,1,24.03333333,1,1,3,10,1,4,7,7,1,1,5,17,16,19,22.9
2023-24,202402260MEM,2/26/2024,MEM vs BRK,Luke Kennard,kennalu01,29,MEM,1,BRK,11,2,0,1,0,0,24.25,0,2,2,3,2,3,5,5,1,1,2,11,13,13,16.4
2023-24,202402260MEM,2/26/2024,MEM vs BRK,Vince Williams Jr.,willivi01,46,MEM,1,BRK,6,3,5,0,0,4,24.76666667,0,3,2,5,1,2,1,2,3,0,8,11,9,14,13.1
2023-24,202402260MEM,2/26/2024,MEM vs BRK,Dorian Finney-Smith,finnedo01,48,BRK,0,MEM,13,9,4,0,1,0,24.83333333,4,5,6,10,1,4,0,0,4,1,13,17,22,26,32.8
2023-24,202402260MEM,2/26/2024,MEM vs BRK,Cameron Johnson,johnsca02,44,BRK,0,MEM,12,2,3,1,0,1,24.98333333,0,2,5,9,2,6,0,0,3,1,5,15,14,17,20.9
2023-24,202402260MEM,2/26/2024,MEM vs BRK,Ziaire Williams,willizi02,48,MEM,1,BRK,6,2,0,1,0,2,25.41666667,0,2,3,11,0,5,0,0,1,1,2,6,8,8,9.4
2023-24,202402260MEM,2/26/2024,MEM vs BRK,Dennis Schroder,schrode01,57,BRK,0,MEM,18,2,5,0,0,4,26.38333333,0,2,7,12,3,4,1,2,2,0,7,23,20,25,23.9
2023-24,202402260IND,2/26/2024,IND vs TOR,Myles Turner,turnemy01,56,IND,1,TOR,16,11,1,0,2,3,26.4,5,6,5,8,2,3,4,6,2,2,12,17,27,28,33.7
2023-24,202402260NYK,2/26/2024,NYK vs DET,Isaiah Hartenstein,harteis01,53,NYK,1,DET,6,8,4,0,1,1,26.66666667,4,4,2,5,0,0,2,2,2,1,12,10,14,18,23.6
2023-24,202402260IND,2/26/2024,IND vs TOR,Andrew Nembhard,nembhan01,45,IND,1,TOR,11,0,1,1,0,2,26.75,0,0,5,14,1,4,0,0,3,1,1,12,11,12,13.5
2023-24,202402260MEM,2/26/2024,MEM vs BRK,Jake LaRavia,laravja01,13,MEM,1,BRK,10,5,2,1,2,0,27.73333333,2,3,4,10,1,3,1,2,2,3,7,12,15,17,28
2023-24,202402260SAC,2/26/2024,SAC vs MIA,Haywood Highsmith,highsha01,42,MIA,0,SAC,15,4,0,3,1,0,28.9,3,1,6,9,3,5,0,0,3,4,4,15,19,19,31.8
2023-24,202402260MEM,2/26/2024,MEM vs BRK,Cam Thomas,thomaca02,48,BRK,0,MEM,14,3,5,1,0,0,29.03333333,1,2,5,14,3,5,1,2,1,1,8,19,17,22,28.1
2023-24,202402260MEM,2/26/2024,MEM vs BRK,Jaren Jackson Jr.,jacksja02,53,MEM,1,BRK,15,4,1,2,1,3,29.58333333,1,3,2,12,1,2,10,13,1,3,5,16,19,20,27.3
2023-24,202402260IND,2/26/2024,IND vs TOR,Gary Trent Jr.,trentga02,53,TOR,0,IND,11,5,2,0,0,0,30.58333333,1,4,5,12,1,6,0,0,2,0,7,13,16,18,20
2023-24,202402260MEM,2/26/2024,MEM vs BRK,Mikal Bridges,bridgmi01,57,BRK,0,MEM,11,3,2,2,0,1,30.71666667,0,3,4,10,1,7,2,4,1,2,5,13,14,16,22.6
2023-24,202402260NYK,2/26/2024,NYK vs DET,Jalen Duren,durenja01,42,DET,0,NYK,11,16,4,1,1,0,31.33333333,5,11,4,11,0,0,3,4,2,2,20,15,27,31,42.2
2023-24,202402260NYK,2/26/2024,NYK vs DET,Donte DiVincenzo,divindo01,57,NYK,1,DET,21,3,4,2,0,2,31.95,0,3,8,13,5,10,0,0,1,2,7,25,24,28,34.6
2023-24,202402260IND,2/26/2024,IND vs TOR,Tyrese Haliburton,halibty01,47,IND,1,TOR,9,0,7,2,0,1,32.46666667,0,0,2,11,1,6,4,6,0,2,7,16,9,16,24.5
2023-24,202402260IND,2/26/2024,IND vs TOR,RJ Barrett,barrerj01,47,TOR,0,IND,24,2,5,0,0,2,32.68333333,0,2,11,16,2,3,0,3,4,0,7,29,26,31,31.9
2023-24,202402260NYK,2/26/2024,NYK vs DET,Simone Fontecchio,fontesi01,56,DET,0,NYK,12,3,1,0,0,2,32.96666667,0,3,5,9,2,5,0,0,1,0,4,13,15,16,15.1
2023-24,202402260NYK,2/26/2024,NYK vs DET,Precious Achiuwa,achiupr01,51,NYK,1,DET,4,11,1,2,2,2,33.56666667,4,7,2,7,0,1,0,0,3,4,12,5,15,16,28.7
2023-24,202402260IND,2/26/2024,IND vs TOR,Immanuel Quickley,quickim01,53,TOR,0,IND,19,6,2,2,1,4,34.91666667,0,6,8,16,3,7,0,0,3,3,8,21,25,27,34.2
2023-24,202402260SAC,2/26/2024,SAC vs MIA,Delon Wright,wrighde01,34,MIA,0,SAC,13,2,5,2,1,0,35.33333333,0,2,3,5,2,4,5,6,0,3,7,18,15,20,31.9
2023-24,202402260NYK,2/26/2024,NYK vs DET,Ausar Thompson,thompau01,57,DET,0,NYK,7,4,3,3,0,4,35.61666667,0,4,3,5,1,3,0,2,3,3,7,10,11,14,21.3
2023-24,202402260SAC,2/26/2024,SAC vs MIA,Keegan Murray,murrake02,53,SAC,1,MIA,28,5,1,3,1,1,35.86666667,2,3,10,14,6,7,2,2,5,4,6,29,33,34,46.5
2023-24,202402260SAC,2/26/2024,SAC vs MIA,Bam Adebayo,adebaba01,47,MIA,0,SAC,28,10,7,2,1,5,36.05,2,8,11,18,0,1,6,7,1,3,17,35,38,45,54.5
2023-24,202402260NYK,2/26/2024,NYK vs DET,Cade Cunningham,cunnica01,47,DET,0,NYK,32,5,8,0,2,5,36.05,2,3,10,19,5,7,7,8,1,2,13,40,37,45,51
2023-24,202402260IND,2/26/2024,IND vs TOR,Pascal Siakam,siakapa01,57,IND,1,TOR,27,9,6,0,1,1,36.61666667,3,6,11,22,3,8,2,2,4,1,15,33,36,42,48.8
2023-24,202402260SAC,2/26/2024,SAC vs MIA,Jaime Jaquez Jr.,jaqueja01,51,MIA,0,SAC,26,5,2,4,0,2,37.68333333,1,4,12,17,1,2,1,2,2,4,7,28,31,33,45
2023-24,202402260SAC,2/26/2024,SAC vs MIA,Kevin Huerter,huertke01,55,SAC,1,MIA,14,5,2,0,0,1,37.83333333,0,5,5,15,2,9,2,2,2,0,7,16,19,21,22
2023-24,202402260IND,2/26/2024,IND vs TOR,Scottie Barnes,barnesc01,58,TOR,0,IND,21,12,12,0,5,3,37.85,3,9,8,18,0,3,5,5,1,5,24,33,33,45,65.4
2023-24,202402260SAC,2/26/2024,SAC vs MIA,De'Aaron Fox,foxde01,51,SAC,1,MIA,27,8,6,3,1,7,38.53333333,3,5,13,24,1,5,0,0,2,4,14,33,35,41,50.6
2023-24,202402260SAC,2/26/2024,SAC vs MIA,Duncan Robinson,robindu01,52,MIA,0,SAC,4,4,11,0,0,2,38.6,1,3,1,11,0,6,2,3,3,0,15,15,8,19,23.3
2023-24,202402260IND,2/26/2024,IND vs TOR,Bennedict Mathurin,mathube01,56,IND,1,TOR,34,9,5,2,1,2,38.61666667,1,8,11,15,5,8,7,9,4,3,14,39,43,48,59.3
2023-24,202402260NYK,2/26/2024,NYK vs DET,Jalen Brunson,brunsja01,55,NYK,1,DET,35,1,12,2,0,4,39.6,0,1,11,26,3,11,10,11,3,2,13,47,36,48,56.2
2023-24,202402260SAC,2/26/2024,SAC vs MIA,Domantas Sabonis,sabondo01,57,SAC,1,MIA,14,14,10,0,0,3,40.26666667,3,11,6,8,1,1,1,4,2,0,24,24,28,38,42.8
2023-24,202402260SAC,2/26/2024,SAC vs MIA,Caleb Martin,martica02,40,MIA,0,SAC,16,6,1,1,0,1,40.3,2,4,6,14,3,6,1,1,2,1,7,17,22,23,26.7
2023-24,202402260NYK,2/26/2024,NYK vs DET,Josh Hart,hartjo01,57,NYK,1,DET,23,8,6,2,1,1,41.95,2,6,8,17,3,5,4,7,2,3,14,29,31,37,49.6
2023-24,202402250PHO,2/25/2024,PHO vs LAL,Drew Eubanks,eubandr01,52,PHO,1,LAL,2,1,1,1,2,0,10.18333333,1,0,1,2,0,0,0,0,1,3,2,3,3,4,13.7
2023-24,202402250LAC,2/25/2024,LAC vs SAC,Trey Lyles,lylestr01,41,SAC,0,LAC,3,3,0,0,0,2,10.51666667,2,1,1,2,0,0,1,2,1,0,3,3,6,6,4.6
2023-24,202402250HOU,2/25/2024,HOU vs OKC,Aaron Holiday,holidaa01,54,HOU,1,OKC,7,0,1,0,0,1,10.7,0,0,3,5,1,1,0,0,0,0,1,8,7,8,7.5
2023-24,202402250ATL,2/25/2024,ATL vs ORL,Kobe Bufkin,bufkiko01,6,ATL,1,ORL,2,1,3,1,1,1,10.75,0,1,1,4,0,2,0,0,1,2,4,5,3,6,12.7
2023-24,202402250NOP,2/25/2024,NOP vs CHI,Jeremiah Robinson-Earl,robinje02,24,NOP,1,CHI,3,0,0,1,1,1,11.18333333,0,0,1,2,1,2,0,0,1,2,0,3,3,3,8
2023-24,202402250POR,2/25/2024,POR vs CHO,Ashton Hagans,haganas01,6,POR,1,CHO,3,3,1,0,0,1,11.23333333,3,0,1,4,0,0,1,2,2,0,4,4,6,7,7.1
2023-24,202402250PHI,2/25/2024,PHI vs MIL,Mo Bamba,bambamo01,35,PHI,1,MIL,0,3,2,0,0,0,11.26666667,1,2,0,1,0,0,0,0,2,0,5,2,3,5,6.6
2023-24,202402250GSW,2/25/2024,GSW vs DEN,Peyton Watson,watsope01,56,DEN,0,GSW,3,1,1,0,0,1,11.31666667,0,1,1,4,1,3,0,2,1,0,2,4,4,5,4.7
2023-24,202402250ATL,2/25/2024,ATL vs ORL,Markelle Fultz,fultzma01,22,ORL,0,ATL,3,4,1,0,1,1,11.8,3,1,1,5,0,1,1,2,0,1,5,4,7,8,11.3
2023-24,202402250HOU,2/25/2024,HOU vs OKC,Jaylin Williams,willija07,48,OKC,0,HOU,5,5,1,0,0,0,11.95,1,4,2,4,1,3,0,0,0,0,6,6,10,11,12.5
2023-24,202402250GSW,2/25/2024,GSW vs DEN,Zeke Nnaji,nnajize01,43,DEN,0,GSW,6,3,1,0,1,0,11.96666667,3,0,1,3,0,0,4,4,2,1,4,7,9,10,14.1
2023-24,202402250IND,2/25/2024,IND vs DAL,Doug McDermott,mcderdo01,51,IND,1,DAL,3,2,1,0,0,0,12.1,0,2,1,2,0,1,1,2,0,0,3,4,5,6,6.9
2023-24,202402250HOU,2/25/2024,HOU vs OKC,Gordon Hayward,haywago01,28,OKC,0,HOU,0,4,2,0,0,1,12.18333333,2,2,0,3,0,0,0,0,0,0,6,2,4,6,6.8
2023-24,202402250WAS,2/25/2024,WAS vs CLE,Jared Butler,butleja02,20,WAS,1,CLE,2,0,2,0,0,0,12.28333333,0,0,1,4,0,3,0,0,2,0,2,4,2,4,5
2023-24,202402250IND,2/25/2024,IND vs DAL,Ben Sheppard,sheppbe01,36,IND,1,DAL,15,1,4,2,0,0,12.41666667,0,1,5,6,5,5,0,0,3,2,5,19,16,20,28.2
2023-24,202402250GSW,2/25/2024,GSW vs DEN,Trayce Jackson-Davis,jackstr02,43,GSW,1,DEN,6,2,1,1,2,1,12.45,1,1,3,4,0,0,0,2,2,3,3,7,8,9,17.9
2023-24,202402250ATL,2/25/2024,ATL vs ORL,Moritz Wagner,wagnemo01,56,ORL,0,ATL,2,5,1,1,1,2,12.7,1,4,1,2,0,1,0,0,1,2,6,3,7,8,13.5
2023-24,202402250POR,2/25/2024,POR vs CHO,Duop Reath,reathdu01,42,POR,1,CHO,7,1,0,0,1,0,12.93333333,0,1,3,5,1,3,0,0,3,1,1,7,8,8,11.2
2023-24,202402250GSW,2/25/2024,GSW vs DEN,Gary Payton II,paytoga02,22,GSW,1,DEN,0,5,1,2,0,0,13.73333333,3,2,0,1,0,0,0,0,1,2,6,1,5,6,13.5
2023-24,202402250UTA,2/25/2024,UTA vs SAS,Sandro Mamukelashvili,mamuksa01,32,SAS,0,UTA,8,1,1,2,0,0,13.86666667,1,0,4,5,0,0,0,0,2,2,2,9,9,10,16.7
2023-24,202402250GSW,2/25/2024,GSW vs DEN,Lester Quinones,quinole01,22,GSW,1,DEN,6,3,1,0,0,1,14.03333333,2,1,2,4,2,2,0,0,1,0,4,7,9,10,10.1
2023-24,202402250NOP,2/25/2024,NOP vs CHI,Andre Drummond,drumman01,57,CHI,0,NOP,7,8,1,0,0,0,14.25,1,7,2,5,0,0,3,3,2,0,9,8,15,16,18.1
2023-24,202402250LAC,2/25/2024,LAC vs SAC,Daniel Theis,theisda01,41,LAC,1,SAC,8,6,1,0,1,1,14.28333333,3,3,4,5,0,1,0,0,3,1,7,9,14,15,18.7
2023-24,202402250IND,2/25/2024,IND vs DAL,Dereck Lively II,livelde01,39,DAL,0,IND,4,3,0,4,0,0,14.48333333,1,2,2,3,0,0,0,1,3,4,3,4,7,7,19.6
2023-24,202402250UTA,2/25/2024,UTA vs SAS,Cedi Osman,osmande01,58,SAS,0,UTA,3,1,0,0,0,4,14.58333333,0,1,1,2,1,2,0,0,1,0,1,3,4,4,0.2
2023-24,202402250WAS,2/25/2024,WAS vs CLE,Richaun Holmes,holmeri01,27,WAS,1,CLE,11,7,0,0,0,2,14.66666667,1,6,4,6,0,0,3,3,2,0,7,11,18,18,17.4
2023-24,202402250IND,2/25/2024,IND vs DAL,Derrick Jones Jr.,jonesde02,52,DAL,0,IND,0,3,0,0,0,1,14.83333333,1,2,0,0,0,0,0,0,0,0,3,0,3,3,2.6
2023-24,202402250NOP,2/25/2024,NOP vs CHI,Jordan Hawkins,hawkijo01,51,NOP,1,CHI,8,1,0,0,0,1,15.01666667,0,1,3,7,2,5,0,0,1,0,1,8,9,9,8.2
2023-24,202402250HOU,2/25/2024,HOU vs OKC,Aaron Wiggins,wiggiaa01,54,OKC,0,HOU,0,2,0,1,1,0,15.05,1,1,0,2,0,1,0,0,0,2,2,0,2,2,8.4
2023-24,202402250IND,2/25/2024,IND vs DAL,Jalen Smith,smithja04,39,IND,1,DAL,2,6,2,0,0,1,15.25,1,5,1,6,0,4,0,0,3,0,8,4,8,10,11.2
2023-24,202402250NOP,2/25/2024,NOP vs CHI,Dalen Terry,terryda01,37,CHI,0,NOP,2,4,3,2,0,1,15.4,1,3,1,4,0,1,0,0,4,2,7,5,6,9,16.3
2023-24,202402250UTA,2/25/2024,UTA vs SAS,Brice Sensabaugh,sensabr01,8,UTA,1,SAS,5,3,1,0,0,1,15.61666667,0,3,2,3,1,1,0,0,0,0,4,6,8,9,9.1
2023-24,202402250HOU,2/25/2024,HOU vs OKC,Jeff Green,greenje02,55,HOU,1,OKC,2,0,1,0,0,0,15.71666667,0,0,1,3,0,2,0,0,0,0,1,3,2,3,3.5
2023-24,202402250WAS,2/25/2024,WAS vs CLE,Johnny Davis,davisjo06,26,WAS,1,CLE,2,2,0,0,0,0,15.81666667,0,2,1,3,0,2,0,0,5,0,2,2,4,4,4.4
2023-24,202402250LAC,2/25/2024,LAC vs SAC,Chris Duarte,duartch01,39,SAC,0,LAC,4,2,0,2,0,0,15.86666667,0,2,1,3,1,3,1,1,0,2,2,4,6,6,12.4
2023-24,202402250GSW,2/25/2024,GSW vs DEN,Reggie Jackson,jacksre01,58,DEN,0,GSW,3,0,2,0,0,1,15.98333333,0,0,1,2,1,2,0,0,4,0,2,5,3,5,5
2023-24,202402250ATL,2/25/2024,ATL vs ORL,Garrison Mathews,mathega01,41,ATL,1,ORL,3,2,0,0,0,0,16.5,0,2,1,4,1,4,0,0,2,0,2,3,5,5,5.4
2023-24,202402250HOU,2/25/2024,HOU vs OKC,Cam Whitmore,whitmca01,31,HOU,1,OKC,12,3,0,1,1,2,16.73333333,0,3,4,9,1,4,3,4,3,2,3,12,15,15,19.6
2023-24,202402250HOU,2/25/2024,HOU vs OKC,Isaiah Joe,joeis01,53,OKC,0,HOU,5,3,0,3,0,1,16.91666667,0,3,2,5,1,3,0,0,3,3,3,5,8,8,16.6
2023-24,202402250ATL,2/25/2024,ATL vs ORL,Clint Capela,capelca01,49,ATL,1,ORL,4,7,0,0,0,1,17.08333333,4,3,2,8,0,0,0,0,2,0,7,4,11,11,11.4
2023-24,202402250WAS,2/25/2024,WAS vs CLE,Georges Niang,niangge01,56,CLE,0,WAS,8,4,0,1,0,0,17.2,0,4,3,6,2,4,0,0,0,1,4,8,12,12,15.8
2023-24,202402250PHI,2/25/2024,PHI vs MIL,Nicolas Batum,batumni01,37,PHI,1,MIL,6,1,0,1,0,0,17.4,0,1,2,5,2,5,0,0,0,1,1,6,7,7,10.2
2023-24,202402250PHI,2/25/2024,PHI vs MIL,Patrick Beverley,beverpa01,53,MIL,0,PHI,3,0,2,1,0,0,17.75,0,0,1,5,1,5,0,0,0,1,2,5,3,5,9
2023-24,202402250LAC,2/25/2024,LAC vs SAC,Davion Mitchell,mitchda01,46,SAC,0,LAC,6,0,1,0,0,0,18.21666667,0,0,2,3,2,3,0,0,3,0,1,7,6,7,7.5
2023-24,202402250POR,2/25/2024,POR vs CHO,Jabari Walker,walkeja01,52,POR,1,CHO,6,5,0,0,0,1,18.23333333,4,1,3,8,0,3,0,0,1,0,5,6,11,11,11
2023-24,202402250LAC,2/25/2024,LAC vs SAC,Russell Westbrook,westbru01,56,LAC,1,SAC,8,4,2,1,0,1,18.26666667,1,3,3,10,0,2,2,2,1,1,6,10,12,14,17.8
2023-24,202402250UTA,2/25/2024,UTA vs SAS,Blake Wesley,weslebl01,37,SAS,0,UTA,0,2,5,0,0,0,18.28333333,0,2,0,2,0,0,0,0,0,0,7,5,2,7,9.9
2023-24,202402250POR,2/25/2024,POR vs CHO,Toumani Camara,camarto01,55,POR,1,CHO,0,3,1,0,0,0,18.48333333,2,1,0,4,0,3,0,0,1,0,4,1,3,4,5.1
2023-24,202402250PHI,2/25/2024,PHI vs MIL,De'Anthony Melton,meltode01,35,PHI,1,MIL,16,3,3,2,0,0,18.48333333,0,3,5,12,4,8,2,2,2,2,6,19,19,22,30.1
2023-24,202402250ATL,2/25/2024,ATL vs ORL,Goga Bitadze,bitadgo01,48,ORL,0,ATL,2,5,2,0,3,1,18.5,2,3,1,5,0,1,0,0,2,3,7,4,7,9,19
2023-24,202402250HOU,2/25/2024,HOU vs OKC,Cason Wallace,wallaca01,57,OKC,0,HOU,6,2,1,0,2,0,18.5,1,1,2,7,2,5,0,0,0,2,3,7,8,9,15.9
2023-24,202402250WAS,2/25/2024,WAS vs CLE,Isaac Okoro,okorois01,47,CLE,0,WAS,7,1,2,2,0,0,18.55,0,1,2,6,1,4,2,2,0,2,3,9,8,10,17.2
2023-24,202402250PHI,2/25/2024,PHI vs MIL,Bobby Portis,portibo01,58,MIL,0,PHI,17,5,1,1,2,2,18.6,1,4,7,11,3,4,0,0,2,3,6,18,22,23,31.5
2023-24,202402250UTA,2/25/2024,UTA vs SAS,Walker Kessler,kesslwa01,50,UTA,1,SAS,10,6,2,0,3,2,18.66666667,1,5,4,5,0,0,2,4,3,3,8,12,16,18,27.2
2023-24,202402250IND,2/25/2024,IND vs DAL,Obi Toppin,toppiob01,59,IND,1,DAL,8,2,4,0,0,2,18.73333333,0,2,3,5,2,4,0,0,1,0,6,12,10,14,14.4
2023-24,202402250IND,2/25/2024,IND vs DAL,T.J. McConnell,mccontj01,48,IND,1,DAL,12,0,7,0,0,1,19.11666667,0,0,6,10,0,0,0,0,1,0,7,19,12,19,21.5
2023-24,202402250ATL,2/25/2024,ATL vs ORL,Joe Ingles,inglejo01,44,ORL,0,ATL,3,2,3,1,0,0,19.16666667,1,1,1,2,1,2,0,0,0,1,5,6,5,8,12.9
2023-24,202402250NOP,2/25/2024,NOP vs CHI,Larry Nance Jr.,nancela02,40,NOP,1,CHI,2,3,0,0,0,4,19.16666667,2,1,0,2,0,1,2,2,2,0,3,2,5,5,1.6
2023-24,202402250NOP,2/25/2024,NOP vs CHI,Matt Ryan,ryanma01,16,NOP,1,CHI,14,4,0,0,0,1,19.36666667,0,4,5,10,4,9,0,0,3,0,4,14,18,18,17.8
2023-24,202402250ATL,2/25/2024,ATL vs ORL,Bruno Fernando,fernabr01,20,ATL,1,ORL,7,1,4,2,0,0,19.41666667,0,1,2,5,0,0,3,4,2,2,5,11,8,12,20.2
2023-24,202402250IND,2/25/2024,IND vs DAL,Daniel Gafford,gaffoda01,50,DAL,0,IND,8,5,0,0,1,0,19.46666667,3,2,4,6,0,0,0,2,2,1,5,8,13,13,17
2023-24,202402250UTA,2/25/2024,UTA vs SAS,Julian Champagnie,champju02,51,SAS,0,UTA,2,6,4,2,1,1,19.56666667,2,4,1,6,0,4,0,0,2,3,10,6,8,12,23.2
2023-24,202402250NOP,2/25/2024,NOP vs CHI,Jevon Carter,carteje01,54,CHI,0,NOP,8,3,2,2,0,1,19.65,1,2,3,7,2,6,0,0,0,2,5,10,11,13,19.6
2023-24,202402250GSW,2/25/2024,GSW vs DEN,Christian Braun,braunch01,58,DEN,0,GSW,7,3,0,1,1,0,19.81666667,2,1,3,7,1,2,0,0,1,2,3,7,10,10,16.6
2023-24,202402250LAC,2/25/2024,LAC vs SAC,Amir Coffey,coffeam01,44,LAC,1,SAC,0,2,1,0,0,0,19.9,1,1,0,2,0,0,0,0,2,0,3,1,2,3,3.9
2023-24,202402250UTA,2/25/2024,UTA vs SAS,Kris Dunn,dunnkr01,50,UTA,1,SAS,8,2,1,4,0,3,20.4,0,2,3,3,1,1,1,2,1,4,3,9,10,11,20.9
2023-24,202402250ATL,2/25/2024,ATL vs ORL,Caleb Houstan,houstca01,41,ORL,0,ATL,12,2,0,0,0,0,20.5,0,2,4,9,4,9,0,0,1,0,2,12,14,14,14.4
2023-24,202402250POR,2/25/2024,POR vs CHO,Bryce McGowens,mcgowbr01,45,CHO,0,POR,4,4,1,0,1,0,20.61666667,0,4,1,3,0,1,2,2,0,1,5,5,8,9,13.3
2023-24,202402250UTA,2/25/2024,UTA vs SAS,Zach Collins,colliza01,46,SAS,0,UTA,17,8,3,1,1,2,21.03333333,2,6,7,17,2,3,1,5,2,2,11,20,25,28,35.1
2023-24,202402250HOU,2/25/2024,HOU vs OKC,Amen Thompson,thompam01,38,HOU,1,OKC,6,6,1,2,3,1,21.06666667,1,5,2,10,0,2,2,4,3,5,7,7,12,13,28.7
2023-24,202402250PHI,2/25/2024,PHI vs MIL,Kyle Lowry,lowryky01,39,PHI,1,MIL,3,2,3,2,0,1,21.13333333,1,1,1,2,1,2,0,0,2,2,5,6,5,8,14.9
2023-24,202402250PHI,2/25/2024,PHI vs MIL,Pat Connaughton,connapa01,52,MIL,0,PHI,7,5,1,0,2,1,22.4,2,3,3,4,1,2,0,0,0,2,6,8,12,13,19.5
2023-24,202402250HOU,2/25/2024,HOU vs OKC,Josh Giddey,giddejo01,56,OKC,0,HOU,2,9,5,3,1,1,23.16666667,3,6,1,5,0,0,0,0,5,4,14,7,11,16,31.3
2023-24,202402250IND,2/25/2024,IND vs DAL,Tim Hardaway Jr.,hardati02,54,DAL,0,IND,11,3,1,0,1,4,23.25,0,3,4,12,3,6,0,0,0,1,4,12,14,15,15.1
2023-24,202402250PHO,2/25/2024,PHO vs LAL,Spencer Dinwiddie,dinwisp01,53,LAL,0,PHO,3,0,2,0,0,0,23.43333333,0,0,1,5,1,4,0,0,2,0,2,5,3,5,6
2023-24,202402250POR,2/25/2024,POR vs CHO,Grant Williams,willigr01,53,CHO,0,POR,5,2,1,0,1,3,23.63333333,0,2,1,4,1,3,2,4,3,1,3,6,7,8,8.9
2023-24,202402250PHO,2/25/2024,PHO vs LAL,Bol Bol,bolbo01,20,PHO,1,LAL,11,4,1,0,2,0,23.96666667,1,3,5,9,1,4,0,0,1,2,5,12,15,16,23.3
2023-24,202402250POR,2/25/2024,POR vs CHO,Vasilije Micic,micicva01,36,CHO,0,POR,11,2,7,2,0,0,24.45,0,2,5,6,1,2,0,0,1,2,9,18,13,20,29.9
2023-24,202402250IND,2/25/2024,IND vs DAL,Maxi Kleber,klebima01,21,DAL,0,IND,3,1,1,0,0,0,24.5,0,1,1,3,1,2,0,0,0,0,2,4,4,5,5.7
2023-24,202402250POR,2/25/2024,POR vs CHO,Tre Mann,manntr01,19,CHO,0,POR,6,2,3,3,0,0,24.55,0,2,2,7,1,3,1,1,3,3,5,9,8,11,21.9
2023-24,202402250GSW,2/25/2024,GSW vs DEN,Jonathan Kuminga,kuminjo01,55,GSW,1,DEN,19,6,3,0,0,1,24.68333333,1,5,5,10,0,1,9,13,1,0,9,22,25,28,29.7
2023-24,202402250LAC,2/25/2024,LAC vs SAC,Kevin Huerter,huertke01,54,SAC,0,LAC,15,3,2,0,0,1,24.75,0,3,6,10,3,6,0,0,2,0,5,17,18,20,20.6
2023-24,202402250PHI,2/25/2024,PHI vs MIL,Jae Crowder,crowdja01,27,MIL,0,PHI,0,8,3,1,0,1,25.25,1,7,0,4,0,3,0,0,1,1,11,3,8,11,16.1
2023-24,202402250UTA,2/25/2024,UTA vs SAS,Taylor Hendricks,hendrita0,19,UTA,1,SAS,9,3,0,0,1,0,25.76666667,1,2,4,8,1,5,0,0,6,1,3,9,12,12,15.6
2023-24,202402250PHO,2/25/2024,PHO vs LAL,Rui Hachimura,hachiru01,46,LAL,0,PHO,13,4,0,0,0,0,26.1,0,4,5,9,2,2,1,1,2,0,4,13,17,17,17.8
2023-24,202402250WAS,2/25/2024,WAS vs CLE,Max Strus,strusma01,56,CLE,0,WAS,3,3,5,0,0,2,26.58333333,0,3,0,3,0,3,3,4,0,0,8,8,6,11,12.1
2023-24,202402250PHI,2/25/2024,PHI vs MIL,Paul Reed,reedpa01,57,PHI,1,MIL,13,8,1,0,2,3,26.78333333,4,4,6,13,1,2,0,0,5,2,9,14,21,22,27.1
2023-24,202402250UTA,2/25/2024,UTA vs SAS,John Collins,collijo01,54,UTA,1,SAS,20,8,1,2,2,1,26.8,0,8,6,11,3,6,5,5,1,4,9,21,28,29,42.1
2023-24,202402250UTA,2/25/2024,UTA vs SAS,Collin Sexton,sextoco01,58,UTA,1,SAS,16,2,10,4,0,4,26.86666667,1,1,4,9,0,0,8,8,4,4,12,26,18,28,41.4
2023-24,202402250UTA,2/25/2024,UTA vs SAS,Victor Wembanyama,wembavi01,52,SAS,0,UTA,22,10,2,1,5,4,26.96666667,2,8,9,17,1,3,3,4,1,6,12,24,32,34,51
2023-24,202402250GSW,2/25/2024,GSW vs DEN,Draymond Green,greendr01,32,GSW,1,DEN,7,5,4,1,0,6,27.16666667,0,5,3,6,1,1,0,0,1,1,9,11,12,16,16
2023-24,202402250PHO,2/25/2024,PHO vs LAL,Taurean Prince,princta02,57,LAL,0,PHO,8,1,1,0,0,0,27.16666667,0,1,3,10,2,6,0,0,0,0,2,9,9,10,10.7
2023-24,202402250ATL,2/25/2024,ATL vs ORL,Anthony Black,blackan01,53,ORL,0,ATL,4,8,1,0,0,3,27.38333333,2,6,1,7,1,3,1,2,1,0,9,5,12,13,12.1
2023-24,202402250PHI,2/25/2024,PHI vs MIL,Buddy Hield,hieldbu01,60,PHI,1,MIL,11,2,4,0,0,2,27.5,1,1,4,13,3,9,0,0,0,0,6,15,13,17,17.4
2023-24,202402250LAC,2/25/2024,LAC vs SAC,Malik Monk,monkma01,55,SAC,0,LAC,12,2,5,0,0,1,27.9,0,2,4,11,2,6,2,2,0,0,7,17,14,19,20.9
2023-24,202402250ATL,2/25/2024,ATL vs ORL,Jalen Suggs,suggsja01,53,ORL,0,ATL,14,2,6,2,1,3,28.13333333,0,2,6,10,2,4,0,0,3,3,8,20,16,22,31.4
2023-24,202402250UTA,2/25/2024,UTA vs SAS,Malaki Branham,branhma01,53,SAS,0,UTA,14,2,2,0,0,0,28.35,0,2,5,12,2,6,2,2,2,0,4,16,16,18,19.4
2023-24,202402250NOP,2/25/2024,NOP vs CHI,Jonas Valanciunas,valanjo01,58,NOP,1,CHI,14,17,0,0,1,0,28.35,7,10,7,15,0,3,0,0,2,1,17,14,31,31,37.4
2023-24,202402250WAS,2/25/2024,WAS vs CLE,Caris LeVert,leverca01,46,CLE,0,WAS,18,12,8,0,0,0,28.43333333,2,10,6,10,1,3,5,6,2,0,20,26,30,38,44.4
2023-24,202402250ATL,2/25/2024,ATL vs ORL,De'Andre Hunter,huntede01,33,ATL,1,ORL,18,7,2,2,0,1,28.48333333,1,6,5,8,2,3,6,6,3,2,9,20,25,27,34.4
2023-24,202402250WAS,2/25/2024,WAS vs CLE,Evan Mobley,mobleev01,33,CLE,0,WAS,21,6,1,1,5,1,28.66666667,2,4,9,11,0,0,3,6,4,6,7,22,27,28,46.7
2023-24,202402250UTA,2/25/2024,UTA vs SAS,Jeremy Sochan,sochaje01,58,SAS,0,UTA,1,4,3,1,1,0,29.15,0,4,0,5,0,1,1,2,2,2,7,4,5,8,16.3
2023-24,202402250IND,2/25/2024,IND vs DAL,Pascal Siakam,siakapa01,56,IND,1,DAL,12,9,2,2,0,0,29.26666667,0,9,5,11,0,2,2,2,1,2,11,14,21,23,31.8
2023-24,202402250PHI,2/25/2024,PHI vs MIL,Kelly Oubre Jr.,oubreke01,45,PHI,1,MIL,12,9,2,3,0,3,29.28333333,5,4,5,15,1,5,1,2,3,3,11,14,21,23,31.8
2023-24,202402250HOU,2/25/2024,HOU vs OKC,Alperen Sengun,sengual01,56,HOU,1,OKC,19,12,2,1,1,6,29.5,5,7,6,12,1,3,6,7,4,2,14,21,31,33,36.4
2023-24,202402250IND,2/25/2024,IND vs DAL,Myles Turner,turnemy01,55,IND,1,DAL,33,8,1,0,0,4,29.8,2,6,10,15,2,7,11,12,2,0,9,34,41,42,40.1
2023-24,202402250UTA,2/25/2024,UTA vs SAS,Tre Jones,jonestr01,53,SAS,0,UTA,15,3,9,1,0,3,29.9,0,3,5,6,3,4,2,2,3,1,12,24,18,27,32.1
2023-24,202402250GSW,2/25/2024,GSW vs DEN,Brandin Podziemski,podzibr01,50,GSW,1,DEN,4,6,4,1,0,2,30.1,2,4,2,6,0,1,0,0,0,1,10,8,10,14,18.2
2023-24,202402250UTA,2/25/2024,UTA vs SAS,Keyonte George,georgke01,52,UTA,1,SAS,7,3,6,1,1,3,30.33333333,0,3,3,13,1,4,0,0,0,2,9,13,10,16,22.6
2023-24,202402250ATL,2/25/2024,ATL vs ORL,Cole Anthony,anthoco01,57,ORL,0,ATL,15,3,3,1,2,3,30.46666667,0,3,6,16,2,6,1,3,4,3,6,18,18,21,29.1
2023-24,202402250IND,2/25/2024,IND vs DAL,P.J. Washington,washipj01,49,DAL,0,IND,2,6,1,2,0,4,30.51666667,0,6,1,6,0,3,0,0,3,2,7,3,8,9,12.7
2023-24,202402250POR,2/25/2024,POR vs CHO,Matisse Thybulle,thybuma01,54,POR,1,CHO,0,4,0,6,2,0,30.61666667,0,4,0,3,0,2,0,0,1,8,4,0,4,4,28.8
2023-24,202402250GSW,2/25/2024,GSW vs DEN,Andrew Wiggins,wiggian01,51,GSW,1,DEN,14,4,4,0,1,0,30.63333333,0,4,5,10,2,4,2,2,2,1,8,18,18,22,27.8
2023-24,202402250GSW,2/25/2024,GSW vs DEN,Klay Thompson,thompkl01,53,GSW,1,DEN,23,2,1,0,0,2,30.7,0,2,7,15,5,13,4,4,4,0,3,24,25,26,24.9
2023-24,202402250PHI,2/25/2024,PHI vs MIL,Tobias Harris,harrito02,51,PHI,1,MIL,8,8,0,1,3,0,31,1,7,3,11,0,3,2,2,1,4,8,8,16,16,29.6
2023-24,202402250IND,2/25/2024,IND vs DAL,Tyrese Haliburton,halibty01,46,IND,1,DAL,17,3,10,4,0,1,31.38333333,0,3,8,15,1,5,0,0,0,4,13,27,20,30,46.6
2023-24,202402250POR,2/25/2024,POR vs CHO,Cody Martin,martico01,25,CHO,0,POR,11,6,10,2,1,2,31.48333333,1,5,4,8,1,3,2,2,0,3,16,21,17,27,40.2
2023-24,202402250HOU,2/25/2024,HOU vs OKC,Luguentz Dort,dortlu01,55,OKC,0,HOU,16,5,2,1,0,0,31.53333333,0,5,5,9,4,6,2,2,4,1,7,18,21,23,28
2023-24,202402250NOP,2/25/2024,NOP vs CHI,Alex Caruso,carusal01,49,CHI,0,NOP,12,3,2,2,0,0,31.73333333,1,2,5,13,2,9,0,0,2,2,5,14,15,17,24.6
2023-24,202402250PHI,2/25/2024,PHI vs MIL,Malik Beasley,beaslma01,56,MIL,0,PHI,20,2,1,0,0,1,31.85,0,2,7,9,6,7,0,0,3,0,3,21,22,23,22.9
2023-24,202402250HOU,2/25/2024,HOU vs OKC,Jalen Green,greenja05,57,HOU,1,OKC,11,7,4,0,2,2,31.86666667,1,6,5,13,1,5,0,0,1,2,11,15,18,22,29.4
2023-24,202402250POR,2/25/2024,POR vs CHO,Jerami Grant,grantje01,49,POR,1,CHO,15,2,5,2,0,5,31.88333333,0,2,6,18,1,6,2,2,0,2,7,20,17,22,25.9
2023-24,202402250PHI,2/25/2024,PHI vs MIL,Brook Lopez,lopezbr01,55,MIL,0,PHI,11,7,3,0,5,2,31.96666667,2,5,4,9,1,4,2,2,2,5,10,14,18,21,36.9
2023-24,202402250GSW,2/25/2024,GSW vs DEN,Michael Porter Jr.,portemi01,57,DEN,0,GSW,9,7,1,1,0,0,32.11666667,0,7,3,11,1,6,2,2,1,1,8,10,16,17,21.9
2023-24,202402250IND,2/25/2024,IND vs DAL,Kyrie Irving,irvinky01,35,DAL,0,IND,29,6,2,0,0,1,32.15,0,6,10,22,3,7,6,6,0,0,8,31,35,37,38.2
2023-24,202402250GSW,2/25/2024,GSW vs DEN,Stephen Curry,curryst01,53,GSW,1,DEN,20,1,4,0,0,3,32.16666667,0,1,6,19,1,10,7,8,2,0,5,24,21,25,24.2
2023-24,202402250IND,2/25/2024,IND vs DAL,Josh Green,greenjo02,44,DAL,0,IND,14,5,1,2,0,2,32.43333333,2,3,6,8,2,3,0,0,1,2,6,15,19,20,25.5
2023-24,202402250UTA,2/25/2024,UTA vs SAS,Lauri Markkanen,markkla01,48,UTA,1,SAS,26,7,4,2,1,1,32.46666667,1,6,10,18,5,8,1,1,0,3,11,30,33,37,48.4
2023-24,202402250GSW,2/25/2024,GSW vs DEN,Aaron Gordon,gordoaa01,52,DEN,0,GSW,17,6,2,3,1,2,32.66666667,2,4,7,10,0,3,3,5,4,4,8,19,23,25,37.2
2023-24,202402250LAC,2/25/2024,LAC vs SAC,De'Aaron Fox,foxde01,50,SAC,0,LAC,33,6,7,3,0,3,32.73333333,2,4,12,22,0,4,9,10,3,3,13,40,39,46,56.7
2023-24,202402250POR,2/25/2024,POR vs CHO,Kris Murray,murrakr01,36,POR,1,CHO,6,9,4,2,0,2,32.75,6,3,2,9,0,4,2,4,4,2,13,10,15,19,26.8
2023-24,202402250POR,2/25/2024,POR vs CHO,Nick Richards,richani01,48,CHO,0,POR,21,10,0,2,3,0,32.8,2,8,8,11,0,0,5,7,2,5,10,21,31,31,48
2023-24,202402250NOP,2/25/2024,NOP vs CHI,Zion Williamson,willizi01,47,NOP,1,CHI,19,8,11,0,2,3,32.91666667,1,7,9,15,0,0,1,2,2,2,19,30,27,38,48.1
2023-24,202402250WAS,2/25/2024,WAS vs CLE,Darius Garland,garlada01,32,CLE,0,WAS,17,2,7,1,0,3,32.93333333,0,2,6,15,3,9,2,2,2,1,9,24,19,26,29.9
2023-24,202402250UTA,2/25/2024,UTA vs SAS,Jordan Clarkson,clarkjo01,48,UTA,1,SAS,22,2,10,0,0,1,32.95,0,2,8,17,4,8,2,2,0,0,12,32,24,34,38.4
2023-24,202402250IND,2/25/2024,IND vs DAL,Bennedict Mathurin,mathube01,55,IND,1,DAL,14,11,5,3,0,2,32.95,2,9,5,14,3,7,1,1,4,3,16,19,25,30,41.7
2023-24,202402250WAS,2/25/2024,WAS vs CLE,Marvin Bagley III,baglema01,40,WAS,1,CLE,9,10,2,0,1,1,32.98333333,2,8,4,10,0,2,1,3,1,1,12,11,19,21,26
2023-24,202402250LAC,2/25/2024,LAC vs SAC,Ivica Zubac,zubaciv01,46,LAC,1,SAC,16,6,2,1,0,4,33.01666667,1,5,8,9,0,0,0,0,3,1,8,18,22,24,25.2
2023-24,202402250IND,2/25/2024,IND vs DAL,Andrew Nembhard,nembhan01,44,IND,1,DAL,15,3,2,1,0,0,33.08333333,1,2,7,8,1,1,0,0,1,1,5,17,18,20,24.6
2023-24,202402250IND,2/25/2024,IND vs DAL,Luka Doncic,doncilu01,49,DAL,0,IND,33,6,6,1,2,3,33.1,1,5,10,21,4,8,9,12,4,3,12,39,39,45,55.2
2023-24,202402250HOU,2/25/2024,HOU vs OKC,Chet Holmgren,holmgch01,57,OKC,0,HOU,29,8,7,1,3,2,33.2,2,6,11,16,5,8,2,2,3,4,15,36,37,44,59.1
2023-24,202402250HOU,2/25/2024,HOU vs OKC,Dillon Brooks,brookdi01,48,HOU,1,OKC,13,2,2,0,0,1,33.35,1,1,4,10,4,5,1,2,2,0,4,15,15,17,17.4
2023-24,202402250ATL,2/25/2024,ATL vs ORL,Franz Wagner,wagnefr01,50,ORL,0,ATL,19,8,5,1,0,2,33.46666667,1,7,7,16,2,6,3,5,5,1,13,24,27,32,37.1
2023-24,202402250NOP,2/25/2024,NOP vs CHI,Nikola Vucevic,vucevni01,52,CHI,0,NOP,22,13,3,1,0,3,33.75,5,8,10,19,2,5,0,0,3,1,16,25,35,38,42.1
2023-24,202402250ATL,2/25/2024,ATL vs ORL,Wendell Carter Jr.,cartewe01,32,ORL,0,ATL,18,10,1,1,1,3,33.88333333,4,6,7,12,2,5,2,4,2,2,11,19,28,29,34.5
2023-24,202402250UTA,2/25/2024,UTA vs SAS,Devin Vassell,vassede01,53,SAS,0,UTA,27,9,5,0,3,6,34.31666667,3,6,10,19,4,8,3,4,1,3,14,32,36,41,48.3
2023-24,202402250ATL,2/25/2024,ATL vs ORL,Saddiq Bey,beysa01,56,ATL,1,ORL,12,2,1,1,0,2,34.5,1,1,5,11,2,5,0,0,1,1,3,13,14,15,16.9
2023-24,202402250POR,2/25/2024,POR vs CHO,Anfernee Simons,simonan01,33,POR,1,CHO,10,4,0,0,0,4,34.86666667,0,4,4,21,0,8,2,2,3,0,4,10,14,14,10.8
2023-24,202402250GSW,2/25/2024,GSW vs DEN,Kentavious Caldwell-Pope,caldwke01,53,DEN,0,GSW,13,2,3,1,0,0,35.05,1,1,5,9,2,4,1,1,1,1,5,16,15,18,22.9
2023-24,202402250LAC,2/25/2024,LAC vs SAC,James Harden,hardeja01,51,LAC,1,SAC,20,5,8,0,0,3,35.41666667,0,5,4,13,2,10,10,10,3,0,13,28,25,33,35
2023-24,202402250WAS,2/25/2024,WAS vs CLE,Tyus Jones,jonesty01,57,WAS,1,CLE,3,1,11,1,0,1,35.41666667,0,1,1,4,1,1,0,0,1,1,12,14,4,15,22.7
2023-24,202402250PHO,2/25/2024,PHO vs LAL,Austin Reaves,reaveau01,60,LAL,0,PHO,14,4,4,1,0,2,35.43333333,0,4,5,12,2,7,2,2,1,1,8,18,18,22,25.8
2023-24,202402250ATL,2/25/2024,ATL vs ORL,Bogdan Bogdanovic,bogdabo01,55,ATL,1,ORL,17,5,3,1,0,1,35.55,0,5,5,11,3,5,4,4,2,1,8,20,22,25,29.5
2023-24,202402250LAC,2/25/2024,LAC vs SAC,Harrison Barnes,barneha02,56,SAC,0,LAC,22,2,1,1,0,1,35.63333333,1,1,8,12,4,7,2,3,0,1,3,23,24,25,27.9
2023-24,202402250PHI,2/25/2024,PHI vs MIL,Giannis Antetokounmpo,antetgi01,56,MIL,0,PHI,30,12,9,0,1,6,35.75,1,11,10,17,1,2,9,12,1,1,21,39,42,51,54.9
2023-24,202402250PHI,2/25/2024,PHI vs MIL,Damian Lillard,lillada01,53,MIL,0,PHI,24,7,9,2,0,5,35.75,0,7,8,15,4,8,4,4,4,2,16,33,31,40,46.9
2023-24,202402250LAC,2/25/2024,LAC vs SAC,Domantas Sabonis,sabondo01,56,SAC,0,LAC,17,15,12,3,0,1,35.85,7,8,7,17,0,1,3,4,4,3,27,29,32,44,61
2023-24,202402250LAC,2/25/2024,LAC vs SAC,Kawhi Leonard,leonaka01,51,LAC,1,SAC,20,8,3,4,1,3,35.9,0,8,7,18,0,3,6,7,0,5,11,23,28,31,46.1
2023-24,202402250GSW,2/25/2024,GSW vs DEN,Jamal Murray,murraja01,42,DEN,0,GSW,27,4,3,0,1,4,36.18333333,1,3,9,16,3,5,6,6,3,1,7,30,31,34,35.3
2023-24,202402250HOU,2/25/2024,HOU vs OKC,Jalen Williams,willija06,51,OKC,0,HOU,22,4,5,0,0,0,36.18333333,0,4,9,22,2,6,2,2,4,0,9,27,26,31,34.3
2023-24,202402250WAS,2/25/2024,WAS vs CLE,Donovan Mitchell,mitchdo01,45,CLE,0,WAS,16,4,5,1,0,3,36.3,0,4,4,10,3,6,5,5,5,1,9,21,20,25,28.3
2023-24,202402250HOU,2/25/2024,HOU vs OKC,Shai Gilgeous-Alexander,gilgesh01,56,OKC,0,HOU,36,5,7,3,1,4,36.58333333,0,5,13,23,2,3,8,9,2,4,12,43,41,48,60.5
2023-24,202402250PHO,2/25/2024,PHO vs LAL,LeBron James,jamesle01,52,LAL,0,PHO,28,7,12,2,1,3,36.78333333,1,6,12,19,3,6,1,4,3,3,19,40,35,47,60.4
2023-24,202402250GSW,2/25/2024,GSW vs DEN,Nikola Jokic,jokicni01,56,DEN,0,GSW,32,16,16,4,1,2,36.81666667,2,14,13,24,2,6,4,4,3,5,32,48,48,64,88.2
2023-24,202402250NOP,2/25/2024,NOP vs CHI,Trey Murphy III,murphtr02,33,NOP,1,CHI,9,10,2,1,1,0,36.85,0,10,3,11,3,9,0,0,1,2,12,11,19,21,30
2023-24,202402250PHO,2/25/2024,PHO vs LAL,D'Angelo Russell,russeda01,55,LAL,0,PHO,20,3,7,1,1,2,36.9,0,3,8,14,4,8,0,1,2,2,10,27,23,30,38.1
2023-24,202402250WAS,2/25/2024,WAS vs CLE,Jarrett Allen,allenja01,51,CLE,0,WAS,22,12,5,0,1,1,36.93333333,2,10,11,18,0,0,0,2,3,1,17,27,34,39,45.9
2023-24,202402250PHO,2/25/2024,PHO vs LAL,Jusuf Nurkic,nurkiju01,54,PHO,1,LAL,18,22,7,1,1,3,37.06666667,7,15,7,12,0,0,4,5,2,2,29,25,40,47,57.9
2023-24,202402250LAC,2/25/2024,LAC vs SAC,Norman Powell,powelno01,55,LAC,1,SAC,21,2,2,1,0,1,37.06666667,1,1,8,17,5,9,0,0,1,1,4,23,23,25,28.4
2023-24,202402250NOP,2/25/2024,NOP vs CHI,Coby White,whiteco01,57,CHI,0,NOP,16,7,3,2,0,1,37.1,1,6,5,18,2,9,4,4,2,2,10,19,23,26,33.9
2023-24,202402250LAC,2/25/2024,LAC vs SAC,Keegan Murray,murrake02,52,SAC,0,LAC,11,8,1,1,1,1,37.11666667,2,6,4,11,3,7,0,0,2,2,9,12,19,20,27.1
2023-24,202402250PHO,2/25/2024,PHO vs LAL,Royce O'Neale,onealro01,55,PHO,1,LAL,20,9,4,2,1,0,37.13333333,0,9,7,12,6,10,0,0,2,3,13,24,29,33,45.8
2023-24,202402250POR,2/25/2024,POR vs CHO,Deandre Ayton,aytonde01,39,POR,1,CHO,26,19,2,1,1,2,37.25,3,16,11,16,0,0,4,4,1,2,21,28,45,47,55.8
2023-24,202402250WAS,2/25/2024,WAS vs CLE,Landry Shamet,shamela01,40,WAS,1,CLE,15,5,2,3,0,0,37.3,1,4,6,15,3,8,0,0,2,3,7,17,20,22,33
2023-24,202402250WAS,2/25/2024,WAS vs CLE,Jordan Poole,poolejo01,55,WAS,1,CLE,31,5,5,1,0,2,37.55,0,5,11,21,6,13,3,3,6,1,10,36,36,41,45.5
2023-24,202402250HOU,2/25/2024,HOU vs OKC,Fred VanVleet,vanvlfr01,50,HOU,1,OKC,20,3,3,1,0,4,38.13333333,1,2,7,16,4,10,2,2,2,1,6,23,23,26,27.1
2023-24,202402250POR,2/25/2024,POR vs CHO,Brandon Miller,millebr02,51,CHO,0,POR,17,4,1,2,0,5,38.2,0,4,8,18,1,6,0,0,2,2,5,18,21,22,24.3
2023-24,202402250PHO,2/25/2024,PHO vs LAL,Devin Booker,bookede01,48,PHO,1,LAL,21,3,9,1,0,3,38.41666667,1,2,8,18,1,4,4,4,2,1,12,30,24,33,38.1
2023-24,202402250PHO,2/25/2024,PHO vs LAL,Grayson Allen,allengr01,52,PHO,1,LAL,24,2,0,1,1,2,38.46666667,1,1,8,17,6,12,2,2,1,2,2,24,26,26,30.4
2023-24,202402250PHI,2/25/2024,PHI vs MIL,Tyrese Maxey,maxeyty01,52,PHI,1,MIL,24,3,7,3,0,1,38.48333333,0,3,8,19,3,8,5,5,3,3,10,31,27,34,46.1
2023-24,202402250NOP,2/25/2024,NOP vs CHI,Herbert Jones,joneshe01,53,NOP,1,CHI,15,3,6,0,1,0,38.5,2,1,5,10,4,6,1,2,4,1,9,21,18,24,30.6
2023-24,202402250PHO,2/25/2024,PHO vs LAL,Kevin Durant,duranke01,51,PHO,1,LAL,22,5,7,0,2,3,38.58333333,1,4,7,20,2,8,6,6,2,2,12,29,27,34,41.5
2023-24,202402250NOP,2/25/2024,NOP vs CHI,Brandon Ingram,ingrabr01,52,NOP,1,CHI,22,3,6,3,1,9,38.65,0,3,7,16,2,6,6,8,1,4,9,28,25,31,37.6
2023-24,202402250ATL,2/25/2024,ATL vs ORL,Dejounte Murray,murrade01,54,ATL,1,ORL,25,9,11,2,0,3,38.81666667,1,8,11,20,2,5,1,2,1,2,20,36,34,45,55.3
2023-24,202402250ATL,2/25/2024,ATL vs ORL,Jalen Johnson,johnsja05,43,ATL,1,ORL,21,10,7,1,2,0,38.9,2,8,9,19,2,5,1,1,3,3,17,28,31,38,52.5
2023-24,202402250WAS,2/25/2024,WAS vs CLE,Kyle Kuzma,kuzmaky01,55,WAS,1,CLE,27,6,5,1,1,2,39.03333333,0,6,10,24,2,10,5,7,0,2,11,32,33,38,45.7
2023-24,202402250NOP,2/25/2024,NOP vs CHI,Ayo Dosunmu,dosunay01,55,CHI,0,NOP,21,3,8,3,0,1,39.13333333,1,2,8,15,3,6,2,2,1,3,11,29,24,32,44.6
2023-24,202402250LAC,2/25/2024,LAC vs SAC,Terance Mann,mannte01,50,LAC,1,SAC,14,6,4,0,0,2,39.4,3,3,6,7,1,2,1,1,1,0,10,18,20,24,25.2
2023-24,202402250POR,2/25/2024,POR vs CHO,Miles Bridges,bridgmi02,46,CHO,0,POR,18,10,1,1,0,4,39.56666667,1,9,8,18,2,6,0,1,0,1,11,19,28,29,30.5
2023-24,202402250NOP,2/25/2024,NOP vs CHI,DeMar DeRozan,derozde01,55,CHI,0,NOP,24,6,7,0,0,2,40.05,1,5,6,13,2,4,10,12,1,0,13,31,30,37,39.7
2023-24,202402250HOU,2/25/2024,HOU vs OKC,Jabari Smith Jr.,smithja05,52,HOU,1,OKC,20,17,4,1,0,1,41.46666667,4,13,6,15,4,9,4,4,1,1,21,24,37,41,48.4
2023-24,202402250PHO,2/25/2024,PHO vs LAL,Anthony Davis,davisan02,56,LAL,0,PHO,22,14,0,3,2,3,41.7,2,12,11,17,0,0,0,0,3,5,14,22,36,36,50.8
2023-24,202402240NYK,2/24/2024,NYK vs BOS,Sam Hauser,hausesa01,56,BOS,0,NYK,6,3,0,0,0,0,10.48333333,1,2,2,2,2,2,0,0,1,0,3,6,9,9,9.6
2023-24,202402240MIN,2/24/2024,MIN vs BRK,Day'Ron Sharpe,sharpda01,41,BRK,0,MIN,4,7,0,1,0,2,11.5,4,3,2,4,0,0,0,0,3,1,7,4,11,11,13.4
2023-24,202402240DET,2/24/2024,DET vs ORL,Troy Brown Jr.,browntr01,42,DET,1,ORL,3,3,0,0,0,1,12.95,1,2,1,4,1,3,0,0,1,0,3,3,6,6,5.6
2023-24,202402240NYK,2/24/2024,NYK vs BOS,Jericho Sims,simsje01,30,NYK,1,BOS,0,2,0,0,0,0,14.38333333,0,2,0,0,0,0,0,0,0,0,2,0,2,2,2.4
2023-24,202402240MIN,2/24/2024,MIN vs BRK,Lonnie Walker IV,walkelo01,36,BRK,0,MIN,3,1,2,1,0,2,14.85,0,1,1,4,1,3,0,0,0,1,3,5,4,6,8.2
2023-24,202402240DET,2/24/2024,DET vs ORL,James Wiseman,wisemja01,37,DET,1,ORL,5,4,2,0,1,0,15.16666667,2,2,1,2,0,0,3,4,1,1,6,7,9,11,15.8
2023-24,202402240NYK,2/24/2024,NYK vs BOS,Payton Pritchard,pritcpa01,57,BOS,0,NYK,2,2,2,1,0,1,15.28333333,2,0,1,3,0,1,0,0,2,1,4,4,4,6,9.4
2023-24,202402240MIN,2/24/2024,MIN vs BRK,Ben Simmons,simmobe01,14,BRK,0,MIN,4,8,1,3,1,1,15.36666667,2,6,2,6,0,0,0,0,0,4,9,5,12,13,26.1
2023-24,202402240MIN,2/24/2024,MIN vs BRK,Dennis Smith Jr.,smithde03,40,BRK,0,MIN,0,4,2,1,0,0,15.46666667,0,4,0,6,0,0,0,0,0,1,6,2,4,6,10.8
2023-24,202402240DET,2/24/2024,DET vs ORL,Joe Ingles,inglejo01,43,ORL,0,DET,0,1,2,0,0,1,16.33333333,0,1,0,3,0,1,0,0,0,0,3,2,1,3,3.2
2023-24,202402240NYK,2/24/2024,NYK vs BOS,Miles McBride,mcbrimi01,44,NYK,1,BOS,11,3,1,0,0,1,16.36666667,1,2,5,7,1,2,0,0,1,0,4,12,14,15,15.1
2023-24,202402240DET,2/24/2024,DET vs ORL,Malachi Flynn,flynnma01,49,DET,1,ORL,8,1,3,1,0,1,16.75,0,1,3,6,1,2,1,2,0,1,4,11,9,12,15.7
2023-24,202402240DET,2/24/2024,DET vs ORL,Moritz Wagner,wagnemo01,55,ORL,0,DET,14,7,1,1,0,0,17.38333333,6,1,6,9,0,0,2,2,0,1,8,15,21,22,26.9
2023-24,202402240MIN,2/24/2024,MIN vs BRK,Monte Morris,morrimo01,11,MIN,1,BRK,5,2,4,1,1,0,18.11666667,0,2,2,4,1,3,0,0,0,2,6,9,7,11,19.4
2023-24,202402240NYK,2/24/2024,NYK vs BOS,Bojan Bogdanovic,bogdabo02,32,NYK,1,BOS,8,0,0,0,0,1,18.53333333,0,0,2,7,1,4,3,3,2,0,0,8,8,8,7
2023-24,202402240DET,2/24/2024,DET vs ORL,Evan Fournier,fournev01,7,DET,1,ORL,13,3,1,1,0,0,18.58333333,0,3,5,7,2,3,1,1,0,1,4,14,16,17,21.1
2023-24,202402240NYK,2/24/2024,NYK vs BOS,Alec Burks,burksal01,48,NYK,1,BOS,7,3,0,0,0,1,18.91666667,0,3,3,11,1,7,0,0,1,0,3,7,10,10,9.6
2023-24,202402240DET,2/24/2024,DET vs ORL,Jonathan Isaac,isaacjo01,39,ORL,0,DET,12,6,0,2,1,0,20,1,5,5,7,2,2,0,0,0,3,6,12,18,18,28.2
2023-24,202402240DET,2/24/2024,DET vs ORL,Ausar Thompson,thompau01,56,DET,1,ORL,8,2,0,0,0,3,20.73333333,0,2,4,4,0,0,0,0,5,0,2,8,10,10,7.4
2023-24,202402240DET,2/24/2024,DET vs ORL,Cole Anthony,anthoco01,56,ORL,0,DET,13,3,7,1,0,0,20.96666667,0,3,5,11,1,2,2,2,2,1,10,20,16,23,30.1
2023-24,202402240MIN,2/24/2024,MIN vs BRK,Nickeil Alexander-Walker,alexani01,57,MIN,1,BRK,0,6,2,0,1,2,21.33333333,2,4,0,6,0,5,0,0,3,1,8,2,6,8,11.2
2023-24,202402240MIN,2/24/2024,MIN vs BRK,Cameron Johnson,johnsca02,43,BRK,0,MIN,10,7,0,1,0,0,22,3,4,2,9,2,7,4,5,2,1,7,10,17,17,21.4
2023-24,202402240DET,2/24/2024,DET vs ORL,Anthony Black,blackan01,52,ORL,0,DET,5,2,0,1,1,0,22.48333333,0,2,2,6,1,3,0,0,2,2,2,5,7,7,13.4
2023-24,202402240DET,2/24/2024,DET vs ORL,Wendell Carter Jr.,cartewe01,31,ORL,0,DET,11,10,2,1,0,1,22.48333333,3,7,3,5,2,3,3,4,2,1,12,13,21,23,28
2023-24,202402240NYK,2/24/2024,NYK vs BOS,Isaiah Hartenstein,harteis01,52,NYK,1,BOS,6,7,4,0,1,2,24.13333333,5,2,1,1,0,0,4,4,4,1,11,10,13,17,21.4
2023-24,202402240DET,2/24/2024,DET vs ORL,Gary Harris,harriga01,35,ORL,0,DET,12,3,0,1,0,0,25.36666667,0,3,4,6,4,5,0,1,3,1,3,12,15,15,18.6
2023-24,202402240DET,2/24/2024,DET vs ORL,Jalen Suggs,suggsja01,52,ORL,0,DET,14,2,5,2,2,3,26.08333333,1,1,6,7,2,3,0,0,2,4,7,19,16,21,32.9
2023-24,202402240NYK,2/24/2024,NYK vs BOS,Al Horford,horfoal01,47,BOS,0,NYK,10,7,0,0,1,0,26.31666667,4,3,5,7,0,0,0,0,2,1,7,10,17,17,21.4
2023-24,202402240DET,2/24/2024,DET vs ORL,Quentin Grimes,grimequ01,46,DET,1,ORL,5,2,4,2,1,1,26.48333333,0,2,2,8,1,5,0,0,1,3,6,9,7,11,21.4
2023-24,202402240MIN,2/24/2024,MIN vs BRK,Naz Reid,reidna01,57,MIN,1,BRK,6,9,1,0,3,3,26.75,4,5,2,9,0,5,2,4,4,3,10,7,15,16,24.3
2023-24,202402240MIN,2/24/2024,MIN vs BRK,Dennis Schroder,schrode01,56,BRK,0,MIN,9,1,2,0,0,2,28.31666667,0,1,4,14,1,5,0,0,2,0,3,11,10,12,11.2
2023-24,202402240DET,2/24/2024,DET vs ORL,Paolo Banchero,banchpa01,57,ORL,0,DET,15,5,3,0,2,0,29.1,0,5,5,17,0,2,5,9,1,2,8,18,20,23,31.5
2023-24,202402240MIN,2/24/2024,MIN vs BRK,Mike Conley,conlemi01,52,MIN,1,BRK,14,3,3,1,0,1,29.6,0,3,5,10,4,8,0,0,1,1,6,17,17,20,24.1
2023-24,202402240MIN,2/24/2024,MIN vs BRK,Nic Claxton,claxtni01,46,BRK,0,MIN,12,7,3,0,1,1,29.98333333,3,4,6,12,0,0,0,0,2,1,10,15,19,22,26.9
2023-24,202402240MIN,2/24/2024,MIN vs BRK,Dorian Finney-Smith,finnedo01,47,BRK,0,MIN,11,9,0,0,0,1,30.4,3,6,4,9,1,4,2,2,4,0,9,11,20,20,20.8
2023-24,202402240DET,2/24/2024,DET vs ORL,Simone Fontecchio,fontesi01,55,DET,1,ORL,17,3,5,1,0,0,31.21666667,1,2,7,13,3,5,0,0,2,1,8,22,20,25,31.1
2023-24,202402240DET,2/24/2024,DET vs ORL,Cade Cunningham,cunnica01,46,DET,1,ORL,26,7,4,1,0,3,31.25,1,6,11,20,4,7,0,0,4,1,11,30,33,37,40.4
2023-24,202402240MIN,2/24/2024,MIN vs BRK,Kyle Anderson,anderky01,57,MIN,1,BRK,12,9,3,0,1,0,31.28333333,0,9,6,10,0,2,0,0,1,1,12,15,21,24,30.3
2023-24,202402240NYK,2/24/2024,NYK vs BOS,Kristaps Porzingis,porzikr01,42,BOS,0,NYK,22,4,4,0,1,1,31.53333333,2,2,7,11,3,4,5,5,3,1,8,26,26,30,34.8
2023-24,202402240DET,2/24/2024,DET vs ORL,Franz Wagner,wagnefr01,49,ORL,0,DET,14,5,3,0,0,5,31.66666667,0,5,6,13,0,2,2,3,2,0,8,17,19,22,19.5
2023-24,202402240NYK,2/24/2024,NYK vs BOS,Donte DiVincenzo,divindo01,56,NYK,1,BOS,12,4,0,0,1,0,31.73333333,2,2,4,12,4,8,0,0,4,1,4,12,16,16,19.8
2023-24,202402240NYK,2/24/2024,NYK vs BOS,Derrick White,whitede01,53,BOS,0,NYK,13,3,6,2,0,0,32.33333333,1,2,5,8,3,5,0,0,1,2,9,19,16,22,31.6
2023-24,202402240DET,2/24/2024,DET vs ORL,Jalen Duren,durenja01,41,DET,1,ORL,16,11,3,1,4,1,32.83333333,2,9,6,7,0,0,4,6,5,5,14,19,27,30,47.7
2023-24,202402240MIN,2/24/2024,MIN vs BRK,Jaden McDaniels,mcdanja02,47,MIN,1,BRK,7,2,1,0,0,3,33.45,0,2,2,4,2,4,1,2,2,0,3,8,9,10,7.9
2023-24,202402240DET,2/24/2024,DET vs ORL,Jaden Ivey,iveyja01,52,DET,1,ORL,8,0,7,0,1,2,34.03333333,0,0,3,14,2,6,0,0,2,1,7,15,8,15,19.5
2023-24,202402240NYK,2/24/2024,NYK vs BOS,Precious Achiuwa,achiupr01,50,NYK,1,BOS,8,9,1,0,1,1,34.36666667,4,5,4,8,0,2,0,0,2,1,10,9,17,18,22.3
2023-24,202402240NYK,2/24/2024,NYK vs BOS,Jaylen Brown,brownja02,52,BOS,0,NYK,30,8,3,1,0,0,34.95,0,8,13,24,3,9,1,3,2,1,11,33,38,41,47.1
2023-24,202402240NYK,2/24/2024,NYK vs BOS,Jrue Holiday,holidjr01,52,BOS,0,NYK,12,1,6,2,1,1,35.05,0,1,5,10,2,6,0,0,2,3,7,18,13,19,30.2
2023-24,202402240MIN,2/24/2024,MIN vs BRK,Cam Thomas,thomaca02,47,BRK,0,MIN,18,6,2,0,0,2,35.4,0,6,7,19,0,5,4,4,3,0,8,20,24,26,26.2
2023-24,202402240MIN,2/24/2024,MIN vs BRK,Mikal Bridges,bridgmi01,56,BRK,0,MIN,15,6,8,0,0,0,36.25,1,5,7,21,1,11,0,0,1,0,14,23,21,29,34.2
2023-24,202402240MIN,2/24/2024,MIN vs BRK,Karl-Anthony Towns,townska01,56,MIN,1,BRK,28,9,4,1,2,2,36.31666667,0,9,8,17,4,8,8,8,3,3,13,32,37,41,51.8
2023-24,202402240NYK,2/24/2024,NYK vs BOS,Jalen Brunson,brunsja01,54,NYK,1,BOS,34,3,9,1,0,4,37.56666667,1,2,12,25,4,9,6,6,0,1,12,43,37,46,50.1
2023-24,202402240MIN,2/24/2024,MIN vs BRK,Anthony Edwards,edwaran01,54,MIN,1,BRK,29,8,3,2,1,1,37.83333333,0,8,11,23,1,3,6,9,0,3,11,32,37,40,51.1
2023-24,202402240NYK,2/24/2024,NYK vs BOS,Josh Hart,hartjo01,56,NYK,1,BOS,16,8,6,0,0,3,41.7,2,6,6,10,2,5,2,3,1,0,14,22,24,30,31.6
2023-24,202402240NYK,2/24/2024,NYK vs BOS,Jayson Tatum,tatumja01,54,BOS,0,NYK,19,6,6,2,1,4,43.36666667,1,5,7,15,2,8,3,4,3,3,12,25,25,31,40.2
2023-24,202402230GSW,2/23/2024,GSW vs CHO,Kevon Looney,looneke01,55,GSW,1,CHO,2,3,0,0,0,1,10.11666667,1,2,1,3,0,0,0,0,1,0,3,2,5,5,4.6
2023-24,202402230MIN,2/23/2024,MIN vs MIL,Monte Morris,morrimo01,10,MIN,1,MIL,5,0,1,0,0,0,10.15,0,0,2,5,1,2,0,0,0,0,1,6,5,6,6.5
2023-24,202402230GSW,2/23/2024,GSW vs CHO,Lester Quinones,quinole01,21,GSW,1,CHO,5,4,0,0,0,0,10.26666667,2,2,2,5,0,2,1,2,2,0,4,5,9,9,9.8
2023-24,202402230ATL,2/23/2024,ATL vs TOR,Bruno Fernando,fernabr01,19,ATL,1,TOR,12,4,0,1,0,1,10.5,4,0,5,8,0,0,2,4,0,1,4,12,16,16,18.8
2023-24,202402230POR,2/23/2024,POR vs DEN,Zeke Nnaji,nnajize01,42,DEN,0,POR,6,3,1,1,0,0,10.8,2,1,3,4,0,0,0,0,1,1,4,7,9,10,14.1
2023-24,202402230PHI,2/23/2024,PHI vs CLE,Dean Wade,wadede01,46,CLE,0,PHI,0,3,0,0,1,0,11.01666667,0,3,0,1,0,1,0,0,0,1,3,0,3,3,6.6
2023-24,202402230HOU,2/23/2024,HOU vs PHO,Aaron Holiday,holidaa01,53,HOU,1,PHO,3,0,3,2,0,1,11.06666667,0,0,0,1,0,0,3,3,3,2,3,6,3,6,12.5
2023-24,202402230LAL,2/23/2024,LAL vs SAS,Cedi Osman,osmande01,57,SAS,0,LAL,2,2,4,0,0,1,11.15,0,2,1,2,0,1,0,0,0,0,6,6,4,8,9.4
2023-24,202402230GSW,2/23/2024,GSW vs CHO,Gary Payton II,paytoga02,21,GSW,1,CHO,12,0,0,1,0,0,11.46666667,0,0,5,8,1,2,1,2,1,1,0,12,12,12,15
2023-24,202402230HOU,2/23/2024,HOU vs PHO,Josh Okogie,okogijo01,51,PHO,0,HOU,0,3,3,1,0,2,11.78333333,1,2,0,2,0,1,0,0,0,1,6,3,3,6,9.1
2023-24,202402230PHI,2/23/2024,PHI vs CLE,Sam Merrill,merrisa01,39,CLE,0,PHI,3,3,0,1,0,0,12.31666667,0,3,1,4,1,4,0,0,0,1,3,3,6,6,9.6
2023-24,202402230NOP,2/23/2024,NOP vs MIA,Naji Marshall,marshna01,46,NOP,1,MIA,0,1,2,0,1,0,12.71666667,0,1,0,4,0,3,0,0,1,1,3,2,1,3,7.2
2023-24,202402230POR,2/23/2024,POR vs DEN,Duop Reath,reathdu01,41,POR,1,DEN,8,6,1,1,2,1,12.95,3,3,3,10,0,3,2,3,1,3,7,9,14,15,24.7
2023-24,202402230ATL,2/23/2024,ATL vs TOR,Garrison Mathews,mathega01,40,ATL,1,TOR,3,0,0,0,0,0,13.1,0,0,1,2,1,2,0,0,0,0,0,3,3,3,3
2023-24,202402230LAL,2/23/2024,LAL vs SAS,Max Christie,chrisma02,46,LAL,1,SAS,3,2,0,0,1,0,13.21666667,0,2,1,1,0,0,1,2,0,1,2,3,5,5,8.4
2023-24,202402230POR,2/23/2024,POR vs DEN,Jabari Walker,walkeja01,51,POR,1,DEN,2,6,0,0,0,1,14.18333333,4,2,1,5,0,0,0,0,0,0,6,2,8,8,8.2
2023-24,202402230MEM,2/23/2024,MEM vs LAC,P.J. Tucker,tuckepj01,16,LAC,0,MEM,0,3,0,0,0,0,14.21666667,1,2,0,0,0,0,0,0,2,0,3,0,3,3,3.6
2023-24,202402230ATL,2/23/2024,ATL vs TOR,Jordan Nwora,nworajo01,30,TOR,0,ATL,0,4,2,1,0,0,14.23333333,0,4,0,5,0,3,0,0,0,1,6,2,4,6,10.8
2023-24,202402230MEM,2/23/2024,MEM vs LAC,Derrick Rose,rosede01,22,MEM,1,LAC,4,1,2,0,0,3,14.25,0,1,2,5,0,0,0,0,1,0,3,6,5,7,5.2
2023-24,202402230OKC,2/23/2024,OKC vs WAS,Kenrich Williams,willike04,45,OKC,1,WAS,12,2,1,0,0,1,14.43333333,0,2,4,6,4,6,0,0,2,0,3,13,14,15,14.9
2023-24,202402230OKC,2/23/2024,OKC vs WAS,Gordon Hayward,haywago01,27,OKC,1,WAS,8,6,1,0,0,0,14.65,1,5,3,7,0,0,2,2,0,0,7,9,14,15,16.7
2023-24,202402230GSW,2/23/2024,GSW vs CHO,Trayce Jackson-Davis,jackstr02,42,GSW,1,CHO,2,8,2,0,0,1,14.65,5,3,1,4,0,0,0,0,2,0,10,4,10,12,13.6
2023-24,202402230NOP,2/23/2024,NOP vs MIA,CJ McCollum,mccolcj01,43,NOP,1,MIA,2,2,1,0,1,0,14.76666667,0,2,1,7,0,3,0,0,0,1,3,3,4,5,8.9
2023-24,202402230MIN,2/23/2024,MIN vs MIL,Nickeil Alexander-Walker,alexani01,56,MIN,1,MIL,13,1,1,0,1,0,15.13333333,0,1,5,9,3,3,0,0,0,1,2,14,14,15,18.7
2023-24,202402230OKC,2/23/2024,OKC vs WAS,Eugene Omoruyi,omorueu01,26,WAS,0,OKC,7,1,1,1,0,0,15.16666667,0,1,3,6,0,1,1,2,2,1,2,8,8,9,12.7
2023-24,202402230OKC,2/23/2024,OKC vs WAS,Aaron Wiggins,wiggiaa01,53,OKC,1,WAS,12,3,1,0,0,3,15.25,1,2,4,5,1,1,3,3,1,0,4,13,15,16,14.1
2023-24,202402230HOU,2/23/2024,HOU vs PHO,Jeff Green,greenje02,54,HOU,1,PHO,3,2,1,0,0,1,15.36666667,0,2,1,3,1,2,0,0,1,0,3,4,5,6,5.9
2023-24,202402230OKC,2/23/2024,OKC vs WAS,Patrick Baldwin Jr.,baldwpa01,19,WAS,0,OKC,3,2,0,1,1,0,15.6,0,2,1,4,1,4,0,0,1,2,2,3,5,5,11.4
2023-24,202402230MEM,2/23/2024,MEM vs LAC,Lamar Stevens,stevela01,23,MEM,1,LAC,8,8,1,1,1,0,15.73333333,3,5,4,9,0,0,0,0,2,2,9,9,16,17,25.1
2023-24,202402230MIN,2/23/2024,MIN vs MIL,Patrick Beverley,beverpa01,52,MIL,0,MIN,4,3,3,0,1,0,15.75,3,0,2,3,0,0,0,0,3,1,6,7,7,10,15.1
2023-24,202402230GSW,2/23/2024,GSW vs CHO,Dario Saric,saricda01,53,GSW,1,CHO,2,4,3,0,0,4,15.78333333,0,4,1,4,0,2,0,0,1,0,7,5,6,9,7.3
2023-24,202402230PHI,2/23/2024,PHI vs CLE,De'Anthony Melton,meltode01,34,PHI,1,CLE,7,1,1,0,0,1,16.03333333,0,1,2,6,1,4,2,2,0,0,2,8,8,9,8.7
2023-24,202402230OKC,2/23/2024,OKC vs WAS,Jaylin Williams,willija07,47,OKC,1,WAS,7,8,3,0,1,1,16.31666667,1,7,2,4,2,3,1,2,2,1,11,10,15,18,23.1
2023-24,202402230ATL,2/23/2024,ATL vs TOR,Ochai Agbaji,agbajoc01,56,TOR,0,ATL,14,4,0,1,1,3,16.61666667,2,2,5,6,4,5,0,0,4,2,4,14,18,18,21.8
2023-24,202402230NOP,2/23/2024,NOP vs MIA,Kevin Love,loveke01,45,MIA,0,NOP,3,8,1,0,1,0,16.65,2,6,1,6,1,5,0,0,5,1,9,4,11,12,17.1
2023-24,202402230MEM,2/23/2024,MEM vs LAC,Jake LaRavia,laravja01,12,MEM,1,LAC,3,4,2,2,0,1,16.68333333,3,1,1,8,0,3,1,1,1,2,6,5,7,9,15.8
2023-24,202402230PHI,2/23/2024,PHI vs CLE,Mo Bamba,bambamo01,34,PHI,1,CLE,2,4,3,0,3,0,16.91666667,0,4,1,5,0,1,0,0,1,3,7,5,6,9,20.3
2023-24,202402230PHI,2/23/2024,PHI vs CLE,KJ Martin,martike04,42,PHI,1,CLE,6,6,2,0,1,0,16.91666667,1,5,3,5,0,0,0,1,3,1,8,8,12,14,19.2
2023-24,202402230HOU,2/23/2024,HOU vs PHO,Royce O'Neale,onealro01,54,PHO,0,HOU,1,4,1,1,0,1,17.01666667,2,2,0,5,0,4,1,2,1,1,5,2,5,6,9.3
2023-24,202402230LAL,2/23/2024,LAL vs SAS,Zach Collins,colliza01,45,SAS,0,LAL,14,3,0,0,0,2,17.08333333,0,3,6,8,2,2,0,0,3,0,3,14,17,17,15.6
2023-24,202402230POR,2/23/2024,POR vs DEN,Peyton Watson,watsope01,55,DEN,0,POR,8,4,0,0,1,1,17.88333333,1,3,3,5,1,2,1,2,2,1,4,8,12,12,14.8
2023-24,202402230NOP,2/23/2024,NOP vs MIA,Larry Nance Jr.,nancela02,39,NOP,1,MIA,10,9,1,1,1,1,17.96666667,5,4,5,6,0,1,0,0,2,2,10,11,19,20,27.3
2023-24,202402230NOP,2/23/2024,NOP vs MIA,Jose Alvarado,alvarjo01,39,NOP,1,MIA,5,3,2,1,1,1,18.48333333,1,2,2,9,1,3,0,0,2,2,5,7,8,10,16.6
2023-24,202402230LAL,2/23/2024,LAL vs SAS,Taurean Prince,princta02,56,LAL,1,SAS,5,4,3,1,0,2,18.55,0,4,2,6,1,3,0,1,4,1,7,8,9,12,15.3
2023-24,202402230OKC,2/23/2024,OKC vs WAS,Landry Shamet,shamela01,39,WAS,0,OKC,0,3,0,0,1,3,18.61666667,1,2,0,2,0,2,0,0,2,1,3,0,3,3,3.6
2023-24,202402230HOU,2/23/2024,HOU vs PHO,Thaddeus Young,youngth01,24,PHO,0,HOU,2,8,0,1,0,1,18.88333333,6,2,1,3,0,0,0,0,4,1,8,2,10,10,13.6
2023-24,202402230LAL,2/23/2024,LAL vs SAS,Jaxson Hayes,hayesja02,48,LAL,1,SAS,8,4,0,1,0,0,18.95,2,2,4,5,0,1,0,0,4,1,4,8,12,12,15.8
2023-24,202402230ATL,2/23/2024,ATL vs TOR,Clint Capela,capelca01,48,ATL,1,TOR,5,7,1,0,1,1,19.31666667,3,4,1,4,0,0,3,4,2,1,8,6,12,13,16.9
2023-24,202402230NOP,2/23/2024,NOP vs MIA,Haywood Highsmith,highsha01,41,MIA,0,NOP,5,4,1,0,1,0,19.41666667,2,2,2,2,1,1,0,0,1,1,5,6,9,10,14.3
2023-24,202402230POR,2/23/2024,POR vs DEN,Dalano Banton,bantoda01,28,POR,1,DEN,14,1,3,0,0,0,19.58333333,0,1,5,9,1,3,3,4,1,0,4,17,15,18,19.7
2023-24,202402230OKC,2/23/2024,OKC vs WAS,Jalen Williams,willija06,50,OKC,1,WAS,11,2,5,0,1,1,19.78333333,0,2,5,7,1,2,0,1,4,1,7,16,13,18,22.9
2023-24,202402230PHI,2/23/2024,PHI vs CLE,Cameron Payne,payneca01,53,PHI,1,CLE,16,1,2,1,0,1,19.88333333,0,1,6,11,4,6,0,0,0,1,3,18,17,19,22.2
2023-24,202402230POR,2/23/2024,POR vs DEN,Matisse Thybulle,thybuma01,53,POR,1,DEN,3,2,2,4,0,0,20,0,2,1,5,1,2,0,0,1,4,4,5,5,7,20.4
2023-24,202402230POR,2/23/2024,POR vs DEN,Christian Braun,braunch01,57,DEN,0,POR,3,2,4,0,0,2,20.05,0,2,1,5,0,2,1,2,1,0,6,7,5,9,9.4
2023-24,202402230OKC,2/23/2024,OKC vs WAS,Isaiah Joe,joeis01,52,OKC,1,WAS,8,2,5,1,1,0,20.1,0,2,3,6,2,5,0,0,1,2,7,13,10,15,23.9
2023-24,202402230MIN,2/23/2024,MIN vs MIL,Pat Connaughton,connapa01,51,MIL,0,MIN,8,4,0,0,0,0,20.33333333,1,3,3,5,2,4,0,0,0,0,4,8,12,12,12.8
2023-24,202402230HOU,2/23/2024,HOU vs PHO,Cam Whitmore,whitmca01,30,HOU,1,PHO,15,3,1,0,0,4,20.56666667,0,3,5,11,2,7,3,5,0,0,4,16,18,19,16.1
2023-24,202402230NOP,2/23/2024,NOP vs MIA,Nikola Jovic,jovicni01,23,MIA,0,NOP,3,3,2,0,1,1,20.68333333,0,3,1,3,1,1,0,0,1,1,5,5,6,8,11.6
2023-24,202402230GSW,2/23/2024,GSW vs CHO,Draymond Green,greendr01,31,GSW,1,CHO,5,13,3,1,2,1,20.73333333,3,10,2,6,1,2,0,0,2,3,16,8,18,21,33.1
2023-24,202402230OKC,2/23/2024,OKC vs WAS,Marvin Bagley III,baglema01,39,WAS,0,OKC,15,14,1,2,1,1,20.96666667,10,4,6,12,0,0,3,3,0,3,15,16,29,30,41.3
2023-24,202402230PHI,2/23/2024,PHI vs CLE,Georges Niang,niangge01,55,CLE,0,PHI,9,5,0,0,0,0,21.16666667,0,5,2,4,2,3,3,4,3,0,5,9,14,14,15
2023-24,202402230MEM,2/23/2024,MEM vs LAC,John Konchar,konchjo01,45,MEM,1,LAC,7,4,3,2,1,0,21.28333333,2,2,2,4,1,2,2,2,0,3,7,10,11,14,25.3
2023-24,202402230HOU,2/23/2024,HOU vs PHO,Jalen Green,greenja05,56,HOU,1,PHO,14,3,4,0,1,3,21.4,0,3,5,13,3,6,1,2,0,1,7,18,17,21,23.6
2023-24,202402230GSW,2/23/2024,GSW vs CHO,Klay Thompson,thompkl01,52,GSW,1,CHO,13,2,0,1,0,3,21.46666667,0,2,5,11,3,8,0,0,0,1,2,13,15,15,15.4
2023-24,202402230OKC,2/23/2024,OKC vs WAS,Josh Giddey,giddejo01,55,OKC,1,WAS,12,7,3,1,2,3,21.51666667,2,5,5,8,1,2,1,2,0,3,10,15,19,22,30.9
2023-24,202402230OKC,2/23/2024,OKC vs WAS,Johnny Davis,davisjo06,25,WAS,0,OKC,2,7,1,0,0,1,21.53333333,2,5,1,8,0,2,0,0,2,0,8,3,9,10,10.9
2023-24,202402230ATL,2/23/2024,ATL vs TOR,Gradey Dick,dickgr01,36,TOR,0,ATL,18,2,1,0,0,0,21.55,0,2,8,13,2,5,0,0,1,0,3,19,20,21,21.9
2023-24,202402230MIN,2/23/2024,MIN vs MIL,Bobby Portis,portibo01,57,MIL,0,MIN,14,5,1,0,0,0,21.68333333,1,4,7,13,0,2,0,0,1,0,6,15,19,20,21.5
2023-24,202402230POR,2/23/2024,POR vs DEN,Reggie Jackson,jacksre01,57,DEN,0,POR,9,0,3,0,0,2,21.71666667,0,0,4,10,1,5,0,0,1,0,3,12,9,12,11.5
2023-24,202402230GSW,2/23/2024,GSW vs CHO,Vasilije Micic,micicva01,35,CHO,0,GSW,10,2,3,0,0,2,21.86666667,1,1,4,13,2,7,0,0,0,0,5,13,12,15,14.9
2023-24,202402230ATL,2/23/2024,ATL vs TOR,Kelly Olynyk,olynyke01,55,TOR,0,ATL,10,5,6,0,1,0,21.91666667,1,4,5,9,0,2,0,0,5,1,11,16,15,21,28
2023-24,202402230OKC,2/23/2024,OKC vs WAS,Cason Wallace,wallaca01,56,OKC,1,WAS,13,5,1,0,0,1,22,2,3,5,7,3,5,0,0,2,0,6,14,18,19,19.5
2023-24,202402230OKC,2/23/2024,OKC vs WAS,Jordan Poole,poolejo01,54,WAS,0,OKC,21,3,3,0,0,3,22.5,0,3,7,19,2,8,5,5,4,0,6,24,24,27,26.1
2023-24,202402230NOP,2/23/2024,NOP vs MIA,Jordan Hawkins,hawkijo01,50,NOP,1,MIA,14,3,2,0,1,0,22.6,1,2,4,17,3,12,3,3,2,1,5,16,17,19,23.6
2023-24,202402230MEM,2/23/2024,MEM vs LAC,Russell Westbrook,westbru01,55,LAC,0,MEM,13,2,0,1,0,3,22.6,0,2,6,15,1,4,0,0,0,1,2,13,15,15,15.4
2023-24,202402230OKC,2/23/2024,OKC vs WAS,Chet Holmgren,holmgch01,56,OKC,1,WAS,25,10,0,0,2,3,23.06666667,1,9,11,14,2,5,1,2,2,2,10,25,35,35,40
2023-24,202402230OKC,2/23/2024,OKC vs WAS,Luguentz Dort,dortlu01,54,OKC,1,WAS,9,0,0,2,0,0,23.2,0,0,3,6,3,4,0,0,3,2,0,9,9,9,15
2023-24,202402230OKC,2/23/2024,OKC vs WAS,Tyus Jones,jonesty01,56,WAS,0,OKC,5,1,6,0,0,0,23.2,0,1,2,8,1,4,0,0,0,0,7,11,6,12,15.2
2023-24,202402230MIN,2/23/2024,MIN vs MIL,Naz Reid,reidna01,56,MIN,1,MIL,8,4,1,1,0,1,23.2,1,3,2,10,1,6,3,4,2,1,5,9,12,13,16.3
2023-24,202402230LAL,2/23/2024,LAL vs SAS,Malaki Branham,branhma01,52,SAS,0,LAL,17,2,1,0,0,0,23.35,1,1,6,14,3,5,2,2,1,0,3,18,19,20,20.9
2023-24,202402230LAL,2/23/2024,LAL vs SAS,Julian Champagnie,champju02,50,SAS,0,LAL,7,4,5,1,0,0,23.63333333,2,2,2,7,1,5,2,4,1,1,9,12,11,16,22.3
2023-24,202402230NOP,2/23/2024,NOP vs MIA,Jeremiah Robinson-Earl,robinje02,23,NOP,1,MIA,5,6,1,1,0,1,23.78333333,2,4,2,4,1,2,0,2,1,1,7,6,11,12,15.7
2023-24,202402230POR,2/23/2024,POR vs DEN,Collin Gillespie,gilleco01,19,DEN,0,POR,18,2,4,1,0,0,23.85,0,2,7,9,4,4,0,1,1,1,6,22,20,24,29.4
2023-24,202402230MEM,2/23/2024,MEM vs LAC,GG Jackson II,jacksgg01,24,MEM,1,LAC,11,2,1,0,0,1,23.9,1,1,4,9,1,5,2,4,3,0,3,12,13,14,13.9
2023-24,202402230MIN,2/23/2024,MIN vs MIL,Jaden McDaniels,mcdanja02,46,MIN,1,MIL,2,1,3,1,1,0,23.98333333,0,1,1,5,0,1,0,0,5,2,4,5,3,6,13.7
2023-24,202402230MEM,2/23/2024,MEM vs LAC,Santi Aldama,aldamsa01,45,MEM,1,LAC,7,6,1,0,1,0,24.1,1,5,3,8,1,5,0,0,1,1,7,8,13,14,18.7
2023-24,202402230LAL,2/23/2024,LAL vs SAS,Spencer Dinwiddie,dinwisp01,52,LAL,1,SAS,0,1,1,0,0,0,24.33333333,0,1,0,6,0,3,0,0,1,0,2,1,1,2,2.7
2023-24,202402230POR,2/23/2024,POR vs DEN,Toumani Camara,camarto01,54,POR,1,DEN,6,6,2,1,0,3,24.45,4,2,3,7,0,1,0,0,0,1,8,8,12,14,16.2
2023-24,202402230GSW,2/23/2024,GSW vs CHO,Seth Curry,curryse01,41,CHO,0,GSW,6,2,3,0,1,0,24.5,0,2,2,8,0,3,2,3,2,1,5,9,8,11,15.9
2023-24,202402230OKC,2/23/2024,OKC vs WAS,Corey Kispert,kispeco01,55,WAS,0,OKC,20,2,0,2,0,1,24.88333333,0,2,6,12,3,7,5,6,2,2,2,20,22,22,27.4
2023-24,202402230NOP,2/23/2024,NOP vs MIA,Jonas Valanciunas,valanjo01,57,NOP,1,MIA,12,10,0,0,1,3,24.88333333,2,8,6,13,0,0,0,0,3,1,10,12,22,22,24
2023-24,202402230MEM,2/23/2024,MEM vs LAC,Amir Coffey,coffeam01,43,LAC,0,MEM,2,2,2,2,0,1,24.96666667,2,0,1,6,0,3,0,0,2,2,4,4,4,6,12.4
2023-24,202402230PHI,2/23/2024,PHI vs CLE,Caris LeVert,leverca01,45,CLE,0,PHI,6,5,4,0,2,1,25.13333333,1,4,1,11,0,4,4,4,2,2,9,10,11,15,23
2023-24,202402230ATL,2/23/2024,ATL vs TOR,De'Andre Hunter,huntede01,32,ATL,1,TOR,22,5,2,0,0,1,25.26666667,1,4,8,16,2,7,4,4,3,0,7,24,27,29,30
2023-24,202402230HOU,2/23/2024,HOU vs PHO,Drew Eubanks,eubandr01,51,PHO,0,HOU,9,5,1,1,2,1,25.35,1,4,3,5,0,0,3,4,2,3,6,10,14,15,24.5
2023-24,202402230MEM,2/23/2024,MEM vs LAC,Luke Kennard,kennalu01,28,MEM,1,LAC,7,2,2,1,0,1,25.68333333,0,2,3,8,1,6,0,0,1,1,4,9,9,11,14.4
2023-24,202402230HOU,2/23/2024,HOU vs PHO,Dillon Brooks,brookdi01,47,HOU,1,PHO,2,3,2,1,0,0,25.93333333,0,3,1,6,0,3,0,0,6,1,5,4,5,7,11.6
2023-24,202402230ATL,2/23/2024,ATL vs TOR,Jakob Poeltl,poeltja01,46,TOR,0,ATL,12,13,6,0,2,1,26.03333333,6,7,6,13,0,0,0,0,1,2,19,18,25,31,41.6
2023-24,202402230GSW,2/23/2024,GSW vs CHO,Grant Williams,willigr01,52,CHO,0,GSW,10,3,1,0,0,1,26.1,2,1,4,9,1,5,1,1,2,0,4,11,13,14,14.1
2023-24,202402230OKC,2/23/2024,OKC vs WAS,Kyle Kuzma,kuzmaky01,54,WAS,0,OKC,14,4,2,0,0,3,26.5,1,3,7,14,0,2,0,2,2,0,6,16,18,20,18.8
2023-24,202402230HOU,2/23/2024,HOU vs PHO,Bol Bol,bolbo01,19,PHO,0,HOU,25,14,0,1,1,1,26.51666667,6,8,11,17,2,3,1,2,4,2,14,25,39,39,46.8
2023-24,202402230PHI,2/23/2024,PHI vs CLE,Evan Mobley,mobleev01,32,CLE,0,PHI,8,10,0,0,1,4,26.58333333,2,8,3,8,0,0,2,6,4,1,10,8,18,18,19
2023-24,202402230MEM,2/23/2024,MEM vs LAC,Ivica Zubac,zubaciv01,45,LAC,0,MEM,10,10,2,0,0,0,26.78333333,3,7,5,7,0,0,0,0,6,0,12,12,20,22,25
2023-24,202402230NOP,2/23/2024,NOP vs MIA,Jaime Jaquez Jr.,jaqueja01,50,MIA,0,NOP,8,4,1,1,0,0,26.86666667,2,2,2,8,0,3,4,4,0,1,5,9,12,13,17.3
2023-24,202402230NOP,2/23/2024,NOP vs MIA,Jimmy Butler,butleji01,38,MIA,0,NOP,23,9,6,3,1,3,27,2,7,7,12,1,1,8,12,0,4,15,29,32,38,51.8
2023-24,202402230LAL,2/23/2024,LAL vs SAS,Tre Jones,jonestr01,52,SAS,0,LAL,8,3,4,1,0,0,27.48333333,1,2,3,6,2,2,0,0,1,1,7,12,11,15,20.6
2023-24,202402230POR,2/23/2024,POR vs DEN,Aaron Gordon,gordoaa01,51,DEN,0,POR,8,2,7,2,1,3,27.68333333,0,2,4,5,0,1,0,2,1,3,9,15,10,17,26.9
2023-24,202402230MIN,2/23/2024,MIN vs MIL,Mike Conley,conlemi01,51,MIN,1,MIL,9,2,2,2,0,3,27.9,2,0,4,8,1,2,0,0,0,2,4,11,11,13,17.4
2023-24,202402230PHI,2/23/2024,PHI vs CLE,Kelly Oubre Jr.,oubreke01,44,PHI,1,CLE,10,5,1,1,0,3,28.11666667,1,4,4,9,1,3,1,2,5,1,6,11,15,16,17.5
2023-24,202402230GSW,2/23/2024,GSW vs CHO,Cody Martin,martico01,24,CHO,0,GSW,7,3,3,4,0,1,28.23333333,0,3,3,9,1,5,0,0,1,4,6,10,10,13,26.1
2023-24,202402230GSW,2/23/2024,GSW vs CHO,Jonathan Kuminga,kuminjo01,54,GSW,1,CHO,6,7,6,2,3,3,28.38333333,1,6,2,9,0,2,2,2,2,5,13,12,13,19,35.4
2023-24,202402230GSW,2/23/2024,GSW vs CHO,Andrew Wiggins,wiggian01,50,GSW,1,CHO,14,2,3,1,1,2,28.48333333,0,2,5,8,2,4,2,2,0,2,5,17,16,19,24.9
2023-24,202402230GSW,2/23/2024,GSW vs CHO,Nick Richards,richani01,47,CHO,0,GSW,11,13,1,1,1,4,28.61666667,5,8,4,6,0,0,3,3,2,2,14,12,24,25,30.1
2023-24,202402230MIN,2/23/2024,MIN vs MIL,Kyle Anderson,anderky01,56,MIN,1,MIL,8,2,6,2,0,3,28.96666667,1,1,4,4,0,0,0,0,3,2,8,14,10,16,22.4
2023-24,202402230PHI,2/23/2024,PHI vs CLE,Isaac Okoro,okorois01,46,CLE,0,PHI,11,2,4,0,2,0,28.98333333,1,1,5,11,1,3,0,0,1,2,6,15,13,17,25.4
2023-24,202402230LAL,2/23/2024,LAL vs SAS,Anthony Davis,davisan02,55,LAL,1,SAS,28,13,0,1,0,1,29.05,5,8,10,14,0,1,8,10,2,1,13,28,41,41,45.6
2023-24,202402230ATL,2/23/2024,ATL vs TOR,Bogdan Bogdanovic,bogdabo01,54,ATL,1,TOR,14,4,5,2,0,0,29.31666667,0,4,5,17,3,11,1,1,2,2,9,19,18,23,32.3
2023-24,202402230LAL,2/23/2024,LAL vs SAS,Keldon Johnson,johnske04,53,SAS,0,LAL,14,2,3,0,0,3,29.46666667,1,1,5,9,1,3,3,4,0,0,5,17,16,19,17.9
2023-24,202402230OKC,2/23/2024,OKC vs WAS,Shai Gilgeous-Alexander,gilgesh01,55,OKC,1,WAS,30,7,9,1,1,1,29.65,0,7,10,17,1,3,9,9,3,2,16,39,37,46,56.9
2023-24,202402230LAL,2/23/2024,LAL vs SAS,Devin Vassell,vassede01,52,SAS,0,LAL,10,3,3,0,2,2,30.08333333,1,2,3,15,2,5,2,2,1,2,6,13,13,16,22.1
2023-24,202402230HOU,2/23/2024,HOU vs PHO,Eric Gordon,gordoer01,49,PHO,0,HOU,5,2,2,1,0,1,30.38333333,0,2,2,8,1,5,0,0,0,1,4,7,7,9,12.4
2023-24,202402230MEM,2/23/2024,MEM vs LAC,Ziaire Williams,willizi02,47,MEM,1,LAC,10,4,1,2,0,0,30.46666667,2,2,4,9,1,5,1,2,3,2,5,11,14,15,22.3
2023-24,202402230OKC,2/23/2024,OKC vs WAS,Bilal Coulibaly,coulibi01,55,WAS,0,OKC,11,5,2,2,0,0,30.51666667,2,3,4,10,2,5,1,3,1,2,7,13,16,18,26
2023-24,202402230NOP,2/23/2024,NOP vs MIA,Duncan Robinson,robindu01,51,MIA,0,NOP,17,0,2,0,2,3,30.7,0,0,6,14,5,11,0,0,1,2,2,19,17,19,23
2023-24,202402230NOP,2/23/2024,NOP vs MIA,Tyler Herro,herroty01,36,MIA,0,NOP,15,6,3,0,1,1,30.75,0,6,6,14,3,5,0,0,2,1,9,18,21,24,28.7
2023-24,202402230LAL,2/23/2024,LAL vs SAS,Victor Wembanyama,wembavi01,51,SAS,0,LAL,27,10,8,5,5,2,30.91666667,1,9,7,16,3,8,10,11,3,10,18,35,37,45,79
2023-24,202402230PHI,2/23/2024,PHI vs CLE,Paul Reed,reedpa01,56,PHI,1,CLE,8,12,1,0,3,0,31.01666667,4,8,4,6,0,0,0,0,5,3,13,9,20,21,32.9
2023-24,202402230MEM,2/23/2024,MEM vs LAC,Terance Mann,mannte01,49,LAC,0,MEM,23,12,1,1,0,1,31.11666667,5,7,9,17,4,8,1,1,4,1,13,24,35,36,40.9
2023-24,202402230GSW,2/23/2024,GSW vs CHO,Stephen Curry,curryst01,52,GSW,1,CHO,15,2,5,1,0,4,31.23333333,0,2,5,14,3,11,2,2,1,1,7,20,17,22,23.9
2023-24,202402230GSW,2/23/2024,GSW vs CHO,Brandin Podziemski,podzibr01,49,GSW,1,CHO,13,6,6,0,0,0,31.23333333,1,5,6,12,1,6,0,0,0,0,12,19,19,25,29.2
2023-24,202402230GSW,2/23/2024,GSW vs CHO,Brandon Miller,millebr02,50,CHO,0,GSW,11,3,5,4,1,4,31.28333333,1,2,4,14,2,7,1,2,3,5,8,16,14,19,33.1
2023-24,202402230MIN,2/23/2024,MIN vs MIL,Brook Lopez,lopezbr01,54,MIL,0,MIN,16,3,1,1,1,1,31.33333333,1,2,6,12,4,10,0,0,2,2,4,17,19,20,26.1
2023-24,202402230NOP,2/23/2024,NOP vs MIA,Caleb Martin,martica02,39,MIA,0,NOP,8,5,3,1,1,3,31.5,1,4,2,5,1,2,3,5,2,2,8,11,13,16,21.5
2023-24,202402230GSW,2/23/2024,GSW vs CHO,Tre Mann,manntr01,18,CHO,0,GSW,10,4,2,1,0,3,31.58333333,0,4,3,9,2,5,2,2,4,1,6,12,14,16,17.8
2023-24,202402230NOP,2/23/2024,NOP vs MIA,Trey Murphy III,murphtr02,32,NOP,1,MIA,5,6,2,1,1,0,31.6,3,3,2,12,1,7,0,0,0,2,8,7,11,13,21.2
2023-24,202402230LAL,2/23/2024,LAL vs SAS,Rui Hachimura,hachiru01,45,LAL,1,SAS,17,7,0,2,1,1,31.61666667,1,6,7,11,3,4,0,0,3,3,7,17,24,24,33.4
2023-24,202402230MIN,2/23/2024,MIN vs MIL,Malik Beasley,beaslma01,55,MIL,0,MIN,14,2,3,3,0,0,31.83333333,0,2,5,12,4,9,0,0,3,3,5,17,16,19,29.9
2023-24,202402230ATL,2/23/2024,ATL vs TOR,Bruce Brown,brownbr01,50,TOR,0,ATL,12,3,3,0,1,0,31.9,0,3,5,9,1,2,1,1,1,1,6,15,15,18,23.1
2023-24,202402230PHI,2/23/2024,PHI vs CLE,Buddy Hield,hieldbu01,59,PHI,1,CLE,13,5,1,0,0,1,31.96666667,1,4,5,9,3,6,0,0,5,0,6,14,18,19,19.5
2023-24,202402230MEM,2/23/2024,MEM vs LAC,Jaren Jackson Jr.,jacksja02,52,MEM,1,LAC,29,4,5,4,0,2,32.26666667,1,3,11,25,2,7,5,7,2,4,9,34,33,38,51.3
2023-24,202402230POR,2/23/2024,POR vs DEN,Kentavious Caldwell-Pope,caldwke01,52,DEN,0,POR,9,4,4,1,0,2,32.53333333,1,3,2,5,1,3,4,5,1,1,8,13,13,17,20.8
2023-24,202402230HOU,2/23/2024,HOU vs PHO,Amen Thompson,thompam01,37,HOU,1,PHO,15,10,2,1,2,0,33.11666667,5,5,6,11,0,2,3,4,1,3,12,17,25,27,39
2023-24,202402230LAL,2/23/2024,LAL vs SAS,Austin Reaves,reaveau01,59,LAL,1,SAS,10,5,9,0,2,5,33.31666667,1,4,4,12,2,5,0,0,2,2,14,19,15,24,30.5
2023-24,202402230POR,2/23/2024,POR vs DEN,Michael Porter Jr.,portemi01,56,DEN,0,POR,34,12,1,1,1,0,34.06666667,4,8,13,21,5,10,3,3,3,2,13,35,46,47,55.9
2023-24,202402230ATL,2/23/2024,ATL vs TOR,Saddiq Bey,beysa01,55,ATL,1,TOR,18,9,1,0,0,0,34.08333333,6,3,6,15,4,7,2,2,0,0,10,19,27,28,30.3
2023-24,202402230PHI,2/23/2024,PHI vs CLE,Tobias Harris,harrito02,50,PHI,1,CLE,15,9,4,2,0,1,34.13333333,2,7,6,14,1,2,2,2,3,2,13,19,24,28,36.8
2023-24,202402230LAL,2/23/2024,LAL vs SAS,LeBron James,jamesle01,51,LAL,1,SAS,30,7,9,1,0,2,34.28333333,1,6,13,22,2,3,2,2,0,1,16,39,37,46,52.9
2023-24,202402230LAL,2/23/2024,LAL vs SAS,Jeremy Sochan,sochaje01,57,SAS,0,LAL,15,13,5,2,0,3,34.36666667,7,6,7,16,1,6,0,0,3,2,18,20,28,33,41.1
2023-24,202402230ATL,2/23/2024,ATL vs TOR,Gary Trent Jr.,trentga02,52,TOR,0,ATL,13,4,4,0,1,1,34.41666667,1,3,4,14,2,9,3,3,2,1,8,17,17,21,25.8
2023-24,202402230MIN,2/23/2024,MIN vs MIL,Karl-Anthony Towns,townska01,55,MIN,1,MIL,22,14,3,1,0,3,34.75,5,9,9,22,3,9,1,2,1,1,17,25,36,39,43.3
2023-24,202402230POR,2/23/2024,POR vs DEN,Nikola Jokic,jokicni01,55,DEN,0,POR,29,15,14,2,1,2,34.76666667,3,12,12,17,1,3,4,5,4,3,29,43,44,58,75
2023-24,202402230HOU,2/23/2024,HOU vs PHO,Alperen Sengun,sengual01,55,HOU,1,PHO,17,12,4,0,1,2,34.8,6,6,6,15,0,1,5,8,4,1,16,21,29,33,38.4
2023-24,202402230LAL,2/23/2024,LAL vs SAS,D'Angelo Russell,russeda01,54,LAL,1,SAS,22,3,6,1,0,1,34.88333333,0,3,8,18,3,7,3,3,1,1,9,28,25,31,36.6
2023-24,202402230MIN,2/23/2024,MIN vs MIL,Jae Crowder,crowdja01,26,MIL,0,MIN,2,7,1,2,1,2,34.91666667,0,7,1,5,0,3,0,0,3,3,8,3,9,10,18.9
2023-24,202402230POR,2/23/2024,POR vs DEN,Deandre Ayton,aytonde01,38,POR,1,DEN,22,10,3,0,0,1,35.05,3,7,11,17,0,0,0,0,3,0,13,25,32,35,37.5
2023-24,202402230PHI,2/23/2024,PHI vs CLE,Max Strus,strusma01,55,CLE,0,PHI,14,1,6,2,1,1,35.23333333,1,0,5,9,2,6,2,3,1,3,7,20,15,21,32.2
2023-24,202402230POR,2/23/2024,POR vs DEN,Kris Murray,murrakr01,35,POR,1,DEN,9,8,2,1,0,0,35.31666667,3,5,4,10,0,4,1,2,4,1,10,11,17,19,24.6
2023-24,202402230ATL,2/23/2024,ATL vs TOR,Trae Young,youngtr01,51,ATL,1,TOR,11,3,7,0,0,4,35.33333333,0,3,4,13,2,6,1,2,3,0,10,18,14,21,21.1
2023-24,202402230NOP,2/23/2024,NOP vs MIA,Zion Williamson,willizi01,46,NOP,1,MIA,23,9,7,1,0,3,35.56666667,4,5,9,22,0,0,5,6,3,1,16,30,32,39,44.3
2023-24,202402230MEM,2/23/2024,MEM vs LAC,Vince Williams Jr.,willivi01,45,MEM,1,LAC,9,6,8,0,0,4,35.63333333,1,5,4,6,1,2,0,0,3,0,14,17,15,23,24.2
2023-24,202402230PHI,2/23/2024,PHI vs CLE,Jarrett Allen,allenja01,50,CLE,0,PHI,24,9,0,0,1,1,35.71666667,0,9,10,16,0,0,4,8,3,1,9,24,33,33,36.8
2023-24,202402230HOU,2/23/2024,HOU vs PHO,Grayson Allen,allengr01,51,PHO,0,HOU,15,6,6,2,2,0,35.81666667,2,4,4,9,3,7,4,6,3,4,12,21,21,27,43.2
2023-24,202402230ATL,2/23/2024,ATL vs TOR,Dejounte Murray,murrade01,53,ATL,1,TOR,24,10,7,1,0,1,35.93333333,3,7,10,18,0,4,4,4,1,1,17,31,34,41,48.5
2023-24,202402230HOU,2/23/2024,HOU vs PHO,Devin Booker,bookede01,47,PHO,0,HOU,25,5,2,1,1,1,36.23333333,1,4,7,24,0,4,11,11,3,2,7,27,30,32,39
2023-24,202402230MEM,2/23/2024,MEM vs LAC,Kawhi Leonard,leonaka01,50,LAC,0,MEM,24,8,4,3,1,6,36.31666667,2,6,10,18,2,6,2,2,2,4,12,28,32,36,45.6
2023-24,202402230NOP,2/23/2024,NOP vs MIA,Bam Adebayo,adebaba01,46,MIA,0,NOP,24,7,1,1,3,3,36.43333333,1,6,11,18,0,0,2,4,2,4,8,25,31,32,42.9
2023-24,202402230POR,2/23/2024,POR vs DEN,Anfernee Simons,simonan01,32,POR,1,DEN,21,3,8,1,0,1,36.46666667,0,3,8,15,3,6,2,2,4,1,11,29,24,32,38.6
2023-24,202402230HOU,2/23/2024,HOU vs PHO,Fred VanVleet,vanvlfr01,49,HOU,1,PHO,23,5,5,2,0,2,36.55,1,4,7,15,6,14,3,4,2,2,10,28,28,33,40.5
2023-24,202402230ATL,2/23/2024,ATL vs TOR,Scottie Barnes,barnesc01,57,TOR,0,ATL,20,5,10,1,1,3,36.6,1,4,8,13,0,2,4,4,2,2,15,30,25,35,44
2023-24,202402230ATL,2/23/2024,ATL vs TOR,Immanuel Quickley,quickim01,52,TOR,0,ATL,24,7,5,0,0,3,36.73333333,0,7,9,20,6,11,0,0,4,0,12,29,31,36,36.9
2023-24,202402230POR,2/23/2024,POR vs DEN,Jerami Grant,grantje01,48,POR,1,DEN,25,2,4,3,0,3,37.13333333,1,1,9,21,3,6,4,7,2,3,6,29,27,31,39.4
2023-24,202402230ATL,2/23/2024,ATL vs TOR,Jalen Johnson,johnsja05,42,ATL,1,TOR,12,12,4,1,3,1,37.15,3,9,6,13,0,2,0,3,0,4,16,16,24,28,43.4
2023-24,202402230MEM,2/23/2024,MEM vs LAC,Paul George,georgpa01,52,LAC,0,MEM,14,5,3,0,0,5,37.3,0,5,5,12,4,7,0,1,2,0,8,17,19,22,19.5
2023-24,202402230NOP,2/23/2024,NOP vs MIA,Herbert Jones,joneshe01,52,NOP,1,MIA,19,5,2,1,0,2,37.63333333,0,5,8,10,1,1,2,2,5,1,7,21,24,26,29
2023-24,202402230MIN,2/23/2024,MIN vs MIL,Anthony Edwards,edwaran01,53,MIN,1,MIL,28,9,5,1,0,3,37.85,0,9,10,27,4,12,4,6,2,1,14,33,37,42,46.3
2023-24,202402230HOU,2/23/2024,HOU vs PHO,Kevin Durant,duranke01,50,PHO,0,HOU,28,11,8,1,2,2,38.01666667,0,11,10,22,1,7,7,10,3,3,19,36,39,47,60.2
2023-24,202402230MIN,2/23/2024,MIN vs MIL,Rudy Gobert,goberru01,55,MIN,1,MIL,12,19,1,0,2,0,38.05,7,12,6,8,0,0,0,1,5,2,20,13,31,32,42.3
2023-24,202402230MIN,2/23/2024,MIN vs MIL,Damian Lillard,lillada01,52,MIL,0,MIN,21,9,10,2,1,3,38.11666667,0,9,8,23,2,8,3,4,3,3,19,31,30,40,52.8
2023-24,202402230PHI,2/23/2024,PHI vs CLE,Darius Garland,garlada01,31,CLE,0,PHI,20,5,9,2,0,3,38.36666667,0,5,6,13,2,6,6,6,1,2,14,29,25,34,42.5
2023-24,202402230MEM,2/23/2024,MEM vs LAC,James Harden,hardeja01,50,LAC,0,MEM,9,8,8,0,1,4,38.51666667,1,7,1,8,1,4,6,7,0,1,16,17,17,25,29.6
2023-24,202402230PHI,2/23/2024,PHI vs CLE,Tyrese Maxey,maxeyty01,51,PHI,1,CLE,24,7,5,2,0,2,38.6,0,7,9,22,2,5,4,4,3,2,12,29,31,36,43.9
2023-24,202402230GSW,2/23/2024,GSW vs CHO,Miles Bridges,bridgmi02,45,CHO,0,GSW,19,11,3,2,1,3,40.61666667,3,8,8,18,3,7,0,0,1,3,14,22,30,33,42.7
2023-24,202402230MIN,2/23/2024,MIN vs MIL,Giannis Antetokounmpo,antetgi01,55,MIL,0,MIN,33,13,5,1,0,3,41.18333333,4,9,9,13,1,1,14,21,1,1,18,38,46,51,56.1
2023-24,202402230HOU,2/23/2024,HOU vs PHO,Jabari Smith Jr.,smithja05,51,HOU,1,PHO,22,16,3,2,1,1,41.2,5,11,6,18,3,10,7,8,6,3,19,25,38,41,53.7
2023-24,202402220IND,2/22/2024,IND vs DET,Marcus Sasser,sassema01,50,DET,0,IND,9,1,2,1,0,1,10,0,1,3,6,2,2,1,2,1,1,3,11,10,12,15.2
2023-24,202402220IND,2/22/2024,IND vs DET,Doug McDermott,mcderdo01,50,IND,1,DET,3,0,2,0,0,0,10.35,0,0,1,3,1,3,0,0,1,0,2,5,3,5,6
2023-24,202402220SAC,2/22/2024,SAC vs SAS,Davion Mitchell,mitchda01,45,SAC,1,SAS,0,0,1,0,0,0,10.65,0,0,0,2,0,1,0,0,1,0,1,1,0,1,1.5
2023-24,202402220PHI,2/22/2024,PHI vs NYK,Isaiah Hartenstein,harteis01,51,NYK,0,PHI,0,2,0,1,0,0,10.8,1,1,0,0,0,0,0,0,0,1,2,0,2,2,5.4
2023-24,202402220DEN,2/22/2024,DEN vs WAS,Eugene Omoruyi,omorueu01,25,WAS,0,DEN,7,3,2,3,0,1,10.85,0,3,3,8,0,2,1,1,2,3,5,9,10,12,21.6
2023-24,202402220IND,2/22/2024,IND vs DET,Malachi Flynn,flynnma01,48,DET,0,IND,2,1,3,2,0,2,11.18333333,0,1,1,5,0,1,0,0,2,2,4,5,3,6,11.7
2023-24,202402220SAC,2/22/2024,SAC vs SAS,Cedi Osman,osmande01,56,SAS,0,SAC,5,2,3,0,0,0,11.3,0,2,2,4,1,2,0,0,1,0,5,8,7,10,11.9
2023-24,202402220NOP,2/22/2024,NOP vs HOU,Larry Nance Jr.,nancela02,38,NOP,1,HOU,0,3,1,0,0,2,11.66666667,1,2,0,0,0,0,0,0,3,0,4,1,3,4,3.1
2023-24,202402220CLE,2/22/2024,CLE vs ORL,Sam Merrill,merrisa01,38,CLE,1,ORL,4,2,4,0,0,0,11.7,1,1,1,2,1,2,1,1,0,0,6,8,6,10,12.4
2023-24,202402220CHI,2/22/2024,CHI vs BOS,Dalen Terry,terryda01,36,CHI,1,BOS,3,3,2,1,0,0,11.83333333,2,1,1,1,0,0,1,2,0,1,5,5,6,8,12.6
2023-24,202402220NOP,2/22/2024,NOP vs HOU,Jock Landale,landajo01,30,HOU,0,NOP,2,3,3,1,0,0,12,1,2,1,1,0,0,0,0,1,1,6,5,5,8,13.1
2023-24,202402220NOP,2/22/2024,NOP vs HOU,Jae'Sean Tate,tateja01,52,HOU,0,NOP,4,5,2,1,0,4,12,0,5,2,3,0,1,0,0,2,1,7,6,9,11,12
2023-24,202402220CHI,2/22/2024,CHI vs BOS,Jevon Carter,carteje01,53,CHI,1,BOS,2,1,2,0,0,0,12.08333333,0,1,1,2,0,1,0,0,1,0,3,4,3,5,6.2
2023-24,202402220UTA,2/22/2024,UTA vs CHO,Brice Sensabaugh,sensabr01,7,UTA,1,CHO,7,0,0,1,0,1,12.63333333,0,0,3,6,1,3,0,0,2,1,0,7,7,7,9
2023-24,202402220CLE,2/22/2024,CLE vs ORL,Dean Wade,wadede01,45,CLE,1,ORL,3,2,0,0,1,0,12.7,0,2,1,2,1,2,0,0,0,1,2,3,5,5,8.4
2023-24,202402220IND,2/22/2024,IND vs DET,Troy Brown Jr.,browntr01,41,DET,0,IND,2,2,2,0,0,1,12.83333333,0,2,1,4,0,2,0,0,1,0,4,4,4,6,6.4
2023-24,202402220SAC,2/22/2024,SAC vs SAS,Malaki Branham,branhma01,51,SAS,0,SAC,5,3,2,0,0,1,13.35,1,2,2,6,1,2,0,0,0,0,5,7,8,10,10.6
2023-24,202402220PHI,2/22/2024,PHI vs NYK,Alec Burks,burksal01,47,NYK,0,PHI,7,1,1,0,0,1,13.36666667,0,1,2,5,2,4,1,3,0,0,2,8,8,9,8.7
2023-24,202402220OKC,2/22/2024,OKC vs LAC,Gordon Hayward,haywago01,26,OKC,1,LAC,0,4,0,0,0,0,13.58333333,0,4,0,2,0,0,0,0,0,0,4,0,4,4,4.8
2023-24,202402220DEN,2/22/2024,DEN vs WAS,Johnny Davis,davisjo06,24,WAS,0,DEN,2,3,1,1,0,0,13.65,0,3,1,4,0,1,0,2,2,1,4,3,5,6,10.1
2023-24,202402220OKC,2/22/2024,OKC vs LAC,Aaron Wiggins,wiggiaa01,52,OKC,1,LAC,9,2,0,2,0,2,13.7,1,1,3,6,2,4,1,1,1,2,2,9,11,11,15.4
2023-24,202402220GSW,2/22/2024,GSW vs LAL,Lester Quinones,quinole01,20,GSW,1,LAL,7,1,1,0,0,2,13.81666667,1,0,2,5,0,1,3,3,4,0,2,8,8,9,7.7
2023-24,202402220CHI,2/22/2024,CHI vs BOS,Luke Kornet,kornelu01,40,BOS,0,CHI,10,4,2,1,0,0,13.86666667,4,0,5,6,0,0,0,0,1,1,6,12,14,16,20.8
2023-24,202402220SAC,2/22/2024,SAC vs SAS,Alex Len,lenal01,23,SAC,1,SAS,4,4,0,0,2,0,13.93333333,1,3,2,5,0,0,0,0,1,2,4,4,8,8,14.8
2023-24,202402220TOR,2/22/2024,TOR vs BRK,Ochai Agbaji,agbajoc01,55,TOR,1,BRK,2,0,2,1,1,1,14.36666667,0,0,1,2,0,1,0,0,0,2,2,4,2,4,10
2023-24,202402220CHI,2/22/2024,CHI vs BOS,Sam Hauser,hausesa01,55,BOS,0,CHI,8,1,1,0,1,0,14.46666667,0,1,3,3,2,2,0,0,0,1,2,9,9,10,13.7
2023-24,202402220TOR,2/22/2024,TOR vs BRK,Dorian Finney-Smith,finnedo01,46,BRK,0,TOR,3,2,0,1,0,3,14.63333333,1,1,1,3,1,3,0,0,4,1,2,3,5,5,5.4
2023-24,202402220GSW,2/22/2024,GSW vs LAL,Trayce Jackson-Davis,jackstr02,41,GSW,1,LAL,17,5,1,0,2,0,14.83333333,4,1,8,10,0,0,1,1,2,2,6,18,22,23,30.5
2023-24,202402220IND,2/22/2024,IND vs DET,Ben Sheppard,sheppbe01,35,IND,1,DET,7,1,0,0,0,0,14.88333333,0,1,3,5,1,2,0,0,1,0,1,7,8,8,8.2
2023-24,202402220SAC,2/22/2024,SAC vs SAS,Trey Lyles,lylestr01,40,SAC,1,SAS,4,3,0,0,0,0,15.01666667,0,3,1,6,1,5,1,2,0,0,3,4,7,7,7.6
2023-24,202402220GSW,2/22/2024,GSW vs LAL,Dario Saric,saricda01,52,GSW,1,LAL,4,4,4,0,0,1,15.05,2,2,2,6,0,3,0,0,1,0,8,8,8,12,13.8
2023-24,202402220OKC,2/22/2024,OKC vs LAC,Kenrich Williams,willike04,44,OKC,1,LAC,7,5,0,0,0,0,15.08333333,1,4,3,7,1,3,0,0,1,0,5,7,12,12,13
2023-24,202402220DEN,2/22/2024,DEN vs WAS,Justin Holiday,holidju01,33,DEN,1,WAS,8,1,2,2,1,0,15.2,0,1,3,5,2,3,0,0,0,3,3,10,9,11,21.2
2023-24,202402220CLE,2/22/2024,CLE vs ORL,Georges Niang,niangge01,54,CLE,1,ORL,9,0,1,0,0,2,15.61666667,0,0,3,4,2,3,1,1,2,0,1,10,9,10,8.5
2023-24,202402220DEN,2/22/2024,DEN vs WAS,Kentavious Caldwell-Pope,caldwke01,51,DEN,1,WAS,0,2,1,0,0,0,15.86666667,0,2,0,6,0,3,0,0,0,0,3,1,2,3,3.9
2023-24,202402220DAL,2/22/2024,DAL vs PHO,Dereck Lively II,livelde01,38,DAL,1,PHO,5,4,1,0,2,0,15.88333333,3,1,2,3,0,0,1,2,1,2,5,6,9,10,17.3
2023-24,202402220TOR,2/22/2024,TOR vs BRK,Day'Ron Sharpe,sharpda01,40,BRK,0,TOR,9,5,1,0,0,4,15.98333333,2,3,3,5,0,0,3,6,2,0,6,10,14,15,12.5
2023-24,202402220OKC,2/22/2024,OKC vs LAC,Russell Westbrook,westbru01,54,LAC,0,OKC,2,1,5,1,0,1,16,0,1,1,9,0,2,0,0,2,1,6,7,3,8,12.7
2023-24,202402220TOR,2/22/2024,TOR vs BRK,Dennis Smith Jr.,smithde03,39,BRK,0,TOR,6,3,1,0,0,4,16.1,0,3,2,3,0,0,2,2,1,0,4,7,9,10,7.1
2023-24,202402220IND,2/22/2024,IND vs DET,Obi Toppin,toppiob01,58,IND,1,DET,9,6,3,1,1,1,16.3,3,3,3,6,2,3,1,2,1,2,9,12,15,18,25.7
2023-24,202402220TOR,2/22/2024,TOR vs BRK,Gradey Dick,dickgr01,35,TOR,1,BRK,7,4,0,0,0,0,16.61666667,1,3,3,6,1,3,0,0,0,0,4,7,11,11,11.8
2023-24,202402220DEN,2/22/2024,DEN vs WAS,Zeke Nnaji,nnajize01,41,DEN,1,WAS,8,3,1,0,4,0,16.61666667,0,3,4,5,0,1,0,0,0,4,4,9,11,12,25.1
2023-24,202402220SAC,2/22/2024,SAC vs SAS,Julian Champagnie,champju02,49,SAS,0,SAC,10,5,2,0,0,0,16.63333333,2,3,4,6,2,3,0,0,2,0,7,12,15,17,19
2023-24,202402220SAC,2/22/2024,SAC vs SAS,Zach Collins,colliza01,44,SAS,0,SAC,3,3,4,1,0,0,16.71666667,0,3,1,4,0,0,1,2,1,1,7,7,6,10,15.6
2023-24,202402220SAC,2/22/2024,SAC vs SAS,Blake Wesley,weslebl01,35,SAS,0,SAC,4,1,1,0,0,1,16.91666667,1,0,1,4,0,2,2,2,2,0,2,5,5,6,5.7
2023-24,202402220NOP,2/22/2024,NOP vs HOU,Jordan Hawkins,hawkijo01,49,NOP,1,HOU,3,2,0,0,0,0,17.08333333,0,2,1,6,1,5,0,0,3,0,2,3,5,5,5.4
2023-24,202402220PHI,2/22/2024,PHI vs NYK,Miles McBride,mcbrimi01,43,NYK,0,PHI,4,2,1,1,0,0,17.11666667,1,1,2,4,0,2,0,0,0,1,3,5,6,7,10.9
2023-24,202402220SAC,2/22/2024,SAC vs SAS,Harrison Barnes,barneha02,55,SAC,1,SAS,5,4,0,1,0,0,17.23333333,1,3,2,5,0,1,1,2,2,1,4,5,9,9,12.8
2023-24,202402220DAL,2/22/2024,DAL vs PHO,Daniel Gafford,gaffoda01,49,DAL,1,PHO,4,5,1,0,1,1,17.23333333,2,3,0,1,0,0,4,4,4,1,6,5,9,10,13.5
2023-24,202402220UTA,2/22/2024,UTA vs CHO,Walker Kessler,kesslwa01,49,UTA,1,CHO,2,2,0,1,1,1,17.25,1,1,1,4,0,1,0,0,1,2,2,2,4,4,9.4
2023-24,202402220DEN,2/22/2024,DEN vs WAS,Marvin Bagley III,baglema01,38,WAS,0,DEN,8,7,2,2,0,0,17.35,5,2,4,8,0,1,0,0,0,2,9,10,15,17,25.4
2023-24,202402220CHI,2/22/2024,CHI vs BOS,Andre Drummond,drumman01,56,CHI,1,BOS,11,8,0,0,1,0,17.38333333,4,4,4,8,0,0,3,4,0,1,8,11,19,19,23.6
2023-24,202402220IND,2/22/2024,IND vs DET,Evan Fournier,fournev01,6,DET,0,IND,10,4,0,0,0,1,17.56666667,0,4,3,4,3,4,1,2,1,0,4,10,14,14,13.8
2023-24,202402220IND,2/22/2024,IND vs DET,T.J. McConnell,mccontj01,47,IND,1,DET,16,6,5,2,1,1,17.6,0,6,7,11,2,2,0,0,1,3,11,21,22,27,38.7
2023-24,202402220CHI,2/22/2024,CHI vs BOS,Julian Phillips,phillju01,31,CHI,1,BOS,9,2,1,0,0,0,17.75,0,2,4,5,1,1,0,0,1,0,3,10,11,12,12.9
2023-24,202402220IND,2/22/2024,IND vs DET,James Wiseman,wisemja01,36,DET,0,IND,6,5,2,0,1,1,17.85,0,5,2,3,0,0,2,5,3,1,7,8,11,13,17
2023-24,202402220GSW,2/22/2024,GSW vs LAL,Spencer Dinwiddie,dinwisp01,51,LAL,0,GSW,5,0,3,0,1,0,17.95,0,0,2,6,0,1,1,1,5,1,3,8,5,8,12.5
2023-24,202402220CLE,2/22/2024,CLE vs ORL,Joe Ingles,inglejo01,42,ORL,0,CLE,12,1,2,1,0,1,18,0,1,4,4,3,3,1,1,2,1,3,14,13,15,18.2
2023-24,202402220PHI,2/22/2024,PHI vs NYK,Jericho Sims,simsje01,29,NYK,0,PHI,4,10,2,0,1,0,18.01666667,5,5,1,2,0,0,2,2,2,1,12,6,14,16,22
2023-24,202402220CLE,2/22/2024,CLE vs ORL,Jalen Suggs,suggsja01,51,ORL,0,CLE,7,1,3,1,0,0,18.13333333,0,1,3,8,1,4,0,0,1,1,4,10,8,11,15.7
2023-24,202402220PHI,2/22/2024,PHI vs NYK,Nicolas Batum,batumni01,35,PHI,1,NYK,0,3,1,0,0,1,18.15,0,3,0,0,0,0,0,0,5,0,4,1,3,4,4.1
2023-24,202402220TOR,2/22/2024,TOR vs BRK,Kelly Olynyk,olynyke01,54,TOR,1,BRK,8,4,1,1,1,1,18.23333333,1,3,2,5,0,1,4,4,3,2,5,9,12,13,19.3
2023-24,202402220GSW,2/22/2024,GSW vs LAL,Jaxson Hayes,hayesja02,47,LAL,0,GSW,7,7,1,0,1,0,18.36666667,4,3,3,6,0,0,1,4,2,1,8,8,14,15,19.9
2023-24,202402220DAL,2/22/2024,DAL vs PHO,Derrick Jones Jr.,jonesde02,51,DAL,1,PHO,4,2,1,0,1,0,18.38333333,1,1,1,3,1,2,1,2,0,1,3,5,6,7,10.9
2023-24,202402220DAL,2/22/2024,DAL vs PHO,Josh Okogie,okogijo01,50,PHO,0,DAL,11,4,1,0,0,2,18.5,4,0,4,7,2,4,1,2,1,0,5,12,15,16,15.3
2023-24,202402220TOR,2/22/2024,TOR vs BRK,Lonnie Walker IV,walkelo01,35,BRK,0,TOR,11,4,0,0,0,0,18.56666667,0,4,4,13,3,7,0,0,3,0,4,11,15,15,15.8
2023-24,202402220CLE,2/22/2024,CLE vs ORL,Jonathan Isaac,isaacjo01,38,ORL,0,CLE,7,7,1,0,2,1,18.86666667,5,2,3,8,0,1,1,2,0,2,8,8,14,15,21.9
2023-24,202402220OKC,2/22/2024,OKC vs LAC,Isaiah Joe,joeis01,51,OKC,1,LAC,9,2,1,0,0,1,19.01666667,0,2,4,5,1,2,0,0,2,0,3,10,11,12,11.9
2023-24,202402220CLE,2/22/2024,CLE vs ORL,Cole Anthony,anthoco01,55,ORL,0,CLE,13,2,6,1,1,1,19.1,0,2,6,8,1,1,0,0,4,2,8,19,15,21,29.4
2023-24,202402220UTA,2/22/2024,UTA vs CHO,Seth Curry,curryse01,40,CHO,0,UTA,10,2,0,0,0,1,19.13333333,1,1,4,8,1,4,1,1,0,0,2,10,12,12,11.4
2023-24,202402220OKC,2/22/2024,OKC vs LAC,Cason Wallace,wallaca01,55,OKC,1,LAC,7,4,3,4,0,0,19.18333333,2,2,3,3,1,1,0,0,1,4,7,10,11,14,28.3
2023-24,202402220GSW,2/22/2024,GSW vs LAL,Moses Moody,moodymo01,40,GSW,1,LAL,4,6,1,0,0,0,19.51666667,1,5,2,6,0,2,0,0,2,0,7,5,10,11,12.7
2023-24,202402220DAL,2/22/2024,DAL vs PHO,Jusuf Nurkic,nurkiju01,53,PHO,0,DAL,5,5,3,2,1,1,19.55,2,3,2,6,0,0,1,2,3,3,8,8,10,13,23.5
2023-24,202402220UTA,2/22/2024,UTA vs CHO,Vasilije Micic,micicva01,34,CHO,0,UTA,4,2,8,0,0,2,19.7,1,1,1,9,0,3,2,4,3,0,10,12,6,14,16.4
2023-24,202402220IND,2/22/2024,IND vs DET,Isaiah Jackson,jacksis01,45,IND,1,DET,13,0,0,0,0,1,19.73333333,0,0,4,4,0,0,5,6,2,0,0,13,13,13,12
2023-24,202402220CHI,2/22/2024,CHI vs BOS,Payton Pritchard,pritcpa01,56,BOS,0,CHI,9,3,1,0,0,2,19.85,0,3,3,6,3,6,0,0,0,0,4,10,12,13,12.1
2023-24,202402220NOP,2/22/2024,NOP vs HOU,Naji Marshall,marshna01,45,NOP,1,HOU,6,2,3,1,0,0,19.88333333,0,2,2,5,2,4,0,0,2,1,5,9,8,11,15.9
2023-24,202402220SAC,2/22/2024,SAC vs SAS,Chris Duarte,duartch01,38,SAC,1,SAS,6,4,1,0,0,0,19.95,1,3,2,3,2,3,0,0,2,0,5,7,10,11,12.3
2023-24,202402220NOP,2/22/2024,NOP vs HOU,Jose Alvarado,alvarjo01,38,NOP,1,HOU,11,2,7,1,2,3,20.18333333,1,1,4,8,2,5,1,2,1,3,9,18,13,20,29.9
2023-24,202402220TOR,2/22/2024,TOR vs BRK,Cameron Johnson,johnsca02,42,BRK,0,TOR,6,2,2,1,1,0,20.66666667,0,2,1,7,0,6,4,4,2,2,4,8,8,10,17.4
2023-24,202402220PHI,2/22/2024,PHI vs NYK,KJ Martin,martike04,41,PHI,1,NYK,6,7,1,1,1,0,21.1,2,5,3,5,0,0,0,0,1,2,8,7,13,14,21.9
2023-24,202402220TOR,2/22/2024,TOR vs BRK,Ben Simmons,simmobe01,13,BRK,0,TOR,2,4,4,0,0,1,21.13333333,0,4,1,2,0,0,0,1,1,0,8,6,6,10,11.8
2023-24,202402220GSW,2/22/2024,GSW vs LAL,Draymond Green,greendr01,30,GSW,1,LAL,8,7,5,0,1,1,21.35,0,7,3,5,2,2,0,0,1,1,12,13,15,20,25.9
2023-24,202402220DEN,2/22/2024,DEN vs WAS,Aaron Gordon,gordoaa01,50,DEN,1,WAS,17,2,4,1,0,3,21.48333333,0,2,7,12,0,2,3,3,4,1,6,21,19,23,25.4
2023-24,202402220DEN,2/22/2024,DEN vs WAS,Reggie Jackson,jacksre01,56,DEN,1,WAS,11,1,5,1,0,2,21.63333333,0,1,5,14,1,7,0,0,1,1,6,16,12,17,20.7
2023-24,202402220DEN,2/22/2024,DEN vs WAS,Peyton Watson,watsope01,54,DEN,1,WAS,11,5,1,1,4,4,22.15,2,3,3,5,1,1,4,5,1,5,6,12,16,17,29.5
2023-24,202402220PHI,2/22/2024,PHI vs NYK,Paul Reed,reedpa01,55,PHI,1,NYK,2,5,0,0,0,0,22.48333333,1,4,1,2,0,0,0,0,4,0,5,2,7,7,8
2023-24,202402220CHI,2/22/2024,CHI vs BOS,Al Horford,horfoal01,46,BOS,0,CHI,0,5,0,0,1,1,22.63333333,1,4,0,1,0,0,0,0,1,1,5,0,5,5,8
2023-24,202402220OKC,2/22/2024,OKC vs LAC,Josh Giddey,giddejo01,54,OKC,1,LAC,12,5,2,0,1,3,22.8,0,5,4,10,1,3,3,3,0,1,7,14,17,19,21
2023-24,202402220DEN,2/22/2024,DEN vs WAS,Christian Braun,braunch01,56,DEN,1,WAS,12,10,1,2,0,1,23.11666667,4,6,5,8,1,2,1,3,2,2,11,13,22,23,30.5
2023-24,202402220CLE,2/22/2024,CLE vs ORL,Wendell Carter Jr.,cartewe01,30,ORL,0,CLE,12,2,1,0,0,1,23.13333333,0,2,5,7,2,3,0,0,2,0,3,13,14,15,14.9
2023-24,202402220TOR,2/22/2024,TOR vs BRK,Dennis Schroder,schrode01,55,BRK,0,TOR,4,2,2,0,0,2,23.25,0,2,1,7,1,3,1,2,4,0,4,6,6,8,7.4
2023-24,202402220PHI,2/22/2024,PHI vs NYK,Bojan Bogdanovic,bogdabo02,31,NYK,0,PHI,22,2,0,3,0,0,23.55,0,2,8,13,6,6,0,2,3,3,2,22,24,24,33.4
2023-24,202402220NOP,2/22/2024,NOP vs HOU,Jalen Green,greenja05,55,HOU,0,NOP,10,4,2,1,0,1,23.63333333,1,3,3,14,2,8,2,2,1,1,6,12,14,16,19.8
2023-24,202402220CLE,2/22/2024,CLE vs ORL,Anthony Black,blackan01,51,ORL,0,CLE,9,3,2,0,0,1,23.71666667,1,2,3,7,1,2,2,2,1,0,5,11,12,14,14.6
2023-24,202402220GSW,2/22/2024,GSW vs LAL,Jonathan Kuminga,kuminjo01,53,GSW,1,LAL,12,3,3,1,0,0,24.18333333,1,2,5,12,1,3,1,2,2,1,6,15,15,18,23.1
2023-24,202402220NOP,2/22/2024,NOP vs HOU,Cam Whitmore,whitmca01,29,HOU,0,NOP,13,4,0,0,2,2,24.45,1,3,5,11,2,8,1,3,1,2,4,13,17,17,21.8
2023-24,202402220DEN,2/22/2024,DEN vs WAS,Corey Kispert,kispeco01,54,WAS,0,DEN,12,2,3,2,0,4,24.63333333,0,2,4,11,3,5,1,2,0,2,5,15,14,17,20.9
2023-24,202402220CLE,2/22/2024,CLE vs ORL,Moritz Wagner,wagnemo01,54,ORL,0,CLE,22,7,0,1,0,0,24.71666667,2,5,7,12,1,1,7,8,4,1,7,22,29,29,33.4
2023-24,202402220TOR,2/22/2024,TOR vs BRK,Bruce Brown,brownbr01,49,TOR,1,BRK,6,1,4,0,0,0,24.83333333,0,1,1,5,0,3,4,4,2,0,5,10,7,11,13.2
2023-24,202402220DAL,2/22/2024,DAL vs PHO,Josh Green,greenjo02,43,DAL,1,PHO,9,2,5,2,0,2,25.11666667,1,1,3,7,3,5,0,0,4,2,7,14,11,16,22.9
2023-24,202402220PHI,2/22/2024,PHI vs NYK,Kyle Lowry,lowryky01,38,PHI,1,NYK,11,4,5,0,0,3,25.11666667,1,3,5,7,1,2,0,0,3,0,9,16,15,20,20.3
2023-24,202402220UTA,2/22/2024,UTA vs CHO,Kris Dunn,dunnkr01,49,UTA,1,CHO,8,3,3,0,0,0,25.16666667,2,1,4,7,0,3,0,0,3,0,6,11,11,14,16.1
2023-24,202402220TOR,2/22/2024,TOR vs BRK,Jakob Poeltl,poeltja01,45,TOR,1,BRK,8,9,2,1,3,1,25.66666667,1,8,3,7,0,0,2,4,2,4,11,10,17,19,32.8
2023-24,202402220UTA,2/22/2024,UTA vs CHO,Taylor Hendricks,hendrita0,18,UTA,1,CHO,12,9,1,0,0,0,25.76666667,4,5,5,9,1,5,1,1,2,0,10,13,21,22,24.3
2023-24,202402220DAL,2/22/2024,DAL vs PHO,Maxi Kleber,klebima01,20,DAL,1,PHO,7,2,1,1,0,0,25.8,0,2,3,7,1,3,0,0,1,1,3,8,9,10,13.9
2023-24,202402220UTA,2/22/2024,UTA vs CHO,Collin Sexton,sextoco01,57,UTA,1,CHO,17,2,5,0,0,4,26.3,0,2,3,9,2,4,9,10,2,0,7,22,19,24,22.9
2023-24,202402220PHI,2/22/2024,PHI vs NYK,Tobias Harris,harrito02,49,PHI,1,NYK,7,4,3,3,0,0,26.6,0,4,3,9,1,3,0,0,2,3,7,10,11,14,25.3
2023-24,202402220NOP,2/22/2024,NOP vs HOU,Jabari Smith Jr.,smithja05,50,HOU,0,NOP,9,4,1,0,0,2,26.63333333,1,3,3,5,2,2,1,2,1,0,5,10,13,14,13.3
2023-24,202402220SAC,2/22/2024,SAC vs SAS,Malik Monk,monkma01,54,SAC,1,SAS,21,3,2,2,2,2,26.75,0,3,8,15,1,5,4,4,0,4,5,23,24,26,37.6
2023-24,202402220NOP,2/22/2024,NOP vs HOU,Alperen Sengun,sengual01,54,HOU,0,NOP,20,9,2,1,0,3,27.13333333,2,7,6,9,1,1,7,10,3,1,11,22,29,31,33.8
2023-24,202402220DEN,2/22/2024,DEN vs WAS,Deni Avdija,avdijde01,55,WAS,0,DEN,5,4,1,0,0,2,27.15,0,4,2,12,1,3,0,0,2,0,5,6,9,10,9.3
2023-24,202402220UTA,2/22/2024,UTA vs CHO,Grant Williams,willigr01,51,CHO,0,UTA,24,0,2,1,0,0,27.2,0,0,7,16,6,11,4,4,3,1,2,26,24,26,30
2023-24,202402220GSW,2/22/2024,GSW vs LAL,Austin Reaves,reaveau01,58,LAL,0,GSW,16,2,4,0,1,2,27.25,0,2,7,11,2,5,0,0,2,1,6,20,18,22,25.4
2023-24,202402220NOP,2/22/2024,NOP vs HOU,Dillon Brooks,brookdi01,46,HOU,0,NOP,7,2,2,0,0,0,27.3,0,2,2,6,2,5,1,2,3,0,4,9,9,11,12.4
2023-24,202402220CLE,2/22/2024,CLE vs ORL,Caris LeVert,leverca01,44,CLE,1,ORL,6,2,2,1,1,2,27.45,0,2,2,10,0,2,2,2,2,2,4,8,8,10,15.4
2023-24,202402220NOP,2/22/2024,NOP vs HOU,Jonas Valanciunas,valanjo01,56,NOP,1,HOU,20,14,3,1,0,1,27.46666667,3,11,9,12,2,2,0,0,3,1,17,23,34,37,43.3
2023-24,202402220NOP,2/22/2024,NOP vs HOU,Amen Thompson,thompam01,36,HOU,0,NOP,22,5,4,0,3,3,27.58333333,2,3,9,13,1,3,3,5,1,3,9,26,27,31,40
2023-24,202402220GSW,2/22/2024,GSW vs LAL,Andrew Wiggins,wiggian01,49,GSW,1,LAL,20,3,2,1,1,1,27.68333333,2,1,8,14,2,5,2,2,2,2,5,22,23,25,31.6
2023-24,202402220OKC,2/22/2024,OKC vs LAC,Terance Mann,mannte01,48,LAC,0,OKC,8,6,6,0,0,1,27.71666667,2,4,3,8,2,3,0,0,0,0,12,14,14,20,23.2
2023-24,202402220GSW,2/22/2024,GSW vs LAL,Brandin Podziemski,podzibr01,48,GSW,1,LAL,10,9,1,0,0,2,27.83333333,3,6,3,12,2,6,2,2,1,0,10,11,19,20,20.3
2023-24,202402220GSW,2/22/2024,GSW vs LAL,Klay Thompson,thompkl01,51,GSW,1,LAL,3,4,5,1,0,0,28.23333333,0,4,1,9,1,4,0,0,2,1,9,8,7,12,18.3
2023-24,202402220IND,2/22/2024,IND vs DET,Myles Turner,turnemy01,54,IND,1,DET,13,11,1,2,2,1,28.26666667,1,10,5,9,0,3,3,3,3,4,12,14,24,25,38.7
2023-24,202402220OKC,2/22/2024,OKC vs LAC,Amir Coffey,coffeam01,42,LAC,0,OKC,8,1,3,2,0,1,28.3,0,1,3,8,1,4,1,1,1,2,4,11,9,12,18.7
2023-24,202402220UTA,2/22/2024,UTA vs CHO,Nick Richards,richani01,46,CHO,0,UTA,8,10,3,1,2,0,28.3,6,4,3,5,0,0,2,4,2,3,13,11,18,21,33.5
2023-24,202402220GSW,2/22/2024,GSW vs LAL,Max Christie,chrisma02,45,LAL,0,GSW,9,3,6,1,1,0,28.76666667,2,1,3,8,1,5,2,2,0,2,9,15,12,18,27.6
2023-24,202402220CLE,2/22/2024,CLE vs ORL,Gary Harris,harriga01,34,ORL,0,CLE,8,0,3,3,0,1,28.93333333,0,0,2,4,2,2,2,2,3,3,3,11,8,11,20.5
2023-24,202402220TOR,2/22/2024,TOR vs BRK,RJ Barrett,barrerj01,46,TOR,1,BRK,12,5,7,0,0,3,29.08333333,0,5,5,13,2,4,0,2,3,0,12,19,17,24,25.5
2023-24,202402220CHI,2/22/2024,CHI vs BOS,Jrue Holiday,holidjr01,51,BOS,0,CHI,9,3,6,2,1,2,29.25,0,3,3,5,2,3,1,2,3,3,9,15,12,18,28.6
2023-24,202402220OKC,2/22/2024,OKC vs LAC,James Harden,hardeja01,49,LAC,0,OKC,17,6,2,1,0,3,29.46666667,2,4,5,9,3,6,4,4,2,1,8,19,23,25,27.2
2023-24,202402220OKC,2/22/2024,OKC vs LAC,Ivica Zubac,zubaciv01,44,LAC,0,OKC,13,12,1,0,1,1,29.48333333,4,8,5,12,0,0,3,4,4,1,13,14,25,26,30.9
2023-24,202402220UTA,2/22/2024,UTA vs CHO,Tre Mann,manntr01,17,CHO,0,UTA,13,6,4,2,0,1,29.65,1,5,4,8,2,3,3,4,4,2,10,17,19,23,31.2
2023-24,202402220CHI,2/22/2024,CHI vs BOS,Kristaps Porzingis,porzikr01,41,BOS,0,CHI,14,4,1,1,3,1,29.66666667,0,4,5,16,2,9,2,2,4,4,5,15,18,19,31.3
2023-24,202402220CHI,2/22/2024,CHI vs BOS,Alex Caruso,carusal01,48,CHI,1,BOS,12,3,5,2,1,3,29.71666667,0,3,5,9,2,4,0,0,3,3,8,17,15,20,29.1
2023-24,202402220SAC,2/22/2024,SAC vs SAS,Tre Jones,jonestr01,51,SAS,0,SAC,10,2,9,0,0,2,29.78333333,1,1,5,8,0,1,0,0,0,0,11,19,12,21,23.9
2023-24,202402220DAL,2/22/2024,DAL vs PHO,Royce O'Neale,onealro01,53,PHO,0,DAL,10,9,2,1,0,1,29.9,1,8,4,12,2,8,0,0,3,1,11,12,19,21,25.8
2023-24,202402220TOR,2/22/2024,TOR vs BRK,Cam Thomas,thomaca02,46,BRK,0,TOR,19,2,4,2,0,2,30.05,1,1,8,16,2,7,1,1,1,2,6,23,21,25,31.4
2023-24,202402220IND,2/22/2024,IND vs DET,Jalen Duren,durenja01,40,DET,0,IND,15,13,2,0,0,4,30.15,2,11,7,11,0,0,1,1,3,0,15,17,28,30,29.6
2023-24,202402220DEN,2/22/2024,DEN vs WAS,Jordan Poole,poolejo01,53,WAS,0,DEN,18,1,1,2,0,2,30.15,0,1,4,17,3,9,7,9,3,2,2,19,19,20,24.7
2023-24,202402220DAL,2/22/2024,DAL vs PHO,Tim Hardaway Jr.,hardati02,53,DAL,1,PHO,12,4,0,2,0,2,30.16666667,0,4,5,13,1,9,1,2,2,2,4,12,16,16,20.8
2023-24,202402220CLE,2/22/2024,CLE vs ORL,Isaac Okoro,okorois01,45,CLE,1,ORL,17,2,1,0,0,2,30.25,0,2,7,9,2,4,1,1,4,0,3,18,19,20,18.9
2023-24,202402220IND,2/22/2024,IND vs DET,Cade Cunningham,cunnica01,45,DET,0,IND,30,5,8,1,0,3,30.28333333,0,5,13,21,4,9,0,0,4,1,13,38,35,43,48
2023-24,202402220NOP,2/22/2024,NOP vs HOU,Fred VanVleet,vanvlfr01,48,HOU,0,NOP,7,3,6,2,0,4,30.43333333,1,2,2,8,2,6,1,2,3,2,9,13,10,16,21.6
2023-24,202402220OKC,2/22/2024,OKC vs LAC,Kawhi Leonard,leonaka01,49,LAC,0,OKC,20,3,2,1,0,2,30.53333333,0,3,9,12,0,2,2,2,2,1,5,22,23,25,27.6
2023-24,202402220DAL,2/22/2024,DAL vs PHO,P.J. Washington,washipj01,48,DAL,1,PHO,12,6,1,1,1,1,30.58333333,2,4,4,10,2,6,2,2,3,2,7,13,18,19,25.7
2023-24,202402220TOR,2/22/2024,TOR vs BRK,Scottie Barnes,barnesc01,56,TOR,1,BRK,18,12,3,3,1,4,30.63333333,4,8,7,13,1,3,3,4,1,4,15,21,30,33,44.9
2023-24,202402220OKC,2/22/2024,OKC vs LAC,Luguentz Dort,dortlu01,53,OKC,1,LAC,19,3,1,1,2,0,30.66666667,1,2,8,13,3,6,0,0,3,3,4,20,22,23,33.1
2023-24,202402220DEN,2/22/2024,DEN vs WAS,Michael Porter Jr.,portemi01,55,DEN,1,WAS,22,11,2,0,0,2,30.68333333,5,6,9,16,2,7,2,2,2,0,13,24,33,35,36.2
2023-24,202402220UTA,2/22/2024,UTA vs CHO,John Collins,collijo01,53,UTA,1,CHO,9,18,2,0,1,2,30.75,6,12,4,10,1,2,0,0,3,1,20,11,27,29,34.6
2023-24,202402220OKC,2/22/2024,OKC vs LAC,Norman Powell,powelno01,54,LAC,0,OKC,19,2,1,0,1,3,30.78333333,1,1,7,15,4,9,1,2,1,1,3,20,21,22,22.9
2023-24,202402220DEN,2/22/2024,DEN vs WAS,Tyus Jones,jonesty01,55,WAS,0,DEN,13,2,14,0,0,2,30.85,2,0,5,8,3,5,0,0,0,0,16,27,15,29,34.4
2023-24,202402220UTA,2/22/2024,UTA vs CHO,Cody Martin,martico01,23,CHO,0,UTA,5,5,2,3,1,3,30.91666667,0,5,2,7,1,3,0,0,3,4,7,7,10,12,23
2023-24,202402220DEN,2/22/2024,DEN vs WAS,Kyle Kuzma,kuzmaky01,53,WAS,0,DEN,31,12,3,3,0,3,31.01666667,6,6,12,25,6,8,1,4,4,3,15,34,43,46,55.9
2023-24,202402220UTA,2/22/2024,UTA vs CHO,Keyonte George,georgke01,51,UTA,1,CHO,16,3,5,0,0,5,31.11666667,0,3,7,14,2,8,0,0,2,0,8,21,19,24,22.1
2023-24,202402220DEN,2/22/2024,DEN vs WAS,Jamal Murray,murraja01,41,DEN,1,WAS,18,4,8,3,2,1,31.26666667,0,4,9,17,0,3,0,0,1,5,12,26,22,30,48.8
2023-24,202402220SAC,2/22/2024,SAC vs SAS,Victor Wembanyama,wembavi01,50,SAS,0,SAC,19,13,4,5,5,1,31.28333333,5,8,8,21,1,6,2,3,1,10,17,23,32,36,69.6
2023-24,202402220NOP,2/22/2024,NOP vs HOU,CJ McCollum,mccolcj01,42,NOP,1,HOU,28,6,6,0,0,2,31.3,1,5,11,22,4,10,2,3,1,0,12,34,34,40,42.2
2023-24,202402220SAC,2/22/2024,SAC vs SAS,Keldon Johnson,johnske04,52,SAS,0,SAC,18,4,3,1,0,0,31.36666667,0,4,7,12,2,4,2,2,3,1,7,21,22,25,30.3
2023-24,202402220DEN,2/22/2024,DEN vs WAS,Nikola Jokic,jokicni01,54,DEN,1,WAS,21,19,15,1,0,3,31.38333333,2,17,10,10,0,0,1,2,3,1,34,36,40,55,66.3
2023-24,202402220SAC,2/22/2024,SAC vs SAS,Kevin Huerter,huertke01,53,SAC,1,SAS,21,4,5,0,0,1,31.4,0,4,8,14,5,8,0,0,1,0,9,26,25,30,32.3
2023-24,202402220TOR,2/22/2024,TOR vs BRK,Gary Trent Jr.,trentga02,51,TOR,1,BRK,25,1,2,1,0,0,31.46666667,0,1,9,12,5,7,2,2,4,1,3,27,26,28,32.2
2023-24,202402220IND,2/22/2024,IND vs DET,Pascal Siakam,siakapa01,55,IND,1,DET,20,4,2,0,0,0,31.7,0,4,8,16,2,2,2,2,2,0,6,22,24,26,27.8
2023-24,202402220GSW,2/22/2024,GSW vs LAL,Stephen Curry,curryst01,51,GSW,1,LAL,32,1,8,3,0,1,31.78333333,0,1,12,24,6,13,2,2,1,3,9,40,33,41,53.2
2023-24,202402220CLE,2/22/2024,CLE vs ORL,Franz Wagner,wagnefr01,48,ORL,0,CLE,14,4,4,1,0,3,31.78333333,0,4,6,11,1,4,1,1,1,1,8,18,18,22,24.8
2023-24,202402220GSW,2/22/2024,GSW vs LAL,Taurean Prince,princta02,55,LAL,0,GSW,12,3,2,1,0,1,31.88333333,0,3,5,10,2,7,0,0,0,1,5,14,15,17,20.6
2023-24,202402220IND,2/22/2024,IND vs DET,Jaden Ivey,iveyja01,51,DET,0,IND,14,2,3,0,0,1,31.96666667,1,1,5,11,1,3,3,4,2,0,5,17,16,19,19.9
2023-24,202402220GSW,2/22/2024,GSW vs LAL,Rui Hachimura,hachiru01,44,LAL,0,GSW,8,4,1,1,2,1,32,1,3,3,8,1,4,1,2,1,3,5,9,12,13,22.3
2023-24,202402220TOR,2/22/2024,TOR vs BRK,Nic Claxton,claxtni01,45,BRK,0,TOR,6,10,3,2,0,2,32.01666667,2,8,3,5,0,0,0,0,2,2,13,9,16,19,26.5
2023-24,202402220DEN,2/22/2024,DEN vs WAS,Bilal Coulibaly,coulibi01,54,WAS,0,DEN,4,1,2,1,1,0,32.03333333,0,1,2,6,0,3,0,1,1,2,3,6,5,7,14.2
2023-24,202402220IND,2/22/2024,IND vs DET,Andrew Nembhard,nembhan01,43,IND,1,DET,8,6,5,2,1,2,32.26666667,0,6,4,8,0,2,0,0,2,3,11,13,14,19,29.7
2023-24,202402220GSW,2/22/2024,GSW vs LAL,Anthony Davis,davisan02,54,LAL,0,GSW,27,15,1,0,3,3,32.51666667,3,12,11,19,0,2,5,6,3,3,16,28,42,43,52.5
2023-24,202402220TOR,2/22/2024,TOR vs BRK,Immanuel Quickley,quickim01,51,TOR,1,BRK,24,6,3,3,0,0,32.7,0,6,8,16,5,8,3,3,1,3,9,27,30,33,44.7
2023-24,202402220CHI,2/22/2024,CHI vs BOS,Jaylen Brown,brownja02,51,BOS,0,CHI,21,5,5,1,1,2,32.91666667,0,5,7,12,3,5,4,6,2,2,10,26,26,31,38.5
2023-24,202402220PHI,2/22/2024,PHI vs NYK,Buddy Hield,hieldbu01,58,PHI,1,NYK,14,2,6,1,1,2,32.91666667,0,2,5,15,4,9,0,0,2,2,8,20,16,22,29.4
2023-24,202402220OKC,2/22/2024,OKC vs LAC,Chet Holmgren,holmgch01,55,OKC,1,LAC,17,10,3,0,3,3,32.91666667,3,7,6,12,3,6,2,3,4,3,13,20,27,30,39.5
2023-24,202402220SAC,2/22/2024,SAC vs SAS,Domantas Sabonis,sabondo01,55,SAC,1,SAS,22,11,11,0,1,2,33.01666667,3,8,11,15,0,0,0,0,1,1,22,33,33,44,52.7
2023-24,202402220CLE,2/22/2024,CLE vs ORL,Max Strus,strusma01,54,CLE,1,ORL,18,4,6,1,1,4,33.1,3,1,7,10,1,3,3,4,4,2,10,24,22,28,33.8
2023-24,202402220CHI,2/22/2024,CHI vs BOS,Derrick White,whitede01,52,BOS,0,CHI,28,3,5,2,3,2,33.18333333,0,3,9,14,5,10,5,5,1,5,8,33,31,36,52.1
2023-24,202402220IND,2/22/2024,IND vs DET,Simone Fontecchio,fontesi01,54,DET,0,IND,14,1,0,0,0,1,33.23333333,0,1,6,12,2,6,0,0,1,0,1,14,15,15,14.2
2023-24,202402220PHI,2/22/2024,PHI vs NYK,Kelly Oubre Jr.,oubreke01,43,PHI,1,NYK,14,4,0,2,0,5,33.3,1,3,6,14,0,3,2,2,3,2,4,14,18,18,19.8
2023-24,202402220IND,2/22/2024,IND vs DET,Tyrese Haliburton,halibty01,45,IND,1,DET,25,2,13,2,0,5,33.58333333,0,2,10,18,4,10,1,1,0,2,15,38,27,40,47.9
2023-24,202402220CLE,2/22/2024,CLE vs ORL,Paolo Banchero,banchpa01,56,ORL,0,CLE,12,6,4,0,0,4,33.61666667,2,4,4,15,2,4,2,2,5,0,10,16,18,22,21.2
2023-24,202402220GSW,2/22/2024,GSW vs LAL,D'Angelo Russell,russeda01,53,LAL,0,GSW,18,5,9,2,0,3,33.66666667,0,5,6,15,3,9,3,4,3,2,14,27,23,32,40.5
2023-24,202402220CLE,2/22/2024,CLE vs ORL,Evan Mobley,mobleev01,31,CLE,1,ORL,14,8,6,2,2,1,34,1,7,5,9,0,1,4,4,3,4,14,20,22,28,43.6
2023-24,202402220UTA,2/22/2024,UTA vs CHO,Jordan Clarkson,clarkjo01,47,UTA,1,CHO,15,8,4,1,0,4,34.33333333,1,7,5,13,0,4,5,6,4,1,12,19,23,27,29.6
2023-24,202402220NOP,2/22/2024,NOP vs HOU,Trey Murphy III,murphtr02,31,NOP,1,HOU,13,3,1,3,3,1,34.36666667,0,3,4,12,2,10,3,6,3,6,4,14,16,17,35.1
2023-24,202402220CLE,2/22/2024,CLE vs ORL,Jarrett Allen,allenja01,49,CLE,1,ORL,18,10,1,2,0,2,34.41666667,2,8,6,10,0,0,6,8,1,2,11,19,28,29,35.5
2023-24,202402220OKC,2/22/2024,OKC vs LAC,Shai Gilgeous-Alexander,gilgesh01,54,OKC,1,LAC,31,4,8,1,2,2,34.55,0,4,12,19,3,6,4,6,1,3,12,39,35,43,54.8
2023-24,202402220PHI,2/22/2024,PHI vs NYK,Donte DiVincenzo,divindo01,55,NYK,0,PHI,16,3,3,2,2,2,34.63333333,0,3,6,15,4,11,0,0,1,4,6,19,19,22,34.1
2023-24,202402220CHI,2/22/2024,CHI vs BOS,Nikola Vucevic,vucevni01,51,CHI,1,BOS,22,14,2,0,0,4,34.63333333,5,9,10,19,0,3,2,2,2,0,16,24,36,38,37.8
2023-24,202402220SAC,2/22/2024,SAC vs SAS,Keegan Murray,murrake02,51,SAC,1,SAS,16,4,0,0,0,2,34.65,1,3,6,10,2,4,2,2,3,0,4,16,20,20,18.8
2023-24,202402220CHI,2/22/2024,CHI vs BOS,Jayson Tatum,tatumja01,53,BOS,0,CHI,25,7,5,3,0,3,34.91666667,0,7,8,17,5,10,4,6,3,3,12,30,32,37,46.9
2023-24,202402220NOP,2/22/2024,NOP vs HOU,Zion Williamson,willizi01,45,NOP,1,HOU,27,3,9,2,1,3,34.95,1,2,12,21,0,0,3,4,1,3,12,36,30,39,50.1
2023-24,202402220IND,2/22/2024,IND vs DET,Ausar Thompson,thompau01,55,DET,0,IND,11,7,5,2,3,0,35.1,3,4,5,10,0,2,1,4,2,5,12,16,18,23,41.9
2023-24,202402220CHI,2/22/2024,CHI vs BOS,Coby White,whiteco01,56,CHI,1,BOS,20,2,4,1,0,2,35.16666667,0,2,6,17,4,9,4,4,5,1,6,24,22,26,29.4
2023-24,202402220TOR,2/22/2024,TOR vs BRK,Mikal Bridges,bridgmi01,55,BRK,0,TOR,21,4,1,1,0,1,35.3,0,4,7,16,4,10,3,4,1,1,5,22,25,26,29.3
2023-24,202402220IND,2/22/2024,IND vs DET,Bennedict Mathurin,mathube01,54,IND,1,DET,15,6,5,1,0,2,35.31666667,3,3,5,14,1,3,4,5,2,1,11,20,21,26,30.7
2023-24,202402220DAL,2/22/2024,DAL vs PHO,Eric Gordon,gordoer01,48,PHO,0,DAL,16,1,1,2,1,1,35.35,0,1,5,10,4,7,2,3,3,3,2,17,17,18,26.7
2023-24,202402220CHI,2/22/2024,CHI vs BOS,DeMar DeRozan,derozde01,54,CHI,1,BOS,19,4,5,1,0,2,35.66666667,1,3,7,17,1,3,4,4,2,1,9,24,23,28,32.3
2023-24,202402220DAL,2/22/2024,DAL vs PHO,Kyrie Irving,irvinky01,34,DAL,1,PHO,29,5,3,1,0,1,35.68333333,1,4,11,18,5,8,2,2,2,1,8,32,34,37,41.5
2023-24,202402220OKC,2/22/2024,OKC vs LAC,Paul George,georgpa01,51,LAC,0,OKC,14,7,6,1,0,0,35.85,1,6,6,16,2,6,0,0,2,1,13,20,21,27,34.4
2023-24,202402220SAC,2/22/2024,SAC vs SAS,Jeremy Sochan,sochaje01,56,SAS,0,SAC,16,8,2,2,0,2,35.95,1,7,7,15,1,1,1,2,1,2,10,18,24,26,32.6
2023-24,202402220OKC,2/22/2024,OKC vs LAC,Jalen Williams,willija06,49,OKC,1,LAC,18,4,6,1,3,1,36.06666667,0,4,7,13,2,4,2,4,3,4,10,24,22,28,42.8
2023-24,202402220UTA,2/22/2024,UTA vs CHO,Lauri Markkanen,markkla01,47,UTA,1,CHO,21,9,6,0,0,2,36.68333333,1,8,5,14,2,9,9,10,2,0,15,27,30,36,38.8
2023-24,202402220SAC,2/22/2024,SAC vs SAS,Devin Vassell,vassede01,51,SAS,0,SAC,32,1,7,0,0,1,36.7,0,1,13,18,3,4,3,5,1,0,8,39,33,40,42.7
2023-24,202402220DAL,2/22/2024,DAL vs PHO,Grayson Allen,allengr01,50,PHO,0,DAL,10,5,2,0,0,1,36.75,1,4,2,3,2,2,4,4,3,0,7,12,15,17,18
2023-24,202402220NOP,2/22/2024,NOP vs HOU,Herbert Jones,joneshe01,51,NOP,1,HOU,17,5,4,7,0,1,36.8,1,4,6,9,3,5,2,3,4,7,9,21,22,26,49
2023-24,202402220CLE,2/22/2024,CLE vs ORL,Darius Garland,garlada01,30,CLE,1,ORL,18,2,10,2,0,4,37,0,2,6,12,3,5,3,5,2,2,12,28,20,30,37.4
2023-24,202402220SAC,2/22/2024,SAC vs SAS,De'Aaron Fox,foxde01,49,SAC,1,SAS,28,5,9,2,1,3,37.35,0,5,12,18,2,6,2,4,1,3,14,37,33,42,53.5
2023-24,202402220DAL,2/22/2024,DAL vs PHO,Luka Doncic,doncilu01,48,DAL,1,PHO,41,9,11,3,0,3,38.05,0,9,14,27,6,11,7,7,4,3,20,52,50,61,74.3
2023-24,202402220UTA,2/22/2024,UTA vs CHO,Brandon Miller,millebr02,49,CHO,0,UTA,16,3,5,4,0,1,38.15,0,3,6,16,3,9,1,1,3,4,8,21,19,24,38.1
2023-24,202402220PHI,2/22/2024,PHI vs NYK,Precious Achiuwa,achiupr01,49,NYK,0,PHI,18,11,2,2,1,2,38.21666667,4,7,7,9,1,2,3,7,3,3,13,20,29,31,41.2
2023-24,202402220DAL,2/22/2024,DAL vs PHO,Devin Booker,bookede01,46,PHO,0,DAL,35,5,8,1,0,4,39.3,1,4,13,21,2,6,7,8,2,1,13,43,40,48,52
2023-24,202402220PHI,2/22/2024,PHI vs NYK,Jalen Brunson,brunsja01,53,NYK,0,PHI,21,2,12,2,1,7,39.38333333,0,2,5,18,0,4,11,11,2,3,14,33,23,35,43.4
2023-24,202402220PHI,2/22/2024,PHI vs NYK,Tyrese Maxey,maxeyty01,50,PHI,1,NYK,35,6,5,0,0,4,39.56666667,1,5,11,24,4,11,9,9,1,0,11,40,41,46,45.7
2023-24,202402220DAL,2/22/2024,DAL vs PHO,Kevin Durant,duranke01,49,PHO,0,DAL,23,6,1,1,1,5,40.36666667,0,6,9,22,2,8,3,5,3,2,7,24,29,30,32.7
2023-24,202402220UTA,2/22/2024,UTA vs CHO,Miles Bridges,bridgmi02,44,CHO,0,UTA,26,14,4,0,0,1,40.5,3,11,10,20,4,6,2,4,3,0,18,30,40,44,47.8
2023-24,202402220CHI,2/22/2024,CHI vs BOS,Ayo Dosunmu,dosunay01,54,CHI,1,BOS,14,8,8,1,0,2,40.66666667,1,7,6,14,2,6,0,0,3,1,16,22,22,30,36.6
2023-24,202402220PHI,2/22/2024,PHI vs NYK,Josh Hart,hartjo01,55,NYK,0,PHI,18,12,3,0,1,3,44.21666667,1,11,7,13,2,5,2,2,2,1,15,21,30,33,36.9
2023-24,202402150UTA,2/15/2024,UTA vs GSW,Dario Saric,saricda01,51,GSW,0,UTA,7,3,2,0,0,1,10.06666667,1,2,2,4,1,3,2,2,2,0,5,9,10,12,12.6
2023-24,202402150MEM,2/15/2024,MEM vs MIL,Yuta Watanabe,watanyu01,31,MEM,1,MIL,0,1,1,0,0,0,11.1,0,1,0,2,0,1,0,0,0,0,2,1,1,2,2.7
2023-24,202402150POR,2/15/2024,POR vs MIN,Matisse Thybulle,thybuma01,52,POR,1,MIN,0,0,0,1,0,0,11.25,0,0,0,4,0,2,0,0,2,1,0,0,0,0,3
2023-24,202402150UTA,2/15/2024,UTA vs GSW,Kevon Looney,looneke01,53,GSW,0,UTA,0,2,3,0,1,0,11.38333333,2,0,0,1,0,0,0,0,2,1,5,3,2,5,9.9
2023-24,202402150POR,2/15/2024,POR vs MIN,Ibou Badji,badjiib01,17,POR,1,MIN,3,2,1,0,1,1,11.41666667,1,1,1,2,0,0,1,2,1,1,3,4,5,6,8.9
2023-24,202402150POR,2/15/2024,POR vs MIN,Kris Murray,murrakr01,34,POR,1,MIN,6,4,0,0,0,2,12,1,3,2,5,1,3,1,4,1,0,4,6,10,10,8.8
2023-24,202402150MEM,2/15/2024,MEM vs MIL,A.J. Green,greenaj01,36,MIL,0,MEM,6,1,1,1,0,1,14.08333333,0,1,2,4,2,4,0,0,2,1,2,7,7,8,10.7
2023-24,202402150MEM,2/15/2024,MEM vs MIL,Patrick Beverley,beverpa01,51,MIL,0,MEM,1,4,0,1,0,1,14.21666667,1,3,0,4,0,4,1,2,1,1,4,1,5,5,7.8
2023-24,202402150MEM,2/15/2024,MEM vs MIL,Jacob Gilyard,gilyaja01,37,MEM,1,MIL,0,1,5,1,0,1,15.01666667,0,1,0,3,0,1,0,0,0,1,6,5,1,6,10.7
2023-24,202402150UTA,2/15/2024,UTA vs GSW,Gary Payton II,paytoga02,20,GSW,0,UTA,4,3,0,2,1,1,15.08333333,2,1,2,3,0,0,0,0,2,3,3,4,7,7,15.6
2023-24,202402150POR,2/15/2024,POR vs MIN,Monte Morris,morrimo01,9,MIN,0,POR,12,1,3,1,0,1,15.4,0,1,5,8,1,4,1,1,0,1,4,15,13,16,19.7
2023-24,202402150UTA,2/15/2024,UTA vs GSW,Taylor Hendricks,hendrita0,17,UTA,1,GSW,3,3,0,2,0,2,15.98333333,1,2,1,1,1,1,0,0,0,2,3,3,6,6,10.6
2023-24,202402150UTA,2/15/2024,UTA vs GSW,Lester Quinones,quinole01,19,GSW,0,UTA,6,1,4,1,0,0,16.46666667,0,1,1,2,1,2,3,4,1,1,5,10,7,11,16.2
2023-24,202402150POR,2/15/2024,POR vs MIN,Duop Reath,reathdu01,40,POR,1,MIN,6,3,0,0,0,1,16.76666667,3,0,2,9,1,5,1,2,1,0,3,6,9,9,8.6
2023-24,202402150POR,2/15/2024,POR vs MIN,Toumani Camara,camarto01,53,POR,1,MIN,13,5,2,0,2,1,18.3,1,4,5,5,1,1,2,3,2,2,7,15,18,20,27
2023-24,202402150POR,2/15/2024,POR vs MIN,Dalano Banton,bantoda01,27,POR,1,MIN,4,2,0,2,0,1,18.33333333,0,2,1,4,0,0,2,4,1,2,2,4,6,6,11.4
2023-24,202402150POR,2/15/2024,POR vs MIN,Deandre Ayton,aytonde01,37,POR,1,MIN,2,4,3,3,1,1,19.81666667,0,4,1,5,0,0,0,0,6,4,7,5,6,9,22.3
2023-24,202402150POR,2/15/2024,POR vs MIN,Nickeil Alexander-Walker,alexani01,55,MIN,0,POR,2,2,1,0,0,1,20.7,0,2,1,6,0,4,0,0,3,0,3,3,4,5,4.9
2023-24,202402150POR,2/15/2024,POR vs MIN,Kyle Anderson,anderky01,55,MIN,0,POR,2,7,3,0,0,2,20.7,2,5,1,4,0,0,0,0,1,0,10,5,9,12,12.9
2023-24,202402150UTA,2/15/2024,UTA vs GSW,Kris Dunn,dunnkr01,48,UTA,1,GSW,8,5,1,2,0,3,20.95,1,4,2,3,2,3,2,2,2,2,6,9,13,14,18.5
2023-24,202402150POR,2/15/2024,POR vs MIN,Mike Conley,conlemi01,50,MIN,0,POR,12,4,3,1,0,0,22.3,2,2,3,6,2,4,4,4,1,1,7,15,16,19,24.3
2023-24,202402150POR,2/15/2024,POR vs MIN,Naz Reid,reidna01,55,MIN,0,POR,10,3,0,0,0,0,22.4,1,2,4,8,2,2,0,0,4,0,3,10,13,13,13.6
2023-24,202402150MEM,2/15/2024,MEM vs MIL,Trey Jemison,jemistr01,9,MEM,1,MIL,10,6,2,0,1,2,23.3,4,2,4,11,0,0,2,2,4,1,8,12,16,18,21.2
2023-24,202402150MEM,2/15/2024,MEM vs MIL,Pat Connaughton,connapa01,50,MIL,0,MEM,2,5,0,2,1,2,23.86666667,2,3,1,3,0,1,0,0,1,3,5,2,7,7,15
2023-24,202402150MEM,2/15/2024,MEM vs MIL,Jae Crowder,crowdja01,25,MIL,0,MEM,4,5,0,1,0,1,24.13333333,1,4,2,4,0,2,0,0,2,1,5,4,9,9,12
2023-24,202402150POR,2/15/2024,POR vs MIN,Jabari Walker,walkeja01,50,POR,1,MIN,8,4,1,1,0,0,24.41666667,1,3,3,6,0,1,2,2,1,1,5,9,12,13,17.3
2023-24,202402150UTA,2/15/2024,UTA vs GSW,Jonathan Kuminga,kuminjo01,52,GSW,0,UTA,13,5,4,0,1,2,24.46666667,1,4,5,6,0,0,3,4,1,1,9,17,18,22,26
2023-24,202402150MEM,2/15/2024,MEM vs MIL,Bobby Portis,portibo01,56,MIL,0,MEM,15,7,2,0,0,2,24.76666667,3,4,7,12,1,1,0,0,1,0,9,17,22,24,24.4
2023-24,202402150UTA,2/15/2024,UTA vs GSW,Walker Kessler,kesslwa01,48,UTA,1,GSW,4,6,2,1,1,1,25.31666667,3,3,1,2,0,1,2,2,3,2,8,6,10,12,19.2
2023-24,202402150POR,2/15/2024,POR vs MIN,Rudy Gobert,goberru01,54,MIN,0,POR,11,12,2,0,2,3,26.31666667,2,10,4,7,0,0,3,4,4,2,14,13,23,25,31.4
2023-24,202402150POR,2/15/2024,POR vs MIN,Jaden McDaniels,mcdanja02,45,MIN,0,POR,17,5,1,2,0,2,28,1,4,6,11,1,4,4,4,2,2,6,18,22,23,28.5
2023-24,202402150UTA,2/15/2024,UTA vs GSW,Klay Thompson,thompkl01,50,GSW,0,UTA,35,6,2,0,0,0,28.05,0,6,13,22,7,13,2,2,0,0,8,37,41,43,45.2
2023-24,202402150UTA,2/15/2024,UTA vs GSW,Andrew Wiggins,wiggian01,48,GSW,0,UTA,19,7,2,0,0,3,28.63333333,3,4,7,12,3,4,2,2,2,0,9,21,26,28,27.4
2023-24,202402150UTA,2/15/2024,UTA vs GSW,Draymond Green,greendr01,29,GSW,0,UTA,23,5,5,4,2,0,28.81666667,0,5,9,14,3,5,2,4,4,6,10,28,28,33,54.5
2023-24,202402150MEM,2/15/2024,MEM vs MIL,Lamar Stevens,stevela01,22,MEM,1,MIL,13,5,1,1,0,3,28.83333333,0,5,6,10,1,1,0,3,1,1,6,14,18,19,20.5
2023-24,202402150MEM,2/15/2024,MEM vs MIL,Jordan Goodwin,goodwjo01,42,MEM,1,MIL,11,7,3,2,0,2,28.93333333,2,5,5,12,1,3,0,0,1,2,10,14,18,21,27.9
2023-24,202402150POR,2/15/2024,POR vs MIN,Karl-Anthony Towns,townska01,54,MIN,0,POR,23,8,1,1,2,3,29.73333333,2,6,8,13,1,2,6,6,3,3,9,24,31,32,40.1
2023-24,202402150MEM,2/15/2024,MEM vs MIL,Malik Beasley,beaslma01,54,MIL,0,MEM,9,2,0,2,0,0,29.75,0,2,3,10,3,10,0,0,4,2,2,9,11,11,17.4
2023-24,202402150MEM,2/15/2024,MEM vs MIL,GG Jackson II,jacksgg01,23,MEM,1,MIL,27,1,0,0,1,3,29.83333333,0,1,10,17,6,10,1,3,3,1,1,27,28,28,28.2
2023-24,202402150UTA,2/15/2024,UTA vs GSW,John Collins,collijo01,52,UTA,1,GSW,18,13,2,1,1,1,30.58333333,4,9,8,14,1,3,1,1,4,2,15,20,31,33,41.6
2023-24,202402150POR,2/15/2024,POR vs MIN,Scoot Henderson,hendesc01,43,POR,1,MIN,15,1,4,1,0,3,31.11666667,0,1,5,12,0,4,5,6,1,1,5,19,16,20,22.2
2023-24,202402150MEM,2/15/2024,MEM vs MIL,Santi Aldama,aldamsa01,44,MEM,1,MIL,7,3,7,0,1,1,32.51666667,0,3,3,4,1,1,0,0,1,1,10,14,10,17,23.1
2023-24,202402150POR,2/15/2024,POR vs MIN,Anthony Edwards,edwaran01,52,MIN,0,POR,34,6,7,2,1,1,32.61666667,1,5,12,21,3,7,7,8,1,3,13,41,40,47,59.7
2023-24,202402150POR,2/15/2024,POR vs MIN,Anfernee Simons,simonan01,31,POR,1,MIN,12,5,6,0,0,5,32.78333333,0,5,4,15,3,8,1,1,5,0,11,18,17,23,22
2023-24,202402150POR,2/15/2024,POR vs MIN,Jerami Grant,grantje01,47,POR,1,MIN,20,2,0,0,1,0,33.23333333,1,1,6,14,2,4,6,6,2,1,2,20,22,22,25.4
2023-24,202402150UTA,2/15/2024,UTA vs GSW,Jordan Clarkson,clarkjo01,46,UTA,1,GSW,13,2,9,0,0,3,33.31666667,2,0,3,8,1,5,6,7,2,0,11,22,15,24,25.9
2023-24,202402150UTA,2/15/2024,UTA vs GSW,Brandin Podziemski,podzibr01,47,GSW,0,UTA,13,6,8,0,0,2,33.76666667,3,3,5,12,3,7,0,0,1,0,14,21,19,27,30.2
2023-24,202402150UTA,2/15/2024,UTA vs GSW,Collin Sexton,sextoco01,56,UTA,1,GSW,35,3,9,1,1,3,33.86666667,1,2,10,18,3,8,12,13,2,2,12,44,38,47,55.1
2023-24,202402150UTA,2/15/2024,UTA vs GSW,Lauri Markkanen,markkla01,46,UTA,1,GSW,20,14,3,0,0,1,33.95,5,9,6,23,4,11,4,4,1,0,17,23,34,37,40.3
2023-24,202402150MEM,2/15/2024,MEM vs MIL,Vince Williams Jr.,willivi01,44,MEM,1,MIL,18,12,7,2,0,2,34.1,1,11,7,11,0,2,4,4,5,2,19,25,30,37,46.9
2023-24,202402150MEM,2/15/2024,MEM vs MIL,Brook Lopez,lopezbr01,53,MIL,0,MEM,14,11,2,2,4,1,34.61666667,2,9,5,14,2,9,2,2,2,6,13,16,25,27,47.2
2023-24,202402150MEM,2/15/2024,MEM vs MIL,Damian Lillard,lillada01,51,MIL,0,MEM,24,5,7,1,0,4,34.96666667,2,3,7,21,3,13,7,7,2,1,12,31,29,36,39.5
2023-24,202402150UTA,2/15/2024,UTA vs GSW,Stephen Curry,curryst01,50,GSW,0,UTA,16,2,10,1,0,4,35.46666667,1,1,4,14,2,8,6,8,2,1,12,26,18,28,32.4
2023-24,202402150MEM,2/15/2024,MEM vs MIL,Ziaire Williams,willizi02,46,MEM,1,MIL,27,4,4,3,0,2,36.36666667,0,4,9,13,4,7,5,7,1,3,8,31,31,35,44.8
2023-24,202402150MEM,2/15/2024,MEM vs MIL,Giannis Antetokounmpo,antetgi01,54,MIL,0,MEM,35,4,12,0,0,1,36.61666667,0,4,15,17,0,0,5,9,5,0,16,47,39,51,56.8
2023-24,202402150UTA,2/15/2024,UTA vs GSW,Keyonte George,georgke01,50,UTA,1,GSW,33,2,6,3,0,2,40.55,0,2,11,22,9,16,2,3,6,3,8,39,35,41,51.4
2023-24,202402140BOS,2/14/2024,BOS vs BRK,Lonnie Walker IV,walkelo01,34,BRK,0,BOS,4,2,1,0,0,1,10.13333333,1,1,2,7,0,2,0,0,1,0,3,5,6,7,6.9
2023-24,202402140PHI,2/14/2024,PHI vs MIA,Jamal Cain,cainja01,16,MIA,0,PHI,2,1,1,1,0,1,10.25,0,1,0,2,0,1,2,2,0,1,2,3,3,4,6.7
2023-24,202402140PHO,2/14/2024,PHO vs DET,David Roddy,roddyda01,49,PHO,1,DET,5,1,0,0,0,1,10.26666667,0,1,2,3,1,2,0,0,1,0,1,5,6,6,5.2
2023-24,202402140TOR,2/14/2024,TOR vs IND,Chris Boucher,bouchch01,46,TOR,1,IND,10,4,0,1,1,0,10.9,2,2,4,5,0,1,2,4,2,2,4,10,14,14,20.8
2023-24,202402140NOP,2/14/2024,NOP vs WAS,Richaun Holmes,holmeri01,25,WAS,0,NOP,2,1,1,1,0,0,10.98333333,0,1,1,2,0,0,0,0,0,1,2,3,3,4,7.7
2023-24,202402140GSW,2/14/2024,GSW vs LAC,Kevon Looney,looneke01,52,GSW,1,LAC,4,2,1,0,0,0,11.26666667,0,2,1,1,0,0,2,2,0,0,3,5,6,7,7.9
2023-24,202402140UTA,2/14/2024,UTA vs LAL,Jaxson Hayes,hayesja02,46,LAL,0,UTA,4,0,1,2,0,0,11.66666667,0,0,2,2,0,0,0,0,1,2,1,5,4,5,11.5
2023-24,202402140PHO,2/14/2024,PHO vs DET,Troy Brown Jr.,browntr01,40,DET,0,PHO,5,5,0,1,0,1,11.7,0,5,2,4,1,2,0,0,1,1,5,5,10,10,13
2023-24,202402140PHI,2/14/2024,PHI vs MIA,Kevin Love,loveke01,44,MIA,0,PHI,2,6,1,0,0,0,11.76666667,1,5,1,2,0,1,0,0,1,0,7,3,8,9,10.7
2023-24,202402140BOS,2/14/2024,BOS vs BRK,Keita Bates-Diop,bateske01,41,BRK,0,BOS,7,1,0,1,0,1,12,0,1,3,4,1,1,0,0,0,1,1,7,8,8,10.2
2023-24,202402140BOS,2/14/2024,BOS vs BRK,Keon Johnson,johnske07,3,BRK,0,BOS,9,1,2,0,0,1,12,0,1,2,5,1,3,4,4,0,0,3,11,10,12,12.2
2023-24,202402140DEN,2/14/2024,DEN vs SAC,Trey Lyles,lylestr01,39,SAC,0,DEN,4,5,0,1,0,0,12.13333333,1,4,2,5,0,3,0,0,1,1,5,4,9,9,13
2023-24,202402140PHO,2/14/2024,PHO vs DET,James Wiseman,wisemja01,35,DET,0,PHO,3,2,0,1,0,2,12.15,1,1,1,3,0,0,1,1,6,1,2,3,5,5,6.4
2023-24,202402140BOS,2/14/2024,BOS vs BRK,Day'Ron Sharpe,sharpda01,39,BRK,0,BOS,7,3,2,1,0,2,13.03333333,2,1,2,2,1,1,2,2,2,1,5,9,10,12,14.6
2023-24,202402140BOS,2/14/2024,BOS vs BRK,Neemias Queta,quetane01,23,BOS,1,BRK,8,4,0,1,0,1,13.21666667,2,2,4,6,0,0,0,0,3,1,4,8,12,12,14.8
2023-24,202402140CHO,2/14/2024,CHO vs ATL,Davis Bertans,bertada01,18,CHO,1,ATL,3,1,1,0,0,0,13.25,0,1,1,4,1,4,0,0,1,0,2,4,4,5,5.7
2023-24,202402140ORL,2/14/2024,ORL vs NYK,Moritz Wagner,wagnemo01,53,ORL,1,NYK,10,2,1,1,1,2,13.26666667,0,2,4,5,0,0,2,2,2,2,3,11,12,13,17.9
2023-24,202402140BOS,2/14/2024,BOS vs BRK,Svi Mykhailiuk,mykhasv01,23,BOS,1,BRK,2,0,0,0,0,1,13.35,0,0,1,2,0,0,0,0,1,0,0,2,2,2,1
2023-24,202402140PHO,2/14/2024,PHO vs DET,Bol Bol,bolbo01,18,PHO,1,DET,9,5,1,0,2,0,13.95,1,4,4,5,1,1,0,0,2,2,6,10,14,15,22.5
2023-24,202402140PHI,2/14/2024,PHI vs MIA,Nikola Jovic,jovicni01,22,MIA,0,PHI,3,3,3,0,0,2,14.1,0,3,1,2,1,2,0,0,4,0,6,6,6,9,9.1
2023-24,202402140GSW,2/14/2024,GSW vs LAC,Gary Payton II,paytoga02,19,GSW,1,LAC,2,2,3,0,0,0,14.25,0,2,1,2,0,1,0,0,2,0,5,5,4,7,8.9
2023-24,202402140BOS,2/14/2024,BOS vs BRK,Dorian Finney-Smith,finnedo01,45,BRK,0,BOS,4,1,0,0,0,0,14.33333333,0,1,1,4,0,2,2,2,1,0,1,4,5,5,5.2
2023-24,202402140ORL,2/14/2024,ORL vs NYK,Jonathan Isaac,isaacjo01,37,ORL,1,NYK,8,5,2,0,1,2,14.53333333,3,2,4,5,0,0,0,0,1,1,7,10,13,15,18
2023-24,202402140PHO,2/14/2024,PHO vs DET,Jaden Ivey,iveyja01,50,DET,0,PHO,2,0,0,1,0,2,14.63333333,0,0,0,6,0,4,2,2,3,1,0,2,2,2,3
2023-24,202402140PHO,2/14/2024,PHO vs DET,Mike Muscala,muscami01,37,DET,0,PHO,3,3,2,1,0,0,14.96666667,2,1,1,6,0,3,1,2,1,1,5,5,6,8,12.6
2023-24,202402140MEM,2/14/2024,MEM vs HOU,Nate Hinton,hintona01,11,HOU,0,MEM,10,3,2,1,1,0,15.01666667,1,2,3,5,2,3,2,3,2,2,5,12,13,15,22.6
2023-24,202402140MEM,2/14/2024,MEM vs HOU,Jae'Sean Tate,tateja01,51,HOU,0,MEM,7,6,1,1,0,1,15.35,4,2,2,7,1,1,2,4,2,1,7,8,13,14,17.7
2023-24,202402140NOP,2/14/2024,NOP vs WAS,Jonas Valanciunas,valanjo01,55,NOP,1,WAS,10,5,3,0,1,1,15.46666667,2,3,5,6,0,0,0,0,1,1,8,13,15,18,22.5
2023-24,202402140DEN,2/14/2024,DEN vs SAC,Peyton Watson,watsope01,53,DEN,1,SAC,3,4,1,1,1,2,15.63333333,1,3,1,4,1,1,0,0,2,2,5,4,7,8,13.3
2023-24,202402140UTA,2/14/2024,UTA vs LAL,Talen Horton-Tucker,hortota01,35,UTA,1,LAL,7,2,4,0,0,1,15.9,1,1,2,5,1,4,2,2,1,0,6,11,9,13,14.4
2023-24,202402140BOS,2/14/2024,BOS vs BRK,Kristaps Porzingis,porzikr01,40,BOS,1,BRK,15,5,1,0,1,1,16.11666667,0,5,6,9,3,4,0,0,0,1,6,16,20,21,24.5
2023-24,202402140MEM,2/14/2024,MEM vs HOU,Derrick Rose,rosede01,21,MEM,1,HOU,8,4,3,0,0,0,16.16666667,0,4,3,6,0,1,2,3,1,0,7,11,12,15,17.3
2023-24,202402140UTA,2/14/2024,UTA vs LAL,Taylor Hendricks,hendrita0,16,UTA,1,LAL,9,5,1,0,0,0,16.18333333,2,3,4,9,1,6,0,0,2,0,6,10,14,15,16.5
2023-24,202402140UTA,2/14/2024,UTA vs LAL,Christian Wood,woodch01,50,LAL,0,UTA,2,4,1,0,0,1,16.23333333,1,3,1,5,0,4,0,0,3,0,5,3,6,7,7.3
2023-24,202402140MEM,2/14/2024,MEM vs HOU,Jeff Green,greenje02,52,HOU,0,MEM,10,4,0,0,0,0,16.28333333,1,3,3,7,0,2,4,4,0,0,4,10,14,14,14.8
2023-24,202402140CHO,2/14/2024,CHO vs ATL,Garrison Mathews,mathega01,39,ATL,0,CHO,0,0,0,1,0,0,16.35,0,0,0,3,0,3,0,0,1,1,0,0,0,0,3
2023-24,202402140TOR,2/14/2024,TOR vs IND,T.J. McConnell,mccontj01,46,IND,0,TOR,6,1,6,1,0,3,16.35,0,1,3,8,0,0,0,0,1,1,7,12,7,13,16.2
2023-24,202402140GSW,2/14/2024,GSW vs LAC,Mason Plumlee,plumlma01,23,LAC,0,GSW,8,6,3,1,0,1,16.48333333,2,4,3,6,0,0,2,3,3,1,9,11,14,17,21.7
2023-24,202402140TOR,2/14/2024,TOR vs IND,Aaron Nesmith,nesmiaa01,52,IND,0,TOR,8,2,1,0,2,0,16.7,0,2,3,10,2,7,0,0,2,2,3,9,10,11,17.9
2023-24,202402140NOP,2/14/2024,NOP vs WAS,Landry Shamet,shamela01,37,WAS,0,NOP,8,2,1,0,0,2,16.86666667,2,0,2,8,0,4,4,4,0,0,3,9,10,11,9.9
2023-24,202402140CHO,2/14/2024,CHO vs ATL,Seth Curry,curryse01,39,CHO,1,ATL,9,0,1,0,0,0,17.1,0,0,4,8,1,4,0,0,0,0,1,10,9,10,10.5
2023-24,202402140DAL,2/14/2024,DAL vs SAS,Dereck Lively II,livelde01,37,DAL,1,SAS,8,5,1,0,4,0,17.13333333,1,4,3,5,0,0,2,2,0,4,6,9,13,14,27.5
2023-24,202402140UTA,2/14/2024,UTA vs LAL,Kris Dunn,dunnkr01,47,UTA,1,LAL,12,1,3,1,0,0,17.35,1,0,5,6,1,2,1,1,3,1,4,15,13,16,20.7
2023-24,202402140ORL,2/14/2024,ORL vs NYK,Jacob Toppin,toppija01,5,NYK,0,ORL,11,4,0,0,0,1,17.36666667,2,2,4,7,1,3,2,2,3,0,4,11,15,15,14.8
2023-24,202402140DAL,2/14/2024,DAL vs SAS,Cedi Osman,osmande01,55,SAS,0,DAL,0,1,3,0,0,0,17.58333333,0,1,0,1,0,1,0,0,1,0,4,3,1,4,5.7
2023-24,202402140BOS,2/14/2024,BOS vs BRK,Cameron Johnson,johnsca02,41,BRK,0,BOS,4,3,2,0,1,1,17.71666667,0,3,1,5,1,3,1,2,0,1,5,6,7,9,12.6
2023-24,202402140BOS,2/14/2024,BOS vs BRK,Dennis Schroder,schrode01,54,BRK,0,BOS,4,3,1,0,0,1,17.83333333,0,3,2,8,0,1,0,0,1,0,4,5,7,8,8.1
2023-24,202402140PHO,2/14/2024,PHO vs DET,Josh Okogie,okogijo01,49,PHO,1,DET,2,2,0,1,1,0,18,1,1,0,3,0,2,2,2,1,2,2,2,4,4,10.4
2023-24,202402140DEN,2/14/2024,DEN vs SAC,Collin Gillespie,gilleco01,18,DEN,1,SAC,3,3,1,2,0,2,18.01666667,0,3,1,5,1,2,0,0,4,2,4,4,6,7,12.1
2023-24,202402140DAL,2/14/2024,DAL vs SAS,Josh Green,greenjo02,42,DAL,1,SAS,8,3,2,0,0,0,18.08333333,1,2,3,4,2,2,0,0,2,0,5,10,11,13,14.6
2023-24,202402140BOS,2/14/2024,BOS vs BRK,Dennis Smith Jr.,smithde03,38,BRK,0,BOS,7,0,5,1,0,1,18.16666667,0,0,3,7,1,4,0,0,2,1,5,12,7,12,16.5
2023-24,202402140BOS,2/14/2024,BOS vs BRK,Jordan Walsh,walshjo01,4,BOS,1,BRK,0,5,0,1,1,2,18.16666667,1,4,0,3,0,2,0,0,3,2,5,0,5,5,10
2023-24,202402140DAL,2/14/2024,DAL vs SAS,Julian Champagnie,champju02,48,SAS,0,DAL,5,2,1,1,0,0,18.2,0,2,2,4,1,3,0,0,0,1,3,6,7,8,11.9
2023-24,202402140PHO,2/14/2024,PHO vs DET,Drew Eubanks,eubandr01,49,PHO,1,DET,6,6,0,2,1,2,18.31666667,3,3,3,8,0,0,0,0,0,3,6,6,12,12,20.2
2023-24,202402140BOS,2/14/2024,BOS vs BRK,Luke Kornet,kornelu01,39,BOS,1,BRK,8,8,3,1,3,0,18.55,4,4,4,5,0,0,0,0,2,4,11,11,16,19,34.1
2023-24,202402140NOP,2/14/2024,NOP vs WAS,Larry Nance Jr.,nancela02,37,NOP,1,WAS,4,6,3,3,1,2,18.9,3,3,1,2,1,2,1,2,1,4,9,7,10,13,25.7
2023-24,202402140DAL,2/14/2024,DAL vs SAS,Derrick Jones Jr.,jonesde02,50,DAL,1,SAS,0,3,0,0,0,1,19,1,2,0,2,0,1,0,0,0,0,3,0,3,3,2.6
2023-24,202402140BOS,2/14/2024,BOS vs BRK,Jalen Wilson,wilsoja03,16,BRK,0,BOS,4,1,2,0,0,0,19.3,0,1,2,5,0,1,0,0,0,0,3,6,5,7,8.2
2023-24,202402140BOS,2/14/2024,BOS vs BRK,Oshae Brissett,brissos01,36,BOS,1,BRK,11,4,5,1,0,0,19.53333333,0,4,3,6,1,3,4,5,1,1,9,16,15,20,26.3
2023-24,202402140ORL,2/14/2024,ORL vs NYK,Joe Ingles,inglejo01,41,ORL,1,NYK,6,2,5,1,1,0,19.83333333,0,2,2,3,2,3,0,0,2,2,7,11,8,13,21.9
2023-24,202402140CHO,2/14/2024,CHO vs ATL,Vasilije Micic,micicva01,33,CHO,1,ATL,13,2,5,0,0,1,19.96666667,0,2,4,9,1,3,4,4,3,0,7,18,15,20,21.9
2023-24,202402140MEM,2/14/2024,MEM vs HOU,John Konchar,konchjo01,44,MEM,1,HOU,8,3,2,1,2,2,20,0,3,3,4,2,2,0,0,3,3,5,10,11,13,21.6
2023-24,202402140DAL,2/14/2024,DAL vs SAS,Tre Jones,jonestr01,50,SAS,0,DAL,4,4,2,0,0,0,20.16666667,0,4,2,8,0,4,0,0,2,0,6,6,8,10,11.8
2023-24,202402140DAL,2/14/2024,DAL vs SAS,Jaden Hardy,hardyja02,50,DAL,1,SAS,13,2,1,0,1,0,20.21666667,0,2,6,12,1,3,0,0,0,1,3,14,15,16,19.9
2023-24,202402140MEM,2/14/2024,MEM vs HOU,Lamar Stevens,stevela01,21,MEM,1,HOU,14,8,1,0,2,0,20.25,1,7,4,8,1,1,5,6,1,2,9,15,22,23,31.1
2023-24,202402140DAL,2/14/2024,DAL vs SAS,Keldon Johnson,johnske04,51,SAS,0,DAL,3,2,0,0,1,1,20.3,0,2,1,11,1,8,0,0,1,1,2,3,5,5,7.4
2023-24,202402140PHO,2/14/2024,PHO vs DET,Simone Fontecchio,fontesi01,53,DET,0,PHO,18,1,1,2,0,0,20.61666667,0,1,7,15,2,7,2,2,3,2,2,19,19,20,26.7
2023-24,202402140BOS,2/14/2024,BOS vs BRK,Nic Claxton,claxtni01,44,BRK,0,BOS,6,8,3,0,0,1,20.71666667,2,6,3,6,0,0,0,0,0,0,11,9,14,17,19.1
2023-24,202402140DAL,2/14/2024,DAL vs SAS,Malaki Branham,branhma01,50,SAS,0,DAL,19,3,1,0,0,1,20.78333333,1,2,7,11,4,5,1,1,0,0,4,20,22,23,23.1
2023-24,202402140DAL,2/14/2024,DAL vs SAS,Zach Collins,colliza01,43,SAS,0,DAL,6,12,4,0,3,1,20.8,5,7,3,9,0,4,0,0,2,3,16,10,18,22,34.4
2023-24,202402140TOR,2/14/2024,TOR vs IND,Ben Sheppard,sheppbe01,34,IND,0,TOR,10,5,0,1,0,1,20.93333333,0,5,3,6,2,4,2,2,1,1,5,10,15,15,18
2023-24,202402140TOR,2/14/2024,TOR vs IND,Gradey Dick,dickgr01,34,TOR,1,IND,7,1,1,1,0,1,21.01666667,0,1,3,7,1,4,0,0,2,1,2,8,8,9,11.7
2023-24,202402140CLE,2/14/2024,CLE vs CHI,Torrey Craig,craigto01,33,CHI,0,CLE,8,5,0,0,1,0,21.61666667,0,5,3,6,2,5,0,0,0,1,5,8,13,13,17
2023-24,202402140MEM,2/14/2024,MEM vs HOU,Ziaire Williams,willizi02,45,MEM,1,HOU,5,2,2,1,0,0,21.68333333,0,2,2,6,0,2,1,1,1,1,4,7,7,9,13.4
2023-24,202402140MEM,2/14/2024,MEM vs HOU,Santi Aldama,aldamsa01,43,MEM,1,HOU,7,5,4,1,1,0,21.71666667,2,3,2,7,1,6,2,4,3,2,9,11,12,16,25
2023-24,202402140NOP,2/14/2024,NOP vs WAS,Jose Alvarado,alvarjo01,37,NOP,1,WAS,7,3,3,2,0,0,21.71666667,0,3,3,7,0,4,1,1,2,2,6,10,10,13,21.1
2023-24,202402140PHI,2/14/2024,PHI vs MIA,Cameron Payne,payneca01,51,PHI,1,MIA,2,3,3,0,0,0,21.98333333,1,2,1,7,0,5,0,0,1,0,6,5,5,8,10.1
2023-24,202402140PHO,2/14/2024,PHO vs DET,Jusuf Nurkic,nurkiju01,52,PHO,1,DET,10,13,7,0,2,4,22.36666667,1,12,2,2,0,0,6,10,4,2,20,17,23,30,38.1
2023-24,202402140PHO,2/14/2024,PHO vs DET,Shake Milton,miltosh01,41,DET,0,PHO,13,9,2,1,1,2,22.5,4,5,4,10,3,6,2,3,0,2,11,15,22,24,30.8
2023-24,202402140PHI,2/14/2024,PHI vs MIA,Ricky Council IV,councri01,14,PHI,1,MIA,13,4,2,0,0,1,22.66666667,0,4,5,10,1,4,2,2,1,0,6,15,17,19,19.8
2023-24,202402140MEM,2/14/2024,MEM vs HOU,Jalen Green,greenja05,54,HOU,0,MEM,4,3,3,0,1,0,22.7,0,3,2,7,0,4,0,0,1,1,6,7,7,10,15.1
2023-24,202402140DAL,2/14/2024,DAL vs SAS,Daniel Gafford,gaffoda01,48,DAL,1,SAS,10,10,2,0,1,2,22.95,2,8,5,7,0,0,0,0,4,1,12,12,20,22,26
2023-24,202402140DEN,2/14/2024,DEN vs SAC,Christian Braun,braunch01,55,DEN,1,SAC,5,3,2,1,1,0,23.41666667,2,1,1,6,1,2,2,4,3,2,5,7,8,10,17.6
2023-24,202402140ORL,2/14/2024,ORL vs NYK,Anthony Black,blackan01,50,ORL,1,NYK,4,2,2,1,0,1,23.43333333,2,0,2,7,0,2,0,0,4,1,4,6,6,8,11.4
2023-24,202402140CLE,2/14/2024,CLE vs CHI,Caris LeVert,leverca01,43,CLE,1,CHI,5,4,9,0,0,1,23.43333333,1,3,2,7,1,3,0,0,2,0,13,14,9,18,22.3
2023-24,202402140TOR,2/14/2024,TOR vs IND,Doug McDermott,mcderdo01,49,IND,0,TOR,13,1,0,0,0,1,23.43333333,1,0,5,12,3,9,0,0,0,0,1,13,14,14,13.2
2023-24,202402140PHO,2/14/2024,PHO vs DET,Jalen Duren,durenja01,39,DET,0,PHO,7,9,5,2,0,1,23.48333333,3,6,2,6,0,0,3,4,3,2,14,12,16,21,30.3
2023-24,202402140PHO,2/14/2024,PHO vs DET,Royce O'Neale,onealro01,52,PHO,1,DET,9,7,3,2,0,1,23.5,0,7,3,6,3,6,0,0,1,2,10,12,16,19,26.9
2023-24,202402140PHO,2/14/2024,PHO vs DET,Marcus Sasser,sassema01,49,DET,0,PHO,4,1,6,0,0,3,23.63333333,0,1,2,7,0,4,0,0,4,0,7,10,5,11,11.2
2023-24,202402140PHO,2/14/2024,PHO vs DET,Saben Lee,leesa01,13,PHO,1,DET,16,6,2,4,0,2,23.65,0,6,4,9,0,3,8,12,0,4,8,18,22,24,36.2
2023-24,202402140GSW,2/14/2024,GSW vs LAC,Amir Coffey,coffeam01,41,LAC,0,GSW,14,6,0,0,0,1,23.7,1,5,4,7,2,4,4,4,3,0,6,14,20,20,20.2
2023-24,202402140NOP,2/14/2024,NOP vs WAS,Naji Marshall,marshna01,44,NOP,1,WAS,13,2,1,3,0,3,23.95,0,2,6,8,1,3,0,0,2,3,3,14,15,16,22.9
2023-24,202402140BOS,2/14/2024,BOS vs BRK,Jrue Holiday,holidjr01,50,BOS,1,BRK,3,4,5,0,0,0,24.06666667,1,3,1,3,1,2,0,0,0,0,9,8,7,12,15.3
2023-24,202402140MEM,2/14/2024,MEM vs HOU,Jordan Goodwin,goodwjo01,41,MEM,1,HOU,10,3,3,1,1,0,24.08333333,1,2,4,8,1,2,1,4,1,2,6,13,13,16,24.1
2023-24,202402140MEM,2/14/2024,MEM vs HOU,GG Jackson II,jacksgg01,22,MEM,1,HOU,20,9,0,0,3,1,24.18333333,3,6,8,15,3,5,1,2,2,3,9,20,29,29,38.8
2023-24,202402140PHO,2/14/2024,PHO vs DET,Eric Gordon,gordoer01,47,PHO,1,DET,13,1,2,2,2,3,24.35,1,0,4,9,2,6,3,3,1,4,3,15,14,16,26.2
2023-24,202402140CLE,2/14/2024,CLE vs CHI,Georges Niang,niangge01,53,CLE,1,CHI,11,2,0,0,0,3,24.4,0,2,5,9,1,5,0,2,6,0,2,11,13,13,10.4
2023-24,202402140ORL,2/14/2024,ORL vs NYK,Wendell Carter Jr.,cartewe01,29,ORL,1,NYK,9,6,1,0,1,0,24.46666667,1,5,4,5,0,1,1,2,2,1,7,10,15,16,20.7
2023-24,202402140ORL,2/14/2024,ORL vs NYK,Cole Anthony,anthoco01,54,ORL,1,NYK,11,2,1,0,2,1,24.93333333,0,2,5,8,0,1,1,1,1,2,3,12,13,14,19.9
2023-24,202402140DAL,2/14/2024,DAL vs SAS,Jeremy Sochan,sochaje01,55,SAS,0,DAL,10,4,1,3,0,2,24.98333333,3,1,4,10,1,2,1,2,2,3,5,11,14,15,23.3
2023-24,202402140BOS,2/14/2024,BOS vs BRK,Cam Thomas,thomaca02,45,BRK,0,BOS,5,1,2,1,0,1,25.11666667,0,1,1,9,1,5,2,2,1,1,3,7,6,8,11.2
2023-24,202402140PHI,2/14/2024,PHI vs MIA,Caleb Martin,martica02,38,MIA,0,PHI,8,1,3,2,0,1,25.18333333,1,0,3,9,0,4,2,2,2,2,4,11,9,12,18.7
2023-24,202402140TOR,2/14/2024,TOR vs IND,Obi Toppin,toppiob01,57,IND,0,TOR,15,5,0,2,2,0,25.3,2,3,6,9,2,5,1,2,1,4,5,15,20,20,33
2023-24,202402140ORL,2/14/2024,ORL vs NYK,Caleb Houstan,houstca01,40,ORL,1,NYK,6,1,0,0,0,1,25.4,1,0,2,3,2,2,0,0,1,0,1,6,7,7,6.2
2023-24,202402140BOS,2/14/2024,BOS vs BRK,Trendon Watford,watfotr01,38,BRK,0,BOS,15,2,1,0,0,0,25.55,0,2,5,7,2,2,3,3,4,0,3,16,17,18,18.9
2023-24,202402140DEN,2/14/2024,DEN vs SAC,Kevin Huerter,huertke01,52,SAC,0,DEN,8,5,2,1,2,0,25.6,1,4,3,7,2,6,0,0,1,3,7,10,13,15,26
2023-24,202402140CLE,2/14/2024,CLE vs CHI,Alex Caruso,carusal01,47,CHI,0,CLE,10,2,3,2,1,1,25.78333333,0,2,3,6,2,4,2,2,2,3,5,13,12,15,24.9
2023-24,202402140CHO,2/14/2024,CHO vs ATL,Bruno Fernando,fernabr01,18,ATL,0,CHO,6,12,1,1,1,0,25.81666667,3,9,2,5,0,0,2,2,5,2,13,7,18,19,27.9
2023-24,202402140PHO,2/14/2024,PHO vs DET,Evan Fournier,fournev01,5,DET,0,PHO,10,4,1,1,1,3,25.81666667,1,3,4,12,2,7,0,0,2,2,5,11,14,15,19.3
2023-24,202402140PHO,2/14/2024,PHO vs DET,Cade Cunningham,cunnica01,44,DET,0,PHO,13,4,8,1,2,5,25.83333333,1,3,5,11,0,1,3,5,3,3,12,21,17,25,33.8
2023-24,202402140UTA,2/14/2024,UTA vs LAL,Collin Sexton,sextoco01,55,UTA,1,LAL,18,0,3,0,2,0,26.08333333,0,0,8,15,2,5,0,0,1,2,3,21,18,21,28.5
2023-24,202402140BOS,2/14/2024,BOS vs BRK,Mikal Bridges,bridgmi01,54,BRK,0,BOS,10,4,4,1,0,1,26.1,1,3,4,12,2,6,0,0,0,1,8,14,14,18,22.8
2023-24,202402140DAL,2/14/2024,DAL vs SAS,Tim Hardaway Jr.,hardati02,52,DAL,1,SAS,8,2,5,1,0,3,26.3,0,2,3,7,2,4,0,0,2,1,7,13,10,15,17.9
2023-24,202402140TOR,2/14/2024,TOR vs IND,Bruce Brown,brownbr01,48,TOR,1,IND,12,3,3,1,0,1,26.38333333,0,3,5,9,0,1,2,2,3,1,6,15,15,18,22.1
2023-24,202402140PHO,2/14/2024,PHO vs DET,Grayson Allen,allengr01,49,PHO,1,DET,9,1,6,1,1,1,26.55,0,1,2,9,1,5,4,4,3,2,7,15,10,16,24.2
2023-24,202402140NOP,2/14/2024,NOP vs WAS,Bilal Coulibaly,coulibi01,53,WAS,0,NOP,6,3,1,1,0,4,26.63333333,0,3,3,6,0,2,0,0,5,1,4,7,9,10,10.1
2023-24,202402140CLE,2/14/2024,CLE vs CHI,Isaac Okoro,okorois01,44,CLE,1,CHI,16,1,2,0,0,0,26.86666667,0,1,6,11,4,8,0,0,1,0,3,18,17,19,20.2
2023-24,202402140DAL,2/14/2024,DAL vs SAS,Victor Wembanyama,wembavi01,49,SAS,0,DAL,26,9,5,1,3,2,27.2,3,6,10,21,2,6,4,5,0,4,14,31,35,40,54.3
2023-24,202402140CHO,2/14/2024,CHO vs ATL,Grant Williams,willigr01,50,CHO,1,ATL,15,10,2,2,0,1,27.28333333,4,6,7,12,1,5,0,0,2,2,12,17,25,27,35
2023-24,202402140NOP,2/14/2024,NOP vs WAS,Herbert Jones,joneshe01,50,NOP,1,WAS,6,6,1,0,1,2,27.38333333,0,6,2,6,0,2,2,2,4,1,7,7,12,13,15.7
2023-24,202402140UTA,2/14/2024,UTA vs LAL,Spencer Dinwiddie,dinwisp01,50,LAL,0,UTA,10,0,4,2,0,1,27.61666667,0,0,4,6,2,4,0,0,2,2,4,14,10,14,21
2023-24,202402140GSW,2/14/2024,GSW vs LAC,Terance Mann,mannte01,47,LAC,0,GSW,9,5,4,0,0,1,27.61666667,2,3,3,8,1,6,2,4,2,0,9,13,14,18,20
2023-24,202402140UTA,2/14/2024,UTA vs LAL,Walker Kessler,kesslwa01,47,UTA,1,LAL,12,7,1,0,3,2,27.68333333,5,2,6,13,0,1,0,0,4,3,8,13,19,20,28.9
2023-24,202402140BOS,2/14/2024,BOS vs BRK,Derrick White,whitede01,51,BOS,1,BRK,27,5,4,1,0,2,27.76666667,0,5,10,16,5,10,2,2,2,1,9,31,32,36,40
2023-24,202402140GSW,2/14/2024,GSW vs LAC,Ivica Zubac,zubaciv01,43,LAC,0,GSW,13,10,3,2,2,3,27.76666667,1,9,5,7,0,0,3,4,1,4,13,16,23,26,38.5
2023-24,202402140MEM,2/14/2024,MEM vs HOU,Jaren Jackson Jr.,jacksja02,51,MEM,1,HOU,18,2,3,0,1,4,27.81666667,0,2,7,12,3,6,1,2,5,1,5,21,20,23,23.9
2023-24,202402140DAL,2/14/2024,DAL vs SAS,Blake Wesley,weslebl01,34,SAS,0,DAL,9,1,6,0,0,3,27.83333333,0,1,3,6,0,2,3,4,0,0,7,15,10,16,16.2
2023-24,202402140UTA,2/14/2024,UTA vs LAL,John Collins,collijo01,51,UTA,1,LAL,11,10,2,1,1,2,27.85,3,7,5,10,0,3,1,3,4,2,12,13,21,23,30
2023-24,202402140DAL,2/14/2024,DAL vs SAS,P.J. Washington,washipj01,47,DAL,1,SAS,3,6,2,0,1,1,27.86666667,1,5,1,6,1,3,0,2,2,1,8,5,9,11,15.2
2023-24,202402140CLE,2/14/2024,CLE vs CHI,Andre Drummond,drumman01,55,CHI,0,CLE,10,15,0,1,1,3,28.05,4,11,4,9,0,0,2,2,2,2,15,10,25,25,31
2023-24,202402140PHI,2/14/2024,PHI vs MIA,KJ Martin,martike04,40,PHI,1,MIA,9,5,3,0,0,2,28.15,1,4,4,7,1,2,0,0,1,0,8,12,14,17,17.5
2023-24,202402140CHO,2/14/2024,CHO vs ATL,De'Andre Hunter,huntede01,31,ATL,0,CHO,21,3,1,1,0,0,28.26666667,0,3,6,12,2,4,7,7,4,1,4,22,24,25,29.1
2023-24,202402140BOS,2/14/2024,BOS vs BRK,Jayson Tatum,tatumja01,52,BOS,1,BRK,20,7,9,0,0,1,28.38333333,1,6,7,16,2,7,4,5,0,0,16,29,27,36,40.9
2023-24,202402140CHO,2/14/2024,CHO vs ATL,Bogdan Bogdanovic,bogdabo01,53,ATL,0,CHO,12,5,4,1,0,5,28.95,1,4,4,9,2,5,2,2,1,1,9,16,17,21,22
2023-24,202402140PHO,2/14/2024,PHO vs DET,Ausar Thompson,thompau01,54,DET,0,PHO,14,7,1,2,1,0,28.95,4,3,7,13,0,0,0,3,4,3,8,15,21,22,32.9
2023-24,202402140DEN,2/14/2024,DEN vs SAC,Reggie Jackson,jacksre01,55,DEN,1,SAC,12,5,9,1,0,1,29.05,2,3,6,13,0,1,0,0,1,1,14,21,17,26,33.5
2023-24,202402140CHO,2/14/2024,CHO vs ATL,Nick Richards,richani01,45,CHO,1,ATL,12,7,0,0,0,1,29.1,1,6,5,5,0,0,2,3,4,0,7,12,19,19,19.4
2023-24,202402140BOS,2/14/2024,BOS vs BRK,Sam Hauser,hausesa01,54,BOS,1,BRK,14,5,2,1,0,0,29.11666667,0,5,5,9,4,8,0,0,0,1,7,16,19,21,26
2023-24,202402140TOR,2/14/2024,TOR vs IND,Jakob Poeltl,poeltja01,44,TOR,1,IND,19,11,3,1,2,2,29.51666667,7,4,8,15,0,0,3,4,3,3,14,22,30,33,43.7
2023-24,202402140MEM,2/14/2024,MEM vs HOU,Luke Kennard,kennalu01,27,MEM,1,HOU,19,2,2,1,0,2,29.56666667,0,2,5,7,4,6,5,7,2,1,4,21,21,23,25.4
2023-24,202402140PHO,2/14/2024,PHO vs DET,Kevin Durant,duranke01,48,PHO,1,DET,25,6,6,1,2,5,29.6,1,5,8,13,1,3,8,8,2,3,12,31,31,37,45.2
2023-24,202402140DEN,2/14/2024,DEN vs SAC,Malik Monk,monkma01,53,SAC,0,DEN,6,3,3,0,0,3,29.6,0,3,2,11,0,3,2,2,4,0,6,9,9,12,11.1
2023-24,202402140GSW,2/14/2024,GSW vs LAC,Klay Thompson,thompkl01,49,GSW,1,LAC,12,3,1,0,1,1,29.63333333,0,3,4,14,1,9,3,3,3,1,4,13,15,16,19.1
2023-24,202402140CHO,2/14/2024,CHO vs ATL,Cody Martin,martico01,22,CHO,1,ATL,6,7,4,1,0,1,29.71666667,2,5,3,6,0,1,0,0,0,1,11,10,13,17,22.4
2023-24,202402140ORL,2/14/2024,ORL vs NYK,Josh Hart,hartjo01,54,NYK,0,ORL,4,3,2,2,0,2,29.73333333,0,3,2,8,0,4,0,0,1,2,5,6,7,9,14.6
2023-24,202402140CHO,2/14/2024,CHO vs ATL,Tre Mann,manntr01,16,CHO,1,ATL,21,8,6,2,0,1,29.73333333,1,7,7,13,4,5,3,3,1,2,14,27,29,35,44.6
2023-24,202402140CLE,2/14/2024,CLE vs CHI,Max Strus,strusma01,53,CLE,1,CHI,7,3,3,1,0,1,29.76666667,0,3,3,8,1,6,0,0,4,1,6,10,10,13,17.1
2023-24,202402140TOR,2/14/2024,TOR vs IND,Gary Trent Jr.,trentga02,50,TOR,1,IND,8,6,3,0,2,0,29.95,0,6,3,9,2,6,0,0,1,2,9,11,14,17,25.7
2023-24,202402140GSW,2/14/2024,GSW vs LAC,Andrew Wiggins,wiggian01,47,GSW,1,LAC,10,6,3,4,0,0,29.96666667,2,4,4,10,2,6,0,0,3,4,9,13,16,19,33.7
2023-24,202402140NOP,2/14/2024,NOP vs WAS,Marvin Bagley III,baglema01,37,WAS,0,NOP,14,10,2,0,2,1,30.08333333,6,4,6,14,1,2,1,2,1,2,12,16,24,26,34
2023-24,202402140ORL,2/14/2024,ORL vs NYK,Alec Burks,burksal01,46,NYK,0,ORL,13,3,0,0,0,1,30.16666667,1,2,5,16,2,6,1,2,3,0,3,13,16,16,15.6
2023-24,202402140MEM,2/14/2024,MEM vs HOU,Aaron Holiday,holidaa01,51,HOU,0,MEM,19,2,1,1,0,2,30.33333333,2,0,7,13,5,8,0,0,3,1,3,20,21,22,23.9
2023-24,202402140CLE,2/14/2024,CLE vs CHI,Darius Garland,garlada01,29,CLE,1,CHI,12,1,7,1,0,2,30.55,0,1,4,10,2,5,2,2,1,1,8,19,13,20,24.7
2023-24,202402140NOP,2/14/2024,NOP vs WAS,Trey Murphy III,murphtr02,30,NOP,1,WAS,13,5,3,3,2,0,30.7,0,5,3,9,3,9,4,4,3,5,8,16,18,21,38.5
2023-24,202402140GSW,2/14/2024,GSW vs LAC,Norman Powell,powelno01,53,LAC,0,GSW,21,2,0,0,0,1,30.73333333,0,2,8,13,5,7,0,0,2,0,2,21,23,23,22.4
2023-24,202402140CLE,2/14/2024,CLE vs CHI,Evan Mobley,mobleev01,30,CLE,1,CHI,14,9,0,1,1,1,30.88333333,4,5,6,8,1,1,1,2,2,2,9,14,23,23,29.8
2023-24,202402140GSW,2/14/2024,GSW vs LAC,Draymond Green,greendr01,28,GSW,1,LAC,9,10,4,1,0,1,31.13333333,1,9,4,12,1,2,0,0,5,1,14,13,19,23,29
2023-24,202402140DAL,2/14/2024,DAL vs SAS,Devin Vassell,vassede01,50,SAS,0,DAL,11,4,6,3,0,1,31.28333333,0,4,4,16,1,4,2,3,1,3,10,17,15,21,32.8
2023-24,202402140DAL,2/14/2024,DAL vs SAS,Luka Doncic,doncilu01,47,DAL,1,SAS,27,9,8,2,1,5,31.31666667,0,9,11,20,1,8,4,4,2,3,17,35,36,44,53.8
2023-24,202402140GSW,2/14/2024,GSW vs LAC,Russell Westbrook,westbru01,53,LAC,0,GSW,15,5,6,1,0,2,31.43333333,4,1,6,14,0,3,3,5,2,1,11,21,20,26,31
2023-24,202402140ORL,2/14/2024,ORL vs NYK,Miles McBride,mcbrimi01,42,NYK,0,ORL,8,1,1,2,0,1,31.5,0,1,2,11,2,6,2,3,3,2,2,9,9,10,15.7
2023-24,202402140TOR,2/14/2024,TOR vs IND,Isaiah Jackson,jacksis01,44,IND,0,TOR,15,11,1,0,4,1,31.55,3,8,7,13,0,1,1,2,4,4,12,16,26,27,40.7
2023-24,202402140ORL,2/14/2024,ORL vs NYK,Franz Wagner,wagnefr01,47,ORL,1,NYK,21,3,6,3,1,1,31.56666667,0,3,7,13,1,4,6,6,3,4,9,27,24,30,44.6
2023-24,202402140CHO,2/14/2024,CHO vs ATL,Saddiq Bey,beysa01,54,ATL,0,CHO,14,4,1,0,1,1,31.65,3,1,5,13,2,5,2,2,0,1,5,15,18,19,22.3
2023-24,202402140CHO,2/14/2024,CHO vs ATL,Dejounte Murray,murrade01,52,ATL,0,CHO,13,7,4,1,2,3,31.65,2,5,5,15,1,7,2,3,2,3,11,17,20,24,33.4
2023-24,202402140BOS,2/14/2024,BOS vs BRK,Payton Pritchard,pritcpa01,55,BOS,1,BRK,28,4,3,0,0,0,31.73333333,1,3,11,16,6,9,0,0,1,0,7,31,32,35,37.3
2023-24,202402140PHI,2/14/2024,PHI vs MIA,Jaime Jaquez Jr.,jaqueja01,49,MIA,0,PHI,12,9,3,2,0,1,32.03333333,3,6,6,12,0,2,0,0,2,2,12,15,21,24,32.3
2023-24,202402140NOP,2/14/2024,NOP vs WAS,Corey Kispert,kispeco01,53,WAS,0,NOP,20,4,6,1,0,2,32.36666667,0,4,7,15,5,10,1,1,5,1,10,26,24,30,34.8
2023-24,202402140GSW,2/14/2024,GSW vs LAC,Brandin Podziemski,podzibr01,46,GSW,1,LAC,25,7,8,1,0,1,32.4,1,6,9,12,5,5,2,6,1,1,15,33,32,40,47.4
2023-24,202402140UTA,2/14/2024,UTA vs LAL,Jordan Clarkson,clarkjo01,45,UTA,1,LAL,17,3,5,0,0,4,32.48333333,0,3,6,14,3,8,2,2,2,0,8,22,20,25,24.1
2023-24,202402140UTA,2/14/2024,UTA vs LAL,Taurean Prince,princta02,54,LAL,0,UTA,11,3,1,0,1,0,32.61666667,0,3,4,8,1,2,2,2,2,1,4,12,14,15,19.1
2023-24,202402140PHI,2/14/2024,PHI vs MIA,Kelly Oubre Jr.,oubreke01,42,PHI,1,MIA,9,3,2,1,0,1,32.66666667,0,3,4,11,0,4,1,2,6,1,5,11,12,14,17.6
2023-24,202402140TOR,2/14/2024,TOR vs IND,Andrew Nembhard,nembhan01,42,IND,0,TOR,14,3,5,2,0,1,32.7,1,2,5,8,2,3,2,3,2,2,8,19,17,22,30.1
2023-24,202402140PHI,2/14/2024,PHI vs MIA,Duncan Robinson,robindu01,50,MIA,0,PHI,20,1,4,1,0,2,32.73333333,0,1,7,11,5,7,1,1,4,1,5,24,21,25,28.2
2023-24,202402140DAL,2/14/2024,DAL vs SAS,Kyrie Irving,irvinky01,33,DAL,1,SAS,34,9,7,2,1,1,32.91666667,1,8,15,22,4,9,0,0,1,3,16,41,43,50,63.3
2023-24,202402140GSW,2/14/2024,GSW vs LAC,Paul George,georgpa01,50,LAC,0,GSW,24,5,5,2,1,2,32.95,0,5,8,17,1,7,7,8,6,3,10,29,29,34,44.5
2023-24,202402140DEN,2/14/2024,DEN vs SAC,Harrison Barnes,barneha02,54,SAC,0,DEN,20,5,0,0,1,1,32.96666667,0,5,6,9,3,6,5,6,2,1,5,20,25,25,28
2023-24,202402140UTA,2/14/2024,UTA vs LAL,Keyonte George,georgke01,49,UTA,1,LAL,13,5,7,2,0,2,32.98333333,0,5,5,9,3,5,0,0,3,2,12,20,18,25,33.5
2023-24,202402140CLE,2/14/2024,CLE vs CHI,Ayo Dosunmu,dosunay01,53,CHI,0,CLE,12,4,2,0,0,3,33.18333333,2,2,4,10,4,7,0,0,3,0,6,14,16,18,16.8
2023-24,202402140NOP,2/14/2024,NOP vs WAS,CJ McCollum,mccolcj01,41,NOP,1,WAS,26,3,6,1,0,0,33.28333333,0,3,9,17,3,9,5,5,2,1,9,32,29,35,41.6
2023-24,202402140DEN,2/14/2024,DEN vs SAC,Aaron Gordon,gordoaa01,49,DEN,1,SAC,25,15,2,0,0,4,33.3,3,12,8,15,1,2,8,8,0,0,17,27,40,42,42
2023-24,202402140UTA,2/14/2024,UTA vs LAL,D'Angelo Russell,russeda01,52,LAL,0,UTA,11,9,17,1,0,2,33.31666667,1,8,4,8,0,1,3,3,4,1,26,28,20,37,48.3
2023-24,202402140MEM,2/14/2024,MEM vs HOU,Jabari Smith Jr.,smithja05,49,HOU,0,MEM,6,11,1,1,0,2,33.33333333,1,10,3,13,0,6,0,0,2,1,12,7,17,18,21.7
2023-24,202402140TOR,2/14/2024,TOR vs IND,RJ Barrett,barrerj01,45,TOR,1,IND,23,9,3,1,1,3,33.53333333,3,6,9,17,1,3,4,8,1,2,12,26,32,35,41.3
2023-24,202402140UTA,2/14/2024,UTA vs LAL,Rui Hachimura,hachiru01,43,LAL,0,UTA,36,2,1,0,1,0,33.63333333,0,2,13,19,6,8,4,5,0,1,3,37,38,39,42.9
2023-24,202402140UTA,2/14/2024,UTA vs LAL,Austin Reaves,reaveau01,57,LAL,0,UTA,22,4,7,3,0,3,33.66666667,0,4,9,13,3,5,1,1,0,3,11,29,26,33,43.3
2023-24,202402140UTA,2/14/2024,UTA vs LAL,Lauri Markkanen,markkla01,45,UTA,1,LAL,16,8,1,0,1,2,33.68333333,2,6,6,15,2,7,2,2,1,1,9,17,24,25,28.1
2023-24,202402140MEM,2/14/2024,MEM vs HOU,Amen Thompson,thompam01,35,HOU,0,MEM,19,12,2,2,1,2,33.71666667,6,6,9,17,0,0,1,3,6,3,14,21,31,33,43.4
2023-24,202402140NOP,2/14/2024,NOP vs WAS,Zion Williamson,willizi01,44,NOP,1,WAS,36,6,8,0,1,1,34.05,2,4,15,21,0,0,6,9,2,1,14,44,42,50,57.2
2023-24,202402140CHO,2/14/2024,CHO vs ATL,Miles Bridges,bridgmi02,43,CHO,1,ATL,17,5,4,1,1,1,34.23333333,1,4,5,13,3,6,4,4,4,2,9,21,22,26,34
2023-24,202402140MEM,2/14/2024,MEM vs HOU,Alperen Sengun,sengual01,53,HOU,0,MEM,19,5,6,1,1,1,34.25,3,2,8,16,1,2,2,7,6,2,11,25,24,30,39
2023-24,202402140TOR,2/14/2024,TOR vs IND,Tyrese Haliburton,halibty01,44,IND,0,TOR,21,4,12,2,0,1,34.38333333,0,4,6,13,5,9,4,5,3,2,16,33,25,37,48.8
2023-24,202402140CHO,2/14/2024,CHO vs ATL,Trae Young,youngtr01,50,ATL,0,CHO,12,2,12,0,0,4,34.43333333,1,1,4,12,2,8,2,2,4,0,14,24,14,26,28.4
2023-24,202402140MEM,2/14/2024,MEM vs HOU,Vince Williams Jr.,willivi01,43,MEM,1,HOU,12,8,7,3,1,2,34.53333333,1,7,1,6,0,4,10,12,1,4,15,19,20,27,42.1
2023-24,202402140NOP,2/14/2024,NOP vs WAS,Brandon Ingram,ingrabr01,51,NOP,1,WAS,18,3,8,2,0,1,34.55,1,2,6,13,2,3,4,6,4,2,11,26,21,29,38.6
2023-24,202402140GSW,2/14/2024,GSW vs LAC,Stephen Curry,curryst01,49,GSW,1,LAC,41,4,5,0,0,4,34.65,1,3,15,31,9,19,2,2,3,0,9,46,45,50,49.3
2023-24,202402140DEN,2/14/2024,DEN vs SAC,Keegan Murray,murrake02,50,SAC,0,DEN,6,5,1,0,1,3,34.73333333,1,4,2,8,0,4,2,2,3,1,6,7,11,12,13.5
2023-24,202402140GSW,2/14/2024,GSW vs LAC,Jonathan Kuminga,kuminjo01,51,GSW,1,LAC,13,8,6,0,0,2,34.78333333,5,3,6,13,0,1,1,1,2,0,14,19,21,27,29.6
2023-24,202402140ORL,2/14/2024,ORL vs NYK,Paolo Banchero,banchpa01,55,ORL,1,NYK,36,6,5,1,0,3,34.81666667,0,6,15,20,6,10,0,0,0,1,11,41,42,47,50.7
2023-24,202402140ORL,2/14/2024,ORL vs NYK,Jalen Brunson,brunsja01,52,NYK,0,ORL,33,1,6,2,0,3,35,1,0,11,21,5,8,6,7,0,2,7,39,34,40,46.2
2023-24,202402140NOP,2/14/2024,NOP vs WAS,Jordan Poole,poolejo01,52,WAS,0,NOP,19,5,6,3,0,4,35.1,2,3,7,15,5,10,0,0,5,3,11,25,24,30,39
2023-24,202402140DEN,2/14/2024,DEN vs SAC,Justin Holiday,holidju01,32,DEN,1,SAC,8,4,2,1,0,1,35.15,1,3,2,8,2,5,2,2,3,1,6,10,12,14,17.8
2023-24,202402140CLE,2/14/2024,CLE vs CHI,Jarrett Allen,allenja01,48,CLE,1,CHI,13,10,3,1,1,0,35.23333333,1,9,6,9,0,1,1,2,1,2,13,16,23,26,35.5
2023-24,202402140TOR,2/14/2024,TOR vs IND,Immanuel Quickley,quickim01,50,TOR,1,IND,14,6,7,0,0,1,35.3,1,5,5,11,1,5,3,3,2,0,13,21,20,27,30.7
2023-24,202402140TOR,2/14/2024,TOR vs IND,Pascal Siakam,siakapa01,54,IND,0,TOR,23,5,7,1,1,0,35.65,2,3,8,17,1,3,6,9,5,2,12,30,28,35,45.5
2023-24,202402140TOR,2/14/2024,TOR vs IND,Scottie Barnes,barnesc01,55,TOR,1,IND,29,12,8,1,1,6,35.95,2,10,12,22,0,4,5,5,1,2,20,37,41,49,55.4
2023-24,202402140CHO,2/14/2024,CHO vs ATL,Brandon Miller,millebr02,48,CHO,1,ATL,26,6,4,1,3,5,36.06666667,3,3,8,19,4,9,6,6,2,4,10,30,32,36,46.2
2023-24,202402140MEM,2/14/2024,MEM vs HOU,Dillon Brooks,brookdi01,45,HOU,0,MEM,19,10,2,2,0,1,36.48333333,4,6,5,17,2,10,7,7,3,2,12,21,29,31,39
2023-24,202402140PHI,2/14/2024,PHI vs MIA,Haywood Highsmith,highsha01,40,MIA,0,PHI,16,2,1,2,1,1,36.48333333,1,1,5,13,4,10,2,2,1,3,3,17,18,19,27.9
2023-24,202402140DEN,2/14/2024,DEN vs SAC,Michael Porter Jr.,portemi01,54,DEN,1,SAC,19,4,2,0,0,1,37.43333333,1,3,8,17,3,7,0,0,0,0,6,21,23,25,25.8
2023-24,202402140DEN,2/14/2024,DEN vs SAC,Domantas Sabonis,sabondo01,54,SAC,0,DEN,20,13,7,3,0,5,37.63333333,2,11,9,16,0,0,2,3,3,3,20,27,33,40,50.1
2023-24,202402140CHO,2/14/2024,CHO vs ATL,Jalen Johnson,johnsja05,41,ATL,0,CHO,19,12,0,0,2,2,37.98333333,5,7,9,18,0,5,1,2,3,2,12,19,31,31,37.4
2023-24,202402140UTA,2/14/2024,UTA vs LAL,Anthony Davis,davisan02,53,LAL,0,UTA,37,15,1,0,2,2,38,3,12,13,25,1,3,10,13,0,2,16,38,52,53,60.5
2023-24,202402140PHI,2/14/2024,PHI vs MIA,Tyler Herro,herroty01,35,MIA,0,PHI,23,7,7,0,0,3,38.08333333,1,6,10,23,1,8,2,3,1,0,14,30,30,37,38.9
2023-24,202402140CLE,2/14/2024,CLE vs CHI,Donovan Mitchell,mitchdo01,44,CLE,1,CHI,30,6,7,2,0,0,38.86666667,0,6,8,21,2,8,12,13,1,2,13,37,36,43,53.7
2023-24,202402140ORL,2/14/2024,ORL vs NYK,Jericho Sims,simsje01,28,NYK,0,ORL,8,8,1,1,0,0,38.93333333,2,6,3,5,0,0,2,3,0,1,9,9,16,17,22.1
2023-24,202402140DEN,2/14/2024,DEN vs SAC,Nikola Jokic,jokicni01,53,DEN,1,SAC,15,5,8,0,1,0,38.96666667,0,5,6,17,0,6,3,4,4,1,13,23,20,28,36
2023-24,202402140PHI,2/14/2024,PHI vs MIA,Paul Reed,reedpa01,54,PHI,1,MIA,18,12,2,0,1,0,39.13333333,3,9,7,12,1,1,3,3,3,1,14,20,30,32,38.4
2023-24,202402140CLE,2/14/2024,CLE vs CHI,Coby White,whiteco01,55,CHI,0,CLE,32,7,4,1,0,4,39.21666667,0,7,11,17,5,8,5,6,3,1,11,36,39,43,45.4
2023-24,202402140PHI,2/14/2024,PHI vs MIA,Bam Adebayo,adebaba01,45,MIA,0,PHI,23,13,4,2,0,2,39.36666667,3,10,9,14,0,0,5,5,2,2,17,27,36,40,48.6
2023-24,202402140PHI,2/14/2024,PHI vs MIA,Tyrese Maxey,maxeyty01,49,PHI,1,MIA,30,6,7,0,0,3,39.4,1,5,12,23,2,7,4,4,2,0,13,37,36,43,44.7
2023-24,202402140CLE,2/14/2024,CLE vs CHI,Nikola Vucevic,vucevni01,50,CHI,0,CLE,9,8,1,0,0,2,39.41666667,3,5,4,16,1,5,0,0,4,0,9,10,17,18,18.1
2023-24,202402140NOP,2/14/2024,NOP vs WAS,Tyus Jones,jonesty01,54,WAS,0,NOP,14,2,15,1,0,2,39.53333333,0,2,5,7,4,6,0,0,2,1,17,29,16,31,39.9
2023-24,202402140NOP,2/14/2024,NOP vs WAS,Deni Avdija,avdijde01,54,WAS,0,NOP,43,15,3,0,1,3,39.9,5,10,13,24,6,10,11,13,2,1,18,46,58,61,65.5
2023-24,202402140GSW,2/14/2024,GSW vs LAC,James Harden,hardeja01,48,LAC,0,GSW,26,8,7,0,1,1,40.36666667,2,6,7,12,4,9,8,9,0,1,15,33,34,41,48.1
2023-24,202402140CLE,2/14/2024,CLE vs CHI,DeMar DeRozan,derozde01,53,CHI,0,CLE,24,2,6,0,0,0,40.5,0,2,9,16,0,1,6,7,4,0,8,30,26,32,35.4
2023-24,202402140DEN,2/14/2024,DEN vs SAC,De'Aaron Fox,foxde01,48,SAC,0,DEN,30,8,8,2,0,1,42.88333333,3,5,12,26,2,7,4,6,2,2,16,38,38,46,56.6
2023-24,202402140ORL,2/14/2024,ORL vs NYK,Precious Achiuwa,achiupr01,48,NYK,0,ORL,23,14,5,0,0,1,43.35,10,4,8,16,1,2,6,7,1,0,19,28,37,42,46.3
2023-24,202402140PHI,2/14/2024,PHI vs MIA,Buddy Hield,hieldbu01,57,PHI,1,MIA,22,3,10,2,0,5,44.3,0,3,8,15,5,11,1,1,4,2,13,32,25,35,41.6
2023-24,202402130PHO,2/13/2024,PHO vs SAC,Nassir Little,littlna01,31,PHO,1,SAC,3,2,0,0,1,1,10.11666667,0,2,1,3,1,2,0,0,0,1,2,3,5,5,7.4
2023-24,202402130POR,2/13/2024,POR vs MIN,Monte Morris,morrimo01,8,MIN,0,POR,0,1,2,1,0,0,11.55,0,1,0,3,0,1,0,0,1,1,3,2,1,3,7.2
2023-24,202402130ORL,2/13/2024,ORL vs OKC,Cole Anthony,anthoco01,53,ORL,1,OKC,5,4,1,1,0,0,12.45,1,3,2,8,1,2,0,0,1,1,5,6,9,10,14.3
2023-24,202402130POR,2/13/2024,POR vs MIN,Duop Reath,reathdu01,39,POR,1,MIN,6,3,0,1,1,0,12.55,3,0,2,5,1,3,1,2,3,2,3,6,9,9,15.6
2023-24,202402130MIL,2/13/2024,MIL vs MIA,Patrick Beverley,beverpa01,50,MIL,1,MIA,3,2,2,1,0,2,12.95,0,2,1,3,1,1,0,0,1,1,4,5,5,7,9.4
2023-24,202402130LAL,2/13/2024,LAL vs DET,Christian Wood,woodch01,49,LAL,1,DET,11,4,0,1,1,0,13.35,0,4,4,7,1,2,2,2,1,2,4,11,15,15,21.8
2023-24,202402130ORL,2/13/2024,ORL vs OKC,Isaiah Joe,joeis01,50,OKC,0,ORL,10,1,1,0,0,2,13.43333333,0,1,4,6,1,3,1,1,2,0,2,11,11,12,10.7
2023-24,202402130LAL,2/13/2024,LAL vs DET,Jaxson Hayes,hayesja02,45,LAL,1,DET,2,7,1,1,1,1,13.46666667,0,7,0,0,0,0,2,2,1,2,8,3,9,10,16.9
2023-24,202402130ORL,2/13/2024,ORL vs OKC,Moritz Wagner,wagnemo01,52,ORL,1,OKC,11,5,0,0,0,1,14.13333333,4,1,4,7,0,1,3,4,2,0,5,11,16,16,16
2023-24,202402130BRK,2/13/2024,BRK vs BOS,Sam Hauser,hausesa01,53,BOS,0,BRK,3,2,0,0,0,0,14.33333333,1,1,1,3,1,3,0,0,2,0,2,3,5,5,5.4
2023-24,202402130BRK,2/13/2024,BRK vs BOS,Dennis Smith Jr.,smithde03,37,BRK,1,BOS,0,1,2,0,0,2,14.85,0,1,0,2,0,2,0,0,0,0,3,2,1,3,2.2
2023-24,202402130BRK,2/13/2024,BRK vs BOS,Luke Kornet,kornelu01,38,BOS,0,BRK,5,5,1,0,0,1,14.88333333,2,3,2,2,0,0,1,2,5,0,6,6,10,11,11.5
2023-24,202402130MIL,2/13/2024,MIL vs MIA,A.J. Green,greenaj01,35,MIL,1,MIA,4,3,0,1,1,1,14.95,0,3,1,7,1,6,1,1,0,2,3,4,7,7,12.6
2023-24,202402130ORL,2/13/2024,ORL vs OKC,Aaron Wiggins,wiggiaa01,51,OKC,0,ORL,5,1,0,1,1,1,14.98333333,0,1,2,4,1,2,0,0,1,2,1,5,6,6,11.2
2023-24,202402130ORL,2/13/2024,ORL vs OKC,Jonathan Isaac,isaacjo01,36,ORL,1,OKC,3,1,1,2,0,1,15.03333333,0,1,1,6,0,3,1,2,1,2,2,4,4,5,10.7
2023-24,202402130BRK,2/13/2024,BRK vs BOS,Payton Pritchard,pritcpa01,54,BOS,0,BRK,3,3,1,0,0,1,15.4,1,2,1,6,1,5,0,0,3,0,4,4,6,7,7.1
2023-24,202402130ORL,2/13/2024,ORL vs OKC,Cason Wallace,wallaca01,54,OKC,0,ORL,8,2,1,0,1,0,15.98333333,0,2,3,5,2,4,0,0,0,1,3,9,10,11,14.9
2023-24,202402130ORL,2/13/2024,ORL vs OKC,Jaylin Williams,willija07,46,OKC,0,ORL,6,1,2,0,0,0,16.23333333,0,1,2,3,2,3,0,0,1,0,3,8,7,9,10.2
2023-24,202402130BRK,2/13/2024,BRK vs BOS,Lonnie Walker IV,walkelo01,33,BRK,1,BOS,15,3,3,2,0,0,16.75,0,3,5,8,3,5,2,3,0,2,6,18,18,21,29.1
2023-24,202402130POR,2/13/2024,POR vs MIN,Jabari Walker,walkeja01,49,POR,1,MIN,4,7,0,0,0,1,17.15,3,4,2,5,0,0,0,0,4,0,7,4,11,11,11.4
2023-24,202402130LAL,2/13/2024,LAL vs DET,Troy Brown Jr.,browntr01,39,DET,0,LAL,7,4,2,0,0,0,17.28333333,1,3,3,7,1,3,0,0,1,0,6,9,11,13,14.8
2023-24,202402130PHO,2/13/2024,PHO vs SAC,Davion Mitchell,mitchda01,43,SAC,0,PHO,3,0,1,0,0,0,17.28333333,0,0,1,3,1,3,0,2,2,0,1,4,3,4,4.5
2023-24,202402130LAL,2/13/2024,LAL vs DET,Marcus Sasser,sassema01,48,DET,0,LAL,3,3,5,1,0,2,17.75,1,2,1,10,1,3,0,0,1,1,8,8,6,11,15.1
2023-24,202402130MIL,2/13/2024,MIL vs MIA,Jae Crowder,crowdja01,24,MIL,1,MIA,2,1,1,0,0,1,17.81666667,1,0,1,1,0,0,0,0,0,0,2,3,3,4,3.7
2023-24,202402130ORL,2/13/2024,ORL vs OKC,Markelle Fultz,fultzma01,21,ORL,1,OKC,4,7,4,1,0,1,18.46666667,4,3,2,5,0,0,0,0,0,1,11,8,11,15,20.4
2023-24,202402130BRK,2/13/2024,BRK vs BOS,Dorian Finney-Smith,finnedo01,44,BRK,1,BOS,3,2,1,1,1,0,18.66666667,0,2,1,2,0,1,1,2,1,2,3,4,5,6,12.9
2023-24,202402130POR,2/13/2024,POR vs MIN,Matisse Thybulle,thybuma01,51,POR,1,MIN,0,2,1,1,0,1,18.73333333,1,1,0,5,0,3,0,0,2,1,3,1,2,3,5.9
2023-24,202402130LAL,2/13/2024,LAL vs DET,Shake Milton,miltosh01,40,DET,0,LAL,8,6,4,0,0,1,18.91666667,2,4,4,9,0,1,0,0,1,0,10,12,14,18,20.2
2023-24,202402130PHO,2/13/2024,PHO vs SAC,Josh Okogie,okogijo01,48,PHO,1,SAC,7,2,1,1,0,2,18.95,1,1,1,4,1,1,4,4,0,1,3,8,9,10,11.9
2023-24,202402130POR,2/13/2024,POR vs MIN,Karl-Anthony Towns,townska01,53,MIN,0,POR,13,5,1,1,0,3,19.21666667,2,3,2,7,1,3,8,8,3,1,6,14,18,19,20.5
2023-24,202402130POR,2/13/2024,POR vs MIN,Kyle Anderson,anderky01,54,MIN,0,POR,8,3,8,0,0,0,22.05,0,3,1,3,0,0,6,6,0,0,11,16,11,19,23.6
2023-24,202402130POR,2/13/2024,POR vs MIN,Toumani Camara,camarto01,52,POR,1,MIN,14,4,2,0,0,2,22.26666667,1,3,5,7,2,2,2,2,4,0,6,16,18,20,19.8
2023-24,202402130LAL,2/13/2024,LAL vs DET,Taurean Prince,princta02,53,LAL,1,DET,8,5,1,1,1,0,22.55,1,4,3,5,2,3,0,1,1,2,6,9,13,14,21.5
2023-24,202402130BRK,2/13/2024,BRK vs BOS,Jalen Wilson,wilsoja03,15,BRK,1,BOS,9,4,2,0,0,0,22.68333333,1,3,3,4,3,3,0,0,1,0,6,11,13,15,16.8
2023-24,202402130MIL,2/13/2024,MIL vs MIA,Haywood Highsmith,highsha01,39,MIA,0,MIL,2,4,0,2,1,0,22.98333333,0,4,1,4,0,2,0,0,1,3,4,2,6,6,15.8
2023-24,202402130LAL,2/13/2024,LAL vs DET,James Wiseman,wisemja01,34,DET,0,LAL,18,9,2,0,1,1,23.05,5,4,8,12,0,0,2,3,4,1,11,20,27,29,33.8
2023-24,202402130LAL,2/13/2024,LAL vs DET,Jalen Duren,durenja01,38,DET,0,LAL,8,8,0,1,0,1,23.3,4,4,4,9,0,0,0,0,3,1,8,8,16,16,19.6
2023-24,202402130MIL,2/13/2024,MIL vs MIA,Brook Lopez,lopezbr01,52,MIL,1,MIA,7,3,0,0,1,2,23.36666667,0,3,3,9,1,6,0,0,2,1,3,7,10,10,11.6
2023-24,202402130MIL,2/13/2024,MIL vs MIA,Kevin Love,loveke01,43,MIA,0,MIL,19,8,3,2,0,1,23.46666667,0,8,6,8,5,7,2,4,2,2,11,22,27,30,38.1
2023-24,202402130PHO,2/13/2024,PHO vs SAC,Kevin Huerter,huertke01,51,SAC,0,PHO,10,3,1,1,1,1,23.68333333,0,3,4,6,2,3,0,0,2,2,4,11,13,14,20.1
2023-24,202402130BRK,2/13/2024,BRK vs BOS,Ben Simmons,simmobe01,12,BRK,1,BOS,5,6,8,0,0,1,24.08333333,1,5,1,5,0,0,3,6,4,0,14,13,11,19,23.2
2023-24,202402130POR,2/13/2024,POR vs MIN,Jaden McDaniels,mcdanja02,44,MIN,0,POR,0,2,0,0,1,0,24.13333333,2,0,0,7,0,3,0,0,0,1,2,0,2,2,5.4
2023-24,202402130MIL,2/13/2024,MIL vs MIA,Pat Connaughton,connapa01,49,MIL,1,MIA,0,6,3,1,0,1,24.41666667,0,6,0,2,0,1,0,0,3,1,9,3,6,9,13.7
2023-24,202402130LAL,2/13/2024,LAL vs DET,Evan Fournier,fournev01,4,DET,0,LAL,13,4,1,2,0,2,24.51666667,1,3,4,9,2,5,3,4,3,2,5,14,17,18,23.3
2023-24,202402130ORL,2/13/2024,ORL vs OKC,Gary Harris,harriga01,33,ORL,1,OKC,6,2,1,1,2,1,24.75,1,1,2,3,2,3,0,0,2,3,3,7,8,9,17.9
2023-24,202402130MIL,2/13/2024,MIL vs MIA,Caleb Martin,martica02,37,MIA,0,MIL,2,1,2,0,1,1,24.81666667,0,1,1,3,0,2,0,0,2,1,3,4,3,5,8.2
2023-24,202402130POR,2/13/2024,POR vs MIN,Naz Reid,reidna01,54,MIN,0,POR,10,3,1,1,2,0,25.1,0,3,4,8,1,3,1,2,2,3,4,11,13,14,24.1
2023-24,202402130LAL,2/13/2024,LAL vs DET,Cade Cunningham,cunnica01,43,DET,0,LAL,12,7,7,0,0,0,25.11666667,1,6,4,15,0,2,4,4,1,0,14,19,19,26,30.9
2023-24,202402130PHO,2/13/2024,PHO vs SAC,Jusuf Nurkic,nurkiju01,51,PHO,1,SAC,9,9,2,2,2,1,25.35,2,7,3,6,0,0,3,4,3,4,11,11,18,20,33.8
2023-24,202402130MIL,2/13/2024,MIL vs MIA,Bobby Portis,portibo01,55,MIL,1,MIA,16,4,2,0,0,0,25.5,1,3,6,12,2,5,2,2,2,0,6,18,20,22,23.8
2023-24,202402130LAL,2/13/2024,LAL vs DET,Simone Fontecchio,fontesi01,52,DET,0,LAL,8,4,4,0,0,0,25.68333333,1,3,3,6,2,4,0,2,1,0,8,12,12,16,18.8
2023-24,202402130POR,2/13/2024,POR vs MIN,Nickeil Alexander-Walker,alexani01,54,MIN,0,POR,18,3,2,0,1,2,25.95,0,3,6,7,5,6,1,1,2,1,5,20,21,23,25.6
2023-24,202402130POR,2/13/2024,POR vs MIN,Dalano Banton,bantoda01,26,POR,1,MIN,16,5,3,1,0,4,26.01666667,1,4,4,8,1,2,7,10,2,1,8,19,21,24,25.5
2023-24,202402130POR,2/13/2024,POR vs MIN,Mike Conley,conlemi01,49,MIN,0,POR,7,4,6,2,3,2,26.25,1,3,2,7,1,5,2,2,2,5,10,13,11,17,33.8
2023-24,202402130MIL,2/13/2024,MIL vs MIA,Duncan Robinson,robindu01,49,MIA,0,MIL,23,3,5,2,1,0,26.3,0,3,8,12,6,8,1,1,1,3,8,28,26,31,43.1
2023-24,202402130ORL,2/13/2024,ORL vs OKC,Josh Giddey,giddejo01,53,OKC,0,ORL,10,5,5,0,0,1,27.03333333,1,4,5,8,0,3,0,0,1,0,10,15,15,20,22.5
2023-24,202402130PHO,2/13/2024,PHO vs SAC,Eric Gordon,gordoer01,46,PHO,1,SAC,23,3,3,0,1,0,27.21666667,0,3,8,17,4,9,3,3,1,1,6,26,26,29,34.1
2023-24,202402130MIL,2/13/2024,MIL vs MIA,Malik Beasley,beaslma01,53,MIL,1,MIA,16,3,0,3,0,1,27.51666667,0,3,6,10,4,8,0,0,1,3,3,16,19,19,27.6
2023-24,202402130MIL,2/13/2024,MIL vs MIA,Jaime Jaquez Jr.,jaqueja01,48,MIA,0,MIL,12,3,4,0,0,3,27.86666667,1,2,5,12,0,2,2,3,3,0,7,16,15,19,18.6
2023-24,202402130LAL,2/13/2024,LAL vs DET,Anthony Davis,davisan02,52,LAL,1,DET,20,14,4,0,6,1,28.38333333,3,11,6,12,1,3,7,7,1,6,18,24,34,38,59.8
2023-24,202402130BRK,2/13/2024,BRK vs BOS,Nic Claxton,claxtni01,43,BRK,1,BOS,10,8,1,0,2,1,28.48333333,2,6,4,5,0,0,2,4,4,2,9,11,18,19,26.1
2023-24,202402130LAL,2/13/2024,LAL vs DET,Jaden Ivey,iveyja01,49,DET,0,LAL,15,2,5,2,1,2,28.65,0,2,5,16,1,6,4,4,5,3,7,20,17,22,31.9
2023-24,202402130LAL,2/13/2024,LAL vs DET,Ausar Thompson,thompau01,53,DET,0,LAL,19,2,0,1,0,1,28.91666667,1,1,9,13,1,2,0,0,4,1,2,19,21,21,23.4
2023-24,202402130PHO,2/13/2024,PHO vs SAC,Royce O'Neale,onealro01,51,PHO,1,SAC,9,4,5,4,1,0,29.71666667,0,4,3,7,2,5,1,3,4,5,9,14,13,18,36.3
2023-24,202402130LAL,2/13/2024,LAL vs DET,Rui Hachimura,hachiru01,42,LAL,1,DET,15,5,2,0,0,0,30.08333333,2,3,7,10,0,2,1,4,1,0,7,17,20,22,24
2023-24,202402130MIL,2/13/2024,MIL vs MIA,Tyler Herro,herroty01,34,MIA,0,MIL,19,3,5,0,0,1,30.16666667,0,3,7,16,3,8,2,2,0,0,8,24,22,27,29.1
2023-24,202402130MIL,2/13/2024,MIL vs MIA,Nikola Jovic,jovicni01,21,MIA,0,MIL,24,7,3,1,0,0,30.48333333,0,7,8,13,5,8,3,4,1,1,10,27,31,34,39.9
2023-24,202402130ORL,2/13/2024,ORL vs OKC,Luguentz Dort,dortlu01,52,OKC,0,ORL,8,4,4,2,0,1,30.63333333,0,4,3,5,2,4,0,0,1,2,8,12,12,16,23.8
2023-24,202402130LAL,2/13/2024,LAL vs DET,LeBron James,jamesle01,50,LAL,1,DET,25,1,8,0,0,4,30.7,0,1,9,15,3,6,4,4,0,0,9,33,26,34,34.2
2023-24,202402130ORL,2/13/2024,ORL vs OKC,Wendell Carter Jr.,cartewe01,28,ORL,1,OKC,22,6,1,0,0,3,30.78333333,0,6,9,14,1,4,3,3,5,0,7,23,28,29,27.7
2023-24,202402130MIL,2/13/2024,MIL vs MIA,Bam Adebayo,adebaba01,44,MIA,0,MIL,16,12,11,2,0,3,31.26666667,5,7,8,14,0,0,0,0,2,2,23,27,28,39,49.9
2023-24,202402130LAL,2/13/2024,LAL vs DET,Spencer Dinwiddie,dinwisp01,49,LAL,1,DET,6,2,7,2,0,4,31.28333333,0,2,2,6,1,5,1,1,2,2,9,13,8,15,20.9
2023-24,202402130LAL,2/13/2024,LAL vs DET,D'Angelo Russell,russeda01,51,LAL,1,DET,21,2,3,0,1,3,31.68333333,1,1,8,18,4,9,1,2,2,1,5,24,23,26,27.9
2023-24,202402130ORL,2/13/2024,ORL vs OKC,Chet Holmgren,holmgch01,54,OKC,0,ORL,13,9,1,1,5,1,31.76666667,2,7,4,8,1,3,4,4,5,6,10,14,22,23,42.3
2023-24,202402130BRK,2/13/2024,BRK vs BOS,Dennis Schroder,schrode01,53,BRK,1,BOS,9,5,3,0,0,3,31.76666667,0,5,3,10,2,7,1,3,1,0,8,12,14,17,16.5
2023-24,202402130POR,2/13/2024,POR vs MIN,Deandre Ayton,aytonde01,36,POR,1,MIN,22,16,1,0,0,0,31.95,2,14,11,12,0,0,0,0,1,0,17,23,38,39,42.7
2023-24,202402130POR,2/13/2024,POR vs MIN,Anfernee Simons,simonan01,30,POR,1,MIN,20,3,5,1,0,3,32.26666667,0,3,6,19,4,10,4,4,4,1,8,25,23,28,31.1
2023-24,202402130MIL,2/13/2024,MIL vs MIA,Damian Lillard,lillada01,50,MIL,1,MIA,16,2,5,0,0,3,32.36666667,0,2,5,14,2,7,4,4,1,0,7,21,18,23,22.9
2023-24,202402130LAL,2/13/2024,LAL vs DET,Austin Reaves,reaveau01,56,LAL,1,DET,15,7,6,1,1,2,32.48333333,0,7,3,9,2,5,7,7,4,2,13,21,22,28,36.4
2023-24,202402130PHO,2/13/2024,PHO vs SAC,Malik Monk,monkma01,52,SAC,0,PHO,22,4,6,1,1,5,33.13333333,0,4,9,16,0,5,4,4,2,2,10,28,26,32,36.8
2023-24,202402130ORL,2/13/2024,ORL vs OKC,Jalen Suggs,suggsja01,50,ORL,1,OKC,17,7,4,1,0,2,33.16666667,3,4,5,13,4,12,3,4,4,1,11,21,24,28,32.4
2023-24,202402130PHO,2/13/2024,PHO vs SAC,Keegan Murray,murrake02,49,SAC,0,PHO,6,5,1,1,1,0,33.51666667,0,5,3,9,0,2,0,0,5,2,6,7,11,12,19.5
2023-24,202402130MIL,2/13/2024,MIL vs MIA,Giannis Antetokounmpo,antetgi01,53,MIL,1,MIA,23,11,8,0,2,5,33.63333333,2,9,11,18,1,2,0,0,0,2,19,31,34,42,49.2
2023-24,202402130POR,2/13/2024,POR vs MIN,Scoot Henderson,hendesc01,42,POR,1,MIN,14,1,9,0,0,2,33.86666667,0,1,4,9,1,2,5,5,4,0,10,23,15,24,26.7
2023-24,202402130ORL,2/13/2024,ORL vs OKC,Franz Wagner,wagnefr01,46,ORL,1,OKC,15,7,2,0,0,2,34.06666667,1,6,5,16,1,5,4,4,2,0,9,17,22,24,24.4
2023-24,202402130ORL,2/13/2024,ORL vs OKC,Shai Gilgeous-Alexander,gilgesh01,53,OKC,0,ORL,32,3,5,2,1,1,34.28333333,0,3,11,24,1,1,9,10,5,3,8,37,35,40,51.1
2023-24,202402130POR,2/13/2024,POR vs MIN,Anthony Edwards,edwaran01,51,MIN,0,POR,41,4,2,2,1,2,34.3,0,4,16,27,4,8,5,5,1,3,6,43,45,47,55.8
2023-24,202402130BRK,2/13/2024,BRK vs BOS,Cam Thomas,thomaca02,44,BRK,1,BOS,26,2,4,2,0,3,34.38333333,1,1,10,20,4,7,2,2,5,2,6,30,28,32,37.4
2023-24,202402130POR,2/13/2024,POR vs MIN,Jerami Grant,grantje01,46,POR,1,MIN,12,1,4,1,0,3,34.7,1,0,5,17,2,7,0,0,3,1,5,16,13,17,19.2
2023-24,202402130ORL,2/13/2024,ORL vs OKC,Jalen Williams,willija06,48,OKC,0,ORL,33,2,3,1,0,3,34.81666667,0,2,12,18,3,6,6,7,3,1,5,36,35,38,39.9
2023-24,202402130BRK,2/13/2024,BRK vs BOS,Jrue Holiday,holidjr01,49,BOS,0,BRK,14,5,12,2,0,3,35.2,0,5,6,10,2,4,0,0,5,2,17,26,19,31,41
2023-24,202402130ORL,2/13/2024,ORL vs OKC,Paolo Banchero,banchpa01,54,ORL,1,OKC,23,6,10,0,1,4,35.45,0,6,9,15,0,3,5,6,1,1,16,33,29,39,44.2
2023-24,202402130BRK,2/13/2024,BRK vs BOS,Al Horford,horfoal01,45,BOS,0,BRK,16,6,4,1,0,0,36.56666667,1,5,6,6,2,2,2,2,0,1,10,20,22,26,32.2
2023-24,202402130PHO,2/13/2024,PHO vs SAC,Harrison Barnes,barneha02,53,SAC,0,PHO,9,5,0,0,0,0,37.08333333,1,4,4,8,1,4,0,0,3,0,5,9,14,14,15
2023-24,202402130BRK,2/13/2024,BRK vs BOS,Jaylen Brown,brownja02,50,BOS,0,BRK,19,1,4,1,0,4,37.43333333,1,0,7,19,1,6,4,6,5,1,5,23,20,24,25.2
2023-24,202402130POR,2/13/2024,POR vs MIN,Rudy Gobert,goberru01,53,MIN,0,POR,16,15,1,0,1,1,37.45,6,9,7,10,0,0,2,4,3,1,16,17,31,32,37.5
2023-24,202402130PHO,2/13/2024,PHO vs SAC,Kevin Durant,duranke01,47,PHO,1,SAC,28,11,4,1,0,3,38.05,2,9,11,17,2,5,4,6,2,1,15,32,39,43,47.2
2023-24,202402130BRK,2/13/2024,BRK vs BOS,Derrick White,whitede01,50,BOS,0,BRK,16,2,3,0,0,2,38.31666667,0,2,6,11,3,6,1,1,1,0,5,19,18,21,20.9
2023-24,202402130PHO,2/13/2024,PHO vs SAC,Devin Booker,bookede01,44,PHO,1,SAC,25,3,9,3,0,3,38.45,1,2,7,17,0,2,11,13,3,3,12,34,28,37,48.1
2023-24,202402130PHO,2/13/2024,PHO vs SAC,Domantas Sabonis,sabondo01,53,SAC,0,PHO,35,18,12,1,3,1,38.96666667,9,9,14,22,0,2,7,8,4,4,30,47,53,65,85.6
2023-24,202402130BRK,2/13/2024,BRK vs BOS,Jayson Tatum,tatumja01,51,BOS,0,BRK,41,14,5,2,1,2,38.98333333,0,14,14,26,5,11,8,8,3,3,19,46,55,60,72.3
2023-24,202402130PHO,2/13/2024,PHO vs SAC,Grayson Allen,allengr01,48,PHO,1,SAC,19,4,4,0,1,2,39.48333333,1,3,7,10,2,5,3,3,3,1,8,23,23,27,30.8
2023-24,202402130BRK,2/13/2024,BRK vs BOS,Mikal Bridges,bridgmi01,53,BRK,1,BOS,27,2,3,1,0,2,39.78333333,0,2,10,20,3,8,4,4,3,1,5,30,29,32,34.9
2023-24,202402130PHO,2/13/2024,PHO vs SAC,De'Aaron Fox,foxde01,47,SAC,0,PHO,40,9,6,3,0,6,39.83333333,4,5,14,31,5,12,7,10,4,3,15,46,49,55,62.8
2023-24,202402120TOR,2/12/2024,TOR vs SAS,Julian Champagnie,champju02,47,SAS,0,TOR,2,1,0,0,0,1,10.16666667,0,1,1,3,0,2,0,0,0,0,1,2,3,3,2.2
2023-24,202402120UTA,2/12/2024,UTA vs GSW,Kevon Looney,looneke01,51,GSW,0,UTA,0,4,2,0,0,0,10.98333333,1,3,0,2,0,0,0,0,1,0,6,2,4,6,7.8
2023-24,202402120ATL,2/12/2024,ATL vs CHI,Bruno Fernando,fernabr01,17,ATL,1,CHI,4,7,0,0,0,0,11.51666667,4,3,2,5,0,0,0,0,3,0,7,4,11,11,12.4
2023-24,202402120CHO,2/12/2024,CHO vs IND,Davis Bertans,bertada01,17,CHO,1,IND,3,0,0,0,0,0,11.56666667,0,0,1,6,1,6,0,0,1,0,0,3,3,3,3
2023-24,202402120UTA,2/12/2024,UTA vs GSW,Dario Saric,saricda01,49,GSW,0,UTA,0,3,1,0,0,0,11.6,0,3,0,3,0,2,0,0,1,0,4,1,3,4,5.1
2023-24,202402120DAL,2/12/2024,DAL vs WAS,Derrick Jones Jr.,jonesde02,49,DAL,1,WAS,2,2,0,1,0,1,11.96666667,1,1,1,2,0,0,0,0,1,1,2,2,4,4,6.4
2023-24,202402120HOU,2/12/2024,HOU vs NYK,Jae'Sean Tate,tateja01,50,HOU,1,NYK,2,1,0,4,0,1,12.38333333,1,0,1,4,0,0,0,0,2,4,1,2,3,3,14.2
2023-24,202402120DAL,2/12/2024,DAL vs WAS,Richaun Holmes,holmeri01,24,WAS,0,DAL,10,2,0,0,1,0,12.55,1,1,5,7,0,0,0,0,3,1,2,10,12,12,15.4
2023-24,202402120DAL,2/12/2024,DAL vs WAS,Jaden Hardy,hardyja02,49,DAL,1,WAS,10,2,0,0,0,1,12.91666667,0,2,4,9,2,4,0,0,1,0,2,10,12,12,11.4
2023-24,202402120MEM,2/12/2024,MEM vs NOP,Naji Marshall,marshna01,43,NOP,0,MEM,5,7,0,0,0,0,13.05,2,5,2,4,1,2,0,0,1,0,7,5,12,12,13.4
2023-24,202402120MIL,2/12/2024,MIL vs DEN,Collin Gillespie,gilleco01,17,DEN,0,MIL,6,1,1,2,0,3,13.18333333,0,1,2,4,2,4,0,0,0,2,2,7,7,8,11.7
2023-24,202402120DAL,2/12/2024,DAL vs WAS,Landry Shamet,shamela01,36,WAS,0,DAL,6,1,0,2,1,0,13.9,0,1,2,5,2,4,0,0,2,3,1,6,7,7,16.2
2023-24,202402120CHO,2/12/2024,CHO vs IND,Bennedict Mathurin,mathube01,53,IND,0,CHO,0,2,1,0,0,1,14.65,0,2,0,4,0,1,0,0,0,0,3,1,2,3,2.9
2023-24,202402120TOR,2/12/2024,TOR vs SAS,Cedi Osman,osmande01,54,SAS,0,TOR,5,3,2,2,0,2,14.71666667,0,3,2,4,1,3,0,0,2,2,5,7,8,10,15.6
2023-24,202402120CHO,2/12/2024,CHO vs IND,T.J. McConnell,mccontj01,45,IND,0,CHO,8,3,2,0,0,3,14.81666667,0,3,4,7,0,0,0,0,1,0,5,10,11,13,11.6
2023-24,202402120MEM,2/12/2024,MEM vs NOP,Jose Alvarado,alvarjo01,36,NOP,0,MEM,10,3,0,2,0,1,14.93333333,0,3,3,7,2,5,2,2,2,2,3,10,13,13,18.6
2023-24,202402120HOU,2/12/2024,HOU vs NYK,Jeff Green,greenje02,51,HOU,1,NYK,0,1,0,0,0,0,15.15,0,1,0,3,0,1,0,0,1,0,1,0,1,1,1.2
2023-24,202402120UTA,2/12/2024,UTA vs GSW,Gary Payton II,paytoga02,18,GSW,0,UTA,11,2,2,0,0,1,15.35,1,1,4,4,1,1,2,2,1,0,4,13,13,15,15.4
2023-24,202402120MEM,2/12/2024,MEM vs NOP,John Konchar,konchjo01,43,MEM,1,NOP,2,3,2,2,1,1,15.36666667,0,3,1,2,0,1,0,0,1,3,5,4,5,7,16.6
2023-24,202402120MIL,2/12/2024,MIL vs DEN,A.J. Green,greenaj01,34,MIL,1,DEN,9,0,1,0,0,0,15.41666667,0,0,3,5,3,5,0,0,2,0,1,10,9,10,10.5
2023-24,202402120UTA,2/12/2024,UTA vs GSW,Talen Horton-Tucker,hortota01,34,UTA,1,GSW,13,3,4,2,0,2,16.13333333,1,2,5,9,1,3,2,2,2,2,7,17,16,20,26.6
2023-24,202402120ATL,2/12/2024,ATL vs CHI,Andre Drummond,drumman01,54,CHI,0,ATL,7,11,0,0,0,0,16.16666667,3,8,3,7,0,1,1,2,2,0,11,7,18,18,20.2
2023-24,202402120UTA,2/12/2024,UTA vs GSW,Lester Quinones,quinole01,17,GSW,0,UTA,0,2,2,1,0,1,16.28333333,0,2,0,3,0,2,0,0,1,1,4,2,2,4,7.4
2023-24,202402120LAC,2/12/2024,LAC vs MIN,Norman Powell,powelno01,52,LAC,1,MIN,6,2,0,0,0,1,16.55,0,2,2,7,1,2,1,2,1,0,2,6,8,8,7.4
2023-24,202402120CHO,2/12/2024,CHO vs IND,Isaiah Jackson,jacksis01,43,IND,0,CHO,4,2,1,2,1,0,16.56666667,0,2,2,3,0,0,0,2,1,3,3,5,6,7,16.9
2023-24,202402120CHO,2/12/2024,CHO vs IND,Obi Toppin,toppiob01,56,IND,0,CHO,6,4,1,0,0,1,16.9,1,3,2,5,2,4,0,0,0,0,5,7,10,11,11.3
2023-24,202402120HOU,2/12/2024,HOU vs NYK,Alec Burks,burksal01,45,NYK,0,HOU,5,1,2,0,0,1,16.91666667,1,0,1,8,1,5,2,2,1,0,3,7,6,8,8.2
2023-24,202402120MEM,2/12/2024,MEM vs NOP,Jonas Valanciunas,valanjo01,54,NOP,0,MEM,6,6,3,0,1,1,17.5,2,4,1,4,0,1,4,6,3,1,9,9,12,15,19.7
2023-24,202402120TOR,2/12/2024,TOR vs SAS,Ochai Agbaji,agbajoc01,53,TOR,1,SAS,2,2,1,1,0,1,17.51666667,2,0,1,8,0,3,0,0,0,1,3,3,4,5,7.9
2023-24,202402120MIL,2/12/2024,MIL vs DEN,Jamal Murray,murraja01,40,DEN,0,MIL,3,2,0,0,0,2,17.55,0,2,1,5,1,3,0,0,0,0,2,3,5,5,3.4
2023-24,202402120MEM,2/12/2024,MEM vs NOP,Trey Jemison,jemistr01,8,MEM,1,NOP,6,5,1,1,3,2,17.73333333,0,5,3,4,0,0,0,0,4,4,6,7,11,12,23.5
2023-24,202402120CLE,2/12/2024,CLE vs PHI,Georges Niang,niangge01,52,CLE,1,PHI,0,5,0,0,1,1,18.11666667,1,4,0,4,0,2,0,0,2,1,5,0,5,5,8
2023-24,202402120LAC,2/12/2024,LAC vs MIN,Monte Morris,morrimo01,7,MIN,0,LAC,5,2,2,1,1,0,18.46666667,0,2,2,5,1,4,0,0,1,2,4,7,7,9,16.4
2023-24,202402120MIL,2/12/2024,MIL vs DEN,Justin Holiday,holidju01,31,DEN,0,MIL,5,2,1,0,0,0,18.88333333,0,2,2,6,1,5,0,0,2,0,3,6,7,8,8.9
2023-24,202402120CHO,2/12/2024,CHO vs IND,Seth Curry,curryse01,38,CHO,1,IND,18,2,2,1,0,0,18.9,0,2,7,11,2,5,2,2,0,1,4,20,20,22,26.4
2023-24,202402120CLE,2/12/2024,CLE vs PHI,Mo Bamba,bambamo01,31,PHI,0,CLE,7,8,1,0,1,1,19.01666667,2,6,3,6,1,2,0,0,1,1,9,8,15,16,20.1
2023-24,202402120TOR,2/12/2024,TOR vs SAS,Zach Collins,colliza01,42,SAS,0,TOR,6,2,3,1,0,0,19.01666667,1,1,2,5,0,1,2,2,2,1,5,9,8,11,15.9
2023-24,202402120UTA,2/12/2024,UTA vs GSW,Taylor Hendricks,hendrita0,15,UTA,1,GSW,0,4,0,0,1,2,19.28333333,0,4,0,2,0,2,0,0,4,1,4,0,4,4,5.8
2023-24,202402120UTA,2/12/2024,UTA vs GSW,Kris Dunn,dunnkr01,46,UTA,1,GSW,2,2,3,3,0,1,19.48333333,1,1,1,6,0,3,0,0,2,3,5,5,4,7,16.9
2023-24,202402120MIL,2/12/2024,MIL vs DEN,Patrick Beverley,beverpa01,49,MIL,1,DEN,5,1,4,1,0,1,19.7,0,1,2,5,1,2,0,0,4,1,5,9,6,10,14.2
2023-24,202402120TOR,2/12/2024,TOR vs SAS,Blake Wesley,weslebl01,33,SAS,0,TOR,10,2,2,1,0,4,19.91666667,0,2,3,5,1,1,3,4,1,1,4,12,12,14,14.4
2023-24,202402120TOR,2/12/2024,TOR vs SAS,Jakob Poeltl,poeltja01,43,TOR,1,SAS,12,6,1,0,0,0,20.03333333,3,3,5,10,0,0,2,2,2,0,7,13,18,19,20.7
2023-24,202402120LAC,2/12/2024,LAC vs MIN,Kyle Anderson,anderky01,53,MIN,0,LAC,5,2,6,2,0,0,20.41666667,1,1,2,6,1,1,0,0,1,2,8,11,7,13,22.4
2023-24,202402120CLE,2/12/2024,CLE vs PHI,Ricky Council IV,councri01,13,PHI,0,CLE,8,5,0,0,0,0,20.63333333,1,4,2,7,0,2,4,5,1,0,5,8,13,13,14
2023-24,202402120ATL,2/12/2024,ATL vs CHI,Dalen Terry,terryda01,34,CHI,0,ATL,7,4,1,1,0,0,20.71666667,0,4,3,3,1,1,0,0,3,1,5,8,11,12,16.3
2023-24,202402120TOR,2/12/2024,TOR vs SAS,Malaki Branham,branhma01,49,SAS,0,TOR,10,0,3,0,0,0,20.96666667,0,0,4,12,1,4,1,1,1,0,3,13,10,13,14.5
2023-24,202402120TOR,2/12/2024,TOR vs SAS,Kelly Olynyk,olynyke01,52,TOR,1,SAS,17,5,2,3,0,1,21.03333333,0,5,6,10,1,4,4,4,3,3,7,19,22,24,34
2023-24,202402120MIL,2/12/2024,MIL vs DEN,Peyton Watson,watsope01,52,DEN,0,MIL,5,4,1,0,0,0,21.1,1,3,2,6,0,2,1,1,2,0,5,6,9,10,11.3
2023-24,202402120CHO,2/12/2024,CHO vs IND,Vasilije Micic,micicva01,32,CHO,1,IND,2,3,4,0,0,2,21.18333333,1,2,1,3,0,1,0,0,3,0,7,6,5,9,9.6
2023-24,202402120TOR,2/12/2024,TOR vs SAS,Gradey Dick,dickgr01,33,TOR,1,SAS,18,2,0,0,0,1,21.75,1,1,7,10,4,5,0,0,1,0,2,18,20,20,19.4
2023-24,202402120TOR,2/12/2024,TOR vs SAS,Gary Trent Jr.,trentga02,49,TOR,1,SAS,4,1,0,2,0,2,21.78333333,0,1,2,7,0,0,0,0,1,2,1,4,5,5,9.2
2023-24,202402120DAL,2/12/2024,DAL vs WAS,Tim Hardaway Jr.,hardati02,51,DAL,1,WAS,5,3,1,1,1,1,21.96666667,0,3,2,13,1,7,0,0,3,2,4,6,8,9,15.1
2023-24,202402120MIL,2/12/2024,MIL vs DEN,Reggie Jackson,jacksre01,54,DEN,0,MIL,7,1,3,0,0,0,22.1,0,1,3,7,1,2,0,0,0,0,4,10,8,11,12.7
2023-24,202402120MIL,2/12/2024,MIL vs DEN,Pat Connaughton,connapa01,48,MIL,1,DEN,5,5,5,1,1,0,22.33333333,0,5,2,2,1,1,0,0,0,2,10,10,10,15,24.5
2023-24,202402120MIL,2/12/2024,MIL vs DEN,Christian Braun,braunch01,54,DEN,0,MIL,7,5,0,2,0,0,22.41666667,0,5,2,7,0,3,3,4,2,2,5,7,12,12,19
2023-24,202402120LAC,2/12/2024,LAC vs MIN,Ivica Zubac,zubaciv01,42,LAC,1,MIN,6,11,2,0,1,2,22.6,5,6,2,5,0,0,2,2,4,1,13,8,17,19,23.2
2023-24,202402120MIL,2/12/2024,MIL vs DEN,Damian Lillard,lillada01,49,MIL,1,DEN,18,3,5,0,0,2,22.7,1,2,6,15,2,5,4,4,3,0,8,23,21,26,27.1
2023-24,202402120MIL,2/12/2024,MIL vs DEN,Jae Crowder,crowdja01,23,MIL,1,DEN,2,1,1,2,0,1,22.9,0,1,1,4,0,2,0,0,0,2,2,3,3,4,9.7
2023-24,202402120HOU,2/12/2024,HOU vs NYK,Bojan Bogdanovic,bogdabo02,30,NYK,0,HOU,15,4,0,0,1,1,23.01666667,0,4,7,13,1,5,0,1,2,1,4,15,19,19,21.8
2023-24,202402120CLE,2/12/2024,CLE vs PHI,Isaac Okoro,okorois01,43,CLE,1,PHI,8,5,1,0,1,0,23.15,3,2,2,6,2,4,2,2,2,1,6,9,13,14,18.5
2023-24,202402120UTA,2/12/2024,UTA vs GSW,Draymond Green,greendr01,27,GSW,0,UTA,12,10,8,1,1,1,23.48333333,2,8,5,7,2,4,0,0,4,2,18,20,22,30,41
2023-24,202402120LAC,2/12/2024,LAC vs MIN,Nickeil Alexander-Walker,alexani01,53,MIN,0,LAC,15,2,5,2,0,2,23.8,0,2,6,9,3,3,0,0,2,2,7,20,17,22,28.9
2023-24,202402120DAL,2/12/2024,DAL vs WAS,Maxi Kleber,klebima01,19,DAL,1,WAS,5,5,0,0,1,2,23.86666667,1,4,2,5,1,3,0,1,1,1,5,5,10,10,12
2023-24,202402120TOR,2/12/2024,TOR vs SAS,RJ Barrett,barrerj01,44,TOR,1,SAS,13,5,2,1,0,4,24.08333333,2,3,6,10,0,2,1,2,3,1,7,15,18,20,21
2023-24,202402120DAL,2/12/2024,DAL vs WAS,Daniel Gafford,gaffoda01,47,DAL,1,WAS,16,17,2,2,5,2,24.11666667,7,10,7,13,0,0,2,3,0,7,19,18,33,35,58.4
2023-24,202402120LAC,2/12/2024,LAC vs MIN,Mike Conley,conlemi01,48,MIN,0,LAC,5,4,7,2,0,1,24.15,1,3,2,5,1,3,0,0,1,2,11,12,9,16,25.3
2023-24,202402120CLE,2/12/2024,CLE vs PHI,Cameron Payne,payneca01,50,PHI,0,CLE,15,2,4,0,0,0,24.31666667,0,2,4,10,1,3,6,6,1,0,6,19,17,21,23.4
2023-24,202402120DAL,2/12/2024,DAL vs WAS,Corey Kispert,kispeco01,52,WAS,0,DAL,5,4,1,0,0,1,24.45,1,3,2,11,1,7,0,0,2,0,5,6,9,10,10.3
2023-24,202402120MEM,2/12/2024,MEM vs NOP,Scotty Pippen Jr.,pippesc02,8,MEM,1,NOP,6,3,6,0,1,0,24.66666667,2,1,2,7,2,5,0,0,3,1,9,12,9,15,21.6
2023-24,202402120UTA,2/12/2024,UTA vs GSW,Brandin Podziemski,podzibr01,45,GSW,0,UTA,10,4,3,1,0,4,24.91666667,0,4,4,9,2,3,0,0,1,1,7,13,14,17,18.3
2023-24,202402120MEM,2/12/2024,MEM vs NOP,Yuta Watanabe,watanyu01,30,MEM,1,NOP,11,2,1,2,0,1,25,0,2,5,12,1,7,0,0,1,2,3,12,13,14,19.9
2023-24,202402120MEM,2/12/2024,MEM vs NOP,Trey Murphy III,murphtr02,29,NOP,0,MEM,9,3,2,1,1,0,25.1,1,2,3,8,1,5,2,2,0,2,5,11,12,14,21.6
2023-24,202402120LAC,2/12/2024,LAC vs MIN,Terance Mann,mannte01,46,LAC,1,MIN,2,2,1,1,0,1,25.21666667,0,2,1,3,0,0,0,0,1,1,3,3,4,5,7.9
2023-24,202402120ATL,2/12/2024,ATL vs CHI,Jevon Carter,carteje01,51,CHI,0,ATL,11,2,2,1,0,1,25.23333333,0,2,4,8,3,6,0,0,3,1,4,13,13,15,18.4
2023-24,202402120MIL,2/12/2024,MIL vs DEN,Bobby Portis,portibo01,54,MIL,1,DEN,13,8,3,0,0,3,25.35,1,7,6,14,1,3,0,0,2,0,11,16,21,24,24.1
2023-24,202402120LAC,2/12/2024,LAC vs MIN,Jaden McDaniels,mcdanja02,43,MIN,0,LAC,11,0,1,1,1,2,25.41666667,0,0,5,8,1,4,0,0,3,2,1,12,11,12,16.5
2023-24,202402120TOR,2/12/2024,TOR vs SAS,Immanuel Quickley,quickim01,49,TOR,1,SAS,7,3,3,1,1,3,25.53333333,0,3,2,12,1,9,2,2,2,2,6,10,10,13,18.1
2023-24,202402120UTA,2/12/2024,UTA vs GSW,Walker Kessler,kesslwa01,46,UTA,1,GSW,11,9,1,2,4,2,25.8,1,8,5,7,0,0,1,1,2,6,10,12,20,21,39.3
2023-24,202402120CLE,2/12/2024,CLE vs PHI,KJ Martin,martike04,39,PHI,0,CLE,10,8,1,0,0,2,25.88333333,3,5,5,5,0,0,0,0,4,0,9,11,18,19,19.1
2023-24,202402120LAC,2/12/2024,LAC vs MIN,Amir Coffey,coffeam01,40,LAC,1,MIN,10,1,2,0,0,0,25.98333333,0,1,4,5,1,1,1,1,2,0,3,12,11,13,14.2
2023-24,202402120UTA,2/12/2024,UTA vs GSW,Collin Sexton,sextoco01,54,UTA,1,GSW,22,6,5,0,0,2,26.05,2,4,9,15,2,3,2,4,1,0,11,27,28,33,34.7
2023-24,202402120HOU,2/12/2024,HOU vs NYK,Aaron Holiday,holidaa01,50,HOU,1,NYK,18,3,4,0,0,0,26.1,1,2,7,14,2,6,2,4,3,0,7,22,21,25,27.6
2023-24,202402120CHO,2/12/2024,CHO vs IND,Nick Richards,richani01,44,CHO,1,IND,13,9,1,0,1,2,26.21666667,3,6,6,6,0,0,1,3,3,1,10,14,22,23,26.3
2023-24,202402120MEM,2/12/2024,MEM vs NOP,Lamar Stevens,stevela01,20,MEM,1,NOP,10,7,0,0,2,2,26.33333333,1,6,5,10,0,1,0,0,3,2,7,10,17,17,22.4
2023-24,202402120DAL,2/12/2024,DAL vs WAS,Jordan Poole,poolejo01,51,WAS,0,DAL,3,6,3,3,1,1,26.5,0,6,1,12,1,6,0,0,4,4,9,6,9,12,25.7
2023-24,202402120CLE,2/12/2024,CLE vs PHI,Caris LeVert,leverca01,42,CLE,1,PHI,11,4,6,0,1,1,26.66666667,2,2,5,14,1,6,0,0,4,1,10,17,15,21,26.8
2023-24,202402120LAC,2/12/2024,LAC vs MIN,Naz Reid,reidna01,53,MIN,0,LAC,11,7,1,0,0,2,26.73333333,0,7,5,9,1,2,0,0,3,0,8,12,18,19,18.9
2023-24,202402120ATL,2/12/2024,ATL vs CHI,Bogdan Bogdanovic,bogdabo01,52,ATL,1,CHI,28,2,4,1,0,1,26.88333333,1,1,11,16,6,10,0,0,1,1,6,32,30,34,38.4
2023-24,202402120LAC,2/12/2024,LAC vs MIN,Karl-Anthony Towns,townska01,52,MIN,0,LAC,24,4,3,0,1,1,27.03333333,0,4,8,12,1,5,7,8,3,1,7,27,28,31,35.3
2023-24,202402120UTA,2/12/2024,UTA vs GSW,Jonathan Kuminga,kuminjo01,50,GSW,0,UTA,14,2,0,0,1,3,27.1,1,1,4,10,1,1,5,6,2,1,2,14,16,16,16.4
2023-24,202402120TOR,2/12/2024,TOR vs SAS,Devin Vassell,vassede01,49,SAS,0,TOR,25,3,6,1,0,0,27.38333333,1,2,9,15,5,7,2,2,1,1,9,31,28,34,40.6
2023-24,202402120ATL,2/12/2024,ATL vs CHI,Torrey Craig,craigto01,32,CHI,0,ATL,9,6,5,1,1,1,27.48333333,1,5,3,5,2,4,1,2,4,2,11,14,15,20,28.7
2023-24,202402120CLE,2/12/2024,CLE vs PHI,Evan Mobley,mobleev01,29,CLE,1,PHI,14,10,3,2,4,1,27.88333333,2,8,6,11,1,2,1,2,2,6,13,17,24,27,47.5
2023-24,202402120DAL,2/12/2024,DAL vs WAS,Marvin Bagley III,baglema01,36,WAS,0,DAL,12,13,2,1,1,1,28.06666667,5,8,6,10,0,0,0,0,3,2,15,14,25,27,35.6
2023-24,202402120TOR,2/12/2024,TOR vs SAS,Tre Jones,jonestr01,49,SAS,0,TOR,7,7,10,1,0,1,28.08333333,0,7,3,6,1,2,0,0,1,1,17,17,14,24,32.4
2023-24,202402120TOR,2/12/2024,TOR vs SAS,Keldon Johnson,johnske04,50,SAS,0,TOR,12,4,6,3,1,0,28.11666667,0,4,4,8,0,2,4,5,1,4,10,18,16,22,37.8
2023-24,202402120UTA,2/12/2024,UTA vs GSW,Andrew Wiggins,wiggian01,46,GSW,0,UTA,17,2,0,1,0,1,28.13333333,0,2,6,10,3,3,2,3,1,1,2,17,19,19,21.4
2023-24,202402120ATL,2/12/2024,ATL vs CHI,De'Andre Hunter,huntede01,30,ATL,1,CHI,23,6,0,1,2,2,28.21666667,2,4,6,14,4,7,7,7,4,3,6,23,29,29,37.2
2023-24,202402120UTA,2/12/2024,UTA vs GSW,John Collins,collijo01,50,UTA,1,GSW,11,7,5,0,1,3,28.35,2,5,3,6,0,1,5,5,0,1,12,16,18,23,26.9
2023-24,202402120MIL,2/12/2024,MIL vs DEN,Aaron Gordon,gordoaa01,48,DEN,0,MIL,14,7,2,1,2,1,28.45,1,6,6,11,2,4,0,0,2,3,9,16,21,23,33.4
2023-24,202402120MEM,2/12/2024,MEM vs NOP,Luke Kennard,kennalu01,26,MEM,1,NOP,12,3,1,0,0,2,28.61666667,0,3,4,10,4,9,0,0,1,0,4,13,15,16,15.1
2023-24,202402120CLE,2/12/2024,CLE vs PHI,Paul Reed,reedpa01,53,PHI,0,CLE,13,8,1,2,2,0,28.66666667,3,5,6,10,0,1,1,1,1,4,9,14,21,22,36.1
2023-24,202402120CHO,2/12/2024,CHO vs IND,Brandon Miller,millebr02,47,CHO,1,IND,12,4,1,0,0,1,28.68333333,0,4,4,8,2,5,2,2,4,0,5,13,16,17,17.3
2023-24,202402120HOU,2/12/2024,HOU vs NYK,Jericho Sims,simsje01,27,NYK,0,HOU,4,7,0,0,0,1,28.73333333,3,4,2,3,0,0,0,0,4,0,7,4,11,11,11.4
2023-24,202402120TOR,2/12/2024,TOR vs SAS,Victor Wembanyama,wembavi01,48,SAS,0,TOR,27,14,5,2,10,7,28.98333333,2,12,10,14,2,4,5,6,2,12,19,32,41,46,80.3
2023-24,202402120LAC,2/12/2024,LAC vs MIN,Russell Westbrook,westbru01,52,LAC,1,MIN,11,2,3,2,0,1,29,0,2,3,11,1,5,4,5,2,2,5,14,13,16,22.9
2023-24,202402120DAL,2/12/2024,DAL vs WAS,Josh Green,greenjo02,41,DAL,1,WAS,13,4,2,2,1,0,29.06666667,1,3,5,8,1,3,2,3,4,3,6,15,17,19,29.8
2023-24,202402120MIL,2/12/2024,MIL vs DEN,Brook Lopez,lopezbr01,51,MIL,1,DEN,9,5,3,0,3,1,29.08333333,1,4,3,9,3,7,0,0,2,3,8,12,14,17,27.5
2023-24,202402120UTA,2/12/2024,UTA vs GSW,Keyonte George,georgke01,48,UTA,1,GSW,5,1,4,0,0,2,29.31666667,0,1,2,10,1,6,0,0,1,0,5,9,6,10,10.2
2023-24,202402120MEM,2/12/2024,MEM vs NOP,Santi Aldama,aldamsa01,42,MEM,1,NOP,6,4,5,0,1,1,29.45,0,4,2,9,2,8,0,0,0,1,9,11,10,15,20.3
2023-24,202402120LAC,2/12/2024,LAC vs MIN,Paul George,georgpa01,49,LAC,1,MIN,18,6,3,1,0,0,29.78333333,0,6,5,16,2,8,6,6,2,1,9,21,24,27,32.7
2023-24,202402120CHO,2/12/2024,CHO vs IND,Cody Martin,martico01,21,CHO,1,IND,11,5,2,1,1,3,29.78333333,0,5,5,8,1,2,0,0,2,2,7,13,16,18,23
2023-24,202402120HOU,2/12/2024,HOU vs NYK,Jalen Green,greenja05,53,HOU,1,NYK,16,5,4,2,0,1,29.8,0,5,4,15,0,6,8,9,0,2,9,20,21,25,33
2023-24,202402120CLE,2/12/2024,CLE vs PHI,Max Strus,strusma01,52,CLE,1,PHI,10,4,4,0,0,1,29.88333333,2,2,4,7,2,5,0,0,3,0,8,14,14,18,19.8
2023-24,202402120UTA,2/12/2024,UTA vs GSW,Klay Thompson,thompkl01,48,GSW,0,UTA,26,6,2,0,0,1,29.91666667,1,5,11,19,3,7,1,1,0,0,8,28,32,34,35.2
2023-24,202402120TOR,2/12/2024,TOR vs SAS,Jeremy Sochan,sochaje01,54,SAS,0,TOR,16,6,0,1,2,2,30.05,0,6,7,12,0,2,2,2,2,3,6,16,22,22,30.2
2023-24,202402120LAC,2/12/2024,LAC vs MIN,Kawhi Leonard,leonaka01,48,LAC,1,MIN,18,4,1,1,0,3,30.1,4,0,8,17,1,3,1,1,2,1,5,19,22,23,24.3
2023-24,202402120TOR,2/12/2024,TOR vs SAS,Scottie Barnes,barnesc01,54,TOR,1,SAS,7,9,9,1,1,5,30.23333333,5,4,3,15,1,3,0,1,3,2,18,16,16,25,32.3
2023-24,202402120MEM,2/12/2024,MEM vs NOP,Larry Nance Jr.,nancela02,36,NOP,0,MEM,8,9,3,1,0,1,30.26666667,2,7,3,4,1,2,1,2,3,1,12,11,17,20,25.3
2023-24,202402120MIL,2/12/2024,MIL vs DEN,Malik Beasley,beaslma01,52,MIL,1,DEN,9,5,1,0,0,0,30.38333333,1,4,3,6,3,6,0,0,0,0,6,10,14,15,16.5
2023-24,202402120MIL,2/12/2024,MIL vs DEN,Giannis Antetokounmpo,antetgi01,52,MIL,1,DEN,36,18,5,3,2,2,30.4,4,14,14,19,0,0,8,14,2,5,23,41,54,59,78.1
2023-24,202402120DAL,2/12/2024,DAL vs WAS,Bilal Coulibaly,coulibi01,52,WAS,0,DAL,4,7,1,0,2,1,30.4,4,3,1,10,1,4,1,2,2,2,8,5,11,12,18.9
2023-24,202402120CLE,2/12/2024,CLE vs PHI,Darius Garland,garlada01,28,CLE,1,PHI,21,0,9,1,0,0,30.65,0,0,9,16,3,8,0,0,0,1,9,30,21,30,37.5
2023-24,202402120MIL,2/12/2024,MIL vs DEN,Michael Porter Jr.,portemi01,53,DEN,0,MIL,11,6,4,1,0,2,30.8,3,3,3,11,2,8,3,3,2,1,10,15,17,21,25.2
2023-24,202402120TOR,2/12/2024,TOR vs SAS,Bruce Brown,brownbr01,47,TOR,1,SAS,12,5,4,1,0,1,31.03333333,1,4,5,8,1,2,1,1,1,1,9,16,17,21,26
2023-24,202402120CHO,2/12/2024,CHO vs IND,Grant Williams,willigr01,49,CHO,1,IND,21,4,3,0,1,2,31.16666667,0,4,6,12,2,6,7,8,3,1,7,24,25,28,31.3
2023-24,202402120CHO,2/12/2024,CHO vs IND,Myles Turner,turnemy01,53,IND,0,CHO,22,5,1,2,2,1,31.43333333,0,5,8,13,1,5,5,5,1,4,6,23,27,28,40.5
2023-24,202402120MIL,2/12/2024,MIL vs DEN,Nikola Jokic,jokicni01,52,DEN,0,MIL,29,12,8,0,0,5,31.51666667,3,9,13,25,2,5,1,3,1,0,20,37,41,49,50.4
2023-24,202402120UTA,2/12/2024,UTA vs GSW,Stephen Curry,curryst01,48,GSW,0,UTA,25,6,10,3,1,1,32.08333333,0,6,9,19,7,16,0,0,1,4,16,35,31,41,58.2
2023-24,202402120DAL,2/12/2024,DAL vs WAS,Kyle Kuzma,kuzmaky01,52,WAS,0,DAL,23,8,0,1,0,4,32.08333333,0,8,9,19,1,7,4,5,4,1,8,23,31,31,31.6
2023-24,202402120LAC,2/12/2024,LAC vs MIN,James Harden,hardeja01,47,LAC,1,MIN,17,2,6,1,1,0,32.15,0,2,5,13,3,8,4,5,0,2,8,23,19,25,34.4
2023-24,202402120ATL,2/12/2024,ATL vs CHI,Saddiq Bey,beysa01,53,ATL,1,CHI,11,5,3,0,0,0,32.28333333,1,4,5,11,0,5,1,2,1,0,8,14,16,19,21.5
2023-24,202402120LAC,2/12/2024,LAC vs MIN,Anthony Edwards,edwaran01,50,MIN,0,LAC,23,7,8,1,0,1,32.4,0,7,8,18,1,11,6,6,2,1,15,31,30,38,45.4
2023-24,202402120ATL,2/12/2024,ATL vs CHI,Onyeka Okongwu,okongon01,53,ATL,1,CHI,11,12,1,0,1,0,32.51666667,5,7,5,8,0,1,1,2,3,1,13,12,23,24,29.9
2023-24,202402120UTA,2/12/2024,UTA vs GSW,Jordan Clarkson,clarkjo01,44,UTA,1,GSW,22,4,1,0,1,1,32.63333333,2,2,7,17,4,7,4,4,3,1,5,23,26,27,30.3
2023-24,202402120ATL,2/12/2024,ATL vs CHI,Coby White,whiteco01,54,CHI,0,ATL,20,4,7,1,0,1,32.75,1,3,8,17,1,5,3,4,1,1,11,27,24,31,37.3
2023-24,202402120DAL,2/12/2024,DAL vs WAS,Tyus Jones,jonesty01,53,WAS,0,DAL,14,3,16,2,0,2,33.01666667,0,3,6,13,0,1,2,2,1,2,19,30,17,33,45.6
2023-24,202402120MEM,2/12/2024,MEM vs NOP,CJ McCollum,mccolcj01,40,NOP,0,MEM,11,5,2,1,0,2,33.08333333,0,5,4,15,3,8,0,0,1,1,7,13,16,18,21
2023-24,202402120CHO,2/12/2024,CHO vs IND,Andrew Nembhard,nembhan01,41,IND,0,CHO,10,2,7,3,0,0,33.18333333,0,2,5,7,0,1,0,0,2,3,9,17,12,19,31.9
2023-24,202402120LAC,2/12/2024,LAC vs MIN,Rudy Gobert,goberru01,52,MIN,0,LAC,17,11,0,0,4,2,33.35,6,5,6,11,0,0,5,5,4,4,11,17,28,28,40.2
2023-24,202402120CHO,2/12/2024,CHO vs IND,Aaron Nesmith,nesmiaa01,51,IND,0,CHO,21,3,1,0,0,2,33.35,0,3,8,13,1,4,4,7,3,0,4,22,24,25,24.1
2023-24,202402120ATL,2/12/2024,ATL vs CHI,Dejounte Murray,murrade01,51,ATL,1,CHI,17,5,9,2,0,6,33.81666667,1,4,7,17,2,8,1,2,4,2,14,26,22,31,36.5
2023-24,202402120CHO,2/12/2024,CHO vs IND,Tre Mann,manntr01,15,CHO,1,IND,11,9,7,0,0,4,33.88333333,1,8,5,11,1,3,0,0,1,0,16,18,20,27,28.3
2023-24,202402120UTA,2/12/2024,UTA vs GSW,Lauri Markkanen,markkla01,44,UTA,1,GSW,19,5,0,1,0,1,33.88333333,0,5,8,17,3,7,0,0,1,1,5,19,24,24,27
2023-24,202402120DAL,2/12/2024,DAL vs WAS,Deni Avdija,avdijde01,53,WAS,0,DAL,25,7,3,0,1,5,33.93333333,1,6,11,17,1,3,2,6,3,1,10,28,32,35,35.9
2023-24,202402120ATL,2/12/2024,ATL vs CHI,Nikola Vucevic,vucevni01,49,CHI,0,ATL,24,11,2,1,0,0,34.1,2,9,8,16,1,2,7,9,3,1,13,26,35,37,43.2
2023-24,202402120CHO,2/12/2024,CHO vs IND,Tyrese Haliburton,halibty01,43,IND,0,CHO,13,6,12,0,0,3,34.16666667,1,5,5,15,3,8,0,0,1,0,18,25,19,31,35.2
2023-24,202402120MEM,2/12/2024,MEM vs NOP,Zion Williamson,willizi01,43,NOP,0,MEM,14,5,4,1,1,3,34.71666667,2,3,4,13,0,0,6,7,1,2,9,18,19,23,29
2023-24,202402120CHO,2/12/2024,CHO vs IND,Pascal Siakam,siakapa01,53,IND,0,CHO,18,5,4,2,0,0,34.75,0,5,8,12,1,3,1,2,1,2,9,22,23,27,36
2023-24,202402120ATL,2/12/2024,ATL vs CHI,Jalen Johnson,johnsja05,40,ATL,1,CHI,13,8,2,0,0,0,34.93333333,1,7,5,9,0,2,3,4,3,0,10,15,21,23,25.6
2023-24,202402120MEM,2/12/2024,MEM vs NOP,Herbert Jones,joneshe01,49,NOP,0,MEM,17,9,1,5,0,3,35.16666667,3,6,5,9,3,6,4,4,3,5,10,18,26,27,41.3
2023-24,202402120CLE,2/12/2024,CLE vs PHI,Buddy Hield,hieldbu01,56,PHI,0,CLE,24,4,8,1,0,3,35.55,0,4,9,13,5,8,1,1,6,1,12,32,28,36,40.8
2023-24,202402120HOU,2/12/2024,HOU vs NYK,Alperen Sengun,sengual01,52,HOU,1,NYK,18,3,6,1,3,3,35.6,0,3,6,10,0,0,6,8,3,4,9,24,21,27,39.6
2023-24,202402120DAL,2/12/2024,DAL vs WAS,P.J. Washington,washipj01,46,DAL,1,WAS,9,5,3,0,0,2,35.68333333,0,5,4,11,0,5,1,2,2,0,8,12,14,17,17.5
2023-24,202402120ATL,2/12/2024,ATL vs CHI,Trae Young,youngtr01,49,ATL,1,CHI,19,3,14,0,0,2,35.7,0,3,3,14,2,10,11,12,1,0,17,33,22,36,41.6
2023-24,202402120MEM,2/12/2024,MEM vs NOP,Jaren Jackson Jr.,jacksja02,50,MEM,1,NOP,22,6,3,1,0,4,35.8,0,6,8,19,2,8,4,5,2,1,9,25,28,31,32.7
2023-24,202402120MEM,2/12/2024,MEM vs NOP,Brandon Ingram,ingrabr01,50,NOP,0,MEM,16,2,6,1,1,6,36.18333333,0,2,7,14,2,6,0,1,4,2,8,22,18,24,27.4
2023-24,202402120HOU,2/12/2024,HOU vs NYK,Dillon Brooks,brookdi01,44,HOU,1,NYK,23,5,1,0,0,2,36.78333333,2,3,8,15,6,7,1,2,3,0,6,24,28,29,28.5
2023-24,202402120CLE,2/12/2024,CLE vs PHI,Jarrett Allen,allenja01,47,CLE,1,PHI,21,10,3,0,1,3,37,4,6,9,13,0,0,3,4,2,1,13,24,31,34,37.5
2023-24,202402120MEM,2/12/2024,MEM vs NOP,Vince Williams Jr.,willivi01,42,MEM,1,NOP,12,3,9,1,0,4,37.03333333,0,3,4,8,1,5,3,3,2,1,12,21,15,24,28.1
2023-24,202402120DAL,2/12/2024,DAL vs WAS,Luka Doncic,doncilu01,46,DAL,1,WAS,26,11,15,1,2,5,37.28333333,1,10,8,16,2,7,8,11,3,3,26,41,37,52,65.7
2023-24,202402120CLE,2/12/2024,CLE vs PHI,Donovan Mitchell,mitchdo01,43,CLE,1,PHI,36,4,6,3,0,3,37.36666667,1,3,9,20,4,9,14,17,2,3,10,42,40,46,55.8
2023-24,202402120HOU,2/12/2024,HOU vs NYK,Jabari Smith Jr.,smithja05,48,HOU,1,NYK,20,7,2,0,0,1,37.86666667,2,5,6,13,2,6,6,8,1,0,9,22,27,29,30.4
2023-24,202402120HOU,2/12/2024,HOU vs NYK,Amen Thompson,thompam01,34,HOU,1,NYK,8,13,5,5,0,3,38.28333333,6,7,4,5,0,0,0,2,2,5,18,13,21,26,43.1
2023-24,202402120ATL,2/12/2024,ATL vs CHI,DeMar DeRozan,derozde01,52,CHI,0,ATL,29,3,5,0,0,1,38.41666667,0,3,10,17,0,2,9,11,1,0,8,34,32,37,39.1
2023-24,202402120ATL,2/12/2024,ATL vs CHI,Ayo Dosunmu,dosunay01,52,CHI,0,ATL,29,2,7,1,1,2,38.53333333,0,2,12,18,5,7,0,1,2,2,9,36,31,38,45.9
2023-24,202402120CHO,2/12/2024,CHO vs IND,Miles Bridges,bridgmi02,42,CHO,1,IND,20,10,7,3,0,2,38.61666667,0,10,9,17,1,6,1,1,0,3,17,27,30,37,49.5
2023-24,202402120HOU,2/12/2024,HOU vs NYK,Precious Achiuwa,achiupr01,47,NYK,0,HOU,8,17,0,0,3,3,38.66666667,9,8,4,8,0,1,0,1,4,3,17,8,25,25,34.4
2023-24,202402120HOU,2/12/2024,HOU vs NYK,Jalen Brunson,brunsja01,51,NYK,0,HOU,27,4,7,0,0,5,38.8,0,4,10,25,2,6,5,8,4,0,11,34,31,38,37.3
2023-24,202402120HOU,2/12/2024,HOU vs NYK,Donte DiVincenzo,divindo01,54,NYK,0,HOU,23,5,4,2,0,3,40.95,2,3,9,21,5,14,0,0,3,2,9,27,28,32,38
2023-24,202402120CLE,2/12/2024,CLE vs PHI,Kelly Oubre Jr.,oubreke01,41,PHI,0,CLE,24,3,1,2,1,0,41.03333333,1,2,10,14,2,3,2,2,2,3,4,25,27,28,38.1
2023-24,202402120CLE,2/12/2024,CLE vs PHI,Tyrese Maxey,maxeyty01,48,PHI,0,CLE,22,4,9,0,0,4,41.81666667,1,3,9,21,2,5,2,4,5,0,13,31,26,35,36.3
2023-24,202402120HOU,2/12/2024,HOU vs NYK,Josh Hart,hartjo01,53,NYK,0,HOU,17,11,5,2,0,2,42.2,2,9,7,11,3,5,0,0,3,2,16,22,28,33,41.7
2023-24,202402120DAL,2/12/2024,DAL vs WAS,Kyrie Irving,irvinky01,32,DAL,1,WAS,26,7,4,0,2,2,42.9,1,6,10,19,2,7,4,6,3,2,11,30,33,37,44.4
2023-24,202402110OKC,2/11/2024,OKC vs SAC,Kenrich Williams,willike04,42,OKC,1,SAC,6,1,1,0,0,0,10.75,0,1,2,3,2,2,0,0,0,0,2,7,7,8,8.7
2023-24,202402110MIA,2/11/2024,MIA vs BOS,Sam Hauser,hausesa01,52,BOS,0,MIA,6,0,0,0,0,0,14.73333333,0,0,2,4,2,4,0,0,1,0,0,6,6,6,6
2023-24,202402110MIA,2/11/2024,MIA vs BOS,Kevin Love,loveke01,42,MIA,1,BOS,5,7,2,0,0,1,15.26666667,1,6,2,6,1,4,0,0,0,0,9,7,12,14,15.4
2023-24,202402110MIA,2/11/2024,MIA vs BOS,Payton Pritchard,pritcpa01,53,BOS,0,MIA,8,3,2,0,0,0,15.31666667,1,2,3,5,2,4,0,0,0,0,5,10,11,13,14.6
2023-24,202402110OKC,2/11/2024,OKC vs SAC,Isaiah Joe,joeis01,49,OKC,1,SAC,3,3,2,1,0,0,16.35,1,2,1,1,1,1,0,0,2,1,5,5,6,8,12.6
2023-24,202402110OKC,2/11/2024,OKC vs SAC,Aaron Wiggins,wiggiaa01,50,OKC,1,SAC,5,0,2,0,0,1,16.48333333,0,0,2,4,1,2,0,0,1,0,2,7,5,7,7
2023-24,202402110OKC,2/11/2024,OKC vs SAC,Kevin Huerter,huertke01,50,SAC,0,OKC,4,2,1,0,0,2,17.16666667,1,1,2,7,0,3,0,0,0,0,3,5,6,7,5.9
2023-24,202402110OKC,2/11/2024,OKC vs SAC,Keon Ellis,elliske01,31,SAC,0,OKC,5,1,1,0,1,0,17.35,0,1,2,4,1,3,0,0,5,1,2,6,6,7,10.7
2023-24,202402110OKC,2/11/2024,OKC vs SAC,Davion Mitchell,mitchda01,42,SAC,0,OKC,14,4,2,1,0,1,19.83333333,1,3,5,6,4,4,0,0,2,1,6,16,18,20,23.8
2023-24,202402110OKC,2/11/2024,OKC vs SAC,Josh Giddey,giddejo01,52,OKC,1,SAC,5,5,4,0,1,0,20.08333333,0,5,2,6,1,3,0,0,3,1,9,9,10,14,20
2023-24,202402110OKC,2/11/2024,OKC vs SAC,Harrison Barnes,barneha02,52,SAC,0,OKC,14,1,0,0,0,0,21.4,0,1,4,7,1,4,5,5,3,0,1,14,15,15,15.2
2023-24,202402110OKC,2/11/2024,OKC vs SAC,Jaylin Williams,willija07,45,OKC,1,SAC,5,1,2,0,0,0,21.7,0,1,0,3,0,1,5,6,2,0,3,7,6,8,9.2
2023-24,202402110MIA,2/11/2024,MIA vs BOS,Haywood Highsmith,highsha01,38,MIA,1,BOS,2,3,0,2,0,0,23.16666667,3,0,1,4,0,1,0,0,4,2,3,2,5,5,11.6
2023-24,202402110MIA,2/11/2024,MIA vs BOS,Terry Rozier,roziete01,40,MIA,1,BOS,13,4,6,0,0,0,24.13333333,2,2,6,16,0,4,1,1,0,0,10,19,17,23,26.8
2023-24,202402110OKC,2/11/2024,OKC vs SAC,Trey Lyles,lylestr01,38,SAC,0,OKC,1,5,0,1,1,1,24.3,1,4,0,2,0,2,1,2,2,2,5,1,6,6,12
2023-24,202402110MIA,2/11/2024,MIA vs BOS,Al Horford,horfoal01,44,BOS,0,MIA,4,5,0,0,3,0,24.85,0,5,1,5,0,2,2,2,1,3,5,4,9,9,19
2023-24,202402110MIA,2/11/2024,MIA vs BOS,Jaime Jaquez Jr.,jaqueja01,47,MIA,1,BOS,6,3,1,0,0,1,28.6,1,2,2,6,1,2,1,2,1,0,4,7,9,10,10.1
2023-24,202402110OKC,2/11/2024,OKC vs SAC,Malik Monk,monkma01,51,SAC,0,OKC,26,4,5,0,1,4,29.06666667,1,3,10,20,6,10,0,0,3,1,9,31,30,35,37.3
2023-24,202402110OKC,2/11/2024,OKC vs SAC,Chet Holmgren,holmgch01,53,OKC,1,SAC,14,4,2,2,4,2,30.73333333,1,3,5,9,0,2,4,4,3,6,6,16,18,20,37.8
2023-24,202402110MIA,2/11/2024,MIA vs BOS,Kristaps Porzingis,porzikr01,39,BOS,0,MIA,25,9,3,0,2,1,31.56666667,0,9,8,14,2,4,7,9,4,2,12,28,34,37,45.3
2023-24,202402110OKC,2/11/2024,OKC vs SAC,Luguentz Dort,dortlu01,51,OKC,1,SAC,17,9,0,3,1,2,32.75,2,7,5,9,3,5,4,4,3,4,9,17,26,26,37.8
2023-24,202402110OKC,2/11/2024,OKC vs SAC,De'Aaron Fox,foxde01,46,SAC,0,OKC,15,1,5,0,0,3,32.75,0,1,6,17,2,8,1,3,3,0,6,20,16,21,20.7
2023-24,202402110MIA,2/11/2024,MIA vs BOS,Duncan Robinson,robindu01,48,MIA,1,BOS,15,2,1,0,0,1,32.8,0,2,5,11,3,8,2,2,5,0,3,16,17,18,17.9
2023-24,202402110OKC,2/11/2024,OKC vs SAC,Keegan Murray,murrake02,48,SAC,0,OKC,13,10,3,1,2,1,33.86666667,2,8,6,12,1,6,0,0,0,3,13,16,23,26,37.5
2023-24,202402110MIA,2/11/2024,MIA vs BOS,Bam Adebayo,adebaba01,43,MIA,1,BOS,22,13,4,2,2,2,34.38333333,3,10,7,18,0,0,8,8,2,4,17,26,35,39,53.6
2023-24,202402110MIA,2/11/2024,MIA vs BOS,Jrue Holiday,holidjr01,48,BOS,0,MIA,15,3,6,1,1,0,35.45,1,2,5,8,5,6,0,0,3,2,9,21,18,24,33.6
2023-24,202402110MIA,2/11/2024,MIA vs BOS,Caleb Martin,martica02,36,MIA,1,BOS,15,8,1,0,0,1,35.91666667,4,4,6,12,3,7,0,0,1,0,9,16,23,24,25.1
2023-24,202402110OKC,2/11/2024,OKC vs SAC,Jalen Williams,willija06,47,OKC,1,SAC,32,8,9,0,0,2,36.75,1,7,13,20,2,4,4,4,3,0,17,41,40,49,53.1
2023-24,202402110MIA,2/11/2024,MIA vs BOS,Jaylen Brown,brownja02,49,BOS,0,MIA,20,9,2,0,0,6,37.2,3,6,8,16,3,8,1,4,1,0,11,22,29,31,27.8
2023-24,202402110MIA,2/11/2024,MIA vs BOS,Derrick White,whitede01,49,BOS,0,MIA,6,2,4,0,1,1,37.91666667,0,2,3,9,0,5,0,0,2,1,6,10,8,12,16.4
2023-24,202402110MIA,2/11/2024,MIA vs BOS,Tyler Herro,herroty01,33,MIA,1,BOS,24,5,4,0,0,1,38.51666667,0,5,10,21,4,12,0,0,1,0,9,28,29,33,35
2023-24,202402110MIA,2/11/2024,MIA vs BOS,Jayson Tatum,tatumja01,50,BOS,0,MIA,26,10,9,0,2,1,38.68333333,1,9,11,20,2,6,2,2,1,2,19,35,36,45,56.5
2023-24,202402110OKC,2/11/2024,OKC vs SAC,Shai Gilgeous-Alexander,gilgesh01,52,OKC,1,SAC,38,3,7,1,2,1,38.8,0,3,15,26,3,4,5,9,0,3,10,45,41,48,60.1
2023-24,202402110OKC,2/11/2024,OKC vs SAC,Domantas Sabonis,sabondo01,52,SAC,0,OKC,21,11,14,1,0,5,41.53333333,4,7,9,14,1,2,2,3,3,1,25,35,32,46,53.2
2023-24,202402100DAL,2/10/2024,DAL vs OKC,Jaden Hardy,hardyja02,48,DAL,1,OKC,11,0,3,1,0,0,10.21666667,0,0,4,5,2,3,1,2,1,1,3,14,11,14,18.5
2023-24,202402100GSW,2/10/2024,GSW vs PHO,Josh Okogie,okogijo01,47,PHO,0,GSW,8,1,1,1,1,0,10.36666667,1,0,3,3,2,2,0,0,0,2,2,9,9,10,16.7
2023-24,202402100NYK,2/10/2024,NYK vs IND,Miles McBride,mcbrimi01,40,NYK,1,IND,6,2,0,1,0,0,10.53333333,1,1,2,4,0,2,2,2,0,1,2,6,8,8,11.4
2023-24,202402100GSW,2/10/2024,GSW vs PHO,Dario Saric,saricda01,48,GSW,1,PHO,0,1,2,1,0,0,10.55,0,1,0,3,0,1,0,0,1,1,3,2,1,3,7.2
2023-24,202402100POR,2/10/2024,POR vs NOP,Ibou Badji,badjiib01,15,POR,1,NOP,4,1,1,0,0,1,10.76666667,0,1,2,2,0,0,0,0,3,0,2,5,5,6,5.7
2023-24,202402100GSW,2/10/2024,GSW vs PHO,Royce O'Neale,onealro01,50,PHO,0,GSW,3,4,1,1,1,1,11.28333333,2,2,1,3,1,2,0,0,2,2,5,4,7,8,14.3
2023-24,202402100CHO,2/10/2024,CHO vs MEM,Davis Bertans,bertada01,16,CHO,1,MEM,9,2,1,2,0,0,11.65,0,2,3,5,3,5,0,0,1,2,3,10,11,12,18.9
2023-24,202402100LAC,2/10/2024,LAC vs DET,Mason Plumlee,plumlma01,21,LAC,1,DET,6,5,0,0,1,1,11.65,0,5,1,2,0,0,4,4,1,1,5,6,11,11,14
2023-24,202402100ORL,2/10/2024,ORL vs CHI,Dalen Terry,terryda01,33,CHI,0,ORL,5,1,2,0,0,0,11.65,1,0,2,5,1,3,0,0,4,0,3,7,6,8,9.2
2023-24,202402100LAC,2/10/2024,LAC vs DET,Shake Milton,miltosh01,39,DET,0,LAC,4,3,0,1,0,0,11.86666667,1,2,2,5,0,1,0,0,1,1,3,4,7,7,10.6
2023-24,202402100BRK,2/10/2024,BRK vs SAS,Dominick Barlow,barlodo01,23,SAS,0,BRK,7,9,0,0,0,0,12,7,2,1,5,0,0,5,6,0,0,9,7,16,16,17.8
2023-24,202402100BRK,2/10/2024,BRK vs SAS,Cedi Osman,osmande01,53,SAS,0,BRK,8,5,0,0,0,1,12.28333333,1,4,2,5,2,3,2,2,0,0,5,8,13,13,13
2023-24,202402100LAC,2/10/2024,LAC vs DET,James Wiseman,wisemja01,33,DET,0,LAC,4,3,1,0,0,1,12.56666667,2,1,2,4,0,0,0,0,0,0,4,5,7,8,8.1
2023-24,202402100ATL,2/10/2024,ATL vs HOU,Jock Landale,landajo01,29,HOU,0,ATL,2,9,2,0,0,2,12.76666667,3,6,0,3,0,1,2,2,1,0,11,4,11,13,13.8
2023-24,202402100DAL,2/10/2024,DAL vs OKC,Kenrich Williams,willike04,41,OKC,0,DAL,0,1,2,0,0,0,13.28333333,1,0,0,2,0,1,0,0,5,0,3,2,1,3,4.2
2023-24,202402100DAL,2/10/2024,DAL vs OKC,Ousmane Dieng,diengou01,27,OKC,0,DAL,3,0,2,0,1,1,13.5,0,0,1,9,1,5,0,0,0,1,2,5,3,5,8
2023-24,202402100TOR,2/10/2024,TOR vs CLE,Dean Wade,wadede01,44,CLE,0,TOR,0,4,0,1,0,0,13.58333333,0,4,0,5,0,4,0,0,2,1,4,0,4,4,7.8
2023-24,202402100DAL,2/10/2024,DAL vs OKC,Lindy Waters III,waterli01,22,OKC,0,DAL,9,3,1,0,1,0,13.63333333,0,3,3,6,3,5,0,0,2,1,4,10,12,13,17.1
2023-24,202402100GSW,2/10/2024,GSW vs PHO,Gary Payton II,paytoga02,17,GSW,1,PHO,11,4,2,1,1,0,14,2,2,5,5,1,1,0,0,2,2,6,13,15,17,24.8
2023-24,202402100ORL,2/10/2024,ORL vs CHI,Goga Bitadze,bitadgo01,44,ORL,1,CHI,5,2,0,0,1,0,14.31666667,1,1,2,2,0,0,1,3,1,1,2,5,7,7,10.4
2023-24,202402100CHO,2/10/2024,CHO vs MEM,Trey Jemison,jemistr01,7,MEM,0,CHO,1,3,2,0,1,0,14.4,2,1,0,0,0,0,1,2,1,1,5,3,4,6,10.6
2023-24,202402100POR,2/10/2024,POR vs NOP,Jordan Hawkins,hawkijo01,48,NOP,0,POR,0,3,1,0,0,0,14.45,1,2,0,3,0,2,0,0,0,0,4,1,3,4,5.1
2023-24,202402100LAC,2/10/2024,LAC vs DET,Marcus Sasser,sassema01,47,DET,0,LAC,5,2,4,1,0,2,14.48333333,0,2,2,4,1,2,0,0,4,1,6,9,7,11,14.4
2023-24,202402100ATL,2/10/2024,ATL vs HOU,Reggie Bullock,bullore01,22,HOU,0,ATL,3,2,0,0,0,0,14.6,0,2,1,3,1,3,0,0,1,0,2,3,5,5,5.4
2023-24,202402100WAS,2/10/2024,WAS vs PHI,Marvin Bagley III,baglema01,35,WAS,1,PHI,2,1,0,0,2,0,14.86666667,0,1,1,7,0,1,0,0,1,2,1,2,3,3,9.2
2023-24,202402100ATL,2/10/2024,ATL vs HOU,Kobe Bufkin,bufkiko01,4,ATL,1,HOU,3,3,0,0,0,0,15.76666667,1,2,1,4,1,4,0,0,1,0,3,3,6,6,6.6
2023-24,202402100CHO,2/10/2024,CHO vs MEM,Derrick Rose,rosede01,20,MEM,0,CHO,10,4,5,0,0,0,16,0,4,4,7,2,2,0,0,0,0,9,15,14,19,22.3
2023-24,202402100GSW,2/10/2024,GSW vs PHO,Drew Eubanks,eubandr01,47,PHO,0,GSW,4,4,1,2,2,0,16.26666667,1,3,1,1,0,0,2,2,0,4,5,5,8,9,22.3
2023-24,202402100DAL,2/10/2024,DAL vs OKC,Isaiah Joe,joeis01,48,OKC,0,DAL,6,1,1,0,0,0,16.3,0,1,2,6,2,4,0,0,0,0,2,7,7,8,8.7
2023-24,202402100BRK,2/10/2024,BRK vs SAS,Blake Wesley,weslebl01,32,SAS,0,BRK,6,0,3,2,0,0,16.3,0,0,2,3,0,1,2,2,2,2,3,9,6,9,16.5
2023-24,202402100ORL,2/10/2024,ORL vs CHI,Markelle Fultz,fultzma01,20,ORL,1,CHI,5,6,3,1,0,1,16.7,0,6,2,7,0,2,1,1,1,1,9,8,11,14,18.7
2023-24,202402100ORL,2/10/2024,ORL vs CHI,Andre Drummond,drumman01,53,CHI,0,ORL,4,5,0,2,0,3,16.85,2,3,1,3,0,0,2,4,4,2,5,4,9,9,13
2023-24,202402100NYK,2/10/2024,NYK vs IND,Obi Toppin,toppiob01,55,IND,0,NYK,9,2,0,1,0,2,16.93333333,0,2,3,5,2,2,1,2,0,1,2,9,11,11,12.4
2023-24,202402100DAL,2/10/2024,DAL vs OKC,Daniel Gafford,gaffoda01,46,DAL,1,OKC,19,9,0,0,1,0,17.16666667,4,5,7,11,0,0,5,6,2,1,9,19,28,28,32.8
2023-24,202402100NYK,2/10/2024,NYK vs IND,Isaiah Jackson,jacksis01,42,IND,0,NYK,12,8,1,0,1,3,17.28333333,3,5,5,6,0,0,2,2,6,1,9,13,20,21,23.1
2023-24,202402100POR,2/10/2024,POR vs NOP,Naji Marshall,marshna01,42,NOP,0,POR,10,3,1,0,0,1,17.61666667,1,2,4,5,2,2,0,0,2,0,4,11,13,14,14.1
2023-24,202402100TOR,2/10/2024,TOR vs CLE,Georges Niang,niangge01,51,CLE,0,TOR,13,1,0,0,1,0,17.78333333,0,1,5,8,3,5,0,0,4,1,1,13,14,14,17.2
2023-24,202402100DAL,2/10/2024,DAL vs OKC,Luguentz Dort,dortlu01,50,OKC,0,DAL,5,0,2,0,0,2,17.81666667,0,0,2,7,1,6,0,0,3,0,2,7,5,7,6
2023-24,202402100NYK,2/10/2024,NYK vs IND,T.J. McConnell,mccontj01,44,IND,0,NYK,16,4,6,1,0,1,17.81666667,0,4,8,10,0,0,0,0,1,1,10,22,20,26,31.8
2023-24,202402100NYK,2/10/2024,NYK vs IND,Taj Gibson,gibsota01,14,NYK,1,IND,0,3,1,0,0,0,18.58333333,0,3,0,4,0,0,0,0,2,0,4,1,3,4,5.1
2023-24,202402100POR,2/10/2024,POR vs NOP,Larry Nance Jr.,nancela02,35,NOP,0,POR,2,2,1,0,0,0,18.96666667,0,2,1,2,0,0,0,0,0,0,3,3,4,5,5.9
2023-24,202402100WAS,2/10/2024,WAS vs PHI,Landry Shamet,shamela01,35,WAS,1,PHI,9,1,0,3,0,0,19.01666667,0,1,4,7,1,4,0,0,4,3,1,9,10,10,19.2
2023-24,202402100GSW,2/10/2024,GSW vs PHO,Lester Quinones,quinole01,16,GSW,1,PHO,6,3,0,0,0,0,19.15,1,2,2,6,2,4,0,0,1,0,3,6,9,9,9.6
2023-24,202402100BRK,2/10/2024,BRK vs SAS,Malaki Branham,branhma01,48,SAS,0,BRK,5,2,2,0,0,1,19.36666667,2,0,2,8,1,5,0,0,0,0,4,7,7,9,9.4
2023-24,202402100TOR,2/10/2024,TOR vs CLE,Ochai Agbaji,agbajoc01,52,TOR,1,CLE,8,2,0,0,0,1,19.4,0,2,3,9,0,5,2,3,3,0,2,8,10,10,9.4
2023-24,202402100LAC,2/10/2024,LAC vs DET,Troy Brown Jr.,browntr01,38,DET,0,LAC,8,2,2,0,0,0,19.45,0,2,2,5,2,5,2,2,1,0,4,10,10,12,13.4
2023-24,202402100BRK,2/10/2024,BRK vs SAS,Julian Champagnie,champju02,46,SAS,0,BRK,2,3,1,0,0,0,19.63333333,1,2,1,5,0,3,0,0,2,0,4,3,5,6,7.1
2023-24,202402100LAC,2/10/2024,LAC vs DET,Ivica Zubac,zubaciv01,41,LAC,1,DET,6,5,1,0,2,0,19.78333333,0,5,2,3,0,0,2,2,0,2,6,7,11,12,19.5
2023-24,202402100POR,2/10/2024,POR vs NOP,Toumani Camara,camarto01,51,POR,1,NOP,5,3,1,1,0,3,19.81666667,0,3,2,8,1,3,0,0,1,1,4,6,8,9,10.1
2023-24,202402100POR,2/10/2024,POR vs NOP,Jose Alvarado,alvarjo01,35,NOP,0,POR,2,2,2,3,1,1,19.85,0,2,1,3,0,1,0,0,0,4,4,4,4,6,18.4
2023-24,202402100CHO,2/10/2024,CHO vs MEM,Seth Curry,curryse01,37,CHO,1,MEM,3,2,1,2,1,1,19.86666667,1,1,1,3,1,3,0,0,0,3,3,4,5,6,14.9
2023-24,202402100TOR,2/10/2024,TOR vs CLE,Bruce Brown,brownbr01,46,TOR,1,CLE,2,2,0,0,0,1,19.88333333,0,2,1,5,0,2,0,0,1,0,2,2,4,4,3.4
2023-24,202402100BRK,2/10/2024,BRK vs SAS,Dorian Finney-Smith,finnedo01,43,BRK,1,SAS,3,3,3,1,1,0,20.48333333,1,2,1,4,1,4,0,2,6,2,6,6,6,9,17.1
2023-24,202402100ORL,2/10/2024,ORL vs CHI,Torrey Craig,craigto01,31,CHI,0,ORL,3,1,1,1,1,0,20.73333333,1,0,1,3,1,2,0,0,0,2,2,4,4,5,11.7
2023-24,202402100TOR,2/10/2024,TOR vs CLE,Jakob Poeltl,poeltja01,42,TOR,1,CLE,6,7,1,0,1,0,20.98333333,3,4,3,7,0,0,0,2,2,1,8,7,13,14,18.9
2023-24,202402100WAS,2/10/2024,WAS vs PHI,Cameron Payne,payneca01,49,PHI,0,WAS,6,1,6,0,0,1,21.15,0,1,3,8,0,3,0,1,1,0,7,12,7,13,15.2
2023-24,202402100CHO,2/10/2024,CHO vs MEM,Jacob Gilyard,gilyaja01,36,MEM,0,CHO,6,3,4,1,0,1,21.33333333,0,3,2,6,2,6,0,0,0,1,7,10,9,13,17.6
2023-24,202402100BRK,2/10/2024,BRK vs SAS,Ben Simmons,simmobe01,11,BRK,1,SAS,13,3,5,3,2,4,21.5,0,3,6,7,0,0,1,2,2,5,8,18,16,21,35.1
2023-24,202402100DAL,2/10/2024,DAL vs OKC,Aaron Wiggins,wiggiaa01,49,OKC,0,DAL,7,4,0,2,0,0,21.91666667,1,3,2,4,1,2,2,2,3,2,4,7,11,11,17.8
2023-24,202402100NYK,2/10/2024,NYK vs IND,Alec Burks,burksal01,44,NYK,1,IND,22,2,1,0,0,3,21.98333333,0,2,7,14,4,7,4,4,1,0,3,23,24,25,22.9
2023-24,202402100DAL,2/10/2024,DAL vs OKC,Chet Holmgren,holmgch01,52,OKC,0,DAL,13,12,0,0,1,0,22,4,8,4,7,2,3,3,4,4,1,12,13,25,25,30.4
2023-24,202402100TOR,2/10/2024,TOR vs CLE,Caris LeVert,leverca01,41,CLE,0,TOR,13,5,5,0,1,2,22.2,1,4,6,8,1,2,0,0,2,1,10,18,18,23,27.5
2023-24,202402100TOR,2/10/2024,TOR vs CLE,Gradey Dick,dickgr01,32,TOR,1,CLE,14,0,1,0,0,1,22.25,0,0,4,8,3,6,3,3,2,0,1,15,14,15,14.5
2023-24,202402100TOR,2/10/2024,TOR vs CLE,Kelly Olynyk,olynyke01,51,TOR,1,CLE,11,6,3,3,1,2,22.3,4,2,4,10,1,2,2,2,0,4,9,14,17,20,32.7
2023-24,202402100ORL,2/10/2024,ORL vs CHI,Gary Harris,harriga01,32,ORL,1,CHI,2,2,0,0,0,0,22.33333333,2,0,1,5,0,2,0,0,1,0,2,2,4,4,4.4
2023-24,202402100WAS,2/10/2024,WAS vs PHI,Paul Reed,reedpa01,52,PHI,0,WAS,12,7,1,0,1,0,22.36666667,3,4,6,8,0,0,0,0,3,1,8,13,19,20,24.9
2023-24,202402100ATL,2/10/2024,ATL vs HOU,Aaron Holiday,holidaa01,49,HOU,0,ATL,18,1,2,0,1,0,22.43333333,0,1,7,10,3,5,1,1,4,1,3,20,19,21,25.2
2023-24,202402100POR,2/10/2024,POR vs NOP,Kris Murray,murrakr01,32,POR,1,NOP,3,4,2,1,0,0,22.43333333,0,4,1,2,1,1,0,0,0,1,6,5,7,9,13.8
2023-24,202402100DAL,2/10/2024,DAL vs OKC,Josh Giddey,giddejo01,51,OKC,0,DAL,11,3,3,1,0,1,22.85,1,2,3,14,3,9,2,2,1,1,6,14,14,17,21.1
2023-24,202402100TOR,2/10/2024,TOR vs CLE,Gary Trent Jr.,trentga02,48,TOR,1,CLE,6,2,2,1,0,1,22.98333333,0,2,2,7,2,5,0,0,1,1,4,8,8,10,13.4
2023-24,202402100LAC,2/10/2024,LAC vs DET,Norman Powell,powelno01,51,LAC,1,DET,2,3,0,1,1,0,23,0,3,1,3,0,0,0,0,2,2,3,2,5,5,11.6
2023-24,202402100NYK,2/10/2024,NYK vs IND,Bennedict Mathurin,mathube01,52,IND,0,NYK,4,6,0,0,1,4,23.05,1,5,2,6,0,1,0,2,1,1,6,4,10,10,10.2
2023-24,202402100GSW,2/10/2024,GSW vs PHO,Eric Gordon,gordoer01,45,PHO,0,GSW,7,1,0,1,0,1,23.23333333,0,1,2,5,1,3,2,2,1,1,1,7,8,8,10.2
2023-24,202402100POR,2/10/2024,POR vs NOP,Ashton Hagans,haganas01,2,POR,1,NOP,5,2,4,1,1,1,23.23333333,0,2,2,4,0,1,1,2,4,2,6,9,7,11,18.4
2023-24,202402100WAS,2/10/2024,WAS vs PHI,KJ Martin,martike04,38,PHI,0,WAS,4,2,0,0,1,0,23.25,1,1,2,3,0,0,0,0,3,1,2,4,6,6,9.4
2023-24,202402100DAL,2/10/2024,DAL vs OKC,Derrick Jones Jr.,jonesde02,48,DAL,1,OKC,8,4,1,1,0,3,23.31666667,0,4,3,4,1,2,1,2,3,1,5,9,12,13,14.3
2023-24,202402100LAC,2/10/2024,LAC vs DET,Terance Mann,mannte01,45,LAC,1,DET,2,3,1,0,0,0,23.61666667,0,3,0,3,0,2,2,2,2,0,4,3,5,6,7.1
2023-24,202402100BRK,2/10/2024,BRK vs SAS,Dennis Smith Jr.,smithde03,36,BRK,1,SAS,14,6,2,0,1,0,23.71666667,1,5,6,9,2,3,0,0,1,1,8,16,20,22,27.2
2023-24,202402100GSW,2/10/2024,GSW vs PHO,Klay Thompson,thompkl01,47,GSW,1,PHO,5,2,1,1,1,1,24.33333333,0,2,2,10,1,7,0,0,0,2,3,6,7,8,13.9
2023-24,202402100WAS,2/10/2024,WAS vs PHI,Corey Kispert,kispeco01,51,WAS,1,PHI,5,2,0,0,0,0,24.35,0,2,2,6,1,4,0,0,1,0,2,5,7,7,7.4
2023-24,202402100CHO,2/10/2024,CHO vs MEM,Luke Kennard,kennalu01,25,MEM,0,CHO,11,0,4,0,0,1,24.41666667,0,0,3,7,2,5,3,3,1,0,4,15,11,15,16
2023-24,202402100DAL,2/10/2024,DAL vs OKC,P.J. Washington,washipj01,45,DAL,1,OKC,14,5,1,1,0,2,24.48333333,1,4,6,10,1,4,1,2,3,1,6,15,19,20,22.5
2023-24,202402100POR,2/10/2024,POR vs NOP,Dalano Banton,bantoda01,25,POR,1,NOP,12,3,3,0,0,2,24.76666667,0,3,5,14,1,5,1,1,0,0,6,15,15,18,18.1
2023-24,202402100CHO,2/10/2024,CHO vs MEM,Nick Richards,richani01,43,CHO,1,MEM,13,7,1,0,2,1,24.83333333,2,5,6,10,0,0,1,2,2,2,8,14,20,21,27.9
2023-24,202402100DAL,2/10/2024,DAL vs OKC,Tim Hardaway Jr.,hardati02,50,DAL,1,OKC,10,1,1,1,0,1,25.01666667,0,1,4,9,2,6,0,0,2,1,2,11,11,12,14.7
2023-24,202402100DAL,2/10/2024,DAL vs OKC,Maxi Kleber,klebima01,18,DAL,1,OKC,12,12,3,1,1,0,25.1,3,9,3,6,2,4,4,4,1,2,15,15,24,27,36.9
2023-24,202402100ORL,2/10/2024,ORL vs CHI,Jonathan Isaac,isaacjo01,35,ORL,1,CHI,7,12,0,1,3,0,25.38333333,6,6,3,8,1,2,0,0,4,4,12,7,19,19,33.4
2023-24,202402100DAL,2/10/2024,DAL vs OKC,Cason Wallace,wallaca01,52,OKC,0,DAL,15,2,0,1,0,1,25.45,0,2,5,11,3,7,2,2,2,1,2,15,17,17,19.4
2023-24,202402100ORL,2/10/2024,ORL vs CHI,Jalen Suggs,suggsja01,49,ORL,1,CHI,13,1,1,1,0,3,25.7,0,1,5,9,3,5,0,0,1,1,2,14,14,15,15.7
2023-24,202402100ORL,2/10/2024,ORL vs CHI,Wendell Carter Jr.,cartewe01,27,ORL,1,CHI,6,3,1,0,1,1,25.88333333,0,3,3,6,0,2,0,0,2,1,4,7,9,10,13.1
2023-24,202402100CHO,2/10/2024,CHO vs MEM,Vasilije Micic,micicva01,31,CHO,1,MEM,18,1,9,0,0,3,26.25,0,1,8,13,2,3,0,0,1,0,10,27,19,28,29.7
2023-24,202402100CHO,2/10/2024,CHO vs MEM,GG Jackson II,jacksgg01,21,MEM,0,CHO,16,1,2,2,1,1,26.4,1,0,7,14,2,6,0,1,1,3,3,18,17,19,28.2
2023-24,202402100GSW,2/10/2024,GSW vs PHO,Jusuf Nurkic,nurkiju01,50,PHO,0,GSW,6,6,4,0,1,2,26.43333333,1,5,3,7,0,1,0,0,3,1,10,10,12,16,20.2
2023-24,202402100LAC,2/10/2024,LAC vs DET,Amir Coffey,coffeam01,39,LAC,1,DET,12,1,0,1,1,0,26.73333333,0,1,3,8,2,5,4,4,1,2,1,12,13,13,19.2
2023-24,202402100BRK,2/10/2024,BRK vs SAS,Dennis Schroder,schrode01,52,BRK,1,SAS,15,3,12,0,0,2,26.78333333,0,3,6,13,3,5,0,0,4,0,15,27,18,30,34.6
2023-24,202402100TOR,2/10/2024,TOR vs CLE,Isaac Okoro,okorois01,42,CLE,0,TOR,12,2,4,1,0,0,26.8,0,2,4,10,1,5,3,3,1,1,6,16,14,18,23.4
2023-24,202402100DAL,2/10/2024,DAL vs OKC,Jalen Williams,willija06,46,OKC,0,DAL,9,3,7,0,0,2,26.96666667,1,2,4,10,1,3,0,0,2,0,10,16,12,19,21.1
2023-24,202402100BRK,2/10/2024,BRK vs SAS,Nic Claxton,claxtni01,42,BRK,1,SAS,20,11,0,1,2,0,27.03333333,3,8,10,15,0,1,0,0,3,3,11,20,31,31,42.2
2023-24,202402100CHO,2/10/2024,CHO vs MEM,Tre Mann,manntr01,14,CHO,1,MEM,9,4,9,2,0,2,27.2,1,3,4,11,1,5,0,0,1,2,13,18,13,22,31.3
2023-24,202402100DAL,2/10/2024,DAL vs OKC,Josh Green,greenjo02,40,DAL,1,OKC,6,2,2,2,0,1,27.31666667,0,2,2,4,0,1,2,2,3,2,4,8,8,10,16.4
2023-24,202402100TOR,2/10/2024,TOR vs CLE,Evan Mobley,mobleev01,28,CLE,0,TOR,17,11,3,0,0,2,27.41666667,4,7,7,13,1,4,2,4,3,0,14,20,28,31,32.7
2023-24,202402100LAC,2/10/2024,LAC vs DET,Ausar Thompson,thompau01,52,DET,0,LAC,10,8,5,2,0,2,27.5,4,4,5,12,0,2,0,0,2,2,13,15,18,23,31.1
2023-24,202402100LAC,2/10/2024,LAC vs DET,Russell Westbrook,westbru01,51,LAC,1,DET,13,3,2,1,0,1,27.5,0,3,5,10,2,4,1,2,1,1,5,15,16,18,21.6
2023-24,202402100BRK,2/10/2024,BRK vs SAS,Tre Jones,jonestr01,48,SAS,0,BRK,6,2,2,2,0,2,27.96666667,1,1,2,3,0,1,2,2,0,2,4,8,8,10,15.4
2023-24,202402100CHO,2/10/2024,CHO vs MEM,Cody Martin,martico01,20,CHO,1,MEM,5,7,2,0,0,4,28.13333333,0,7,2,7,1,3,0,0,0,0,9,7,12,14,12.4
2023-24,202402100GSW,2/10/2024,GSW vs PHO,Andrew Wiggins,wiggian01,45,GSW,1,PHO,12,5,3,2,0,0,28.33333333,1,4,5,13,1,4,1,2,3,2,8,15,17,20,28.5
2023-24,202402100DAL,2/10/2024,DAL vs OKC,Shai Gilgeous-Alexander,gilgesh01,51,OKC,0,DAL,25,6,5,0,1,3,28.88333333,2,4,9,16,0,0,7,8,1,1,11,30,31,36,39.7
2023-24,202402100TOR,2/10/2024,TOR vs CLE,Darius Garland,garlada01,27,CLE,0,TOR,11,3,8,1,0,2,28.91666667,1,2,4,11,1,5,2,2,0,1,11,19,14,22,27.6
2023-24,202402100POR,2/10/2024,POR vs NOP,Jabari Walker,walkeja01,48,POR,1,NOP,6,4,0,0,0,1,28.95,1,3,3,5,0,1,0,0,4,0,4,6,10,10,9.8
2023-24,202402100POR,2/10/2024,POR vs NOP,Jonas Valanciunas,valanjo01,53,NOP,0,POR,16,9,1,0,1,3,29.03333333,1,8,7,9,0,0,2,2,4,1,10,17,25,26,28.3
2023-24,202402100BRK,2/10/2024,BRK vs SAS,Victor Wembanyama,wembavi01,47,SAS,0,BRK,21,4,3,0,1,4,29.03333333,0,4,7,16,3,6,4,4,2,1,7,24,25,28,29.3
2023-24,202402100WAS,2/10/2024,WAS vs PHI,Ricky Council IV,councri01,12,PHI,0,WAS,19,10,1,0,0,0,29.18333333,5,5,7,13,0,1,5,8,2,0,11,20,29,30,32.5
2023-24,202402100POR,2/10/2024,POR vs NOP,Matisse Thybulle,thybuma01,50,POR,1,NOP,7,2,1,2,0,1,29.18333333,1,1,2,6,1,5,2,2,0,2,3,8,9,10,15.9
2023-24,202402100BRK,2/10/2024,BRK vs SAS,Jeremy Sochan,sochaje01,53,SAS,0,BRK,8,5,3,1,0,0,29.2,1,4,4,9,0,2,0,0,0,1,8,11,13,16,21.5
2023-24,202402100TOR,2/10/2024,TOR vs CLE,Max Strus,strusma01,51,CLE,0,TOR,14,2,7,0,0,0,29.26666667,1,1,6,11,2,6,0,0,2,0,9,21,16,23,26.9
2023-24,202402100WAS,2/10/2024,WAS vs PHI,Jordan Poole,poolejo01,50,WAS,1,PHI,11,4,4,2,0,2,29.28333333,1,3,4,8,2,4,1,2,4,2,8,15,15,19,25.8
2023-24,202402100GSW,2/10/2024,GSW vs PHO,Draymond Green,greendr01,26,GSW,1,PHO,15,7,9,0,0,4,29.5,2,5,7,9,1,3,0,0,4,0,16,24,22,31,32.9
2023-24,202402100POR,2/10/2024,POR vs NOP,Trey Murphy III,murphtr02,28,NOP,0,POR,24,5,0,1,2,0,29.55,1,4,7,10,5,8,5,6,1,3,5,24,29,29,39
2023-24,202402100BRK,2/10/2024,BRK vs SAS,Keldon Johnson,johnske04,49,SAS,0,BRK,19,4,1,0,1,2,29.73333333,1,3,7,14,3,6,2,2,2,1,5,20,23,24,26.3
2023-24,202402100BRK,2/10/2024,BRK vs SAS,Jalen Wilson,wilsoja03,14,BRK,1,SAS,8,6,2,0,0,0,29.86666667,2,4,3,4,2,3,0,0,4,0,8,10,14,16,18.2
2023-24,202402100ORL,2/10/2024,ORL vs CHI,Cole Anthony,anthoco01,52,ORL,1,CHI,14,11,3,0,0,3,30,2,9,5,11,1,5,3,4,2,0,14,17,25,28,28.7
2023-24,202402100TOR,2/10/2024,TOR vs CLE,Jarrett Allen,allenja01,46,CLE,0,TOR,18,15,2,0,1,1,30.18333333,6,9,9,12,0,1,0,2,2,1,17,20,33,35,41
2023-24,202402100WAS,2/10/2024,WAS vs PHI,Bilal Coulibaly,coulibi01,51,WAS,1,PHI,13,5,1,0,0,3,30.18333333,3,2,3,6,0,1,7,10,1,0,6,14,18,19,17.5
2023-24,202402100NYK,2/10/2024,NYK vs IND,Tyrese Haliburton,halibty01,42,IND,0,NYK,22,3,12,0,1,1,30.28333333,0,3,7,14,4,9,4,5,0,1,15,34,25,37,45.6
2023-24,202402100ATL,2/10/2024,ATL vs HOU,Bogdan Bogdanovic,bogdabo01,51,ATL,1,HOU,8,7,2,0,0,2,30.68333333,1,6,3,12,1,6,1,1,4,0,9,10,15,17,17.4
2023-24,202402100NYK,2/10/2024,NYK vs IND,Myles Turner,turnemy01,52,IND,0,NYK,23,8,4,1,0,2,30.71666667,0,8,9,9,2,2,3,4,4,1,12,27,31,35,39.6
2023-24,202402100CHO,2/10/2024,CHO vs MEM,Brandon Miller,millebr02,46,CHO,1,MEM,18,6,1,0,0,3,30.9,0,6,7,9,3,4,1,1,4,0,7,19,24,25,23.7
2023-24,202402100WAS,2/10/2024,WAS vs PHI,Tyus Jones,jonesty01,52,WAS,1,PHI,25,3,9,1,0,1,30.96666667,0,3,9,14,6,9,1,1,2,1,12,34,28,37,44.1
2023-24,202402100NYK,2/10/2024,NYK vs IND,Pascal Siakam,siakapa01,52,IND,0,NYK,19,6,3,1,0,1,31.06666667,0,6,8,13,2,6,1,4,0,1,9,22,25,28,32.7
2023-24,202402100NYK,2/10/2024,NYK vs IND,Aaron Nesmith,nesmiaa01,50,IND,0,NYK,13,3,0,0,0,1,31.16666667,1,2,5,12,3,7,0,0,4,0,3,13,16,16,15.6
2023-24,202402100DAL,2/10/2024,DAL vs OKC,Luka Doncic,doncilu01,45,DAL,1,OKC,32,8,9,0,0,3,31.3,0,8,9,14,4,8,10,13,3,0,17,41,40,49,52.1
2023-24,202402100TOR,2/10/2024,TOR vs CLE,Donovan Mitchell,mitchdo01,42,CLE,0,TOR,15,4,6,2,1,3,31.45,1,3,5,11,3,6,2,2,2,3,10,21,19,25,34.8
2023-24,202402100ATL,2/10/2024,ATL vs HOU,Jeff Green,greenje02,50,HOU,0,ATL,19,6,2,0,1,5,31.48333333,1,5,6,10,4,7,3,5,4,1,8,21,25,27,27.2
2023-24,202402100GSW,2/10/2024,GSW vs PHO,Grayson Allen,allengr01,47,PHO,0,GSW,10,4,2,0,0,0,32.03333333,0,4,4,11,2,6,0,0,0,0,6,12,14,16,17.8
2023-24,202402100LAC,2/10/2024,LAC vs DET,Simone Fontecchio,fontesi01,51,DET,0,LAC,20,9,1,1,0,1,32.1,2,7,8,19,3,9,1,1,1,1,10,21,29,30,34.3
2023-24,202402100POR,2/10/2024,POR vs NOP,CJ McCollum,mccolcj01,39,NOP,0,POR,8,3,7,1,1,1,32.15,0,3,2,14,1,9,3,4,2,2,10,15,11,18,27.1
2023-24,202402100ATL,2/10/2024,ATL vs HOU,Onyeka Okongwu,okongon01,52,ATL,1,HOU,11,7,1,0,3,1,32.35,3,4,4,10,0,1,3,7,5,3,8,12,18,19,28.9
2023-24,202402100CHO,2/10/2024,CHO vs MEM,Grant Williams,willigr01,48,CHO,1,MEM,15,8,1,0,0,2,32.36666667,0,8,5,11,3,6,2,2,0,0,9,16,23,24,24.1
2023-24,202402100TOR,2/10/2024,TOR vs CLE,Immanuel Quickley,quickim01,48,TOR,1,CLE,10,3,4,1,0,0,32.38333333,1,2,4,10,2,4,0,0,1,1,7,14,13,17,22.6
2023-24,202402100CHO,2/10/2024,CHO vs MEM,Santi Aldama,aldamsa01,41,MEM,0,CHO,11,6,3,2,0,0,32.46666667,1,5,5,14,1,7,0,2,1,2,9,14,17,20,28.7
2023-24,202402100ATL,2/10/2024,ATL vs HOU,Amen Thompson,thompam01,33,HOU,0,ATL,12,11,3,1,0,2,32.56666667,4,7,6,10,0,1,0,0,5,1,14,15,23,26,30.7
2023-24,202402100TOR,2/10/2024,TOR vs CLE,RJ Barrett,barrerj01,43,TOR,1,CLE,14,7,1,1,0,2,32.65,2,5,5,14,0,2,4,7,0,1,8,15,21,22,24.9
2023-24,202402100WAS,2/10/2024,WAS vs PHI,Tobias Harris,harrito02,48,PHI,0,WAS,11,7,3,3,1,4,32.78333333,1,6,4,14,0,2,3,4,1,4,10,14,18,21,31.9
2023-24,202402100ATL,2/10/2024,ATL vs HOU,Trae Young,youngtr01,48,ATL,1,HOU,18,4,8,2,1,4,32.9,0,4,6,16,2,9,4,6,3,3,12,26,22,30,39.8
2023-24,202402100NYK,2/10/2024,NYK vs IND,Bojan Bogdanovic,bogdabo02,29,NYK,1,IND,11,3,1,1,0,0,32.96666667,0,3,3,10,2,6,3,4,2,1,4,12,14,15,19.1
2023-24,202402100DAL,2/10/2024,DAL vs OKC,Kyrie Irving,irvinky01,31,DAL,1,OKC,25,6,8,1,0,1,33.15,1,5,11,19,2,7,1,2,2,1,14,33,31,39,46.2
2023-24,202402100BRK,2/10/2024,BRK vs SAS,Mikal Bridges,bridgmi01,52,BRK,1,SAS,14,6,3,1,1,1,33.45,0,6,4,11,3,6,3,3,0,2,9,17,20,23,30.7
2023-24,202402100CHO,2/10/2024,CHO vs MEM,Jaren Jackson Jr.,jacksja02,49,MEM,0,CHO,29,3,3,1,2,5,33.6,1,2,12,23,5,9,0,0,4,3,6,32,32,35,41.1
2023-24,202402100GSW,2/10/2024,GSW vs PHO,Stephen Curry,curryst01,47,GSW,1,PHO,30,9,6,1,0,3,33.86666667,1,8,10,22,9,16,1,2,0,1,15,36,39,45,49.8
2023-24,202402100GSW,2/10/2024,GSW vs PHO,Bradley Beal,bealbr01,29,PHO,0,GSW,15,6,5,2,0,2,34.13333333,2,4,7,16,1,4,0,0,4,2,11,20,21,26,33.7
2023-24,202402100BRK,2/10/2024,BRK vs SAS,Devin Vassell,vassede01,48,SAS,0,BRK,17,6,4,0,1,2,34.13333333,1,5,7,20,2,6,1,1,0,1,10,21,23,27,31.2
2023-24,202402100GSW,2/10/2024,GSW vs PHO,Jonathan Kuminga,kuminjo01,49,GSW,1,PHO,21,5,2,0,0,1,34.25,1,4,9,18,0,1,3,5,4,0,7,23,26,28,29
2023-24,202402100NYK,2/10/2024,NYK vs IND,Andrew Nembhard,nembhan01,40,IND,0,NYK,7,1,4,0,0,0,34.36666667,1,0,3,6,1,1,0,0,3,0,5,11,8,12,14.2
2023-24,202402100CHO,2/10/2024,CHO vs MEM,John Konchar,konchjo01,42,MEM,0,CHO,8,10,2,4,1,1,34.6,4,6,4,8,0,3,0,0,2,5,12,10,18,20,37
2023-24,202402100LAC,2/10/2024,LAC vs DET,Cade Cunningham,cunnica01,42,DET,0,LAC,22,6,10,0,1,2,34.73333333,0,6,9,18,1,3,3,3,2,1,16,32,28,38,45.2
2023-24,202402100ATL,2/10/2024,ATL vs HOU,Dillon Brooks,brookdi01,43,HOU,0,ATL,14,1,1,0,0,0,34.78333333,1,0,5,19,2,10,2,2,3,0,2,15,15,16,16.7
2023-24,202402100TOR,2/10/2024,TOR vs CLE,Scottie Barnes,barnesc01,53,TOR,1,CLE,24,10,10,1,1,1,35.16666667,2,8,9,15,1,3,5,6,3,2,20,34,34,44,56
2023-24,202402100GSW,2/10/2024,GSW vs PHO,Brandin Podziemski,podzibr01,44,GSW,1,PHO,10,8,7,0,0,2,35.18333333,1,7,4,12,2,4,0,0,1,0,15,17,18,25,28.1
2023-24,202402100LAC,2/10/2024,LAC vs DET,Kawhi Leonard,leonaka01,47,LAC,1,DET,24,4,5,2,0,3,35.28333333,0,4,7,18,3,7,7,7,2,2,9,29,28,33,39.3
2023-24,202402100LAC,2/10/2024,LAC vs DET,Jalen Duren,durenja01,37,DET,0,LAC,10,18,1,2,1,3,35.43333333,3,15,5,12,0,0,0,0,4,3,19,11,28,29,39.1
2023-24,202402100WAS,2/10/2024,WAS vs PHI,Tyrese Maxey,maxeyty01,47,PHI,0,WAS,28,9,7,0,0,2,35.83333333,0,9,11,25,3,7,3,4,1,0,16,35,37,44,47.3
2023-24,202402100NYK,2/10/2024,NYK vs IND,Josh Hart,hartjo01,52,NYK,1,IND,4,10,5,1,0,1,35.9,1,9,2,6,0,2,0,0,4,1,15,9,14,19,25.5
2023-24,202402100LAC,2/10/2024,LAC vs DET,Jaden Ivey,iveyja01,48,DET,0,LAC,23,4,2,0,0,3,35.96666667,1,3,10,21,2,6,1,1,3,0,6,25,27,29,27.8
2023-24,202402100BRK,2/10/2024,BRK vs SAS,Cam Thomas,thomaca02,43,BRK,1,SAS,25,2,4,2,0,2,36.05,1,1,9,19,5,10,2,2,2,2,6,29,27,31,37.4
2023-24,202402100LAC,2/10/2024,LAC vs DET,Paul George,georgpa01,48,LAC,1,DET,33,5,3,3,0,1,36.18333333,0,5,14,24,4,13,1,1,3,3,8,36,38,41,51.5
2023-24,202402100POR,2/10/2024,POR vs NOP,Brandon Ingram,ingrabr01,49,NOP,0,POR,17,4,9,1,1,5,36.18333333,2,2,8,21,0,2,1,4,3,2,13,26,21,30,36.3
2023-24,202402100LAC,2/10/2024,LAC vs DET,James Harden,hardeja01,46,LAC,1,DET,14,6,8,1,1,5,36.25,0,6,4,11,2,8,4,4,1,2,14,22,20,28,34.2
2023-24,202402100WAS,2/10/2024,WAS vs PHI,Buddy Hield,hieldbu01,55,PHI,0,WAS,23,5,6,4,0,2,36.35,1,4,9,16,4,9,1,2,3,4,11,29,28,34,48
2023-24,202402100ORL,2/10/2024,ORL vs CHI,Alex Caruso,carusal01,46,CHI,0,ORL,9,8,1,1,4,2,36.36666667,3,5,4,6,1,2,0,0,3,5,9,10,17,18,33.1
2023-24,202402100CHO,2/10/2024,CHO vs MEM,Vince Williams Jr.,willivi01,41,MEM,0,CHO,14,2,8,2,0,3,36.78333333,0,2,6,13,2,6,0,0,3,2,10,22,16,24,31.4
2023-24,202402100ATL,2/10/2024,ATL vs HOU,Jabari Smith Jr.,smithja05,47,HOU,0,ATL,9,10,2,4,4,3,36.91666667,2,8,4,15,1,7,0,0,2,8,12,11,19,21,45
2023-24,202402100WAS,2/10/2024,WAS vs PHI,Kyle Kuzma,kuzmaky01,51,WAS,1,PHI,21,3,5,0,4,4,37.16666667,0,3,9,17,2,6,1,2,5,4,8,26,24,29,40.1
2023-24,202402100POR,2/10/2024,POR vs NOP,Deandre Ayton,aytonde01,35,POR,1,NOP,18,17,3,2,3,3,37.23333333,6,11,9,18,0,0,0,0,0,5,20,21,35,38,54.9
2023-24,202402100ATL,2/10/2024,ATL vs HOU,Jalen Green,greenja05,52,HOU,0,ATL,26,14,10,1,0,5,37.23333333,2,12,10,22,2,9,4,7,1,1,24,36,40,50,55.8
2023-24,202402100POR,2/10/2024,POR vs NOP,Herbert Jones,joneshe01,48,NOP,0,POR,14,4,5,3,0,1,37.31666667,2,2,6,7,2,3,0,0,2,3,9,19,18,23,34.3
2023-24,202402100NYK,2/10/2024,NYK vs IND,Jalen Brunson,brunsja01,50,NYK,1,IND,39,3,4,1,0,2,37.46666667,0,3,14,25,1,5,10,10,2,1,7,43,42,46,49.6
2023-24,202402100GSW,2/10/2024,GSW vs PHO,Devin Booker,bookede01,43,PHO,0,GSW,32,4,6,1,1,2,38.13333333,1,3,11,21,2,8,8,9,3,2,10,38,36,42,49.8
2023-24,202402100CHO,2/10/2024,CHO vs MEM,Miles Bridges,bridgmi02,41,CHO,1,MEM,25,6,5,2,1,3,38.8,1,5,11,13,2,2,1,2,0,3,11,30,31,36,45.7
2023-24,202402100WAS,2/10/2024,WAS vs PHI,Kelly Oubre Jr.,oubreke01,40,PHI,0,WAS,16,7,4,1,1,2,39.08333333,2,5,6,13,1,5,3,4,4,2,11,20,23,27,34.4
2023-24,202402100ATL,2/10/2024,ATL vs HOU,Saddiq Bey,beysa01,52,ATL,1,HOU,24,6,3,1,1,1,39.28333333,2,4,8,15,4,9,4,4,1,2,9,27,30,33,40.7
2023-24,202402100WAS,2/10/2024,WAS vs PHI,Deni Avdija,avdijde01,52,WAS,1,PHI,21,13,5,0,1,5,39.3,0,13,9,14,1,4,2,2,2,1,18,26,34,39,42.1
2023-24,202402100GSW,2/10/2024,GSW vs PHO,Kevin Durant,duranke01,46,PHO,0,GSW,24,10,7,1,2,6,39.4,1,9,10,25,2,8,2,2,0,3,17,31,34,41,49.5
2023-24,202402100NYK,2/10/2024,NYK vs IND,Donte DiVincenzo,divindo01,53,NYK,1,IND,14,3,4,1,1,1,39.41666667,0,3,6,15,2,9,0,1,2,2,7,18,17,21,28.6
2023-24,202402100ORL,2/10/2024,ORL vs CHI,Ayo Dosunmu,dosunay01,51,CHI,0,ORL,19,2,2,1,0,1,39.41666667,0,2,7,12,5,8,0,0,5,1,4,21,21,23,26.4
2023-24,202402100ATL,2/10/2024,ATL vs HOU,Dejounte Murray,murrade01,50,ATL,1,HOU,34,6,7,2,1,1,39.86666667,0,6,9,19,4,9,12,15,0,3,13,41,40,47,59.7
2023-24,202402100ATL,2/10/2024,ATL vs HOU,Jalen Johnson,johnsja05,39,ATL,1,HOU,21,6,3,2,2,2,39.88333333,2,4,8,11,1,2,4,4,3,4,9,24,27,30,42.7
2023-24,202402100POR,2/10/2024,POR vs NOP,Jerami Grant,grantje01,45,POR,1,NOP,24,5,4,0,0,4,41.3,2,3,7,17,2,5,8,12,2,0,9,28,29,33,32
2023-24,202402100ORL,2/10/2024,ORL vs CHI,Paolo Banchero,banchpa01,53,ORL,1,CHI,19,7,8,1,1,3,42.93333333,1,6,5,13,2,6,7,8,1,2,15,27,26,34,42.4
2023-24,202402100NYK,2/10/2024,NYK vs IND,Precious Achiuwa,achiupr01,46,NYK,1,IND,15,6,0,2,3,2,43.15,3,3,6,6,1,1,2,2,2,5,6,15,21,21,35.2
2023-24,202402100ORL,2/10/2024,ORL vs CHI,Nikola Vucevic,vucevni01,48,CHI,0,ORL,26,17,4,3,1,0,43.28333333,9,8,12,25,1,7,1,2,3,4,21,30,43,47,64.4
2023-24,202402100ORL,2/10/2024,ORL vs CHI,Franz Wagner,wagnefr01,45,ORL,1,CHI,36,3,5,0,0,1,43.51666667,1,2,12,22,5,12,7,10,3,0,8,41,39,44,46.1
2023-24,202402100ORL,2/10/2024,ORL vs CHI,DeMar DeRozan,derozde01,51,CHI,0,ORL,28,4,4,0,0,1,44.16666667,1,3,11,24,1,4,5,6,3,0,8,32,32,36,37.8
2023-24,202402100ORL,2/10/2024,ORL vs CHI,Coby White,whiteco01,53,CHI,0,ORL,14,4,7,2,0,1,45.48333333,1,3,5,21,2,11,2,2,2,2,11,21,18,25,34.3
2023-24,202402090MIL,2/9/2024,MIL vs CHO,Thanasis Antetokounmpo,antetth01,21,MIL,1,CHO,4,1,1,0,1,0,10.7,1,0,2,3,0,1,0,0,2,1,2,5,5,6,9.7
2023-24,202402090TOR,2/9/2024,TOR vs HOU,Jontay Porter,portejo01,15,TOR,1,HOU,7,3,0,1,0,0,10.86666667,2,1,3,6,1,2,0,0,1,1,3,7,10,10,13.6
2023-24,202402090BOS,2/9/2024,BOS vs WAS,Luke Kornet,kornelu01,36,BOS,1,WAS,0,0,0,0,1,0,11.11666667,0,0,0,0,0,0,0,0,2,1,0,0,0,0,3
2023-24,202402090TOR,2/9/2024,TOR vs HOU,Reggie Bullock,bullore01,21,HOU,0,TOR,6,3,0,0,0,0,11.33333333,0,3,2,2,2,2,0,0,1,0,3,6,9,9,9.6
2023-24,202402090MIL,2/9/2024,MIL vs CHO,Patrick Beverley,beverpa01,48,MIL,1,CHO,6,1,4,0,0,1,11.68333333,0,1,2,5,2,3,0,0,1,0,5,10,7,11,12.2
2023-24,202402090PHI,2/9/2024,PHI vs ATL,Terquavion Smith,smithte01,9,PHI,1,ATL,8,0,0,1,0,1,12.73333333,0,0,3,7,2,6,0,0,0,1,0,8,8,8,10
2023-24,202402090BOS,2/9/2024,BOS vs WAS,Eugene Omoruyi,omorueu01,22,WAS,0,BOS,4,5,2,0,0,2,13.11666667,1,4,2,4,0,1,0,0,2,0,7,6,9,11,11
2023-24,202402090MIL,2/9/2024,MIL vs CHO,Andre Jackson Jr.,jacksan01,42,MIL,1,CHO,2,2,0,1,0,1,13.2,0,2,1,3,0,2,0,0,2,1,2,2,4,4,6.4
2023-24,202402090BOS,2/9/2024,BOS vs WAS,Landry Shamet,shamela01,34,WAS,0,BOS,3,1,0,0,0,1,13.6,0,1,1,3,1,2,0,0,1,0,1,3,4,4,3.2
2023-24,202402090PHI,2/9/2024,PHI vs ATL,Garrison Mathews,mathega01,36,ATL,0,PHI,8,1,1,0,0,0,13.96666667,0,1,2,3,1,2,3,3,3,0,2,9,9,10,10.7
2023-24,202402090PHI,2/9/2024,PHI vs ATL,Bruno Fernando,fernabr01,16,ATL,0,PHI,8,3,0,0,2,0,14.1,0,3,4,4,0,0,0,0,4,2,3,8,11,11,17.6
2023-24,202402090TOR,2/9/2024,TOR vs HOU,Jae'Sean Tate,tateja01,48,HOU,0,TOR,4,3,1,1,0,0,14.53333333,1,2,2,3,0,1,0,0,1,1,4,5,7,8,12.1
2023-24,202402090SAC,2/9/2024,SAC vs DEN,Alex Len,lenal01,19,SAC,1,DEN,11,2,1,1,0,1,14.9,2,0,4,5,0,1,3,5,3,1,3,12,13,14,16.9
2023-24,202402090SAC,2/9/2024,SAC vs DEN,Sasha Vezenkov,vezenal01,35,SAC,1,DEN,6,0,1,1,0,0,15.58333333,0,0,2,7,2,4,0,0,2,1,1,7,6,7,10.5
2023-24,202402090MIL,2/9/2024,MIL vs CHO,Pat Connaughton,connapa01,47,MIL,1,CHO,5,6,1,0,0,1,15.7,2,4,2,3,1,2,0,0,0,0,7,6,11,12,12.7
2023-24,202402090SAC,2/9/2024,SAC vs DEN,Reggie Jackson,jacksre01,53,DEN,0,SAC,8,1,4,1,0,3,15.96666667,0,1,3,5,0,0,2,2,2,1,5,12,9,13,15.2
2023-24,202402090LAL,2/9/2024,LAL vs NOP,Skylar Mays,mayssk01,28,LAL,1,NOP,2,1,0,0,1,0,16.16666667,0,1,1,5,0,3,0,0,0,1,1,2,3,3,6.2
2023-24,202402090BOS,2/9/2024,BOS vs WAS,Sam Hauser,hausesa01,51,BOS,1,WAS,5,1,1,1,0,0,16.21666667,0,1,1,6,1,6,2,2,1,1,2,6,6,7,10.7
2023-24,202402090PHI,2/9/2024,PHI vs ATL,Mo Bamba,bambamo01,30,PHI,1,ATL,3,3,3,1,3,1,16.48333333,2,1,1,3,1,2,0,0,2,4,6,6,6,9,22.1
2023-24,202402090BOS,2/9/2024,BOS vs WAS,Payton Pritchard,pritcpa01,52,BOS,1,WAS,11,6,1,0,0,0,16.9,0,6,4,7,2,5,1,1,0,0,7,12,17,18,19.7
2023-24,202402090LAL,2/9/2024,LAL vs NOP,Jaxson Hayes,hayesja02,44,LAL,1,NOP,6,8,0,2,1,0,17.15,3,5,3,4,0,0,0,0,1,3,8,6,14,14,24.6
2023-24,202402090TOR,2/9/2024,TOR vs HOU,Cam Whitmore,whitmca01,28,HOU,0,TOR,17,3,1,0,0,2,17.53333333,0,3,5,9,3,5,4,4,1,0,4,18,20,21,20.1
2023-24,202402090MIL,2/9/2024,MIL vs CHO,Nathan Mensah,mensana01,25,CHO,0,MIL,4,4,0,0,0,0,18.1,1,3,2,3,0,0,0,0,4,0,4,4,8,8,8.8
2023-24,202402090SAC,2/9/2024,SAC vs DEN,Zeke Nnaji,nnajize01,38,DEN,0,SAC,7,2,3,0,0,0,18.15,0,2,2,6,0,2,3,4,2,0,5,10,9,12,13.9
2023-24,202402090MIL,2/9/2024,MIL vs CHO,A.J. Green,greenaj01,33,MIL,1,CHO,3,4,0,1,0,0,18.33333333,1,3,1,9,1,9,0,0,3,1,4,3,7,7,10.8
2023-24,202402090MIL,2/9/2024,MIL vs CHO,JT Thor,thorjt01,42,CHO,0,MIL,0,3,0,0,0,0,18.76666667,0,3,0,1,0,0,0,0,2,0,3,0,3,3,3.6
2023-24,202402090PHI,2/9/2024,PHI vs ATL,KJ Martin,martike04,37,PHI,1,ATL,5,6,0,1,0,1,18.93333333,1,5,2,4,0,1,1,2,4,1,6,5,11,11,14.2
2023-24,202402090LAL,2/9/2024,LAL vs NOP,Trey Murphy III,murphtr02,27,NOP,0,LAL,5,1,0,0,0,0,19.28333333,0,1,2,3,1,2,0,0,1,0,1,5,6,6,6.2
2023-24,202402090LAL,2/9/2024,LAL vs NOP,Larry Nance Jr.,nancela02,34,NOP,0,LAL,4,6,6,0,0,2,19.4,2,4,2,4,0,1,0,2,2,0,12,10,10,16,18.2
2023-24,202402090TOR,2/9/2024,TOR vs HOU,Gradey Dick,dickgr01,31,TOR,1,HOU,6,1,1,1,0,0,19.61666667,0,1,2,5,2,5,0,0,3,1,2,7,7,8,11.7
2023-24,202402090SAC,2/9/2024,SAC vs DEN,Malik Monk,monkma01,50,SAC,1,DEN,23,1,2,1,1,2,19.81666667,0,1,9,13,3,7,2,2,1,2,3,25,24,26,31.2
2023-24,202402090SAC,2/9/2024,SAC vs DEN,Davion Mitchell,mitchda01,41,SAC,1,DEN,2,2,1,0,0,2,20.01666667,0,2,1,3,0,0,0,0,1,0,3,3,4,5,3.9
2023-24,202402090SAC,2/9/2024,SAC vs DEN,Peyton Watson,watsope01,51,DEN,0,SAC,4,3,1,1,3,4,20.13333333,1,2,2,4,0,1,0,0,3,4,4,5,7,8,17.1
2023-24,202402090SAC,2/9/2024,SAC vs DEN,Julian Strawther,strawju01,34,DEN,0,SAC,7,3,2,1,0,2,20.28333333,0,3,3,8,1,5,0,0,1,1,5,9,10,12,14.6
2023-24,202402090SAC,2/9/2024,SAC vs DEN,Trey Lyles,lylestr01,37,SAC,1,DEN,15,7,0,1,0,1,20.83333333,1,6,5,6,3,4,2,2,2,1,7,15,22,22,25.4
2023-24,202402090TOR,2/9/2024,TOR vs HOU,Alperen Sengun,sengual01,51,HOU,0,TOR,7,7,1,0,0,2,20.88333333,3,4,3,7,0,0,1,2,3,0,8,8,14,15,14.9
2023-24,202402090MIL,2/9/2024,MIL vs CHO,Bobby Portis,portibo01,53,MIL,1,CHO,18,7,1,1,0,1,20.98333333,2,5,7,14,3,4,1,1,3,1,8,19,25,26,29.9
2023-24,202402090SAC,2/9/2024,SAC vs DEN,Kevin Huerter,huertke01,49,SAC,1,DEN,12,2,0,0,0,2,21.06666667,1,1,4,6,2,4,2,2,1,0,2,12,14,14,12.4
2023-24,202402090LAL,2/9/2024,LAL vs NOP,Taurean Prince,princta02,52,LAL,1,NOP,3,2,1,0,0,1,21.06666667,0,2,0,2,0,2,3,4,3,0,3,4,5,6,5.9
2023-24,202402090SAC,2/9/2024,SAC vs DEN,Harrison Barnes,barneha02,51,SAC,1,DEN,9,2,2,1,0,0,21.38333333,1,1,3,6,2,4,1,1,0,1,4,11,11,13,17.4
2023-24,202402090LAL,2/9/2024,LAL vs NOP,Jose Alvarado,alvarjo01,34,NOP,0,LAL,7,3,2,0,0,0,21.48333333,1,2,3,9,1,5,0,0,2,0,5,9,10,12,13.6
2023-24,202402090TOR,2/9/2024,TOR vs HOU,Bruce Brown,brownbr01,45,TOR,1,HOU,11,3,0,1,0,1,22.33333333,2,1,5,13,0,2,1,1,2,1,3,11,14,14,16.6
2023-24,202402090TOR,2/9/2024,TOR vs HOU,Jalen Green,greenja05,51,HOU,0,TOR,7,2,1,0,0,4,22.4,0,2,3,11,1,5,0,1,0,0,3,8,9,10,6.9
2023-24,202402090LAL,2/9/2024,LAL vs NOP,Jonas Valanciunas,valanjo01,52,NOP,0,LAL,10,10,2,0,2,2,22.56666667,2,8,4,6,0,0,2,2,2,2,12,12,20,22,29
2023-24,202402090BOS,2/9/2024,BOS vs WAS,Al Horford,horfoal01,43,BOS,1,WAS,6,5,1,2,0,0,23.11666667,2,3,2,5,1,2,1,2,1,2,6,7,11,12,19.5
2023-24,202402090PHI,2/9/2024,PHI vs ATL,De'Andre Hunter,huntede01,29,ATL,0,PHI,11,2,2,1,0,3,23.61666667,0,2,3,6,3,4,2,2,1,1,4,13,13,15,16.4
2023-24,202402090MIL,2/9/2024,MIL vs CHO,Giannis Antetokounmpo,antetgi01,51,MIL,1,CHO,15,14,3,1,1,0,23.65,1,13,5,10,0,1,5,7,5,2,17,18,29,32,42.3
2023-24,202402090MIL,2/9/2024,MIL vs CHO,Nick Smith Jr.,smithni01,36,CHO,0,MIL,13,3,3,0,0,2,23.81666667,0,3,2,10,2,8,7,8,0,0,6,16,16,19,19.1
2023-24,202402090BOS,2/9/2024,BOS vs WAS,Corey Kispert,kispeco01,50,WAS,0,BOS,24,6,4,3,0,0,23.85,0,6,9,14,3,6,3,3,1,3,10,28,30,34,46.2
2023-24,202402090MIL,2/9/2024,MIL vs CHO,Cody Martin,martico01,19,CHO,0,MIL,5,5,5,0,0,3,24.18333333,1,4,2,9,0,3,1,2,2,0,10,10,10,15,15.5
2023-24,202402090MIL,2/9/2024,MIL vs CHO,Malik Beasley,beaslma01,51,MIL,1,CHO,21,2,2,1,0,0,24.46666667,1,1,7,9,7,9,0,1,2,1,4,23,23,25,29.4
2023-24,202402090SAC,2/9/2024,SAC vs DEN,Jamal Murray,murraja01,39,DEN,0,SAC,12,1,3,1,0,6,25.56666667,0,1,4,10,2,5,2,3,1,1,4,15,13,16,14.7
2023-24,202402090LAL,2/9/2024,LAL vs NOP,Dyson Daniels,daniedy01,52,NOP,0,LAL,7,1,1,1,1,2,26.55,0,1,2,4,2,3,1,2,3,2,2,8,8,9,13.7
2023-24,202402090SAC,2/9/2024,SAC vs DEN,Keegan Murray,murrake02,47,SAC,1,DEN,17,1,2,0,0,1,26.63333333,0,1,6,11,1,4,4,4,3,0,3,19,18,20,20.2
2023-24,202402090MIL,2/9/2024,MIL vs CHO,Brook Lopez,lopezbr01,50,MIL,1,CHO,11,7,2,0,3,1,26.88333333,2,5,4,9,1,5,2,2,2,3,9,13,18,20,30.4
2023-24,202402090SAC,2/9/2024,SAC vs DEN,Aaron Gordon,gordoaa01,47,DEN,0,SAC,14,3,2,0,1,2,26.98333333,2,1,5,8,1,2,3,6,0,1,5,16,17,19,21.6
2023-24,202402090TOR,2/9/2024,TOR vs HOU,Jeff Green,greenje02,49,HOU,0,TOR,11,6,4,1,1,0,27.11666667,1,5,3,11,1,6,4,5,1,2,10,15,17,21,30.2
2023-24,202402090SAC,2/9/2024,SAC vs DEN,Christian Braun,braunch01,53,DEN,0,SAC,13,3,1,0,1,1,27.46666667,2,1,4,8,1,2,4,4,3,1,4,14,16,17,20.1
2023-24,202402090SAC,2/9/2024,SAC vs DEN,De'Aaron Fox,foxde01,45,SAC,1,DEN,15,2,10,5,0,3,27.98333333,0,2,7,15,1,2,0,0,3,5,12,25,17,27,44.4
2023-24,202402090LAL,2/9/2024,LAL vs NOP,Herbert Jones,joneshe01,47,NOP,0,LAL,13,0,2,2,0,2,28.88333333,0,0,4,8,3,5,2,2,4,2,2,15,13,15,20
2023-24,202402090MIL,2/9/2024,MIL vs CHO,Damian Lillard,lillada01,48,MIL,1,CHO,26,4,8,3,0,0,29.06666667,0,4,9,18,2,8,6,6,1,3,12,34,30,38,51.8
2023-24,202402090MIL,2/9/2024,MIL vs CHO,Brandon Miller,millebr02,45,CHO,0,MIL,16,6,3,1,1,2,29.08333333,2,4,6,18,1,6,3,4,2,2,9,19,22,25,31.7
2023-24,202402090LAL,2/9/2024,LAL vs NOP,Anthony Davis,davisan02,51,LAL,1,NOP,20,6,6,1,1,3,29.11666667,0,6,7,11,0,1,6,7,4,2,12,26,26,32,39.2
2023-24,202402090MIL,2/9/2024,MIL vs CHO,Jae Crowder,crowdja01,22,MIL,1,CHO,5,2,3,0,0,0,29.66666667,0,2,1,7,1,6,2,3,1,0,5,8,7,10,11.9
2023-24,202402090SAC,2/9/2024,SAC vs DEN,Nikola Jokic,jokicni01,51,DEN,0,SAC,23,8,7,3,0,1,29.75,2,6,9,17,1,1,4,5,2,3,15,30,31,38,51.1
2023-24,202402090MIL,2/9/2024,MIL vs CHO,Nick Richards,richani01,42,CHO,0,MIL,16,11,0,0,1,2,29.9,2,9,7,9,0,0,2,3,2,1,11,16,27,27,30.2
2023-24,202402090MIL,2/9/2024,MIL vs CHO,Leaky Black,blackle01,22,CHO,0,MIL,4,6,2,0,0,2,30.16666667,1,5,1,2,0,0,2,2,2,0,8,6,10,12,12.2
2023-24,202402090TOR,2/9/2024,TOR vs HOU,Dillon Brooks,brookdi01,42,HOU,0,TOR,20,2,3,1,2,4,30.21666667,0,2,6,13,4,5,4,4,5,3,5,23,22,25,31.9
2023-24,202402090LAL,2/9/2024,LAL vs NOP,CJ McCollum,mccolcj01,38,NOP,0,LAL,19,4,3,0,0,0,30.26666667,1,3,8,16,3,9,0,0,3,0,7,22,23,26,28.3
2023-24,202402090MIL,2/9/2024,MIL vs CHO,Bryce McGowens,mcgowbr01,42,CHO,0,MIL,15,5,0,1,0,1,30.35,0,5,5,10,2,5,3,4,5,1,5,15,20,20,23
2023-24,202402090SAC,2/9/2024,SAC vs DEN,Domantas Sabonis,sabondo01,51,SAC,1,DEN,17,17,10,1,0,3,30.53333333,1,16,7,9,1,1,2,2,3,1,27,27,34,44,52.4
2023-24,202402090TOR,2/9/2024,TOR vs HOU,Aaron Holiday,holidaa01,48,HOU,0,TOR,12,3,5,1,0,1,30.81666667,0,3,5,13,2,8,0,0,2,1,8,17,15,20,25.1
2023-24,202402090MIL,2/9/2024,MIL vs CHO,Miles Bridges,bridgmi02,40,CHO,0,MIL,11,5,3,0,0,1,31.36666667,1,4,2,16,2,6,5,6,1,0,8,14,16,19,20.5
2023-24,202402090LAL,2/9/2024,LAL vs NOP,Austin Reaves,reaveau01,55,LAL,1,NOP,27,2,4,0,0,0,31.36666667,0,2,10,15,3,4,4,5,3,0,6,31,29,33,35.4
2023-24,202402090PHI,2/9/2024,PHI vs ATL,Paul Reed,reedpa01,51,PHI,1,ATL,12,13,1,1,1,1,31.5,6,7,5,9,0,2,2,3,6,2,14,13,25,26,34.1
2023-24,202402090LAL,2/9/2024,LAL vs NOP,Zion Williamson,willizi01,42,NOP,0,LAL,30,9,5,1,1,2,31.58333333,3,6,12,19,0,0,6,7,2,2,14,35,39,44,52.3
2023-24,202402090TOR,2/9/2024,TOR vs HOU,Amen Thompson,thompam01,32,HOU,0,TOR,8,9,4,1,0,6,31.73333333,2,7,4,5,0,0,0,0,4,1,13,12,17,21,21.8
2023-24,202402090BOS,2/9/2024,BOS vs WAS,Bilal Coulibaly,coulibi01,50,WAS,0,BOS,21,8,3,2,0,2,32.51666667,3,5,6,18,4,12,5,5,4,2,11,24,29,32,39.1
2023-24,202402090BOS,2/9/2024,BOS vs WAS,Kristaps Porzingis,porzikr01,38,BOS,1,WAS,34,11,0,0,1,3,32.88333333,2,9,9,18,2,4,14,14,3,1,11,34,45,45,47.2
2023-24,202402090BOS,2/9/2024,BOS vs WAS,Derrick White,whitede01,48,BOS,1,WAS,4,2,6,3,1,3,33.05,0,2,2,6,0,4,0,0,4,4,8,10,6,12,24.4
2023-24,202402090TOR,2/9/2024,TOR vs HOU,Jabari Smith Jr.,smithja05,46,HOU,0,TOR,12,10,2,0,0,2,33.43333333,5,5,5,11,2,6,0,0,2,0,12,14,22,24,25
2023-24,202402090TOR,2/9/2024,TOR vs HOU,Gary Trent Jr.,trentga02,47,TOR,1,HOU,8,1,3,4,0,1,33.88333333,0,1,2,11,2,8,2,2,1,4,4,11,9,12,24.7
2023-24,202402090PHI,2/9/2024,PHI vs ATL,Saddiq Bey,beysa01,51,ATL,0,PHI,18,11,1,1,0,0,33.9,5,6,4,11,2,5,8,8,1,1,12,19,29,30,35.7
2023-24,202402090PHI,2/9/2024,PHI vs ATL,Onyeka Okongwu,okongon01,51,ATL,0,PHI,21,8,2,1,2,1,33.9,2,6,9,12,1,2,2,2,3,3,10,23,29,31,41.6
2023-24,202402090BOS,2/9/2024,BOS vs WAS,Jrue Holiday,holidjr01,47,BOS,1,WAS,20,7,5,1,0,2,33.93333333,3,4,9,13,2,2,0,0,2,1,12,25,27,32,36.9
2023-24,202402090PHI,2/9/2024,PHI vs ATL,Bogdan Bogdanovic,bogdabo01,50,ATL,0,PHI,13,3,3,0,3,0,34.03333333,2,1,5,12,3,7,0,0,2,3,6,16,16,19,30.1
2023-24,202402090BOS,2/9/2024,BOS vs WAS,Jaylen Brown,brownja02,48,BOS,1,WAS,18,7,3,1,0,3,34.71666667,1,6,9,15,0,1,0,0,3,1,10,21,25,28,30.9
2023-24,202402090LAL,2/9/2024,LAL vs NOP,Brandon Ingram,ingrabr01,48,NOP,0,LAL,22,7,7,0,3,2,34.88333333,1,6,7,17,0,2,8,8,3,3,14,29,29,36,47.9
2023-24,202402090TOR,2/9/2024,TOR vs HOU,Scottie Barnes,barnesc01,52,TOR,1,HOU,13,10,8,2,2,1,34.95,6,4,4,16,0,3,5,5,2,4,18,21,23,31,48
2023-24,202402090TOR,2/9/2024,TOR vs HOU,RJ Barrett,barrerj01,42,TOR,1,HOU,21,5,7,1,0,2,35.63333333,1,4,8,12,1,3,4,5,2,1,12,28,26,33,38.5
2023-24,202402090PHI,2/9/2024,PHI vs ATL,Cameron Payne,payneca01,48,PHI,1,ATL,20,3,6,2,1,2,35.68333333,3,0,7,16,4,9,2,2,2,3,9,26,23,29,39.6
2023-24,202402090SAC,2/9/2024,SAC vs DEN,Justin Holiday,holidju01,30,DEN,0,SAC,10,3,2,2,0,1,36.73333333,0,3,3,10,3,9,1,2,1,2,5,12,13,15,21.6
2023-24,202402090LAL,2/9/2024,LAL vs NOP,Rui Hachimura,hachiru01,41,LAL,1,NOP,21,5,1,0,1,0,36.85,0,5,9,13,2,5,1,2,3,1,6,22,26,27,31.5
2023-24,202402090BOS,2/9/2024,BOS vs WAS,Kyle Kuzma,kuzmaky01,50,WAS,0,BOS,17,4,5,0,0,0,37.03333333,1,3,6,14,3,8,2,2,5,0,9,22,21,26,29.3
2023-24,202402090TOR,2/9/2024,TOR vs HOU,Jakob Poeltl,poeltja01,41,TOR,1,HOU,16,13,3,3,6,4,37.13333333,5,8,7,11,0,0,2,2,4,9,16,19,29,32,59.1
2023-24,202402090BOS,2/9/2024,BOS vs WAS,Jordan Poole,poolejo01,49,WAS,0,BOS,19,2,5,1,0,3,37.16666667,0,2,7,19,3,10,2,3,5,1,7,24,21,26,28.9
2023-24,202402090BOS,2/9/2024,BOS vs WAS,Tyus Jones,jonesty01,51,WAS,0,BOS,17,2,9,0,1,1,37.38333333,0,2,7,13,3,3,0,0,1,1,11,26,19,28,34.9
2023-24,202402090LAL,2/9/2024,LAL vs NOP,LeBron James,jamesle01,49,LAL,1,NOP,21,4,14,1,1,2,37.51666667,1,3,6,13,2,2,7,8,2,2,18,35,25,39,50.8
2023-24,202402090BOS,2/9/2024,BOS vs WAS,Jayson Tatum,tatumja01,49,BOS,1,WAS,35,10,8,1,2,2,38.06666667,1,9,12,22,3,10,8,9,1,3,18,43,45,53,66
2023-24,202402090TOR,2/9/2024,TOR vs HOU,Immanuel Quickley,quickim01,47,TOR,1,HOU,25,4,2,1,0,1,38.45,0,4,9,19,4,9,3,4,2,1,6,27,29,31,34.8
2023-24,202402090PHI,2/9/2024,PHI vs ATL,Jalen Johnson,johnsja05,38,ATL,0,PHI,11,11,6,0,2,1,38.48333333,0,11,5,12,1,4,0,2,3,2,17,17,22,28,38.2
2023-24,202402090PHI,2/9/2024,PHI vs ATL,Tobias Harris,harrito02,47,PHI,1,ATL,21,6,7,0,0,1,38.58333333,0,6,7,16,2,4,5,6,2,0,13,28,27,34,37.7
2023-24,202402090PHI,2/9/2024,PHI vs ATL,Buddy Hield,hieldbu01,54,PHI,1,ATL,20,4,6,0,0,2,39.55,1,3,8,21,4,12,0,0,3,0,10,26,24,30,31.8
2023-24,202402090LAL,2/9/2024,LAL vs NOP,D'Angelo Russell,russeda01,50,LAL,1,NOP,30,2,5,1,0,0,39.75,0,2,9,19,6,13,6,6,4,1,7,35,32,37,42.9
2023-24,202402090PHI,2/9/2024,PHI vs ATL,Trae Young,youngtr01,47,ATL,0,PHI,37,1,12,1,0,7,39.78333333,0,1,10,21,5,12,12,16,1,1,13,49,38,50,52.2
2023-24,202402090PHI,2/9/2024,PHI vs ATL,Kelly Oubre Jr.,oubreke01,39,PHI,1,ATL,28,12,1,1,1,0,39.95,5,7,8,19,2,8,10,14,4,2,13,29,40,41,49.9
2023-24,202402090BOS,2/9/2024,BOS vs WAS,Deni Avdija,avdijde01,51,WAS,0,BOS,24,11,4,2,0,3,41.78333333,0,11,7,10,3,5,7,8,5,2,15,28,35,39,46.2
2023-24,202402080IND,2/8/2024,IND vs GSW,Isaiah Jackson,jacksis01,41,IND,1,GSW,4,3,2,1,0,0,10.71666667,1,2,1,2,0,0,2,2,1,1,5,6,7,9,13.6
2023-24,202402080LAL,2/8/2024,LAL vs DEN,DeAndre Jordan,jordade01,27,DEN,0,LAL,6,8,1,0,0,0,11.41666667,4,4,3,6,0,0,0,0,2,0,9,7,14,15,17.1
2023-24,202402080NYK,2/8/2024,NYK vs DAL,Jacob Toppin,toppija01,4,NYK,1,DAL,2,2,1,0,0,0,11.5,1,1,1,2,0,1,0,0,0,0,3,3,4,5,5.9
2023-24,202402080BRK,2/8/2024,BRK vs CLE,Sam Merrill,merrisa01,35,CLE,0,BRK,9,0,0,1,0,0,11.73333333,0,0,3,7,3,7,0,0,1,1,0,9,9,9,12
2023-24,202402080POR,2/8/2024,POR vs DET,Justin Minaya,minayju01,15,POR,1,DET,0,1,0,1,0,1,11.86666667,0,1,0,1,0,1,0,0,1,1,1,0,1,1,3.2
2023-24,202402080POR,2/8/2024,POR vs DET,Jared Rhoden,rhodeja01,6,DET,0,POR,2,1,1,0,2,1,12.76666667,0,1,1,2,0,0,0,0,0,2,2,3,3,4,9.7
2023-24,202402080IND,2/8/2024,IND vs GSW,Jalen Smith,smithja04,38,IND,1,GSW,14,5,0,1,0,0,13.31666667,3,2,6,6,2,2,0,0,1,1,5,14,19,19,23
2023-24,202402080LAL,2/8/2024,LAL vs DEN,Christian Braun,braunch01,52,DEN,0,LAL,3,1,1,0,1,0,13.48333333,1,0,1,3,1,1,0,0,0,1,2,4,4,5,8.7
2023-24,202402080IND,2/8/2024,IND vs GSW,Moses Moody,moodymo01,37,GSW,0,IND,5,3,1,2,1,1,13.48333333,0,3,2,3,1,1,0,0,1,3,4,6,8,9,18.1
2023-24,202402080NYK,2/8/2024,NYK vs DAL,Jaden Hardy,hardyja02,47,DAL,0,NYK,4,2,1,1,0,1,13.55,0,2,2,5,0,1,0,0,0,1,3,5,6,7,9.9
2023-24,202402080PHO,2/8/2024,PHO vs UTA,Talen Horton-Tucker,hortota01,33,UTA,0,PHO,7,4,2,0,0,0,13.7,3,1,1,6,0,2,5,9,2,0,6,9,11,13,14.8
2023-24,202402080PHO,2/8/2024,PHO vs UTA,Bol Bol,bolbo01,15,PHO,1,UTA,6,1,0,0,2,0,14.2,0,1,3,5,0,2,0,0,3,2,1,6,7,7,13.2
2023-24,202402080BRK,2/8/2024,BRK vs CLE,Keon Johnson,johnske07,2,BRK,1,CLE,3,2,0,2,0,1,14.33333333,2,0,1,3,1,1,0,0,2,2,2,3,5,5,10.4
2023-24,202402080PHO,2/8/2024,PHO vs UTA,Josh Okogie,okogijo01,46,PHO,1,UTA,4,3,1,1,0,1,14.48333333,3,0,2,4,0,1,0,0,0,1,4,5,7,8,11.1
2023-24,202402080LAL,2/8/2024,LAL vs DEN,Max Christie,chrisma02,44,LAL,1,DEN,7,2,1,1,0,0,15.16666667,1,1,2,7,2,3,1,2,1,1,3,8,9,10,13.9
2023-24,202402080NYK,2/8/2024,NYK vs DAL,Isaiah Hartenstein,harteis01,50,NYK,1,DAL,10,4,2,2,0,2,15.38333333,2,2,4,5,0,0,2,2,2,2,6,12,14,16,21.8
2023-24,202402080MEM,2/8/2024,MEM vs CHI,Trey Jemison,jemistr01,6,MEM,1,CHI,0,2,0,2,0,0,15.4,1,1,0,4,0,0,0,0,4,2,2,0,2,2,8.4
2023-24,202402080ORL,2/8/2024,ORL vs SAS,Cedi Osman,osmande01,52,SAS,0,ORL,3,1,0,1,0,0,15.41666667,0,1,1,2,1,2,0,0,1,1,1,3,4,4,7.2
2023-24,202402080MEM,2/8/2024,MEM vs CHI,Jevon Carter,carteje01,50,CHI,0,MEM,7,0,2,0,0,0,15.51666667,0,0,3,7,1,4,0,0,0,0,2,9,7,9,10
2023-24,202402080POR,2/8/2024,POR vs DET,James Wiseman,wisemja01,32,DET,0,POR,7,5,1,0,1,0,15.55,4,1,3,3,0,0,1,2,4,1,6,8,12,13,17.5
2023-24,202402080ORL,2/8/2024,ORL vs SAS,Joe Ingles,inglejo01,38,ORL,1,SAS,8,3,4,1,0,0,15.78333333,0,3,3,4,2,3,0,0,1,1,7,12,11,15,20.6
2023-24,202402080PHO,2/8/2024,PHO vs UTA,Nassir Little,littlna01,30,PHO,1,UTA,3,3,1,0,1,0,15.98333333,0,3,1,2,1,2,0,0,4,1,4,4,6,7,11.1
2023-24,202402080MEM,2/8/2024,MEM vs CHI,Torrey Craig,craigto01,30,CHI,0,MEM,3,5,1,0,0,0,16.05,1,4,1,4,1,4,0,0,1,0,6,4,8,9,10.5
2023-24,202402080ORL,2/8/2024,ORL vs SAS,Moritz Wagner,wagnemo01,50,ORL,1,SAS,11,2,1,0,0,3,16.21666667,1,1,4,9,0,1,3,3,3,0,3,12,13,14,11.9
2023-24,202402080BRK,2/8/2024,BRK vs CLE,Dean Wade,wadede01,43,CLE,0,BRK,9,1,0,0,2,0,16.45,0,1,3,4,3,4,0,0,2,2,1,9,10,10,16.2
2023-24,202402080LAL,2/8/2024,LAL vs DEN,Jaxson Hayes,hayesja02,43,LAL,1,DEN,9,6,1,1,2,0,17,5,1,4,6,0,1,1,2,1,3,7,10,15,16,26.7
2023-24,202402080POR,2/8/2024,POR vs DET,Mike Muscala,muscami01,34,DET,0,POR,6,3,2,0,1,1,17.4,2,1,2,5,2,3,0,0,0,1,5,8,9,11,14.6
2023-24,202402080PHO,2/8/2024,PHO vs UTA,Taylor Hendricks,hendrita0,14,UTA,0,PHO,3,8,1,0,1,2,17.5,2,6,1,5,1,2,0,0,1,1,9,4,11,12,15.1
2023-24,202402080IND,2/8/2024,IND vs GSW,Dario Saric,saricda01,47,GSW,0,IND,11,7,3,0,0,2,17.61666667,2,5,4,6,2,3,1,1,1,0,10,14,18,21,21.9
2023-24,202402080MIL,2/8/2024,MIL vs MIN,Andre Jackson Jr.,jacksan01,41,MIL,1,MIN,0,1,3,1,0,1,17.7,0,1,0,2,0,0,0,0,0,1,4,3,1,4,7.7
2023-24,202402080PHO,2/8/2024,PHO vs UTA,Drew Eubanks,eubandr01,46,PHO,1,UTA,12,7,0,1,0,0,18.16666667,0,7,5,8,0,0,2,4,3,1,7,12,19,19,23.4
2023-24,202402080ORL,2/8/2024,ORL vs SAS,Cole Anthony,anthoco01,51,ORL,1,SAS,12,2,2,1,0,3,18.71666667,1,1,5,7,2,2,0,0,5,1,4,14,14,16,17.4
2023-24,202402080LAL,2/8/2024,LAL vs DEN,Christian Wood,woodch01,47,LAL,1,DEN,3,4,1,1,1,0,19,0,4,1,1,0,0,1,2,2,2,5,4,7,8,15.3
2023-24,202402080ORL,2/8/2024,ORL vs SAS,Jonathan Isaac,isaacjo01,34,ORL,1,SAS,9,6,1,0,1,1,19.25,0,6,4,4,0,0,1,2,1,1,7,10,15,16,19.7
2023-24,202402080MIL,2/8/2024,MIL vs MIN,Jaden McDaniels,mcdanja02,42,MIN,0,MIL,8,3,0,0,2,1,19.33333333,0,3,3,5,2,4,0,0,3,2,3,8,11,11,16.6
2023-24,202402080ORL,2/8/2024,ORL vs SAS,Gary Harris,harriga01,31,ORL,1,SAS,5,0,4,2,2,0,19.36666667,0,0,2,5,1,3,0,0,2,4,4,9,5,9,23
2023-24,202402080BRK,2/8/2024,BRK vs CLE,Ben Simmons,simmobe01,10,BRK,1,CLE,6,1,2,1,0,2,19.86666667,0,1,3,4,0,0,0,0,1,1,3,8,7,9,11.2
2023-24,202402080MEM,2/8/2024,MEM vs CHI,Jacob Gilyard,gilyaja01,35,MEM,1,CHI,8,0,4,1,0,1,19.96666667,0,0,3,7,2,6,0,0,1,1,4,12,8,12,16
2023-24,202402080ORL,2/8/2024,ORL vs SAS,Malaki Branham,branhma01,47,SAS,0,ORL,2,3,3,1,0,1,20,0,3,1,5,0,3,0,0,3,1,6,5,5,8,12.1
2023-24,202402080IND,2/8/2024,IND vs GSW,Obi Toppin,toppiob01,54,IND,1,GSW,7,1,2,0,0,1,20.1,0,1,3,5,1,3,0,0,1,0,3,9,8,10,10.2
2023-24,202402080IND,2/8/2024,IND vs GSW,Ben Sheppard,sheppbe01,32,IND,1,GSW,8,0,0,0,1,1,20.43333333,0,0,3,5,1,3,1,1,2,1,0,8,8,8,10
2023-24,202402080NYK,2/8/2024,NYK vs DAL,Dwight Powell,poweldw01,45,DAL,0,NYK,5,6,1,0,0,1,20.53333333,3,3,2,2,0,0,1,2,4,0,7,6,11,12,12.7
2023-24,202402080IND,2/8/2024,IND vs GSW,Gui Santos,santogu01,11,GSW,0,IND,13,8,1,0,0,0,20.8,2,6,5,8,2,2,1,2,1,0,9,14,21,22,24.1
2023-24,202402080ORL,2/8/2024,ORL vs SAS,Julian Champagnie,champju02,45,SAS,0,ORL,8,5,2,0,0,0,21.01666667,1,4,2,4,1,3,3,3,0,0,7,10,13,15,17
2023-24,202402080BRK,2/8/2024,BRK vs CLE,Max Strus,strusma01,50,CLE,0,BRK,6,5,2,1,0,1,21.35,1,4,3,5,0,1,0,0,2,1,7,8,11,13,17
2023-24,202402080MIL,2/8/2024,MIL vs MIN,A.J. Green,greenaj01,32,MIL,1,MIN,27,2,3,0,0,1,21.8,0,2,9,11,7,8,2,2,0,0,5,30,29,32,32.9
2023-24,202402080NYK,2/8/2024,NYK vs DAL,Charlie Brown Jr.,brownch02,5,NYK,1,DAL,3,2,0,0,1,0,22.18333333,1,1,1,5,1,3,0,0,4,1,2,3,5,5,8.4
2023-24,202402080IND,2/8/2024,IND vs GSW,T.J. McConnell,mccontj01,43,IND,1,GSW,6,0,8,1,0,1,22.18333333,0,0,3,7,0,0,0,0,1,1,8,14,6,14,20
2023-24,202402080NYK,2/8/2024,NYK vs DAL,Taj Gibson,gibsota01,13,NYK,1,DAL,0,4,1,0,0,1,22.26666667,2,2,0,3,0,1,0,0,4,0,5,1,4,5,5.3
2023-24,202402080LAL,2/8/2024,LAL vs DEN,Justin Holiday,holidju01,29,DEN,0,LAL,2,1,1,0,0,0,22.31666667,1,0,1,1,0,0,0,0,6,0,2,3,3,4,4.7
2023-24,202402080ORL,2/8/2024,ORL vs SAS,Victor Wembanyama,wembavi01,46,SAS,0,ORL,15,1,2,1,3,5,22.53333333,0,1,6,12,2,4,1,1,1,4,3,17,16,18,26.2
2023-24,202402080IND,2/8/2024,IND vs GSW,Myles Turner,turnemy01,51,IND,1,GSW,15,7,1,0,1,1,22.73333333,0,7,5,12,2,5,3,6,3,1,8,16,22,23,26.9
2023-24,202402080BRK,2/8/2024,BRK vs CLE,Noah Clowney,clownno01,5,BRK,1,CLE,8,4,1,0,0,1,22.86666667,3,1,3,6,0,2,2,2,1,0,5,9,12,13,13.3
2023-24,202402080ORL,2/8/2024,ORL vs SAS,Tre Jones,jonestr01,47,SAS,0,ORL,10,1,6,3,0,1,22.95,1,0,3,8,0,2,4,4,1,3,7,16,11,17,28.2
2023-24,202402080BRK,2/8/2024,BRK vs CLE,Caris LeVert,leverca01,40,CLE,0,BRK,4,3,5,1,0,2,23.08333333,0,3,2,6,0,2,0,0,1,1,8,9,7,12,16.1
2023-24,202402080BRK,2/8/2024,BRK vs CLE,Georges Niang,niangge01,50,CLE,0,BRK,13,3,1,1,0,0,23.31666667,1,2,5,9,3,6,0,0,1,1,4,14,16,17,21.1
2023-24,202402080BRK,2/8/2024,BRK vs CLE,Isaac Okoro,okorois01,41,CLE,0,BRK,8,6,1,0,3,2,23.7,2,4,3,6,2,3,0,0,3,3,7,9,14,15,23.7
2023-24,202402080MIL,2/8/2024,MIL vs MIN,Naz Reid,reidna01,52,MIN,0,MIL,17,4,0,1,1,1,23.76666667,1,3,6,11,2,4,3,3,1,2,4,17,21,21,26.8
2023-24,202402080IND,2/8/2024,IND vs GSW,Bennedict Mathurin,mathube01,51,IND,1,GSW,11,0,1,0,0,1,23.78333333,0,0,2,11,0,3,7,8,2,0,1,12,11,12,11.5
2023-24,202402080PHO,2/8/2024,PHO vs UTA,Kris Dunn,dunnkr01,45,UTA,0,PHO,9,4,3,3,0,1,23.91666667,1,3,3,7,2,3,1,2,2,3,7,12,13,16,26.3
2023-24,202402080ORL,2/8/2024,ORL vs SAS,Keldon Johnson,johnske04,48,SAS,0,ORL,12,4,1,0,0,1,24.05,0,4,5,12,2,7,0,0,1,0,5,13,16,17,17.3
2023-24,202402080MIL,2/8/2024,MIL vs MIN,Kyle Anderson,anderky01,52,MIN,0,MIL,8,5,6,3,0,3,24.2,3,2,3,3,0,0,2,2,1,3,11,14,13,19,29
2023-24,202402080PHO,2/8/2024,PHO vs UTA,Collin Sexton,sextoco01,53,UTA,0,PHO,19,4,8,0,1,5,24.41666667,2,2,7,15,3,6,2,6,2,1,12,27,23,31,33.8
2023-24,202402080ORL,2/8/2024,ORL vs SAS,Markelle Fultz,fultzma01,19,ORL,1,SAS,2,5,4,2,0,1,24.63333333,3,2,1,4,0,0,0,0,2,2,9,6,7,11,19
2023-24,202402080LAL,2/8/2024,LAL vs DEN,Peyton Watson,watsope01,50,DEN,0,LAL,5,4,2,0,0,1,24.75,1,3,2,6,1,3,0,0,2,0,6,7,9,11,11.8
2023-24,202402080ORL,2/8/2024,ORL vs SAS,Blake Wesley,weslebl01,31,SAS,0,ORL,10,2,7,1,0,1,25.05,1,1,4,5,1,2,1,1,4,1,9,17,12,19,24.9
2023-24,202402080BRK,2/8/2024,BRK vs CLE,Nic Claxton,claxtni01,41,BRK,1,CLE,6,7,1,0,1,2,25.13333333,2,5,3,10,0,0,0,0,4,1,8,7,13,14,16.9
2023-24,202402080POR,2/8/2024,POR vs DET,Anfernee Simons,simonan01,29,POR,1,DET,29,2,5,0,0,2,25.3,0,2,9,19,4,12,7,7,2,0,7,34,31,36,36.9
2023-24,202402080MIL,2/8/2024,MIL vs MIN,Nickeil Alexander-Walker,alexani01,52,MIN,0,MIL,7,3,4,0,0,1,25.43333333,1,2,2,7,1,4,2,2,0,0,7,11,10,14,15.6
2023-24,202402080IND,2/8/2024,IND vs GSW,Andrew Nembhard,nembhan01,39,IND,1,GSW,10,1,3,1,1,2,25.45,0,1,4,8,2,4,0,0,1,2,4,13,11,14,19.7
2023-24,202402080ORL,2/8/2024,ORL vs SAS,Zach Collins,colliza01,40,SAS,0,ORL,12,3,3,0,2,1,25.46666667,0,3,5,6,0,1,2,2,4,2,6,15,15,18,25.1
2023-24,202402080ORL,2/8/2024,ORL vs SAS,Wendell Carter Jr.,cartewe01,26,ORL,1,SAS,10,6,1,1,0,3,25.53333333,1,5,3,7,3,4,1,2,0,1,7,11,16,17,18.7
2023-24,202402080BRK,2/8/2024,BRK vs CLE,Evan Mobley,mobleev01,27,CLE,0,BRK,14,12,2,0,2,2,25.66666667,0,12,5,8,0,0,4,4,3,2,14,16,26,28,35.4
2023-24,202402080MIL,2/8/2024,MIL vs MIN,Brook Lopez,lopezbr01,49,MIL,1,MIN,12,5,2,1,2,0,25.71666667,1,4,5,8,2,4,0,0,1,3,7,14,17,19,30
2023-24,202402080IND,2/8/2024,IND vs GSW,Tyrese Haliburton,halibty01,41,IND,1,GSW,5,1,11,1,1,3,25.81666667,0,1,2,7,1,4,0,0,1,2,12,16,6,17,25.7
2023-24,202402080IND,2/8/2024,IND vs GSW,Aaron Nesmith,nesmiaa01,49,IND,1,GSW,13,4,1,5,1,2,25.81666667,1,3,4,7,1,3,4,6,2,6,5,14,17,18,35.3
2023-24,202402080BRK,2/8/2024,BRK vs CLE,Dennis Smith Jr.,smithde03,35,BRK,1,CLE,6,4,7,5,0,0,25.98333333,2,2,3,8,0,0,0,0,2,5,11,13,10,17,36.3
2023-24,202402080IND,2/8/2024,IND vs GSW,Andrew Wiggins,wiggian01,44,GSW,0,IND,11,4,5,1,0,0,26.18333333,0,4,5,10,1,3,0,0,3,1,9,16,15,20,26.3
2023-24,202402080LAL,2/8/2024,LAL vs DEN,Reggie Jackson,jacksre01,52,DEN,0,LAL,7,4,3,0,0,0,26.26666667,3,1,3,8,1,4,0,0,1,0,7,10,11,14,16.3
2023-24,202402080BRK,2/8/2024,BRK vs CLE,Trendon Watford,watfotr01,36,BRK,1,CLE,15,6,2,0,2,1,26.48333333,1,5,5,13,0,2,5,5,3,2,8,17,21,23,30.2
2023-24,202402080IND,2/8/2024,IND vs GSW,Lester Quinones,quinole01,15,GSW,0,IND,6,5,5,0,1,0,26.68333333,0,5,2,7,0,3,2,2,3,1,10,11,11,16,22.5
2023-24,202402080PHO,2/8/2024,PHO vs UTA,Walker Kessler,kesslwa01,45,UTA,0,PHO,10,9,2,2,4,0,27.28333333,5,4,4,6,0,0,2,2,1,6,11,12,19,21,41.8
2023-24,202402080MIL,2/8/2024,MIL vs MIN,Giannis Antetokounmpo,antetgi01,50,MIL,1,MIN,17,3,7,1,0,3,27.35,1,2,7,14,0,2,3,7,1,1,10,24,20,27,31.1
2023-24,202402080MEM,2/8/2024,MEM vs CHI,Ayo Dosunmu,dosunay01,50,CHI,0,MEM,10,0,2,0,0,2,27.46666667,0,0,4,5,2,2,0,0,2,0,2,12,10,12,11
2023-24,202402080NYK,2/8/2024,NYK vs DAL,Maxi Kleber,klebima01,17,DAL,0,NYK,2,4,3,1,4,1,27.46666667,1,3,1,2,0,1,0,2,1,5,7,5,6,9,25.3
2023-24,202402080PHO,2/8/2024,PHO vs UTA,Jusuf Nurkic,nurkiju01,49,PHO,1,UTA,16,8,3,1,0,2,27.53333333,1,7,7,11,0,2,2,5,5,1,11,19,24,27,31.1
2023-24,202402080IND,2/8/2024,IND vs GSW,Draymond Green,greendr01,25,GSW,0,IND,8,8,5,2,0,5,27.58333333,2,6,4,8,0,1,0,0,3,2,13,13,16,21,26.1
2023-24,202402080POR,2/8/2024,POR vs DET,Ashton Hagans,haganas01,1,POR,1,DET,4,2,3,0,0,2,27.7,0,2,2,7,0,3,0,0,3,0,5,7,6,9,8.9
2023-24,202402080ORL,2/8/2024,ORL vs SAS,Jeremy Sochan,sochaje01,52,SAS,0,ORL,9,2,1,0,0,2,28.16666667,0,2,4,9,1,4,0,0,1,0,3,10,11,12,10.9
2023-24,202402080ORL,2/8/2024,ORL vs SAS,Franz Wagner,wagnefr01,44,ORL,1,SAS,34,7,7,0,2,1,28.41666667,1,6,13,17,3,4,5,5,0,2,14,41,41,48,57.9
2023-24,202402080POR,2/8/2024,POR vs DET,Kris Murray,murrakr01,31,POR,1,DET,12,3,3,1,1,1,28.45,2,1,5,6,2,2,0,0,1,2,6,15,15,18,25.1
2023-24,202402080POR,2/8/2024,POR vs DET,Ausar Thompson,thompau01,51,DET,0,POR,6,5,1,1,0,0,28.5,2,3,3,9,0,0,0,2,4,1,6,7,11,12,16.5
2023-24,202402080MEM,2/8/2024,MEM vs CHI,Scotty Pippen Jr.,pippesc02,7,MEM,1,CHI,15,2,6,1,1,1,28.51666667,1,1,6,10,3,4,0,1,4,2,8,21,17,23,31.4
2023-24,202402080POR,2/8/2024,POR vs DET,Stanley Umude,umudest01,16,DET,0,POR,14,2,0,0,0,1,28.58333333,0,2,5,8,3,4,1,1,4,0,2,14,16,16,15.4
2023-24,202402080BRK,2/8/2024,BRK vs CLE,Darius Garland,garlada01,26,CLE,0,BRK,14,0,7,1,0,2,28.61666667,0,0,6,10,0,3,2,2,2,1,7,21,14,21,25.5
2023-24,202402080MIL,2/8/2024,MIL vs MIN,Bobby Portis,portibo01,52,MIL,1,MIN,12,9,3,1,0,3,29.2,4,5,5,12,0,2,2,2,3,1,12,15,21,24,27.3
2023-24,202402080MEM,2/8/2024,MEM vs CHI,Alex Caruso,carusal01,45,CHI,0,MEM,7,4,4,2,0,0,29.28333333,0,4,1,4,0,3,5,5,5,2,8,11,11,15,23.8
2023-24,202402080ORL,2/8/2024,ORL vs SAS,Jalen Suggs,suggsja01,48,ORL,1,SAS,17,3,2,2,0,2,29.28333333,1,2,6,11,3,6,2,4,4,2,5,19,20,22,27.6
2023-24,202402080BRK,2/8/2024,BRK vs CLE,Jarrett Allen,allenja01,45,CLE,0,BRK,14,10,2,0,2,2,29.61666667,2,8,3,6,0,1,8,8,2,2,12,16,24,26,33
2023-24,202402080IND,2/8/2024,IND vs GSW,Pascal Siakam,siakapa01,51,IND,1,GSW,16,8,2,1,1,2,29.65,2,6,6,11,2,4,2,4,2,2,10,18,24,26,32.6
2023-24,202402080MIL,2/8/2024,MIL vs MIN,Karl-Anthony Towns,townska01,51,MIN,0,MIL,19,5,1,0,0,1,29.65,2,3,7,15,4,6,1,2,4,0,6,20,24,25,25.5
2023-24,202402080NYK,2/8/2024,NYK vs DAL,Tim Hardaway Jr.,hardati02,49,DAL,0,NYK,19,2,2,0,0,0,29.73333333,0,2,7,14,5,10,0,0,1,0,4,21,21,23,24.4
2023-24,202402080MEM,2/8/2024,MEM vs CHI,John Konchar,konchjo01,41,MEM,1,CHI,4,3,1,0,1,0,29.91666667,1,2,2,5,0,3,0,0,2,1,4,5,7,8,12.1
2023-24,202402080BRK,2/8/2024,BRK vs CLE,Donovan Mitchell,mitchdo01,41,CLE,0,BRK,27,5,4,3,3,4,30.08333333,0,5,10,18,4,10,3,3,1,6,9,31,32,36,53
2023-24,202402080IND,2/8/2024,IND vs GSW,Stephen Curry,curryst01,46,GSW,0,IND,42,2,2,0,1,2,30.1,0,2,15,22,11,16,1,2,2,1,4,44,44,46,48.4
2023-24,202402080BRK,2/8/2024,BRK vs CLE,Cam Thomas,thomaca02,42,BRK,1,CLE,17,4,1,0,0,1,30.35,1,3,6,18,2,4,3,3,1,0,5,18,21,22,22.3
2023-24,202402080PHO,2/8/2024,PHO vs UTA,Keyonte George,georgke01,47,UTA,0,PHO,11,0,6,1,0,1,30.45,0,0,4,11,0,5,3,4,0,1,6,17,11,17,22
2023-24,202402080NYK,2/8/2024,NYK vs DAL,Derrick Jones Jr.,jonesde02,47,DAL,0,NYK,18,5,3,0,0,0,30.46666667,1,4,5,7,1,3,7,7,1,0,8,21,23,26,28.5
2023-24,202402080PHO,2/8/2024,PHO vs UTA,John Collins,collijo01,49,UTA,0,PHO,21,14,1,1,0,0,30.53333333,4,10,9,15,1,2,2,2,5,1,15,22,35,36,42.3
2023-24,202402080MIL,2/8/2024,MIL vs MIN,Mike Conley,conlemi01,47,MIN,0,MIL,18,5,9,0,0,1,30.58333333,0,5,6,8,6,7,0,0,2,0,14,27,23,32,36.5
2023-24,202402080ORL,2/8/2024,ORL vs SAS,Paolo Banchero,banchpa01,52,ORL,1,SAS,16,5,6,2,0,1,31.26666667,0,5,7,12,1,3,1,4,0,2,11,22,21,27,36
2023-24,202402080MEM,2/8/2024,MEM vs CHI,Andre Drummond,drumman01,52,CHI,0,MEM,21,13,1,1,1,1,31.31666667,3,10,10,11,0,0,1,3,1,2,14,22,34,35,43.1
2023-24,202402080NYK,2/8/2024,NYK vs DAL,Josh Green,greenjo02,39,DAL,0,NYK,15,6,3,1,1,0,31.76666667,1,5,5,9,2,5,3,3,2,2,9,18,21,24,32.7
2023-24,202402080LAL,2/8/2024,LAL vs DEN,Aaron Gordon,gordoaa01,46,DEN,0,LAL,11,4,3,2,1,1,31.91666667,0,4,5,8,0,2,1,2,1,3,7,14,15,18,28.3
2023-24,202402080PHO,2/8/2024,PHO vs UTA,Jordan Clarkson,clarkjo01,43,UTA,0,PHO,13,1,4,0,0,0,32.03333333,1,0,4,12,3,8,2,2,0,0,5,17,14,18,20.2
2023-24,202402080MEM,2/8/2024,MEM vs CHI,Jaren Jackson Jr.,jacksja02,48,MEM,1,CHI,28,2,4,0,1,4,32.1,1,1,11,22,4,10,2,5,6,1,6,32,30,34,35.4
2023-24,202402080MEM,2/8/2024,MEM vs CHI,GG Jackson II,jacksgg01,20,MEM,1,CHI,27,9,1,1,0,0,32.41666667,4,5,9,18,4,9,5,6,2,1,10,28,36,37,42.3
2023-24,202402080MIL,2/8/2024,MIL vs MIN,Malik Beasley,beaslma01,50,MIL,1,MIN,3,4,3,1,0,1,32.8,2,2,1,13,0,9,1,2,0,1,7,6,7,10,14.3
2023-24,202402080IND,2/8/2024,IND vs GSW,Jonathan Kuminga,kuminjo01,48,GSW,0,IND,18,2,4,0,2,3,33.43333333,1,1,9,16,0,2,0,0,1,2,6,22,20,24,29.4
2023-24,202402080IND,2/8/2024,IND vs GSW,Brandin Podziemski,podzibr01,43,GSW,0,IND,9,7,7,2,1,2,33.86666667,1,6,3,9,0,1,3,4,3,3,14,16,16,23,34.9
2023-24,202402080PHO,2/8/2024,PHO vs UTA,Lauri Markkanen,markkla01,43,UTA,0,PHO,22,5,1,0,0,4,33.88333333,0,5,8,15,2,6,4,4,1,0,6,23,27,28,25.5
2023-24,202402080LAL,2/8/2024,LAL vs DEN,Taurean Prince,princta02,51,LAL,1,DEN,13,3,2,2,1,1,34.46666667,0,3,4,6,2,3,3,3,2,3,5,15,16,18,27.6
2023-24,202402080MIL,2/8/2024,MIL vs MIN,Rudy Gobert,goberru01,51,MIN,0,MIL,16,11,4,1,0,0,35.21666667,3,8,8,9,0,0,0,1,3,1,15,20,27,31,38.2
2023-24,202402080BRK,2/8/2024,BRK vs CLE,Mikal Bridges,bridgmi01,51,BRK,1,CLE,26,3,5,0,0,3,35.35,1,2,10,23,5,13,1,2,1,0,8,31,29,34,34.1
2023-24,202402080ORL,2/8/2024,ORL vs SAS,Devin Vassell,vassede01,47,SAS,0,ORL,30,5,4,0,0,2,35.35,1,4,11,18,3,7,5,6,0,0,9,34,35,39,40
2023-24,202402080LAL,2/8/2024,LAL vs DEN,LeBron James,jamesle01,48,LAL,1,DEN,25,9,7,1,1,2,35.36666667,1,8,9,20,2,6,5,5,0,2,16,32,34,41,50.3
2023-24,202402080PHO,2/8/2024,PHO vs UTA,Kevin Durant,duranke01,45,PHO,1,UTA,31,8,7,3,2,3,35.4,0,8,14,23,2,6,1,1,1,5,15,38,39,46,63.1
2023-24,202402080PHO,2/8/2024,PHO vs UTA,Grayson Allen,allengr01,46,PHO,1,UTA,8,3,14,2,1,0,35.43333333,0,3,2,4,2,3,2,2,4,3,17,22,11,25,41.6
2023-24,202402080POR,2/8/2024,POR vs DET,Toumani Camara,camarto01,50,POR,1,DET,9,10,1,1,0,1,35.63333333,4,6,4,7,1,1,0,0,5,1,11,10,19,20,24.5
2023-24,202402080MIL,2/8/2024,MIL vs MIN,Anthony Edwards,edwaran01,49,MIN,0,MIL,26,3,9,1,0,0,35.65,0,3,9,20,4,11,4,6,3,1,12,35,29,38,46.1
2023-24,202402080LAL,2/8/2024,LAL vs DEN,Jamal Murray,murraja01,38,DEN,0,LAL,29,7,11,2,0,3,35.65,0,7,12,25,5,9,0,0,2,2,18,40,36,47,56.9
2023-24,202402080MEM,2/8/2024,MEM vs CHI,Coby White,whiteco01,52,CHI,0,MEM,20,6,8,0,0,5,35.88333333,1,5,6,12,2,3,6,6,2,0,14,28,26,34,34.2
2023-24,202402080LAL,2/8/2024,LAL vs DEN,Austin Reaves,reaveau01,54,LAL,1,DEN,15,2,10,2,0,1,36.26666667,1,1,6,16,2,7,1,2,2,2,12,25,17,27,37.4
2023-24,202402080LAL,2/8/2024,LAL vs DEN,Nikola Jokic,jokicni01,50,DEN,0,LAL,24,13,9,0,3,6,36.38333333,3,10,9,20,2,6,4,4,2,3,22,33,37,46,56.1
2023-24,202402080NYK,2/8/2024,NYK vs DAL,Kyrie Irving,irvinky01,30,DAL,0,NYK,16,5,6,0,0,2,36.45,0,5,7,17,2,6,0,0,3,0,11,22,21,27,29
2023-24,202402080PHO,2/8/2024,PHO vs UTA,Bradley Beal,bealbr01,28,PHO,1,UTA,30,2,7,1,0,5,36.73333333,1,1,11,21,6,9,2,2,2,1,9,37,32,39,40.9
2023-24,202402080MEM,2/8/2024,MEM vs CHI,Santi Aldama,aldamsa01,40,MEM,1,CHI,15,5,2,0,0,2,36.76666667,1,4,6,13,3,8,0,0,2,0,7,17,20,22,22
2023-24,202402080MIL,2/8/2024,MIL vs MIN,Pat Connaughton,connapa01,46,MIL,1,MIN,9,2,9,0,1,4,37.28333333,1,1,4,6,1,2,0,0,2,1,11,18,11,20,23.9
2023-24,202402080MEM,2/8/2024,MEM vs CHI,Vince Williams Jr.,willivi01,40,MEM,1,CHI,13,11,8,3,0,1,37.31666667,0,11,5,10,2,5,1,1,2,3,19,21,24,32,46.2
2023-24,202402080MIL,2/8/2024,MIL vs MIN,Jae Crowder,crowdja01,21,MIL,1,MIN,21,8,5,1,0,0,37.35,1,7,7,11,4,5,3,3,2,1,13,26,29,34,41.1
2023-24,202402080POR,2/8/2024,POR vs DET,Jalen Duren,durenja01,36,DET,0,POR,27,22,1,0,3,3,37.45,8,14,9,15,0,1,9,10,5,3,23,28,49,50,60.9
2023-24,202402080LAL,2/8/2024,LAL vs DEN,Rui Hachimura,hachiru01,40,LAL,1,DEN,2,4,0,0,1,1,37.51666667,1,3,1,5,0,2,0,0,2,1,4,2,6,6,8.8
2023-24,202402080MEM,2/8/2024,MEM vs CHI,DeMar DeRozan,derozde01,50,CHI,0,MEM,30,8,1,0,0,2,37.53333333,1,7,11,17,3,3,5,5,3,0,9,31,38,39,39.1
2023-24,202402080POR,2/8/2024,POR vs DET,Marcus Sasser,sassema01,46,DET,0,POR,17,2,11,2,0,2,37.63333333,0,2,6,13,3,7,2,4,2,2,13,28,19,30,39.9
2023-24,202402080LAL,2/8/2024,LAL vs DEN,Michael Porter Jr.,portemi01,52,DEN,0,LAL,27,8,2,0,1,1,37.81666667,1,7,11,20,4,7,1,1,1,1,10,29,35,37,41.6
2023-24,202402080POR,2/8/2024,POR vs DET,Matisse Thybulle,thybuma01,49,POR,1,DET,2,1,7,5,2,0,38.05,0,1,1,6,0,2,0,0,5,7,8,9,3,10,34.7
2023-24,202402080LAL,2/8/2024,LAL vs DEN,Anthony Davis,davisan02,50,LAL,1,DEN,32,9,3,3,4,1,38.23333333,1,8,14,27,0,3,4,6,0,7,12,35,41,44,67.3
2023-24,202402080PHO,2/8/2024,PHO vs UTA,Eric Gordon,gordoer01,44,PHO,1,UTA,19,2,4,1,1,1,38.36666667,0,2,7,8,3,4,2,2,0,2,6,23,21,25,32.4
2023-24,202402080NYK,2/8/2024,NYK vs DAL,Josh Hart,hartjo01,51,NYK,1,DAL,23,10,12,1,0,2,38.85,1,9,8,22,3,8,4,4,3,1,22,35,33,45,54
2023-24,202402080MEM,2/8/2024,MEM vs CHI,Nikola Vucevic,vucevni01,47,CHI,0,MEM,20,10,5,0,2,3,38.96666667,2,8,7,19,3,7,3,3,1,2,15,25,30,35,42.5
2023-24,202402080POR,2/8/2024,POR vs DET,Cade Cunningham,cunnica01,41,DET,0,POR,23,2,5,0,0,2,39.03333333,0,2,8,17,1,5,6,6,0,0,7,28,25,30,30.9
2023-24,202402080BRK,2/8/2024,BRK vs CLE,Jalen Wilson,wilsoja03,13,BRK,1,CLE,8,3,3,1,0,1,39.63333333,0,3,3,8,2,3,0,2,2,1,6,11,11,14,18.1
2023-24,202402080NYK,2/8/2024,NYK vs DAL,Luka Doncic,doncilu01,44,DAL,0,NYK,39,8,11,4,1,3,40.15,0,8,13,24,7,14,6,7,1,5,19,50,47,58,77.1
2023-24,202402080NYK,2/8/2024,NYK vs DAL,Precious Achiuwa,achiupr01,45,NYK,1,DAL,13,16,3,0,1,3,41.41666667,3,13,6,9,1,2,0,0,5,1,19,16,29,32,36.7
2023-24,202402080NYK,2/8/2024,NYK vs DAL,Donte DiVincenzo,divindo01,52,NYK,1,DAL,36,2,3,0,0,4,43.21666667,0,2,13,26,7,12,3,4,0,0,5,39,38,41,38.9
2023-24,202402080POR,2/8/2024,POR vs DET,Jabari Walker,walkeja01,47,POR,1,DET,17,11,2,1,2,1,43.48333333,3,8,6,14,1,3,4,6,3,3,13,19,28,30,41.2
2023-24,202402080POR,2/8/2024,POR vs DET,Jerami Grant,grantje01,44,POR,1,DET,49,8,6,0,0,4,45,2,6,14,29,3,6,18,20,5,0,14,55,57,63,63.6
2023-24,202402080NYK,2/8/2024,NYK vs DAL,Miles McBride,mcbrimi01,39,NYK,1,DAL,21,6,5,2,0,2,45.18333333,4,2,9,22,2,10,1,1,1,2,11,26,27,32,39.7
2023-24,202402080POR,2/8/2024,POR vs DET,Jaden Ivey,iveyja01,47,DET,0,POR,26,3,4,0,0,6,48.08333333,0,3,8,21,7,7,3,6,4,0,7,30,29,33,29.6
2023-24,202402070PHI,2/7/2024,PHI vs GSW,Ricky Council IV,councri01,10,PHI,1,GSW,17,0,0,0,0,0,10.03333333,0,0,4,7,1,3,8,8,1,0,0,17,17,17,17
2023-24,202402070PHI,2/7/2024,PHI vs GSW,Terquavion Smith,smithte01,8,PHI,1,GSW,7,1,2,1,0,1,10.03333333,0,1,3,8,1,4,0,0,0,1,3,9,8,10,13.2
2023-24,202402070BOS,2/7/2024,BOS vs ATL,Patty Mills,millspa02,19,ATL,0,BOS,0,2,1,1,0,0,10.13333333,0,2,0,2,0,1,0,0,0,1,3,1,2,3,6.9
2023-24,202402070MIA,2/7/2024,MIA vs SAS,Doug McDermott,mcderdo01,46,SAS,0,MIA,3,1,0,0,0,0,10.31666667,0,1,1,3,1,3,0,0,1,0,1,3,4,4,4.2
2023-24,202402070LAC,2/7/2024,LAC vs NOP,Jonas Valanciunas,valanjo01,51,NOP,0,LAC,8,2,1,1,0,1,10.55,0,2,3,3,0,0,2,2,1,1,3,9,10,11,13.9
2023-24,202402070SAC,2/7/2024,SAC vs DET,Danilo Gallinari,gallida01,32,DET,0,SAC,2,4,2,0,1,0,10.78333333,1,3,1,1,0,0,0,0,1,1,6,4,6,8,12.8
2023-24,202402070WAS,2/7/2024,WAS vs CLE,Dean Wade,wadede01,42,CLE,0,WAS,6,2,0,1,0,0,11.85,0,2,2,6,2,6,0,0,2,1,2,6,8,8,11.4
2023-24,202402070SAC,2/7/2024,SAC vs DET,Joe Harris,harrijo01,16,DET,0,SAC,2,0,0,0,0,0,12.08333333,0,0,1,3,0,1,0,0,1,0,0,2,2,2,2
2023-24,202402070BOS,2/7/2024,BOS vs ATL,Bruno Fernando,fernabr01,15,ATL,0,BOS,9,4,1,0,0,1,12.1,1,3,2,4,0,0,5,6,1,0,5,10,13,14,14.3
2023-24,202402070WAS,2/7/2024,WAS vs CLE,Landry Shamet,shamela01,33,WAS,1,CLE,3,3,3,0,0,0,12.33333333,1,2,1,5,1,4,0,0,3,0,6,6,6,9,11.1
2023-24,202402070WAS,2/7/2024,WAS vs CLE,Caris LeVert,leverca01,39,CLE,0,WAS,4,5,5,0,0,0,12.55,0,5,2,7,0,2,0,0,1,0,10,9,9,14,17.5
2023-24,202402070WAS,2/7/2024,WAS vs CLE,Delon Wright,wrighde01,29,WAS,1,CLE,5,1,0,2,0,0,12.6,1,0,2,2,1,1,0,0,0,2,1,5,6,6,12.2
2023-24,202402070WAS,2/7/2024,WAS vs CLE,Eugene Omoruyi,omorueu01,21,WAS,1,CLE,3,3,3,3,0,2,12.86666667,3,0,1,6,0,0,1,2,3,3,6,6,6,9,18.1
2023-24,202402070CHO,2/7/2024,CHO vs TOR,Nick Smith Jr.,smithni01,35,CHO,1,TOR,9,0,1,0,0,0,13.23333333,0,0,3,4,3,4,0,0,1,0,1,10,9,10,10.5
2023-24,202402070LAC,2/7/2024,LAC vs NOP,Jose Alvarado,alvarjo01,33,NOP,0,LAC,7,1,0,0,0,0,13.38333333,1,0,3,4,1,2,0,0,0,0,1,7,8,8,8.2
2023-24,202402070PHI,2/7/2024,PHI vs GSW,Dario Saric,saricda01,46,GSW,0,PHI,9,3,2,1,0,2,13.73333333,0,3,3,5,1,2,2,2,2,1,5,11,12,14,16.6
2023-24,202402070BOS,2/7/2024,BOS vs ATL,Garrison Mathews,mathega01,35,ATL,0,BOS,3,0,0,1,0,0,14.2,0,0,1,1,1,1,0,0,2,1,0,3,3,3,6
2023-24,202402070WAS,2/7/2024,WAS vs CLE,Sam Merrill,merrisa01,34,CLE,0,WAS,3,1,2,0,0,0,14.36666667,0,1,1,4,1,3,0,0,0,0,3,5,4,6,7.2
2023-24,202402070CHO,2/7/2024,CHO vs TOR,Thaddeus Young,youngth01,23,TOR,0,CHO,4,8,2,1,0,1,14.56666667,3,5,2,3,0,0,0,0,2,1,10,6,12,14,18.6
2023-24,202402070LAC,2/7/2024,LAC vs NOP,Mason Plumlee,plumlma01,20,LAC,1,NOP,11,3,1,0,0,2,15.1,1,2,4,4,0,0,3,3,6,0,4,12,14,15,14.1
2023-24,202402070CHO,2/7/2024,CHO vs TOR,Gradey Dick,dickgr01,30,TOR,0,CHO,6,1,2,0,0,1,15.35,0,1,2,2,2,2,0,0,0,0,3,8,7,9,9.2
2023-24,202402070CHO,2/7/2024,CHO vs TOR,Bryce McGowens,mcgowbr01,41,CHO,1,TOR,10,4,1,0,0,0,15.35,1,3,4,7,2,5,0,0,2,0,5,11,14,15,16.3
2023-24,202402070MIA,2/7/2024,MIA vs SAS,Blake Wesley,weslebl01,30,SAS,0,MIA,5,1,6,1,0,1,15.66666667,0,1,2,2,0,0,1,4,3,1,7,11,6,12,17.2
2023-24,202402070CHO,2/7/2024,CHO vs TOR,Ish Smith,smithis01,43,CHO,1,TOR,0,2,4,1,0,0,15.83333333,0,2,0,5,0,0,0,0,1,1,6,4,2,6,11.4
2023-24,202402070BOS,2/7/2024,BOS vs ATL,Payton Pritchard,pritcpa01,51,BOS,1,ATL,8,2,2,1,0,2,15.91666667,0,2,3,5,2,4,0,0,1,1,4,10,10,12,14.4
2023-24,202402070PHI,2/7/2024,PHI vs GSW,Furkan Korkmaz,korkmfu01,35,PHI,1,GSW,0,4,0,0,2,1,16.28333333,3,1,0,3,0,2,0,0,0,2,4,0,4,4,9.8
2023-24,202402070MIA,2/7/2024,MIA vs SAS,Kevin Love,loveke01,41,MIA,1,SAS,6,6,0,1,1,1,16.78333333,0,6,2,7,2,6,0,0,3,2,6,6,12,12,18.2
2023-24,202402070MIA,2/7/2024,MIA vs SAS,Zach Collins,colliza01,39,SAS,0,MIA,8,4,3,0,0,1,16.81666667,0,4,3,6,0,1,2,2,5,0,7,11,12,15,16.3
2023-24,202402070WAS,2/7/2024,WAS vs CLE,Georges Niang,niangge01,49,CLE,0,WAS,7,3,0,0,0,1,17.1,0,3,3,4,1,1,0,0,2,0,3,7,10,10,9.6
2023-24,202402070PHI,2/7/2024,PHI vs GSW,Kevon Looney,looneke01,48,GSW,0,PHI,9,9,2,0,2,0,17.13333333,3,6,4,8,0,0,1,1,3,2,11,11,18,20,28.8
2023-24,202402070LAC,2/7/2024,LAC vs NOP,Russell Westbrook,westbru01,50,LAC,1,NOP,4,3,4,1,0,3,17.76666667,2,1,2,7,0,2,0,0,2,1,7,8,7,11,13.6
2023-24,202402070PHI,2/7/2024,PHI vs GSW,Draymond Green,greendr01,24,GSW,0,PHI,4,6,3,1,1,2,18.13333333,1,5,2,4,0,1,0,1,3,2,9,7,10,13,19.7
2023-24,202402070MIA,2/7/2024,MIA vs SAS,Duncan Robinson,robindu01,47,MIA,1,SAS,6,2,2,1,0,2,18.98333333,0,2,1,6,1,6,3,3,2,1,4,8,8,10,12.4
2023-24,202402070PHI,2/7/2024,PHI vs GSW,Moses Moody,moodymo01,36,GSW,0,PHI,8,2,3,0,2,1,19.3,1,1,3,8,2,7,0,0,0,2,5,11,10,13,19.9
2023-24,202402070MIA,2/7/2024,MIA vs SAS,Julian Champagnie,champju02,44,SAS,0,MIA,6,5,3,2,0,0,19.45,3,2,2,7,2,5,0,0,2,2,8,9,11,14,22.5
2023-24,202402070WAS,2/7/2024,WAS vs CLE,Deni Avdija,avdijde01,50,WAS,1,CLE,9,8,3,0,0,2,19.98333333,2,6,3,10,1,3,2,4,0,0,11,12,17,20,21.1
2023-24,202402070SAC,2/7/2024,SAC vs DET,Keegan Murray,murrake02,46,SAC,1,DET,0,4,4,1,1,1,20.31666667,0,4,0,4,0,3,0,0,4,2,8,4,4,8,15.8
2023-24,202402070BOS,2/7/2024,BOS vs ATL,Luke Kornet,kornelu01,35,BOS,1,ATL,4,6,0,0,2,0,21,1,5,2,2,0,0,0,0,2,2,6,4,10,10,17.2
2023-24,202402070LAC,2/7/2024,LAC vs NOP,Ivica Zubac,zubaciv01,40,LAC,1,NOP,12,8,1,0,0,0,21.15,1,7,5,5,0,0,2,3,0,0,9,13,20,21,23.1
2023-24,202402070LAC,2/7/2024,LAC vs NOP,Amir Coffey,coffeam01,38,LAC,1,NOP,8,0,3,0,0,0,21.33333333,0,0,2,4,2,4,2,2,0,0,3,11,8,11,12.5
2023-24,202402070CHO,2/7/2024,CHO vs TOR,Bruce Brown,brownbr01,44,TOR,0,CHO,12,3,4,1,0,0,21.55,0,3,4,5,0,0,4,4,3,1,7,16,15,19,24.6
2023-24,202402070MIA,2/7/2024,MIA vs SAS,Cedi Osman,osmande01,51,SAS,0,MIA,8,5,0,0,0,0,21.58333333,0,5,3,7,2,4,0,0,1,0,5,8,13,13,14
2023-24,202402070LAC,2/7/2024,LAC vs NOP,Dyson Daniels,daniedy01,51,NOP,0,LAC,10,4,1,4,2,1,21.81666667,1,3,5,7,0,2,0,0,2,6,5,11,14,15,33.3
2023-24,202402070LAC,2/7/2024,LAC vs NOP,Trey Murphy III,murphtr02,26,NOP,0,LAC,13,1,2,0,0,1,22.61666667,0,1,5,11,3,8,0,0,2,0,3,15,14,16,16.2
2023-24,202402070SAC,2/7/2024,SAC vs DET,Trey Lyles,lylestr01,36,SAC,1,DET,19,2,1,0,1,0,22.9,1,1,6,13,5,10,2,2,0,1,3,20,21,22,25.9
2023-24,202402070PHI,2/7/2024,PHI vs GSW,Patrick Beverley,beverpa01,47,PHI,1,GSW,13,3,5,0,0,3,22.93333333,0,3,5,8,1,2,2,2,1,0,8,18,16,21,21.1
2023-24,202402070CHO,2/7/2024,CHO vs TOR,Leaky Black,blackle01,21,CHO,1,TOR,3,3,3,0,1,1,23.01666667,0,3,1,2,0,1,1,2,1,1,6,6,6,9,13.1
2023-24,202402070BOS,2/7/2024,BOS vs ATL,De'Andre Hunter,huntede01,28,ATL,0,BOS,10,1,1,0,0,1,23.01666667,0,1,3,9,1,4,3,3,3,0,2,11,11,12,11.7
2023-24,202402070PHI,2/7/2024,PHI vs GSW,Andrew Wiggins,wiggian01,43,GSW,0,PHI,21,10,1,1,1,0,23.21666667,4,6,9,14,2,3,1,2,1,2,11,22,31,32,40.5
2023-24,202402070PHI,2/7/2024,PHI vs GSW,Jaden Springer,sprinja01,32,PHI,1,GSW,8,4,1,2,1,1,23.4,2,2,3,9,0,3,2,2,2,3,5,9,12,13,22.3
2023-24,202402070SAC,2/7/2024,SAC vs DET,Davion Mitchell,mitchda01,40,SAC,1,DET,9,1,1,0,0,0,23.48333333,0,1,3,5,1,2,2,2,3,0,2,10,10,11,11.7
2023-24,202402070PHI,2/7/2024,PHI vs GSW,Lester Quinones,quinole01,14,GSW,0,PHI,13,2,4,0,0,2,24.15,0,2,4,7,4,7,1,2,4,0,6,17,15,19,19.4
2023-24,202402070SAC,2/7/2024,SAC vs DET,Harrison Barnes,barneha02,50,SAC,1,DET,8,4,0,1,0,0,24.25,0,4,4,10,0,4,0,0,0,1,4,8,12,12,15.8
2023-24,202402070PHI,2/7/2024,PHI vs GSW,Kelly Oubre Jr.,oubreke01,38,PHI,1,GSW,11,3,0,0,1,1,24.5,1,2,5,15,1,4,0,0,2,1,3,11,14,14,16.6
2023-24,202402070MIA,2/7/2024,MIA vs SAS,Keldon Johnson,johnske04,47,SAS,0,MIA,7,6,0,0,1,0,24.51666667,3,3,3,10,0,4,1,1,3,1,6,7,13,13,17.2
2023-24,202402070WAS,2/7/2024,WAS vs CLE,Jordan Poole,poolejo01,48,WAS,1,CLE,0,2,5,1,0,1,24.56666667,0,2,0,5,0,4,0,0,6,1,7,5,2,7,11.9
2023-24,202402070PHI,2/7/2024,PHI vs GSW,Stephen Curry,curryst01,45,GSW,0,PHI,9,3,1,0,1,4,24.6,0,3,2,7,1,4,4,4,2,1,4,10,12,13,13.1
2023-24,202402070BOS,2/7/2024,BOS vs ATL,Sam Hauser,hausesa01,50,BOS,1,ATL,10,5,0,0,0,2,24.7,2,3,3,8,2,6,2,2,1,0,5,10,15,15,14
2023-24,202402070MIA,2/7/2024,MIA vs SAS,Caleb Martin,martica02,35,MIA,1,SAS,9,5,2,2,0,1,25,2,3,4,6,1,3,0,0,2,2,7,11,14,16,23
2023-24,202402070LAC,2/7/2024,LAC vs NOP,Terance Mann,mannte01,44,LAC,1,NOP,5,5,1,0,0,2,25.1,2,3,2,5,1,1,0,0,4,0,6,6,10,11,10.5
2023-24,202402070WAS,2/7/2024,WAS vs CLE,Evan Mobley,mobleev01,26,CLE,0,WAS,22,8,1,1,1,2,25.11666667,2,6,9,10,2,2,2,2,2,2,9,23,30,31,37.1
2023-24,202402070PHI,2/7/2024,PHI vs GSW,Brandin Podziemski,podzibr01,42,GSW,0,PHI,6,5,5,2,0,0,25.35,1,4,3,8,0,2,0,0,2,2,10,11,11,16,25.5
2023-24,202402070SAC,2/7/2024,SAC vs DET,Mike Muscala,muscami01,33,DET,0,SAC,9,3,0,0,0,0,25.38333333,0,3,3,8,3,6,0,0,1,0,3,9,12,12,12.6
2023-24,202402070LAC,2/7/2024,LAC vs NOP,Norman Powell,powelno01,50,LAC,1,NOP,18,1,0,1,0,1,25.78333333,0,1,7,14,2,7,2,2,0,1,1,18,19,19,21.2
2023-24,202402070MIA,2/7/2024,MIA vs SAS,Josh Richardson,richajo01,42,MIA,1,SAS,9,4,0,0,0,0,26.46666667,0,4,2,6,1,4,4,4,2,0,4,9,13,13,13.8
2023-24,202402070CHO,2/7/2024,CHO vs TOR,Dennis Schroder,schrode01,51,TOR,0,CHO,16,4,5,0,0,2,26.78333333,0,4,4,9,3,6,5,7,2,0,9,21,20,25,26.3
2023-24,202402070LAC,2/7/2024,LAC vs NOP,Larry Nance Jr.,nancela02,33,NOP,0,LAC,2,3,3,4,0,0,27.38333333,1,2,1,1,0,0,0,0,3,4,6,5,5,8,22.1
2023-24,202402070SAC,2/7/2024,SAC vs DET,Ausar Thompson,thompau01,50,DET,0,SAC,12,6,2,2,1,2,27.4,1,5,5,6,0,0,2,2,5,3,8,14,18,20,29.2
2023-24,202402070WAS,2/7/2024,WAS vs CLE,Isaac Okoro,okorois01,40,CLE,0,WAS,5,3,3,1,1,0,27.65,0,3,2,3,0,1,1,3,1,2,6,8,8,11,19.1
2023-24,202402070MIA,2/7/2024,MIA vs SAS,Victor Wembanyama,wembavi01,45,SAS,0,MIA,18,13,3,1,1,3,27.8,0,13,7,13,3,5,1,3,1,2,16,21,31,34,41.1
2023-24,202402070MIA,2/7/2024,MIA vs SAS,Jaime Jaquez Jr.,jaqueja01,46,MIA,1,SAS,10,3,0,0,0,2,27.95,0,3,4,6,0,2,2,5,1,0,3,10,13,13,11.6
2023-24,202402070CHO,2/7/2024,CHO vs TOR,Cody Martin,martico01,18,CHO,1,TOR,19,5,8,2,0,1,28,0,5,7,13,3,5,2,3,3,2,13,27,24,32,42
2023-24,202402070MIA,2/7/2024,MIA vs SAS,Terry Rozier,roziete01,39,MIA,1,SAS,13,2,5,0,0,1,28.2,1,1,5,15,2,7,1,1,3,0,7,18,15,20,21.9
2023-24,202402070SAC,2/7/2024,SAC vs DET,Killian Hayes,hayeski01,42,DET,0,SAC,8,4,9,0,0,1,28.26666667,0,4,3,7,2,4,0,0,2,0,13,17,12,21,25.3
2023-24,202402070PHI,2/7/2024,PHI vs GSW,Klay Thompson,thompkl01,46,GSW,0,PHI,18,3,1,0,1,0,28.26666667,1,2,6,12,4,5,2,2,1,1,4,19,21,22,26.1
2023-24,202402070WAS,2/7/2024,WAS vs CLE,Bilal Coulibaly,coulibi01,49,WAS,1,CLE,6,3,1,0,0,4,28.28333333,0,3,2,5,1,2,1,1,4,0,4,7,9,10,7.1
2023-24,202402070WAS,2/7/2024,WAS vs CLE,Max Strus,strusma01,49,CLE,0,WAS,2,7,3,0,1,0,28.31666667,2,5,1,5,0,4,0,2,1,1,10,5,9,12,17.9
2023-24,202402070LAC,2/7/2024,LAC vs NOP,Paul George,georgpa01,47,LAC,1,NOP,7,1,4,2,0,3,28.35,0,1,3,15,0,8,1,1,2,2,5,11,8,12,17.2
2023-24,202402070WAS,2/7/2024,WAS vs CLE,Darius Garland,garlada01,25,CLE,0,WAS,13,0,4,0,0,3,28.41666667,0,0,4,12,1,5,4,4,0,0,4,17,13,17,16
2023-24,202402070SAC,2/7/2024,SAC vs DET,Alec Burks,burksal01,43,DET,0,SAC,25,7,2,0,0,0,28.43333333,0,7,7,12,5,7,6,6,3,0,9,27,32,34,36.4
2023-24,202402070CHO,2/7/2024,CHO vs TOR,Gary Trent Jr.,trentga02,46,TOR,0,CHO,14,0,1,3,0,1,28.43333333,0,0,5,13,4,8,0,0,1,3,1,15,14,15,23.5
2023-24,202402070CHO,2/7/2024,CHO vs TOR,Nick Richards,richani01,41,CHO,1,TOR,5,6,1,1,0,1,28.45,2,4,1,2,0,0,3,4,3,1,7,6,11,12,15.7
2023-24,202402070PHI,2/7/2024,PHI vs GSW,KJ Martin,martike04,36,PHI,1,GSW,15,5,2,1,0,1,28.53333333,1,4,6,10,2,3,1,1,1,1,7,17,20,22,26
2023-24,202402070WAS,2/7/2024,WAS vs CLE,Tyus Jones,jonesty01,50,WAS,1,CLE,15,3,8,1,0,1,28.71666667,0,3,6,10,3,4,0,0,1,1,11,23,18,26,32.6
2023-24,202402070MIA,2/7/2024,MIA vs SAS,Bam Adebayo,adebaba01,42,MIA,1,SAS,20,5,2,1,0,1,28.78333333,0,5,10,14,0,0,0,2,4,1,7,22,25,27,31
2023-24,202402070MIA,2/7/2024,MIA vs SAS,Jeremy Sochan,sochaje01,51,SAS,0,MIA,6,5,3,1,0,2,28.8,0,5,3,7,0,2,0,0,2,1,8,9,11,14,17.5
2023-24,202402070MIA,2/7/2024,MIA vs SAS,Tyler Herro,herroty01,32,MIA,1,SAS,24,6,7,0,0,1,29.13333333,1,5,10,15,4,7,0,0,1,0,13,31,30,37,40.7
2023-24,202402070PHI,2/7/2024,PHI vs GSW,Jonathan Kuminga,kuminjo01,47,GSW,0,PHI,18,6,5,1,0,1,29.18333333,1,5,7,14,0,3,4,6,0,1,11,23,24,29,34.7
2023-24,202402070PHI,2/7/2024,PHI vs GSW,Tobias Harris,harrito02,46,PHI,1,GSW,13,7,3,0,1,1,29.4,0,7,6,14,0,1,1,1,1,1,10,16,20,23,27.9
2023-24,202402070PHI,2/7/2024,PHI vs GSW,Tyrese Maxey,maxeyty01,46,PHI,1,GSW,12,2,3,1,1,3,29.81666667,0,2,5,14,2,7,0,0,2,2,5,15,14,17,21.9
2023-24,202402070LAC,2/7/2024,LAC vs NOP,Herbert Jones,joneshe01,46,NOP,0,LAC,13,7,2,0,0,1,30.36666667,2,5,5,11,2,3,1,2,2,0,9,15,20,22,23.4
2023-24,202402070CHO,2/7/2024,CHO vs TOR,Immanuel Quickley,quickim01,46,TOR,0,CHO,18,3,4,0,0,0,30.81666667,0,3,6,13,3,6,3,4,1,0,7,22,21,25,27.6
2023-24,202402070PHI,2/7/2024,PHI vs GSW,Paul Reed,reedpa01,50,PHI,1,GSW,6,8,4,2,2,0,31.11666667,4,4,3,6,0,1,0,0,3,4,12,10,14,18,33.6
2023-24,202402070MIA,2/7/2024,MIA vs SAS,Tre Jones,jonestr01,46,SAS,0,MIA,19,2,6,0,0,3,31.18333333,0,2,7,11,2,4,3,5,0,0,8,25,21,27,27.4
2023-24,202402070BOS,2/7/2024,BOS vs ATL,Kristaps Porzingis,porzikr01,37,BOS,1,ATL,31,3,1,0,2,2,31.4,0,3,13,19,2,4,3,4,2,2,4,32,34,35,40.1
2023-24,202402070CHO,2/7/2024,CHO vs TOR,P.J. Washington,washipj01,44,CHO,1,TOR,6,5,1,0,0,1,31.4,0,5,2,11,0,5,2,4,2,0,6,7,11,12,12.5
2023-24,202402070WAS,2/7/2024,WAS vs CLE,Kyle Kuzma,kuzmaky01,49,WAS,1,CLE,28,4,2,2,1,3,32.13333333,0,4,11,24,5,13,1,1,2,3,6,30,32,34,41.8
2023-24,202402070MIA,2/7/2024,MIA vs SAS,Devin Vassell,vassede01,46,SAS,0,MIA,19,3,3,1,0,2,32.3,0,3,8,18,1,6,2,2,1,1,6,22,22,25,28.1
2023-24,202402070SAC,2/7/2024,SAC vs DET,Marcus Sasser,sassema01,45,DET,0,SAC,18,3,4,0,0,0,32.48333333,0,3,7,14,2,6,2,2,1,0,7,22,21,25,27.6
2023-24,202402070LAC,2/7/2024,LAC vs NOP,Kawhi Leonard,leonaka01,46,LAC,1,NOP,15,6,4,2,1,3,33.2,1,5,4,10,1,3,6,8,0,3,10,19,21,25,34.2
2023-24,202402070CHO,2/7/2024,CHO vs TOR,RJ Barrett,barrerj01,41,TOR,0,CHO,23,6,5,0,1,1,33.36666667,0,6,9,15,4,6,1,1,4,1,11,28,29,34,39.7
2023-24,202402070WAS,2/7/2024,WAS vs CLE,Corey Kispert,kispeco01,49,WAS,1,CLE,23,7,2,0,0,1,33.38333333,1,6,9,15,4,9,1,1,2,0,9,25,30,32,33.4
2023-24,202402070CHO,2/7/2024,CHO vs TOR,Jakob Poeltl,poeltja01,40,TOR,0,CHO,12,12,2,0,1,1,33.43333333,4,8,5,7,0,0,2,2,2,1,14,14,24,26,31.4
2023-24,202402070SAC,2/7/2024,SAC vs DET,Kevin Huerter,huertke01,48,SAC,1,DET,16,1,1,1,1,0,33.76666667,1,0,6,11,4,9,0,0,2,2,2,17,17,18,24.7
2023-24,202402070MIA,2/7/2024,MIA vs SAS,Jimmy Butler,butleji01,37,MIA,1,SAS,17,11,11,3,1,0,33.83333333,1,10,5,12,1,3,6,6,0,4,22,28,28,39,58.7
2023-24,202402070BOS,2/7/2024,BOS vs ATL,Jaylen Brown,brownja02,47,BOS,1,ATL,15,6,6,1,0,2,33.86666667,0,6,7,11,0,2,1,1,4,1,12,21,21,27,32.2
2023-24,202402070SAC,2/7/2024,SAC vs DET,Malik Monk,monkma01,49,SAC,1,DET,23,5,10,0,2,1,34.26666667,0,5,10,21,2,8,1,1,2,2,15,33,28,38,49
2023-24,202402070SAC,2/7/2024,SAC vs DET,De'Aaron Fox,foxde01,44,SAC,1,DET,12,3,7,3,1,2,34.58333333,1,2,5,14,2,5,0,4,4,4,10,19,15,22,36.1
2023-24,202402070LAC,2/7/2024,LAC vs NOP,Zion Williamson,willizi01,41,NOP,0,LAC,21,3,10,1,2,2,35.03333333,1,2,7,16,0,0,7,10,3,3,13,31,24,34,46.6
2023-24,202402070BOS,2/7/2024,BOS vs ATL,Bogdan Bogdanovic,bogdabo01,49,ATL,0,BOS,12,6,3,1,0,0,35.08333333,2,4,5,18,2,10,0,0,3,1,9,15,18,21,26.7
2023-24,202402070WAS,2/7/2024,WAS vs CLE,Daniel Gafford,gaffoda01,45,WAS,1,CLE,14,13,0,1,4,1,35.13333333,4,9,7,12,0,0,0,0,2,5,13,14,27,27,43.6
2023-24,202402070BOS,2/7/2024,BOS vs ATL,Derrick White,whitede01,47,BOS,1,ATL,21,6,7,1,1,2,35.38333333,1,5,8,14,5,10,0,0,2,2,13,28,27,34,42.7
2023-24,202402070LAC,2/7/2024,LAC vs NOP,Brandon Ingram,ingrabr01,47,NOP,0,LAC,15,8,6,1,1,2,35.51666667,1,7,7,14,0,4,1,2,0,2,14,21,23,29,37.6
2023-24,202402070BOS,2/7/2024,BOS vs ATL,Saddiq Bey,beysa01,50,ATL,0,BOS,25,9,1,1,0,0,35.6,2,7,9,16,4,7,3,4,1,1,10,26,34,35,40.3
2023-24,202402070BOS,2/7/2024,BOS vs ATL,Jayson Tatum,tatumja01,48,BOS,1,ATL,20,9,7,1,0,3,35.6,0,9,8,21,2,13,2,2,3,1,16,27,29,36,41.3
2023-24,202402070CHO,2/7/2024,CHO vs TOR,Scottie Barnes,barnesc01,51,TOR,0,CHO,18,4,5,0,1,2,35.7,0,4,6,14,1,5,5,6,2,1,9,23,22,27,31.3
2023-24,202402070BOS,2/7/2024,BOS vs ATL,Onyeka Okongwu,okongon01,50,ATL,0,BOS,19,10,3,0,2,1,35.9,6,4,7,11,1,3,4,4,3,2,13,22,29,32,40.5
2023-24,202402070BOS,2/7/2024,BOS vs ATL,Jalen Johnson,johnsja05,37,ATL,0,BOS,19,15,4,3,0,2,36.1,2,13,8,16,2,5,1,1,0,3,19,23,34,38,50
2023-24,202402070BOS,2/7/2024,BOS vs ATL,Al Horford,horfoal01,42,BOS,1,ATL,14,8,8,2,4,1,36.18333333,2,6,5,12,4,9,0,0,1,6,16,22,22,30,52.6
2023-24,202402070LAC,2/7/2024,LAC vs NOP,CJ McCollum,mccolcj01,37,NOP,0,LAC,25,7,4,1,0,3,36.48333333,0,7,10,17,5,11,0,0,3,1,11,29,32,36,39.4
2023-24,202402070WAS,2/7/2024,WAS vs CLE,Jarrett Allen,allenja01,44,CLE,0,WAS,12,9,2,0,2,3,37.06666667,3,6,5,12,0,1,2,4,1,2,11,14,21,23,28.8
2023-24,202402070SAC,2/7/2024,SAC vs DET,Jalen Duren,durenja01,35,DET,0,SAC,20,15,6,0,0,3,37.21666667,2,13,7,10,0,0,6,6,4,0,21,26,35,41,44
2023-24,202402070CHO,2/7/2024,CHO vs TOR,Miles Bridges,bridgmi02,39,CHO,1,TOR,45,8,7,0,0,1,37.5,5,3,17,27,6,11,5,7,4,0,15,52,53,60,64.1
2023-24,202402070WAS,2/7/2024,WAS vs CLE,Donovan Mitchell,mitchdo01,40,CLE,0,WAS,40,8,5,1,0,5,37.56666667,0,8,14,25,5,10,7,7,1,1,13,45,48,53,55.1
2023-24,202402070BOS,2/7/2024,BOS vs ATL,Trae Young,youngtr01,46,ATL,0,BOS,20,2,10,1,0,4,37.86666667,0,2,8,25,2,10,2,2,0,1,12,30,22,32,36.4
2023-24,202402070SAC,2/7/2024,SAC vs DET,Jaden Ivey,iveyja01,46,DET,0,SAC,37,6,7,0,0,5,37.95,2,4,13,23,5,7,6,6,3,0,13,44,43,50,49.7
2023-24,202402070LAC,2/7/2024,LAC vs NOP,James Harden,hardeja01,45,LAC,1,NOP,19,8,5,1,1,4,38.38333333,1,7,6,11,5,6,2,3,2,2,13,24,27,32,38.1
2023-24,202402070SAC,2/7/2024,SAC vs DET,Domantas Sabonis,sabondo01,50,SAC,1,DET,30,12,7,1,0,0,40.91666667,2,10,11,17,1,3,7,10,3,1,19,37,42,49,57.9
2023-24,202402070CHO,2/7/2024,CHO vs TOR,Brandon Miller,millebr02,44,CHO,1,TOR,20,4,1,2,1,4,41.38333333,0,4,9,17,2,8,0,0,1,3,5,21,24,25,31.3
2023-24,202402060MIA,2/6/2024,MIA vs ORL,Jonathan Isaac,isaacjo01,33,ORL,0,MIA,3,3,1,0,1,2,10.2,0,3,1,2,1,2,0,0,0,1,4,4,6,7,9.1
2023-24,202402060UTA,2/6/2024,UTA vs OKC,Ousmane Dieng,diengou01,26,OKC,0,UTA,8,2,1,1,1,0,10.5,0,2,3,3,2,2,0,0,0,2,3,9,10,11,17.9
2023-24,202402060UTA,2/6/2024,UTA vs OKC,Vasilije Micic,micicva01,30,OKC,0,UTA,0,1,1,0,0,3,10.61666667,0,1,0,1,0,1,0,0,0,0,2,1,1,2,-0.3
2023-24,202402060IND,2/6/2024,IND vs HOU,Jeff Green,greenje02,48,HOU,0,IND,3,2,3,0,0,2,11.48333333,0,2,1,3,0,1,1,1,2,0,5,6,5,8,7.9
2023-24,202402060NYK,2/6/2024,NYK vs MEM,Malachi Flynn,flynnma01,45,NYK,1,MEM,6,1,1,0,0,1,11.66666667,0,1,2,4,2,3,0,0,0,0,2,7,7,8,7.7
2023-24,202402060NYK,2/6/2024,NYK vs MEM,Derrick Rose,rosede01,19,MEM,0,NYK,7,3,2,1,0,3,11.8,0,3,2,4,1,1,2,2,0,1,5,9,10,12,13.6
2023-24,202402060NYK,2/6/2024,NYK vs MEM,Taj Gibson,gibsota01,12,NYK,1,MEM,2,1,1,0,0,1,13.01666667,0,1,0,1,0,1,2,2,0,0,2,3,3,4,3.7
2023-24,202402060PHO,2/6/2024,PHO vs MIL,A.J. Green,greenaj01,31,MIL,0,PHO,0,1,0,0,0,0,13.1,0,1,0,4,0,4,0,0,1,0,1,0,1,1,1.2
2023-24,202402060UTA,2/6/2024,UTA vs OKC,Jaylin Williams,willija07,43,OKC,0,UTA,3,3,3,1,1,1,13.26666667,1,2,1,6,1,3,0,0,1,2,6,6,6,9,16.1
2023-24,202402060UTA,2/6/2024,UTA vs OKC,Kenrich Williams,willike04,40,OKC,0,UTA,0,1,2,1,0,1,13.38333333,1,0,0,4,0,2,0,0,2,1,3,2,1,3,6.2
2023-24,202402060MIA,2/6/2024,MIA vs ORL,Cole Anthony,anthoco01,50,ORL,0,MIA,4,3,0,1,0,2,13.61666667,0,3,2,3,0,1,0,0,1,1,3,4,7,7,8.6
2023-24,202402060IND,2/6/2024,IND vs HOU,Jae'Sean Tate,tateja01,47,HOU,0,IND,3,5,0,1,0,0,13.85,2,3,1,2,1,1,0,0,2,1,5,3,8,8,12
2023-24,202402060MIA,2/6/2024,MIA vs ORL,Joe Ingles,inglejo01,37,ORL,0,MIA,9,1,1,0,0,0,15.08333333,0,1,3,4,3,4,0,0,0,0,2,10,10,11,11.7
2023-24,202402060MIA,2/6/2024,MIA vs ORL,Kevin Love,loveke01,40,MIA,1,ORL,7,4,4,0,0,1,15.16666667,3,1,3,9,1,7,0,0,4,0,8,11,11,15,16.8
2023-24,202402060UTA,2/6/2024,UTA vs OKC,Cason Wallace,wallaca01,51,OKC,0,UTA,3,0,0,0,0,0,15.61666667,0,0,1,2,1,2,0,0,1,0,0,3,3,3,3
2023-24,202402060PHO,2/6/2024,PHO vs MIL,Drew Eubanks,eubandr01,45,PHO,1,MIL,2,5,0,1,1,0,15.71666667,1,4,1,3,0,0,0,0,0,2,5,2,7,7,14
2023-24,202402060UTA,2/6/2024,UTA vs OKC,Kelly Olynyk,olynyke01,50,UTA,1,OKC,10,4,7,0,0,0,16,2,2,4,6,0,0,2,2,2,0,11,17,14,21,25.3
2023-24,202402060CHI,2/6/2024,CHI vs MIN,Kyle Anderson,anderky01,51,MIN,0,CHI,2,2,3,0,0,1,16.05,1,1,1,2,0,0,0,0,1,0,5,5,4,7,7.9
2023-24,202402060IND,2/6/2024,IND vs HOU,Obi Toppin,toppiob01,53,IND,1,HOU,3,4,4,1,0,0,16.06666667,0,4,1,1,1,1,0,0,0,1,8,7,7,11,16.8
2023-24,202402060MIA,2/6/2024,MIA vs ORL,Moritz Wagner,wagnemo01,49,ORL,0,MIA,3,3,0,0,1,1,16.31666667,3,0,1,4,0,1,1,2,2,1,3,3,6,6,8.6
2023-24,202402060IND,2/6/2024,IND vs HOU,Jalen Smith,smithja04,37,IND,1,HOU,9,3,2,0,2,1,16.61666667,1,2,4,6,1,2,0,0,3,2,5,11,12,14,20.6
2023-24,202402060PHO,2/6/2024,PHO vs MIL,Bol Bol,bolbo01,14,PHO,1,MIL,4,6,1,0,1,1,17.15,0,6,2,3,0,1,0,0,2,1,7,5,10,11,14.7
2023-24,202402060UTA,2/6/2024,UTA vs OKC,Aaron Wiggins,wiggiaa01,48,OKC,0,UTA,9,4,1,0,0,0,17.48333333,2,2,3,5,2,3,1,2,0,0,5,10,13,14,15.3
2023-24,202402060BRK,2/6/2024,BRK vs DAL,Dwight Powell,poweldw01,44,DAL,0,BRK,2,2,0,0,1,0,17.63333333,0,2,1,2,0,0,0,0,2,1,2,2,4,4,7.4
2023-24,202402060BRK,2/6/2024,BRK vs DAL,Jalen Wilson,wilsoja03,12,BRK,1,DAL,10,4,2,1,0,0,17.75,1,3,3,7,2,3,2,2,1,1,6,12,14,16,20.8
2023-24,202402060BRK,2/6/2024,BRK vs DAL,Dennis Smith Jr.,smithde03,34,BRK,1,DAL,6,2,3,0,0,1,18.28333333,0,2,3,5,0,1,0,0,3,0,5,9,8,11,11.9
2023-24,202402060PHO,2/6/2024,PHO vs MIL,Robin Lopez,lopezro01,16,MIL,0,PHO,6,1,0,1,2,0,18.46666667,1,0,3,8,0,1,0,0,2,3,1,6,7,7,16.2
2023-24,202402060MIA,2/6/2024,MIA vs ORL,Gary Harris,harriga01,30,ORL,0,MIA,7,1,1,1,0,0,19.26666667,1,0,3,6,0,3,1,1,1,1,2,8,8,9,12.7
2023-24,202402060IND,2/6/2024,IND vs HOU,T.J. McConnell,mccontj01,42,IND,1,HOU,17,3,4,1,0,1,19.26666667,1,2,8,11,0,1,1,1,1,1,7,21,20,24,28.6
2023-24,202402060CHI,2/6/2024,CHI vs MIN,Nickeil Alexander-Walker,alexani01,51,MIN,0,CHI,3,1,2,1,0,0,19.3,0,1,1,4,1,3,0,0,2,1,3,5,4,6,10.2
2023-24,202402060IND,2/6/2024,IND vs HOU,Aaron Holiday,holidaa01,47,HOU,0,IND,8,2,5,0,0,1,20.18333333,0,2,3,3,2,2,0,0,1,0,7,13,10,15,16.9
2023-24,202402060CHI,2/6/2024,CHI vs MIN,Naz Reid,reidna01,51,MIN,0,CHI,10,4,2,0,1,0,20.2,0,4,4,11,2,6,0,0,1,1,6,12,14,16,20.8
2023-24,202402060BRK,2/6/2024,BRK vs DAL,Ben Simmons,simmobe01,9,BRK,1,DAL,9,9,7,1,0,2,20.26666667,4,5,4,7,0,0,1,2,2,1,16,16,18,25,31.3
2023-24,202402060NYK,2/6/2024,NYK vs MEM,Tosan Evbuomwan,evbuoto01,3,MEM,0,NYK,4,1,2,0,0,0,20.5,0,1,2,4,0,2,0,0,1,0,3,6,5,7,8.2
2023-24,202402060IND,2/6/2024,IND vs HOU,Cam Whitmore,whitmca01,27,HOU,0,IND,9,1,1,0,0,1,20.71666667,0,1,4,11,1,3,0,0,3,0,2,10,10,11,10.7
2023-24,202402060NYK,2/6/2024,NYK vs MEM,GG Jackson II,jacksgg01,19,MEM,0,NYK,16,5,1,1,2,1,20.83333333,0,5,5,10,3,6,3,6,1,3,6,17,21,22,31.5
2023-24,202402060UTA,2/6/2024,UTA vs OKC,Walker Kessler,kesslwa01,44,UTA,1,OKC,4,9,1,0,3,1,20.83333333,1,8,2,2,0,0,0,0,3,3,10,5,13,14,24.3
2023-24,202402060BRK,2/6/2024,BRK vs DAL,Grant Williams,willigr01,47,DAL,0,BRK,5,3,0,1,1,3,21.41666667,1,2,2,5,1,3,0,0,1,2,3,5,8,8,11.6
2023-24,202402060MIA,2/6/2024,MIA vs ORL,Duncan Robinson,robindu01,46,MIA,1,ORL,9,1,1,0,1,0,21.61666667,0,1,4,7,1,4,0,0,2,1,2,10,10,11,14.7
2023-24,202402060BRK,2/6/2024,BRK vs DAL,Derrick Jones Jr.,jonesde02,46,DAL,0,BRK,2,7,1,1,0,0,21.66666667,1,6,1,3,0,0,0,0,0,1,8,3,9,10,14.9
2023-24,202402060CHI,2/6/2024,CHI vs MIN,Torrey Craig,craigto01,29,CHI,1,MIN,7,6,1,1,2,2,21.81666667,2,4,2,5,1,4,2,2,1,3,7,8,13,14,22.7
2023-24,202402060PHO,2/6/2024,PHO vs MIL,Eric Gordon,gordoer01,43,PHO,1,MIL,3,4,1,0,0,0,22.28333333,0,4,1,4,1,3,0,0,2,0,5,4,7,8,9.3
2023-24,202402060NYK,2/6/2024,NYK vs MEM,Santi Aldama,aldamsa01,39,MEM,0,NYK,11,4,5,0,0,2,22.51666667,0,4,4,6,3,4,0,0,0,0,9,16,15,20,21.3
2023-24,202402060PHO,2/6/2024,PHO vs MIL,Cameron Payne,payneca01,47,MIL,0,PHO,11,4,3,2,0,1,22.63333333,0,4,4,10,1,4,2,4,2,2,7,14,15,18,25.3
2023-24,202402060NYK,2/6/2024,NYK vs MEM,David Roddy,roddyda01,48,MEM,0,NYK,15,3,3,0,0,3,22.66666667,1,2,6,11,3,5,0,2,0,0,6,18,18,21,20.1
2023-24,202402060MIA,2/6/2024,MIA vs ORL,Jaime Jaquez Jr.,jaqueja01,45,MIA,1,ORL,12,6,2,3,0,2,23.4,2,4,4,11,1,5,3,3,3,3,8,14,18,20,29.2
2023-24,202402060NYK,2/6/2024,NYK vs MEM,Jacob Gilyard,gilyaja01,34,MEM,0,NYK,12,3,4,0,1,4,24.2,0,3,4,6,4,6,0,0,2,1,7,16,15,19,20.6
2023-24,202402060NYK,2/6/2024,NYK vs MEM,Luke Kennard,kennalu01,24,MEM,0,NYK,12,3,4,1,0,0,24.35,0,3,4,8,3,5,1,2,1,1,7,16,15,19,24.6
2023-24,202402060IND,2/6/2024,IND vs HOU,Buddy Hield,hieldbu01,53,IND,1,HOU,12,3,6,0,0,1,24.43333333,0,3,5,7,2,4,0,0,2,0,9,18,15,21,23.6
2023-24,202402060MIA,2/6/2024,MIA vs ORL,Caleb Martin,martica02,34,MIA,1,ORL,11,3,1,1,1,0,24.66666667,1,2,5,9,1,3,0,0,2,2,4,12,14,15,22.1
2023-24,202402060UTA,2/6/2024,UTA vs OKC,Simone Fontecchio,fontesi01,50,UTA,1,OKC,2,6,3,1,0,2,24.88333333,3,3,1,4,0,2,0,0,0,1,9,5,8,11,14.7
2023-24,202402060BRK,2/6/2024,BRK vs DAL,Tim Hardaway Jr.,hardati02,48,DAL,0,BRK,14,7,3,0,0,0,25.43333333,1,6,4,10,3,7,3,3,1,0,10,17,21,24,26.9
2023-24,202402060NYK,2/6/2024,NYK vs MEM,John Konchar,konchjo01,40,MEM,0,NYK,5,4,5,0,0,0,26.15,1,3,2,4,1,3,0,0,1,0,9,10,9,14,17.3
2023-24,202402060UTA,2/6/2024,UTA vs OKC,Josh Giddey,giddejo01,50,OKC,0,UTA,8,3,2,0,1,1,26.16666667,0,3,3,8,2,4,0,0,3,1,5,10,11,13,16.6
2023-24,202402060UTA,2/6/2024,UTA vs OKC,Collin Sexton,sextoco01,52,UTA,1,OKC,14,0,4,0,0,2,26.21666667,0,0,4,10,1,3,5,5,2,0,4,18,14,18,18
2023-24,202402060MIA,2/6/2024,MIA vs ORL,Tyler Herro,herroty01,31,MIA,1,ORL,14,3,4,0,0,1,26.25,0,3,6,13,2,5,0,0,0,0,7,18,17,21,22.6
2023-24,202402060UTA,2/6/2024,UTA vs OKC,Kris Dunn,dunnkr01,44,UTA,1,OKC,8,3,5,4,3,1,26.5,1,2,3,8,2,5,0,0,1,7,8,13,11,16,39.1
2023-24,202402060UTA,2/6/2024,UTA vs OKC,Jordan Clarkson,clarkjo01,42,UTA,1,OKC,12,2,2,2,0,5,26.86666667,0,2,5,12,1,6,1,2,2,2,4,14,14,16,18.4
2023-24,202402060UTA,2/6/2024,UTA vs OKC,Keyonte George,georgke01,46,UTA,1,OKC,16,2,5,1,1,1,26.9,1,1,6,11,4,6,0,0,0,2,7,21,18,23,30.9
2023-24,202402060MIA,2/6/2024,MIA vs ORL,Josh Richardson,richajo01,41,MIA,1,ORL,13,5,1,2,0,0,27.26666667,2,3,5,7,3,3,0,0,4,2,6,14,18,19,26.5
2023-24,202402060MIA,2/6/2024,MIA vs ORL,Markelle Fultz,fultzma01,18,ORL,0,MIA,13,1,4,1,1,2,27.63333333,1,0,5,10,1,2,2,2,3,2,5,17,14,18,24.2
2023-24,202402060MIA,2/6/2024,MIA vs ORL,Jalen Suggs,suggsja01,47,ORL,0,MIA,3,3,4,0,0,0,27.81666667,0,3,1,7,1,6,0,0,2,0,7,7,6,10,12.6
2023-24,202402060MIA,2/6/2024,MIA vs ORL,Wendell Carter Jr.,cartewe01,25,ORL,0,MIA,15,6,3,0,0,0,27.88333333,1,5,6,9,2,4,1,2,5,0,9,18,21,24,26.7
2023-24,202402060IND,2/6/2024,IND vs HOU,Myles Turner,turnemy01,50,IND,1,HOU,21,3,2,1,2,1,28.75,0,3,8,16,2,6,3,4,6,3,5,23,24,26,35.6
2023-24,202402060CHI,2/6/2024,CHI vs MIN,Ayo Dosunmu,dosunay01,49,CHI,1,MIN,6,1,3,1,2,2,28.98333333,0,1,3,6,0,1,0,1,3,3,4,9,7,10,18.7
2023-24,202402060IND,2/6/2024,IND vs HOU,Tyrese Haliburton,halibty01,40,IND,1,HOU,18,2,7,1,2,2,29.08333333,0,2,8,15,2,6,0,1,1,3,9,25,20,27,37.9
2023-24,202402060UTA,2/6/2024,UTA vs OKC,John Collins,collijo01,48,UTA,1,OKC,22,9,0,0,1,1,29.46666667,3,6,9,15,1,4,3,3,3,1,9,22,31,31,34.8
2023-24,202402060MIA,2/6/2024,MIA vs ORL,Bam Adebayo,adebaba01,41,MIA,1,ORL,14,8,3,0,1,3,29.71666667,2,6,7,9,0,0,0,0,3,1,11,17,22,25,28.1
2023-24,202402060UTA,2/6/2024,UTA vs OKC,Luguentz Dort,dortlu01,49,OKC,0,UTA,10,1,1,1,1,0,30.3,0,1,3,8,2,5,2,3,5,2,2,11,11,12,18.7
2023-24,202402060BRK,2/6/2024,BRK vs DAL,Maxi Kleber,klebima01,16,DAL,0,BRK,7,2,3,1,0,1,30.36666667,0,2,3,7,1,5,0,0,3,1,5,10,9,12,15.9
2023-24,202402060UTA,2/6/2024,UTA vs OKC,Chet Holmgren,holmgch01,51,OKC,0,UTA,22,8,3,3,4,1,30.83333333,3,5,8,13,4,6,2,4,3,7,11,25,30,33,56.1
2023-24,202402060PHO,2/6/2024,PHO vs MIL,Bobby Portis,portibo01,51,MIL,0,PHO,5,9,2,4,1,1,31.18333333,3,6,2,9,1,4,0,0,1,5,11,7,14,16,32.8
2023-24,202402060NYK,2/6/2024,NYK vs MEM,Jalen Brunson,brunsja01,49,NYK,1,MEM,27,3,8,3,0,2,31.25,0,3,11,21,1,4,4,5,1,3,11,35,30,38,49.6
2023-24,202402060MIA,2/6/2024,MIA vs ORL,Terry Rozier,roziete01,38,MIA,1,ORL,18,6,7,1,0,1,31.25,1,5,7,12,2,4,2,3,1,1,13,25,24,31,37.7
2023-24,202402060IND,2/6/2024,IND vs HOU,Dillon Brooks,brookdi01,41,HOU,0,IND,23,3,4,1,0,0,31.26666667,1,2,8,15,3,6,4,4,1,1,7,27,26,30,35.6
2023-24,202402060IND,2/6/2024,IND vs HOU,Andrew Nembhard,nembhan01,38,IND,1,HOU,9,2,5,1,0,1,31.33333333,1,1,4,5,1,1,0,0,1,1,7,14,11,16,20.9
2023-24,202402060NYK,2/6/2024,NYK vs MEM,Miles McBride,mcbrimi01,38,NYK,1,MEM,12,3,3,2,0,0,31.43333333,1,2,5,14,2,6,0,0,4,2,6,15,15,18,26.1
2023-24,202402060BRK,2/6/2024,BRK vs DAL,Royce O'Neale,onealro01,49,BRK,1,DAL,18,6,2,0,0,2,31.73333333,1,5,6,16,4,11,2,2,1,0,8,20,24,26,26.2
2023-24,202402060NYK,2/6/2024,NYK vs MEM,Trey Jemison,jemistr01,5,MEM,0,NYK,12,6,2,0,2,1,32.15,5,1,6,10,0,0,0,0,5,2,8,14,18,20,27.2
2023-24,202402060PHO,2/6/2024,PHO vs MIL,Pat Connaughton,connapa01,45,MIL,0,PHO,12,6,6,0,0,0,32.25,0,6,4,6,3,5,1,2,4,0,12,18,18,24,28.2
2023-24,202402060PHO,2/6/2024,PHO vs MIL,Jusuf Nurkic,nurkiju01,48,PHO,1,MIL,10,10,4,2,0,2,32.26666667,5,5,5,9,0,1,0,1,4,2,14,14,20,24,32
2023-24,202402060IND,2/6/2024,IND vs HOU,Jalen Green,greenja05,50,HOU,0,IND,30,3,1,2,0,4,32.85,0,3,12,21,3,5,3,4,1,2,4,31,33,34,37.1
2023-24,202402060BRK,2/6/2024,BRK vs DAL,Josh Green,greenjo02,38,DAL,0,BRK,12,2,3,0,0,1,33.28333333,1,1,5,11,2,5,0,0,1,0,5,15,14,17,17.9
2023-24,202402060IND,2/6/2024,IND vs HOU,Aaron Nesmith,nesmiaa01,48,IND,1,HOU,10,1,1,1,1,3,33.43333333,1,0,3,6,2,4,2,4,5,2,2,11,11,12,15.7
2023-24,202402060PHO,2/6/2024,PHO vs MIL,Grayson Allen,allengr01,45,PHO,1,MIL,8,3,3,1,1,0,33.61666667,0,3,2,4,2,4,2,2,2,2,6,11,11,14,22.1
2023-24,202402060IND,2/6/2024,IND vs HOU,Amen Thompson,thompam01,31,HOU,0,IND,13,13,6,0,3,3,33.88333333,7,6,6,12,0,2,1,4,3,3,19,19,26,32,43.6
2023-24,202402060MIA,2/6/2024,MIA vs ORL,Jimmy Butler,butleji01,36,MIA,1,ORL,23,8,8,3,0,5,34.45,0,8,6,9,2,4,9,12,0,3,16,31,31,39,48.6
2023-24,202402060MIA,2/6/2024,MIA vs ORL,Paolo Banchero,banchpa01,51,ORL,0,MIA,23,9,7,2,0,2,34.48333333,1,8,7,16,1,4,8,12,2,2,16,30,32,39,48.3
2023-24,202402060BRK,2/6/2024,BRK vs DAL,Nic Claxton,claxtni01,40,BRK,1,DAL,9,11,2,0,5,2,34.6,2,9,3,9,0,0,3,3,3,5,13,11,20,22,38.2
2023-24,202402060BRK,2/6/2024,BRK vs DAL,Spencer Dinwiddie,dinwisp01,48,BRK,1,DAL,9,1,5,1,0,0,34.6,0,1,4,8,0,4,1,1,0,1,6,14,10,15,20.7
2023-24,202402060IND,2/6/2024,IND vs HOU,Pascal Siakam,siakapa01,50,IND,1,HOU,29,4,4,1,0,2,34.81666667,1,3,11,16,4,6,3,4,1,1,8,33,33,37,40.8
2023-24,202402060NYK,2/6/2024,NYK vs MEM,Vince Williams Jr.,willivi01,39,MEM,0,NYK,19,3,5,1,0,4,34.83333333,1,2,6,17,3,5,4,4,4,1,8,24,22,27,29.1
2023-24,202402060NYK,2/6/2024,NYK vs MEM,Isaiah Hartenstein,harteis01,49,NYK,1,MEM,17,9,3,1,3,3,34.98333333,4,5,7,8,0,0,3,4,3,4,12,20,26,29,41.3
2023-24,202402060CHI,2/6/2024,CHI vs MIN,Alex Caruso,carusal01,44,CHI,1,MIN,3,9,6,2,4,4,35.15,1,8,1,5,1,3,0,0,1,6,15,9,12,18,36.8
2023-24,202402060MIA,2/6/2024,MIA vs ORL,Franz Wagner,wagnefr01,43,ORL,0,MIA,13,7,3,2,0,7,35.23333333,1,6,5,15,1,7,2,2,1,2,10,16,20,23,24.9
2023-24,202402060UTA,2/6/2024,UTA vs OKC,Jalen Williams,willija06,45,OKC,0,UTA,26,5,5,1,0,2,35.31666667,1,4,10,18,3,6,3,4,0,1,10,31,31,36,40.5
2023-24,202402060CHI,2/6/2024,CHI vs MIN,Andre Drummond,drumman01,51,CHI,1,MIN,16,16,0,0,4,1,35.46666667,6,10,7,13,0,0,2,4,4,4,16,16,32,32,46.2
2023-24,202402060PHO,2/6/2024,PHO vs MIL,Malik Beasley,beaslma01,49,MIL,0,PHO,22,4,2,0,0,3,35.95,2,2,7,17,6,14,2,2,1,0,6,24,26,28,26.8
2023-24,202402060IND,2/6/2024,IND vs HOU,Alperen Sengun,sengual01,50,HOU,0,IND,20,10,6,1,0,1,35.96666667,5,5,7,15,0,1,6,8,2,1,16,26,30,36,43
2023-24,202402060UTA,2/6/2024,UTA vs OKC,Shai Gilgeous-Alexander,gilgesh01,50,OKC,0,UTA,28,4,7,1,1,2,36.05,1,3,11,22,2,3,4,5,1,2,11,35,32,39,47.3
2023-24,202402060UTA,2/6/2024,UTA vs OKC,Lauri Markkanen,markkla01,42,UTA,1,OKC,33,11,2,1,0,2,36.18333333,3,8,12,18,5,7,4,4,3,1,13,35,44,46,50.2
2023-24,202402060CHI,2/6/2024,CHI vs MIN,Mike Conley,conlemi01,46,MIN,0,CHI,9,0,8,0,0,0,36.38333333,0,0,3,7,3,7,0,0,2,0,8,17,9,17,21
2023-24,202402060NYK,2/6/2024,NYK vs MEM,Josh Hart,hartjo01,50,NYK,1,MEM,10,10,4,0,0,1,37.26666667,1,9,3,7,1,2,3,4,1,0,14,14,20,24,27
2023-24,202402060BRK,2/6/2024,BRK vs DAL,Cam Thomas,thomaca02,41,BRK,1,DAL,16,8,8,1,0,2,37.33333333,0,8,6,16,1,3,3,4,2,1,16,24,24,32,38.6
2023-24,202402060PHO,2/6/2024,PHO vs MIL,Devin Booker,bookede01,42,PHO,1,MIL,32,1,4,0,0,1,37.65,0,1,12,21,2,6,6,10,3,0,5,36,33,37,38.2
2023-24,202402060PHO,2/6/2024,PHO vs MIL,Bradley Beal,bealbr01,27,PHO,1,MIL,25,10,3,3,0,4,37.76666667,2,8,10,22,2,8,3,5,3,3,13,28,35,38,46.5
2023-24,202402060BRK,2/6/2024,BRK vs DAL,Mikal Bridges,bridgmi01,50,BRK,1,DAL,28,1,4,2,0,1,38.5,0,1,11,21,5,11,1,1,0,2,5,32,29,33,40.2
2023-24,202402060PHO,2/6/2024,PHO vs MIL,Giannis Antetokounmpo,antetgi01,49,MIL,0,PHO,34,10,6,0,0,5,38.6,4,6,13,24,1,3,7,13,5,0,16,40,44,50,50
2023-24,202402060CHI,2/6/2024,CHI vs MIN,Karl-Anthony Towns,townska01,50,MIN,0,CHI,33,5,3,1,2,2,38.61666667,1,4,11,22,7,16,4,5,4,3,8,36,38,41,50.5
2023-24,202402060PHO,2/6/2024,PHO vs MIL,Kevin Durant,duranke01,44,PHO,1,MIL,28,10,1,1,2,5,39.38333333,0,10,11,21,1,5,5,7,3,3,11,29,38,39,45.5
2023-24,202402060BRK,2/6/2024,BRK vs DAL,Kyrie Irving,irvinky01,29,DAL,0,BRK,36,2,5,2,0,3,39.66666667,0,2,15,24,6,10,0,0,1,2,7,41,38,43,48.9
2023-24,202402060PHO,2/6/2024,PHO vs MIL,Jae Crowder,crowdja01,20,MIL,0,PHO,10,6,3,2,1,1,39.75,0,6,4,9,0,4,2,2,4,3,9,13,16,19,29.7
2023-24,202402060IND,2/6/2024,IND vs HOU,Jabari Smith Jr.,smithja05,45,HOU,0,IND,20,9,0,0,0,3,39.8,5,4,8,15,2,4,2,2,1,0,9,20,29,29,27.8
2023-24,202402060CHI,2/6/2024,CHI vs MIN,Jaden McDaniels,mcdanja02,41,MIN,0,CHI,13,1,3,1,0,4,39.81666667,1,0,6,11,1,3,0,0,4,1,4,16,14,17,17.7
2023-24,202402060NYK,2/6/2024,NYK vs MEM,Donte DiVincenzo,divindo01,51,NYK,1,MEM,32,5,5,3,1,2,40.06666667,0,5,12,18,4,9,4,5,1,4,10,37,37,42,55.5
2023-24,202402060NYK,2/6/2024,NYK vs MEM,Precious Achiuwa,achiupr01,44,NYK,1,MEM,17,5,3,3,1,0,40.3,2,3,8,13,1,2,0,0,2,4,8,20,22,25,39.5
2023-24,202402060CHI,2/6/2024,CHI vs MIN,Coby White,whiteco01,51,CHI,1,MIN,33,5,7,1,0,3,42.21666667,0,5,11,21,7,13,4,5,4,1,12,40,38,45,49.5
2023-24,202402060CHI,2/6/2024,CHI vs MIN,DeMar DeRozan,derozde01,49,CHI,1,MIN,33,3,5,4,0,1,42.61666667,2,1,8,19,0,1,17,18,2,4,8,38,36,41,55.1
2023-24,202402060CHI,2/6/2024,CHI vs MIN,Nikola Vucevic,vucevni01,46,CHI,1,MIN,24,6,2,0,4,0,42.63333333,1,5,10,16,2,4,2,2,5,4,8,26,30,32,46.2
2023-24,202402060BRK,2/6/2024,BRK vs DAL,Luka Doncic,doncilu01,43,DAL,0,BRK,35,18,9,2,1,1,43.01666667,1,17,13,27,4,11,5,10,3,3,27,44,53,62,78.1
2023-24,202402060CHI,2/6/2024,CHI vs MIN,Anthony Edwards,edwaran01,48,MIN,0,CHI,38,12,5,2,1,5,43.55,0,12,12,26,5,9,9,11,5,3,17,43,50,55,63.9
2023-24,202402060CHI,2/6/2024,CHI vs MIN,Rudy Gobert,goberru01,50,MIN,0,CHI,12,16,1,1,1,1,44.4,7,9,3,6,0,0,6,10,5,2,17,13,28,29,37.7
2023-24,202402050CHO,2/5/2024,CHO vs LAL,Jaxson Hayes,hayesja02,42,LAL,0,CHO,0,3,0,1,0,0,10.86666667,1,2,0,1,0,0,0,0,1,1,3,0,3,3,6.6
2023-24,202402050CLE,2/5/2024,CLE vs SAC,Sam Merrill,merrisa01,33,CLE,1,SAC,9,0,2,1,0,0,10.95,0,0,3,4,3,4,0,0,0,1,2,11,9,11,15
2023-24,202402050NOP,2/5/2024,NOP vs TOR,Chris Boucher,bouchch01,45,TOR,0,NOP,11,6,1,0,1,1,12,1,5,4,5,1,2,2,2,0,1,7,12,17,18,21.7
2023-24,202402050NOP,2/5/2024,NOP vs TOR,Jalen McDaniels,mcdanja01,31,TOR,0,NOP,2,3,0,0,0,4,12,1,2,1,5,0,2,0,0,3,0,3,2,5,5,1.6
2023-24,202402050NOP,2/5/2024,NOP vs TOR,Garrett Temple,templga01,15,TOR,0,NOP,5,1,0,1,0,1,12,1,0,2,4,0,2,1,2,2,1,1,5,6,6,8.2
2023-24,202402050PHI,2/5/2024,PHI vs DAL,Danuel House Jr.,houseda01,34,PHI,1,DAL,4,5,0,0,0,1,12.3,2,3,1,4,0,2,2,2,3,0,5,4,9,9,9
2023-24,202402050BRK,2/5/2024,BRK vs GSW,Kevon Looney,looneke01,47,GSW,0,BRK,2,5,3,0,1,0,13.25,2,3,1,2,0,0,0,0,4,1,8,5,7,10,15.5
2023-24,202402050ATL,2/5/2024,ATL vs LAC,Bruno Fernando,fernabr01,14,ATL,1,LAC,7,4,1,0,2,0,13.7,1,3,3,6,0,0,1,3,1,2,5,8,11,12,19.3
2023-24,202402050PHI,2/5/2024,PHI vs DAL,Derrick Jones Jr.,jonesde02,45,DAL,0,PHI,5,2,1,0,0,0,14.5,0,2,2,7,0,4,1,2,1,0,3,6,7,8,8.9
2023-24,202402050NOP,2/5/2024,NOP vs TOR,Thaddeus Young,youngth01,22,TOR,0,NOP,3,2,0,0,0,0,14.51666667,1,1,1,1,0,0,1,2,0,0,2,3,5,5,5.4
2023-24,202402050PHI,2/5/2024,PHI vs DAL,Jaden Hardy,hardyja02,45,DAL,0,PHI,17,1,0,0,0,1,14.65,0,1,6,10,3,6,2,2,0,0,1,17,18,18,17.2
2023-24,202402050NOP,2/5/2024,NOP vs TOR,Gary Trent Jr.,trentga02,45,TOR,0,NOP,2,1,0,0,0,0,14.91666667,0,1,1,5,0,2,0,0,0,0,1,2,3,3,3.2
2023-24,202402050CLE,2/5/2024,CLE vs SAC,Georges Niang,niangge01,48,CLE,1,SAC,2,3,2,0,0,2,15.25,0,3,1,4,0,3,0,0,4,0,5,4,5,7,6.6
2023-24,202402050BRK,2/5/2024,BRK vs GSW,Moses Moody,moodymo01,35,GSW,0,BRK,4,1,0,0,1,1,15.38333333,1,0,2,5,0,1,0,0,0,1,1,4,5,5,7.2
2023-24,202402050CLE,2/5/2024,CLE vs SAC,Dean Wade,wadede01,41,CLE,1,SAC,6,5,2,0,0,0,15.41666667,0,5,2,2,2,2,0,0,0,0,7,8,11,13,15
2023-24,202402050CHO,2/5/2024,CHO vs LAL,Leaky Black,blackle01,20,CHO,1,LAL,2,5,2,0,0,0,15.76666667,1,4,1,4,0,2,0,0,0,0,7,4,7,9,11
2023-24,202402050PHI,2/5/2024,PHI vs DAL,Dwight Powell,poweldw01,43,DAL,0,PHI,0,7,1,0,0,1,15.81666667,2,5,0,1,0,0,0,0,3,0,8,1,7,8,8.9
2023-24,202402050NOP,2/5/2024,NOP vs TOR,Dennis Schroder,schrode01,50,TOR,0,NOP,0,0,5,0,1,2,17.63333333,0,0,0,4,0,2,0,0,0,1,5,5,0,5,8.5
2023-24,202402050BRK,2/5/2024,BRK vs GSW,Gui Santos,santogu01,9,GSW,0,BRK,9,5,0,1,2,0,17.71666667,2,3,3,5,0,0,3,3,2,3,5,9,14,14,24
2023-24,202402050PHI,2/5/2024,PHI vs DAL,Mo Bamba,bambamo01,28,PHI,1,DAL,5,10,0,0,1,1,17.76666667,4,6,2,7,0,1,1,2,4,1,10,5,15,15,19
2023-24,202402050ATL,2/5/2024,ATL vs LAC,Norman Powell,powelno01,49,LAC,0,ATL,13,0,0,0,0,1,17.86666667,0,0,4,8,3,5,2,3,2,0,0,13,13,13,12
2023-24,202402050CHO,2/5/2024,CHO vs LAL,Max Christie,chrisma02,43,LAL,0,CHO,6,3,0,0,1,0,18.01666667,0,3,2,3,0,1,2,2,1,1,3,6,9,9,12.6
2023-24,202402050CLE,2/5/2024,CLE vs SAC,Trey Lyles,lylestr01,35,SAC,0,CLE,7,4,1,1,0,0,18.73333333,0,4,2,5,0,3,3,4,0,1,5,8,11,12,16.3
2023-24,202402050ATL,2/5/2024,ATL vs LAC,De'Andre Hunter,huntede01,27,ATL,1,LAC,27,7,3,0,0,0,18.85,2,5,10,12,3,5,4,5,2,0,10,30,34,37,39.9
2023-24,202402050NOP,2/5/2024,NOP vs TOR,Naji Marshall,marshna01,41,NOP,1,TOR,8,1,5,1,0,4,19.36666667,1,0,2,7,0,2,4,4,3,1,6,13,9,14,15.7
2023-24,202402050CHO,2/5/2024,CHO vs LAL,Taurean Prince,princta02,50,LAL,0,CHO,9,4,1,0,0,2,19.45,1,3,4,7,1,4,0,2,0,0,5,10,13,14,13.3
2023-24,202402050ATL,2/5/2024,ATL vs LAC,Daniel Theis,theisda01,38,LAC,0,ATL,9,8,2,0,0,0,19.5,2,6,4,7,1,1,0,0,3,0,10,11,17,19,21.6
2023-24,202402050CHO,2/5/2024,CHO vs LAL,Nick Smith Jr.,smithni01,34,CHO,1,LAL,5,2,4,0,0,1,19.66666667,0,2,2,7,1,3,0,0,2,0,6,9,7,11,12.4
2023-24,202402050NOP,2/5/2024,NOP vs TOR,Jonas Valanciunas,valanjo01,50,NOP,1,TOR,10,12,3,0,0,0,20.08333333,8,4,4,14,0,0,2,2,1,0,15,13,22,25,28.9
2023-24,202402050NOP,2/5/2024,NOP vs TOR,Larry Nance Jr.,nancela02,32,NOP,1,TOR,4,6,1,0,0,0,20.48333333,1,5,2,4,0,0,0,0,4,0,7,5,10,11,12.7
2023-24,202402050ATL,2/5/2024,ATL vs LAC,Mason Plumlee,plumlma01,19,LAC,0,ATL,8,9,3,1,1,0,20.85,2,7,3,5,0,0,2,4,0,2,12,11,17,20,29.3
2023-24,202402050PHI,2/5/2024,PHI vs DAL,Jaden Springer,sprinja01,31,PHI,1,DAL,8,5,4,3,0,1,21.01666667,1,4,3,7,0,2,2,2,1,3,9,12,13,17,28
2023-24,202402050NOP,2/5/2024,NOP vs TOR,Dyson Daniels,daniedy01,50,NOP,1,TOR,5,3,4,3,1,0,21.06666667,1,2,2,5,1,2,0,0,1,4,7,9,8,12,26.6
2023-24,202402050PHI,2/5/2024,PHI vs DAL,Patrick Beverley,beverpa01,46,PHI,1,DAL,7,3,2,0,0,1,21.15,2,1,3,8,1,3,0,0,1,0,5,9,10,12,12.6
2023-24,202402050ATL,2/5/2024,ATL vs LAC,Terance Mann,mannte01,43,LAC,0,ATL,9,1,2,0,0,0,21.26666667,1,0,4,4,1,1,0,0,2,0,3,11,10,12,13.2
2023-24,202402050PHI,2/5/2024,PHI vs DAL,Tim Hardaway Jr.,hardati02,47,DAL,0,PHI,0,2,0,0,1,0,21.73333333,0,2,0,8,0,5,0,0,2,1,2,0,2,2,5.4
2023-24,202402050NOP,2/5/2024,NOP vs TOR,Zion Williamson,willizi01,40,NOP,1,TOR,16,3,5,0,1,1,21.91666667,1,2,5,8,0,0,6,6,0,1,8,21,19,24,29.1
2023-24,202402050PHI,2/5/2024,PHI vs DAL,Paul Reed,reedpa01,49,PHI,1,DAL,2,6,0,0,1,0,22.33333333,3,3,1,6,0,1,0,0,0,1,6,2,8,8,12.2
2023-24,202402050NOP,2/5/2024,NOP vs TOR,Herbert Jones,joneshe01,45,NOP,1,TOR,7,2,2,1,0,1,22.4,2,0,3,7,1,4,0,0,1,1,4,9,9,11,14.4
2023-24,202402050NOP,2/5/2024,NOP vs TOR,CJ McCollum,mccolcj01,36,NOP,1,TOR,20,6,3,2,0,0,22.63333333,1,5,7,12,6,10,0,0,1,2,9,23,26,29,37.7
2023-24,202402050PHI,2/5/2024,PHI vs DAL,Marcus Morris,morrima03,37,PHI,1,DAL,10,5,0,1,1,1,23.5,0,5,4,10,2,4,0,0,1,2,5,10,15,15,21
2023-24,202402050NOP,2/5/2024,NOP vs TOR,Jordan Nwora,nworajo01,24,TOR,0,NOP,7,3,5,1,0,3,23.53333333,1,2,3,7,1,2,0,0,1,1,8,12,10,15,18.1
2023-24,202402050CLE,2/5/2024,CLE vs SAC,Malik Monk,monkma01,48,SAC,0,CLE,18,4,1,0,0,2,23.78333333,1,3,7,12,2,4,2,4,5,0,5,19,22,23,22.3
2023-24,202402050BRK,2/5/2024,BRK vs GSW,Lester Quinones,quinole01,13,GSW,0,BRK,3,7,2,2,0,1,23.78333333,3,4,1,7,0,2,1,2,3,2,9,5,10,12,19.4
2023-24,202402050CLE,2/5/2024,CLE vs SAC,Caris LeVert,leverca01,38,CLE,1,SAC,17,6,7,1,0,1,23.9,1,5,6,12,3,4,2,4,3,1,13,24,23,30,36.7
2023-24,202402050CHO,2/5/2024,CHO vs LAL,Bryce McGowens,mcgowbr01,40,CHO,1,LAL,10,4,1,2,0,2,23.91666667,1,3,4,7,1,1,1,2,3,2,5,11,14,15,20.3
2023-24,202402050NOP,2/5/2024,NOP vs TOR,Immanuel Quickley,quickim01,45,TOR,0,NOP,8,1,6,0,0,2,24.23333333,1,0,3,10,1,3,1,1,1,0,7,14,9,15,16.2
2023-24,202402050CLE,2/5/2024,CLE vs SAC,Isaac Okoro,okorois01,39,CLE,1,SAC,10,0,0,2,1,2,24.73333333,0,0,3,4,2,2,2,4,1,3,0,10,10,10,17
2023-24,202402050NOP,2/5/2024,NOP vs TOR,Trey Murphy III,murphtr02,25,NOP,1,TOR,10,6,0,0,2,0,24.75,1,5,4,10,2,8,0,0,1,2,6,10,16,16,23.2
2023-24,202402050NOP,2/5/2024,NOP vs TOR,Scottie Barnes,barnesc01,50,TOR,0,NOP,17,5,4,0,2,1,25.21666667,2,3,5,12,2,5,5,6,1,2,9,21,22,26,34
2023-24,202402050NOP,2/5/2024,NOP vs TOR,Jose Alvarado,alvarjo01,32,NOP,1,TOR,11,4,4,3,0,1,25.36666667,0,4,5,11,1,7,0,0,0,3,8,15,15,19,29.8
2023-24,202402050NOP,2/5/2024,NOP vs TOR,Bruce Brown,brownbr01,43,TOR,0,NOP,9,3,3,0,0,1,26.1,1,2,4,7,1,3,0,0,0,0,6,12,12,15,16.1
2023-24,202402050ATL,2/5/2024,ATL vs LAC,Amir Coffey,coffeam01,37,LAC,0,ATL,13,0,2,0,1,0,26.1,0,0,4,8,2,4,3,4,3,1,2,15,13,15,19
2023-24,202402050ATL,2/5/2024,ATL vs LAC,Russell Westbrook,westbru01,49,LAC,0,ATL,13,5,3,2,1,2,26.25,0,5,6,10,0,2,1,3,1,3,8,16,18,21,30.5
2023-24,202402050CLE,2/5/2024,CLE vs SAC,Max Strus,strusma01,48,CLE,1,SAC,22,5,2,2,0,0,26.38333333,1,4,8,13,6,10,0,0,0,2,7,24,27,29,37
2023-24,202402050ATL,2/5/2024,ATL vs LAC,Bogdan Bogdanovic,bogdabo01,48,ATL,1,LAC,16,3,6,1,0,0,26.56666667,1,2,6,12,4,8,0,0,4,1,9,22,19,25,31.6
2023-24,202402050BRK,2/5/2024,BRK vs GSW,Cameron Johnson,johnsca02,40,BRK,1,GSW,13,8,4,1,2,1,26.83333333,1,7,5,9,3,6,0,0,5,3,12,17,21,25,36.6
2023-24,202402050BRK,2/5/2024,BRK vs GSW,Royce O'Neale,onealro01,48,BRK,1,GSW,15,3,1,1,0,1,27.01666667,1,2,5,12,5,12,0,0,4,1,4,16,18,19,22.1
2023-24,202402050PHI,2/5/2024,PHI vs DAL,Maxi Kleber,klebima01,15,DAL,0,PHI,14,4,5,0,1,1,27.5,2,2,6,8,2,4,0,0,0,1,9,19,18,23,28.3
2023-24,202402050CLE,2/5/2024,CLE vs SAC,Darius Garland,garlada01,24,CLE,1,SAC,11,2,5,0,0,2,27.6,1,1,4,7,2,4,1,1,1,0,7,16,13,18,18.9
2023-24,202402050NOP,2/5/2024,NOP vs TOR,Jakob Poeltl,poeltja01,39,TOR,0,NOP,14,9,1,1,2,3,27.68333333,1,8,7,8,0,0,0,2,2,3,10,15,23,24,32.3
2023-24,202402050CLE,2/5/2024,CLE vs SAC,Evan Mobley,mobleev01,25,CLE,1,SAC,11,14,7,2,1,0,27.75,1,13,5,12,0,1,1,2,3,3,21,18,25,32,47.3
2023-24,202402050PHI,2/5/2024,PHI vs DAL,Grant Williams,willigr01,46,DAL,0,PHI,14,7,2,0,1,1,28.28333333,1,6,3,5,2,3,6,7,3,1,9,16,21,23,27.4
2023-24,202402050CHO,2/5/2024,CHO vs LAL,Rui Hachimura,hachiru01,39,LAL,0,CHO,9,5,0,1,0,0,29.21666667,1,4,4,6,1,3,0,0,1,1,5,9,14,14,18
2023-24,202402050CLE,2/5/2024,CLE vs SAC,Jarrett Allen,allenja01,43,CLE,1,SAC,19,7,3,0,2,0,29.56666667,1,6,8,10,0,0,3,4,1,2,10,22,26,29,37.9
2023-24,202402050CLE,2/5/2024,CLE vs SAC,Keegan Murray,murrake02,45,SAC,0,CLE,10,1,2,0,0,0,29.58333333,0,1,4,9,2,4,0,0,3,0,3,12,11,13,14.2
2023-24,202402050BRK,2/5/2024,BRK vs GSW,Klay Thompson,thompkl01,45,GSW,0,BRK,8,6,3,2,0,1,29.8,0,6,4,9,0,3,0,0,1,2,9,11,14,17,24.7
2023-24,202402050NOP,2/5/2024,NOP vs TOR,Brandon Ingram,ingrabr01,46,NOP,1,TOR,41,6,9,0,1,0,29.95,1,5,16,21,8,11,1,1,1,1,15,50,47,56,64.7
2023-24,202402050NOP,2/5/2024,NOP vs TOR,Gradey Dick,dickgr01,29,TOR,0,NOP,22,4,2,1,0,0,30.16666667,0,4,9,16,4,8,0,0,2,1,6,24,26,28,32.8
2023-24,202402050BRK,2/5/2024,BRK vs GSW,Draymond Green,greendr01,23,GSW,0,BRK,8,10,7,0,2,3,30.33333333,2,8,4,6,0,0,0,0,2,2,17,15,18,25,33.5
2023-24,202402050CLE,2/5/2024,CLE vs SAC,Harrison Barnes,barneha02,49,SAC,0,CLE,22,1,0,1,0,0,30.45,0,1,8,15,6,10,0,0,1,1,1,22,23,23,26.2
2023-24,202402050BRK,2/5/2024,BRK vs GSW,Dennis Smith Jr.,smithde03,33,BRK,1,GSW,12,8,5,2,2,4,30.86666667,4,4,4,9,1,3,3,5,4,4,13,17,20,25,37.1
2023-24,202402050CLE,2/5/2024,CLE vs SAC,Kevin Huerter,huertke01,47,SAC,0,CLE,10,3,4,1,0,1,31.36666667,2,1,4,9,2,5,0,0,0,1,7,14,13,17,21.6
2023-24,202402050PHI,2/5/2024,PHI vs DAL,Josh Green,greenjo02,37,DAL,0,PHI,20,6,4,2,0,1,31.6,1,5,6,9,4,7,4,4,0,2,10,24,26,30,38.2
2023-24,202402050PHI,2/5/2024,PHI vs DAL,Kelly Oubre Jr.,oubreke01,37,PHI,1,DAL,19,6,0,1,0,0,31.7,4,2,7,17,2,7,3,5,3,1,6,19,25,25,29.2
2023-24,202402050BRK,2/5/2024,BRK vs GSW,Nic Claxton,claxtni01,39,BRK,1,GSW,15,5,1,0,7,0,31.93333333,2,3,7,9,0,0,1,2,1,7,6,16,20,21,43.5
2023-24,202402050CHO,2/5/2024,CHO vs LAL,Nick Richards,richani01,40,CHO,1,LAL,4,9,1,0,1,1,32.38333333,1,8,1,4,0,0,2,2,3,1,10,5,13,14,18.3
2023-24,202402050ATL,2/5/2024,ATL vs LAC,Paul George,georgpa01,46,LAC,0,ATL,18,3,5,2,0,1,32.45,0,3,7,13,3,5,1,2,3,2,8,23,21,26,34.1
2023-24,202402050PHI,2/5/2024,PHI vs DAL,Tyrese Maxey,maxeyty01,45,PHI,1,DAL,15,2,7,0,0,3,32.85,0,2,6,16,1,5,2,3,4,0,9,22,17,24,24.9
2023-24,202402050CLE,2/5/2024,CLE vs SAC,Donovan Mitchell,mitchdo01,39,CLE,1,SAC,29,2,5,2,0,0,32.88333333,0,2,11,20,5,11,2,2,1,2,7,34,31,36,44.9
2023-24,202402050BRK,2/5/2024,BRK vs GSW,Jonathan Kuminga,kuminjo01,46,GSW,0,BRK,28,10,3,1,2,3,33.03333333,2,8,9,18,0,0,10,12,0,3,13,31,38,41,50.5
2023-24,202402050ATL,2/5/2024,ATL vs LAC,Saddiq Bey,beysa01,49,ATL,1,LAC,18,5,0,1,0,1,33.06666667,3,2,5,8,3,6,5,5,1,1,5,18,23,23,26
2023-24,202402050CHO,2/5/2024,CHO vs LAL,Brandon Miller,millebr02,43,CHO,1,LAL,33,4,3,4,0,2,33.1,1,3,13,25,5,11,2,2,4,4,7,36,37,40,52.3
2023-24,202402050CHO,2/5/2024,CHO vs LAL,P.J. Washington,washipj01,43,CHO,1,LAL,15,8,4,1,0,0,33.95,1,7,6,14,1,5,2,4,0,1,12,19,23,27,33.6
2023-24,202402050CLE,2/5/2024,CLE vs SAC,Domantas Sabonis,sabondo01,49,SAC,0,CLE,12,19,15,0,0,5,34.03333333,4,15,6,9,0,0,0,0,1,0,34,27,31,46,52.3
2023-24,202402050CHO,2/5/2024,CHO vs LAL,Ish Smith,smithis01,42,CHO,1,LAL,8,2,6,2,0,2,34.18333333,0,2,4,9,0,0,0,0,2,2,8,14,10,16,23.4
2023-24,202402050BRK,2/5/2024,BRK vs GSW,Stephen Curry,curryst01,44,GSW,0,BRK,29,5,3,0,0,4,34.28333333,1,4,12,24,4,11,1,1,2,0,8,32,34,37,35.5
2023-24,202402050ATL,2/5/2024,ATL vs LAC,Dejounte Murray,murrade01,49,ATL,1,LAC,21,5,7,0,0,2,34.3,1,4,7,18,3,7,4,5,1,0,12,28,26,33,35.5
2023-24,202402050ATL,2/5/2024,ATL vs LAC,Onyeka Okongwu,okongon01,49,ATL,1,LAC,18,5,0,0,1,2,34.3,4,1,8,10,2,2,0,0,4,1,5,18,23,23,25
2023-24,202402050PHI,2/5/2024,PHI vs DAL,Kyrie Irving,irvinky01,28,DAL,0,PHI,23,5,8,2,1,1,34.61666667,1,4,10,17,2,3,1,1,4,3,13,31,28,36,49
2023-24,202402050PHI,2/5/2024,PHI vs DAL,Tobias Harris,harrito02,45,PHI,1,DAL,17,6,6,2,1,1,34.65,0,6,8,11,1,1,0,0,2,3,12,23,23,29,41.2
2023-24,202402050CLE,2/5/2024,CLE vs SAC,De'Aaron Fox,foxde01,43,SAC,0,CLE,19,4,1,2,1,3,35.41666667,1,3,8,20,3,9,0,0,4,3,5,20,23,24,31.3
2023-24,202402050PHI,2/5/2024,PHI vs DAL,Luka Doncic,doncilu01,42,DAL,0,PHI,19,8,3,1,0,3,35.56666667,0,8,6,15,4,10,3,5,3,1,11,22,27,30,33.1
2023-24,202402050ATL,2/5/2024,ATL vs LAC,Trae Young,youngtr01,45,ATL,1,LAC,25,2,12,2,0,5,35.71666667,0,2,8,14,3,7,6,6,5,2,14,37,27,39,46.4
2023-24,202402050CHO,2/5/2024,CHO vs LAL,Austin Reaves,reaveau01,53,LAL,0,CHO,9,4,11,1,1,5,36.16666667,0,4,3,8,0,5,3,3,3,2,15,20,13,24,31.3
2023-24,202402050BRK,2/5/2024,BRK vs GSW,Cam Thomas,thomaca02,40,BRK,1,GSW,18,5,3,2,0,1,36.35,1,4,4,21,0,6,10,11,6,2,8,21,23,26,33.5
2023-24,202402050ATL,2/5/2024,ATL vs LAC,Jalen Johnson,johnsja05,36,ATL,1,LAC,9,7,5,0,1,1,37.08333333,1,6,3,14,1,3,2,3,4,1,12,14,16,21,26.9
2023-24,202402050CHO,2/5/2024,CHO vs LAL,Anthony Davis,davisan02,49,LAL,0,CHO,26,15,11,0,3,2,37.13333333,3,12,12,16,0,2,2,2,1,3,26,37,41,52,67.5
2023-24,202402050ATL,2/5/2024,ATL vs LAC,Kawhi Leonard,leonaka01,45,LAC,0,ATL,36,2,5,1,1,1,37.21666667,1,1,13,20,5,8,5,5,2,2,7,41,38,43,50.9
2023-24,202402050BRK,2/5/2024,BRK vs GSW,Brandin Podziemski,podzibr01,41,GSW,0,BRK,15,11,3,0,0,0,37.93333333,3,8,6,14,0,4,3,4,3,0,14,18,26,29,32.7
2023-24,202402050ATL,2/5/2024,ATL vs LAC,James Harden,hardeja01,44,LAC,0,ATL,30,8,10,2,1,2,38.5,2,6,7,14,6,9,10,10,3,3,18,40,38,48,61.6
2023-24,202402050BRK,2/5/2024,BRK vs GSW,Spencer Dinwiddie,dinwisp01,47,BRK,1,GSW,9,3,5,0,0,0,39.38333333,0,3,3,12,2,6,1,2,3,0,8,14,12,17,20.1
2023-24,202402050CHO,2/5/2024,CHO vs LAL,LeBron James,jamesle01,47,LAL,0,CHO,26,4,7,1,1,4,39.53333333,0,4,12,22,0,5,2,3,2,2,11,33,30,37,43.3
2023-24,202402050CHO,2/5/2024,CHO vs LAL,D'Angelo Russell,russeda01,49,LAL,0,CHO,28,4,6,1,0,3,39.66666667,0,4,10,21,5,12,3,3,2,1,10,34,32,38,41.8
2023-24,202402050CHO,2/5/2024,CHO vs LAL,Miles Bridges,bridgmi02,38,CHO,1,LAL,41,0,4,0,0,1,40,0,0,16,26,5,10,4,4,1,0,4,45,41,45,46
2023-24,202402050BRK,2/5/2024,BRK vs GSW,Mikal Bridges,bridgmi01,49,BRK,1,GSW,13,6,4,1,1,3,42.51666667,2,4,5,15,1,7,2,2,0,2,10,17,19,23,29.2
2023-24,202402040UTA,2/4/2024,UTA vs MIL,Cameron Payne,payneca01,46,MIL,0,UTA,3,3,2,0,0,0,10.25,1,2,1,3,1,3,0,0,0,0,5,5,6,8,9.6
2023-24,202402040UTA,2/4/2024,UTA vs MIL,Ochai Agbaji,agbajoc01,51,UTA,1,MIL,3,1,1,0,0,0,10.28333333,0,1,1,2,1,2,0,0,0,0,2,4,4,5,5.7
2023-24,202402040OKC,2/4/2024,OKC vs TOR,Gradey Dick,dickgr01,28,TOR,0,OKC,6,0,1,0,0,0,10.38333333,0,0,2,2,0,0,2,2,0,0,1,7,6,7,7.5
2023-24,202402040DEN,2/4/2024,DEN vs POR,Justin Minaya,minayju01,14,POR,0,DEN,0,2,1,0,0,0,10.41666667,2,0,0,1,0,0,0,0,0,0,3,1,2,3,3.9
2023-24,202402040CHO,2/4/2024,CHO vs IND,JT Thor,thorjt01,40,CHO,1,IND,2,3,1,0,0,0,10.41666667,0,3,1,1,0,0,0,0,0,0,4,3,5,6,7.1
2023-24,202402040BOS,2/4/2024,BOS vs MEM,Oshae Brissett,brissos01,32,BOS,1,MEM,6,3,1,1,0,1,10.58333333,1,2,2,4,1,1,1,1,1,1,4,7,9,10,13.1
2023-24,202402040DET,2/4/2024,DET vs ORL,Cole Anthony,anthoco01,49,ORL,0,DET,1,1,0,1,0,1,10.85,0,1,0,3,0,0,1,2,1,1,1,1,2,2,4.2
2023-24,202402040CHO,2/4/2024,CHO vs IND,Obi Toppin,toppiob01,52,IND,0,CHO,0,1,2,0,0,3,11,0,1,0,1,0,1,0,0,1,0,3,2,1,3,1.2
2023-24,202402040CHO,2/4/2024,CHO vs IND,Buddy Hield,hieldbu01,52,IND,0,CHO,3,1,0,0,0,0,11.61666667,0,1,1,4,1,3,0,0,1,0,1,3,4,4,4.2
2023-24,202402040DET,2/4/2024,DET vs ORL,Kevin Knox,knoxke01,31,DET,1,ORL,0,1,1,0,0,1,13.06666667,0,1,0,3,0,2,0,0,1,0,2,1,1,2,1.7
2023-24,202402040WAS,2/4/2024,WAS vs PHO,Delon Wright,wrighde01,28,WAS,1,PHO,2,1,2,1,0,0,13.11666667,0,1,1,3,0,1,0,0,0,1,3,4,3,5,9.2
2023-24,202402040DEN,2/4/2024,DEN vs POR,Duop Reath,reathdu01,38,POR,0,DEN,8,1,1,0,0,1,13.33333333,0,1,3,3,2,2,0,0,3,0,2,9,9,10,9.7
2023-24,202402040DET,2/4/2024,DET vs ORL,Mike Muscala,muscami01,32,DET,1,ORL,0,1,0,0,0,0,13.9,1,0,0,0,0,0,0,0,1,0,1,0,1,1,1.2
2023-24,202402040OKC,2/4/2024,OKC vs TOR,Vasilije Micic,micicva01,29,OKC,1,TOR,3,1,5,0,0,0,14,0,1,1,4,1,3,0,0,0,0,6,8,4,9,11.7
2023-24,202402040OKC,2/4/2024,OKC vs TOR,Jaylin Williams,willija07,42,OKC,1,TOR,3,5,2,0,0,0,14.31666667,3,2,1,5,1,4,0,0,1,0,7,5,8,10,12
2023-24,202402040BOS,2/4/2024,BOS vs MEM,Luke Kornet,kornelu01,34,BOS,1,MEM,2,8,1,1,1,1,14.83333333,5,3,0,2,0,0,2,2,0,2,9,3,10,11,18.1
2023-24,202402040MIA,2/4/2024,MIA vs LAC,Kevin Love,loveke01,39,MIA,1,LAC,6,7,3,0,0,2,14.88333333,0,7,2,4,2,4,0,0,1,0,10,9,13,16,16.9
2023-24,202402040BOS,2/4/2024,BOS vs MEM,Payton Pritchard,pritcpa01,50,BOS,1,MEM,6,2,3,1,0,1,15,1,1,2,8,0,6,2,2,2,1,5,9,8,11,14.9
2023-24,202402040DET,2/4/2024,DET vs ORL,Joe Ingles,inglejo01,36,ORL,0,DET,3,2,2,0,0,1,15.01666667,0,2,1,3,1,3,0,0,1,0,4,5,5,7,7.4
2023-24,202402040MIA,2/4/2024,MIA vs LAC,Russell Westbrook,westbru01,48,LAC,0,MIA,5,1,2,1,0,3,15.2,0,1,2,9,1,4,0,0,0,1,3,7,6,8,9.2
2023-24,202402040WAS,2/4/2024,WAS vs PHO,Drew Eubanks,eubandr01,44,PHO,0,WAS,5,3,1,0,2,3,15.38333333,0,3,1,1,0,0,3,4,2,2,4,6,8,9,13.1
2023-24,202402040WAS,2/4/2024,WAS vs PHO,Bol Bol,bolbo01,13,PHO,0,WAS,8,7,0,1,0,2,15.46666667,2,5,4,7,0,2,0,0,0,1,7,8,15,15,17.4
2023-24,202402040DET,2/4/2024,DET vs ORL,Danilo Gallinari,gallida01,31,DET,1,ORL,2,2,1,1,0,1,15.73333333,0,2,0,5,0,4,2,2,2,1,3,3,4,5,7.9
2023-24,202402040MIN,2/4/2024,MIN vs HOU,Aaron Holiday,holidaa01,46,HOU,0,MIN,5,2,2,2,0,1,15.76666667,0,2,1,3,0,1,3,3,3,2,4,7,7,9,15.4
2023-24,202402040WAS,2/4/2024,WAS vs PHO,Josh Okogie,okogijo01,44,PHO,0,WAS,4,2,0,1,0,1,15.9,2,0,2,2,0,0,0,0,0,1,2,4,6,6,8.4
2023-24,202402040MIN,2/4/2024,MIN vs HOU,Jeff Green,greenje02,47,HOU,0,MIN,4,2,0,0,0,0,15.98333333,1,1,1,3,1,2,1,2,1,0,2,4,6,6,6.4
2023-24,202402040CHO,2/4/2024,CHO vs IND,Bryce McGowens,mcgowbr01,39,CHO,1,IND,4,1,1,0,0,0,16.21666667,0,1,0,2,0,1,4,4,0,0,2,5,5,6,6.7
2023-24,202402040MIN,2/4/2024,MIN vs HOU,Kyle Anderson,anderky01,50,MIN,1,HOU,6,2,4,1,1,0,16.71666667,1,1,3,5,0,1,0,0,2,2,6,10,8,12,20.4
2023-24,202402040MIN,2/4/2024,MIN vs HOU,Jordan McLaughlin,mclaujo01,29,MIN,1,HOU,4,4,2,0,0,1,17.18333333,1,3,1,4,1,3,1,2,0,0,6,6,8,10,10.8
2023-24,202402040WAS,2/4/2024,WAS vs PHO,Johnny Davis,davisjo06,23,WAS,1,PHO,3,0,1,1,0,1,17.63333333,0,0,1,7,1,3,0,0,1,1,1,4,3,4,6.5
2023-24,202402040OKC,2/4/2024,OKC vs TOR,Bruce Brown,brownbr01,42,TOR,0,OKC,2,0,2,0,0,0,17.71666667,0,0,0,4,0,1,2,2,0,0,2,4,2,4,5
2023-24,202402040OKC,2/4/2024,OKC vs TOR,Cason Wallace,wallaca01,50,OKC,1,TOR,8,1,2,0,1,0,18.05,0,1,3,8,2,7,0,0,1,1,3,10,9,11,15.2
2023-24,202402040MIA,2/4/2024,MIA vs LAC,Ivica Zubac,zubaciv01,39,LAC,0,MIA,4,3,0,0,0,1,18.33333333,1,2,2,4,0,0,0,0,2,0,3,4,7,7,6.6
2023-24,202402040UTA,2/4/2024,UTA vs MIL,Pat Connaughton,connapa01,44,MIL,0,UTA,1,4,1,2,0,1,18.38333333,1,3,0,0,0,0,1,4,1,2,5,2,5,6,12.3
2023-24,202402040WAS,2/4/2024,WAS vs PHO,Eric Gordon,gordoer01,42,PHO,0,WAS,7,0,0,1,0,1,18.5,0,0,3,6,1,3,0,0,1,1,0,7,7,7,9
2023-24,202402040CHO,2/4/2024,CHO vs IND,Leaky Black,blackle01,19,CHO,1,IND,0,3,2,1,1,0,18.65,1,2,0,3,0,0,0,0,0,2,5,2,3,5,12.6
2023-24,202402040OKC,2/4/2024,OKC vs TOR,Thaddeus Young,youngth01,21,TOR,0,OKC,6,5,4,1,1,0,18.95,1,4,3,4,0,1,0,0,1,2,9,10,11,15,24
2023-24,202402040MIN,2/4/2024,MIN vs HOU,Jabari Smith Jr.,smithja05,44,HOU,0,MIN,3,2,0,1,0,0,18.96666667,0,2,1,4,1,2,0,0,5,1,2,3,5,5,8.4
2023-24,202402040MIN,2/4/2024,MIN vs HOU,Cam Whitmore,whitmca01,26,HOU,0,MIN,14,2,1,1,0,2,19.08333333,0,2,4,13,3,8,3,6,2,1,3,15,16,17,18.9
2023-24,202402040DET,2/4/2024,DET vs ORL,Alec Burks,burksal01,42,DET,1,ORL,10,3,1,1,0,1,19.53333333,0,3,3,7,1,3,3,3,0,1,4,11,13,14,17.1
2023-24,202402040MIA,2/4/2024,MIA vs LAC,Terance Mann,mannte01,42,LAC,0,MIA,7,5,1,0,0,0,19.63333333,2,3,3,5,1,2,0,0,1,0,6,8,12,13,14.5
2023-24,202402040DEN,2/4/2024,DEN vs POR,Kris Murray,murrakr01,30,POR,0,DEN,8,2,2,1,1,2,19.63333333,0,2,4,7,0,2,0,0,2,2,4,10,10,12,17.4
2023-24,202402040MIN,2/4/2024,MIN vs HOU,Amen Thompson,thompam01,30,HOU,0,MIN,8,7,2,1,0,0,19.68333333,3,4,2,7,0,0,4,6,1,1,9,10,15,17,22.4
2023-24,202402040WAS,2/4/2024,WAS vs PHO,Jordan Poole,poolejo01,47,WAS,1,PHO,4,5,7,0,0,1,19.78333333,0,5,1,7,0,3,2,2,3,0,12,11,9,16,19.5
2023-24,202402040CHO,2/4/2024,CHO vs IND,Jalen Smith,smithja04,36,IND,0,CHO,10,5,0,0,1,0,20.23333333,1,4,4,9,1,3,1,1,0,1,5,10,15,15,19
2023-24,202402040CHO,2/4/2024,CHO vs IND,Tyrese Haliburton,halibty01,39,IND,0,CHO,17,1,4,1,2,1,20.28333333,0,1,6,8,3,5,2,3,0,3,5,21,18,22,32.2
2023-24,202402040DET,2/4/2024,DET vs ORL,Moritz Wagner,wagnemo01,48,ORL,0,DET,10,5,4,0,0,1,20.43333333,1,4,5,5,0,0,0,0,1,0,9,14,15,19,21
2023-24,202402040MIN,2/4/2024,MIN vs HOU,Nickeil Alexander-Walker,alexani01,50,MIN,1,HOU,5,7,1,1,0,2,20.98333333,1,6,2,7,1,4,0,0,2,1,8,6,12,13,15.9
2023-24,202402040DET,2/4/2024,DET vs ORL,Jonathan Isaac,isaacjo01,32,ORL,0,DET,5,6,0,1,1,0,21.06666667,1,5,1,2,0,0,3,4,1,2,6,5,11,11,18.2
2023-24,202402040WAS,2/4/2024,WAS vs PHO,Landry Shamet,shamela01,32,WAS,1,PHO,13,2,1,0,0,1,21.21666667,2,0,6,10,1,4,0,0,1,0,3,14,15,16,15.9
2023-24,202402040CHO,2/4/2024,CHO vs IND,T.J. McConnell,mccontj01,41,IND,0,CHO,4,6,7,0,0,4,21.26666667,1,5,2,5,0,0,0,0,2,0,13,11,10,17,17.7
2023-24,202402040UTA,2/4/2024,UTA vs MIL,Kelly Olynyk,olynyke01,49,UTA,1,MIL,8,7,6,0,0,0,21.35,2,5,2,5,1,2,3,4,3,0,13,14,15,21,25.4
2023-24,202402040DEN,2/4/2024,DEN vs POR,Reggie Jackson,jacksre01,51,DEN,1,POR,7,4,1,1,0,0,21.43333333,0,4,3,11,1,4,0,0,2,1,5,8,11,12,16.3
2023-24,202402040UTA,2/4/2024,UTA vs MIL,A.J. Green,greenaj01,30,MIL,0,UTA,10,5,0,0,0,0,21.8,0,5,3,6,3,6,1,1,2,0,5,10,15,15,16
2023-24,202402040UTA,2/4/2024,UTA vs MIL,Kris Dunn,dunnkr01,43,UTA,1,MIL,2,3,6,0,0,1,22.03333333,1,2,1,5,0,3,0,0,4,0,9,8,5,11,13.6
2023-24,202402040MIN,2/4/2024,MIN vs HOU,Naz Reid,reidna01,50,MIN,1,HOU,13,6,0,1,2,1,22.06666667,0,6,5,11,1,4,2,3,2,3,6,13,19,19,28.2
2023-24,202402040DEN,2/4/2024,DEN vs POR,Toumani Camara,camarto01,49,POR,0,DEN,10,6,0,0,0,1,22.51666667,2,4,4,6,2,3,0,0,4,0,6,10,16,16,16.2
2023-24,202402040DET,2/4/2024,DET vs ORL,Markelle Fultz,fultzma01,17,ORL,0,DET,8,4,2,0,0,1,22.56666667,1,3,4,9,0,0,0,0,3,0,6,10,12,14,14.8
2023-24,202402040MIA,2/4/2024,MIA vs LAC,Amir Coffey,coffeam01,36,LAC,0,MIA,5,3,0,1,1,0,22.93333333,1,2,2,3,1,1,0,0,3,2,3,5,8,8,14.6
2023-24,202402040BOS,2/4/2024,BOS vs MEM,Al Horford,horfoal01,41,BOS,1,MEM,11,5,2,2,0,1,23.16666667,0,5,5,9,1,5,0,0,1,2,7,13,16,18,25
2023-24,202402040WAS,2/4/2024,WAS vs PHO,Eugene Omoruyi,omorueu01,20,WAS,1,PHO,16,10,3,3,0,0,23.25,5,5,6,12,1,3,3,4,3,3,13,19,26,29,41.5
2023-24,202402040BOS,2/4/2024,BOS vs MEM,Trey Jemison,jemistr01,4,MEM,0,BOS,6,5,0,0,2,3,23.35,2,3,2,5,0,0,2,2,3,2,5,6,11,11,15
2023-24,202402040BOS,2/4/2024,BOS vs MEM,Sam Hauser,hausesa01,49,BOS,1,MEM,3,3,1,0,0,0,23.68333333,0,3,1,3,1,3,0,0,1,0,4,4,6,7,8.1
2023-24,202402040DET,2/4/2024,DET vs ORL,Gary Harris,harriga01,29,ORL,0,DET,10,1,1,0,1,2,23.91666667,0,1,4,9,2,5,0,0,3,1,2,11,11,12,13.7
2023-24,202402040DEN,2/4/2024,DEN vs POR,Michael Porter Jr.,portemi01,51,DEN,1,POR,12,5,3,0,3,3,24,3,2,4,10,2,6,2,2,1,3,8,15,17,20,28.5
2023-24,202402040UTA,2/4/2024,UTA vs MIL,Simone Fontecchio,fontesi01,49,UTA,1,MIL,11,4,1,1,0,1,24.03333333,2,2,4,6,1,3,2,2,1,1,5,12,15,16,19.3
2023-24,202402040UTA,2/4/2024,UTA vs MIL,John Collins,collijo01,47,UTA,1,MIL,15,10,2,1,0,3,24.23333333,3,7,7,11,1,4,0,1,2,1,12,17,25,27,30
2023-24,202402040WAS,2/4/2024,WAS vs PHO,Tyus Jones,jonesty01,49,WAS,1,PHO,14,1,8,1,0,2,24.38333333,0,1,7,15,0,3,0,0,0,1,9,22,15,23,28.2
2023-24,202402040MIN,2/4/2024,MIN vs HOU,Mike Conley,conlemi01,45,MIN,1,HOU,8,3,9,1,0,2,24.5,0,3,2,6,1,2,3,4,2,1,12,17,11,20,26.1
2023-24,202402040BOS,2/4/2024,BOS vs MEM,Luke Kennard,kennalu01,23,MEM,0,BOS,11,2,2,0,0,3,24.58333333,0,2,4,8,3,5,0,0,3,0,4,13,13,15,13.4
2023-24,202402040WAS,2/4/2024,WAS vs PHO,Daniel Gafford,gaffoda01,44,WAS,1,PHO,15,7,1,0,2,0,24.75,4,3,7,7,0,0,1,2,4,2,8,16,22,23,30.9
2023-24,202402040UTA,2/4/2024,UTA vs MIL,Keyonte George,georgke01,45,UTA,1,MIL,19,10,2,0,0,3,24.78333333,0,10,7,13,5,9,0,0,2,0,12,21,29,31,31
2023-24,202402040WAS,2/4/2024,WAS vs PHO,Corey Kispert,kispeco01,48,WAS,1,PHO,15,2,4,1,0,3,24.85,1,1,6,13,0,7,3,3,4,1,6,19,17,21,23.4
2023-24,202402040WAS,2/4/2024,WAS vs PHO,Jusuf Nurkic,nurkiju01,47,PHO,0,WAS,18,13,8,1,0,1,24.93333333,4,9,7,11,0,1,4,6,3,1,21,26,31,39,47.6
2023-24,202402040WAS,2/4/2024,WAS vs PHO,Deni Avdija,avdijde01,49,WAS,1,PHO,24,3,1,1,1,5,25.05,1,2,10,13,3,5,1,4,3,2,4,25,27,28,30.1
2023-24,202402040UTA,2/4/2024,UTA vs MIL,Collin Sexton,sextoco01,51,UTA,1,MIL,19,1,3,0,0,4,25.06666667,0,1,5,13,3,7,6,6,2,0,4,22,20,23,20.7
2023-24,202402040WAS,2/4/2024,WAS vs PHO,Bilal Coulibaly,coulibi01,48,WAS,1,PHO,0,1,0,0,0,1,25.16666667,0,1,0,2,0,1,0,0,0,0,1,0,1,1,0.2
2023-24,202402040CHO,2/4/2024,CHO vs IND,Nick Smith Jr.,smithni01,33,CHO,1,IND,2,2,2,2,0,0,25.31666667,1,1,1,8,0,4,0,0,4,2,4,4,4,6,13.4
2023-24,202402040MIA,2/4/2024,MIA vs LAC,Jaime Jaquez Jr.,jaqueja01,44,MIA,1,LAC,7,4,4,0,0,3,25.63333333,3,1,3,11,1,3,0,0,2,0,8,11,11,15,14.8
2023-24,202402040WAS,2/4/2024,WAS vs PHO,Devin Booker,bookede01,41,PHO,0,WAS,14,1,6,0,0,0,25.65,0,1,4,11,1,3,5,5,4,0,7,20,15,21,24.2
2023-24,202402040OKC,2/4/2024,OKC vs TOR,Kenrich Williams,willike04,39,OKC,1,TOR,5,4,1,1,0,0,25.66666667,2,2,2,4,1,2,0,0,1,1,5,6,9,10,14.3
2023-24,202402040UTA,2/4/2024,UTA vs MIL,Jordan Clarkson,clarkjo01,41,UTA,1,MIL,12,5,5,0,0,1,25.8,1,4,3,11,0,4,6,7,2,0,10,17,17,22,24.5
2023-24,202402040CHO,2/4/2024,CHO vs IND,Ish Smith,smithis01,41,CHO,1,IND,3,3,4,0,0,2,25.9,0,3,1,3,1,1,0,0,3,0,7,7,6,10,10.6
2023-24,202402040CHO,2/4/2024,CHO vs IND,Myles Turner,turnemy01,49,IND,0,CHO,16,10,2,1,0,0,26.01666667,3,7,7,14,0,3,2,2,3,1,12,18,26,28,34
2023-24,202402040WAS,2/4/2024,WAS vs PHO,Kevin Durant,duranke01,43,PHO,0,WAS,18,4,3,2,1,1,26.11666667,0,4,7,9,3,3,1,2,0,3,7,21,22,25,35.3
2023-24,202402040MIA,2/4/2024,MIA vs LAC,Mason Plumlee,plumlma01,18,LAC,0,MIA,5,9,0,0,0,0,26.26666667,2,7,1,2,0,0,3,4,0,0,9,5,14,14,15.8
2023-24,202402040CHO,2/4/2024,CHO vs IND,Bennedict Mathurin,mathube01,50,IND,0,CHO,14,5,1,0,0,0,26.73333333,1,4,4,12,2,3,4,6,0,0,6,15,19,20,21.5
2023-24,202402040UTA,2/4/2024,UTA vs MIL,Walker Kessler,kesslwa01,43,UTA,1,MIL,13,8,3,0,3,1,26.75,2,6,5,8,0,0,3,4,4,3,11,16,21,24,35.1
2023-24,202402040DET,2/4/2024,DET vs ORL,Jalen Duren,durenja01,34,DET,1,ORL,15,5,2,0,0,1,26.88333333,2,3,7,7,0,0,1,1,5,0,7,17,20,22,23
2023-24,202402040MIA,2/4/2024,MIA vs LAC,Haywood Highsmith,highsha01,36,MIA,1,LAC,5,3,0,1,0,0,26.88333333,0,3,2,5,1,3,0,0,5,1,3,5,8,8,11.6
2023-24,202402040CHO,2/4/2024,CHO vs IND,Andrew Nembhard,nembhan01,37,IND,0,CHO,0,2,3,1,0,1,27.03333333,0,2,0,4,0,4,0,0,1,1,5,3,2,5,8.9
2023-24,202402040BOS,2/4/2024,BOS vs MEM,Jrue Holiday,holidjr01,46,BOS,1,MEM,7,3,4,1,0,2,27.08333333,0,3,2,6,1,3,2,2,1,1,7,11,10,14,17.6
2023-24,202402040BOS,2/4/2024,BOS vs MEM,Scotty Pippen Jr.,pippesc02,6,MEM,0,BOS,19,6,4,1,0,3,27.18333333,1,5,6,11,2,2,5,6,4,1,10,23,25,29,32.2
2023-24,202402040WAS,2/4/2024,WAS vs PHO,Grayson Allen,allengr01,44,PHO,0,WAS,6,3,4,0,0,1,27.33333333,0,3,2,6,1,4,1,2,0,0,7,10,9,13,14.6
2023-24,202402040MIN,2/4/2024,MIN vs HOU,Karl-Anthony Towns,townska01,49,MIN,1,HOU,14,10,0,0,2,2,27.33333333,2,8,4,12,1,3,5,5,4,2,10,14,24,24,30
2023-24,202402040DET,2/4/2024,DET vs ORL,Ausar Thompson,thompau01,49,DET,1,ORL,17,7,1,1,3,2,27.43333333,4,3,7,10,1,3,2,3,1,4,8,18,24,25,36.9
2023-24,202402040DET,2/4/2024,DET vs ORL,Wendell Carter Jr.,cartewe01,24,ORL,0,DET,7,4,2,1,0,3,27.56666667,1,3,3,4,0,1,1,3,2,1,6,9,11,13,14.8
2023-24,202402040DEN,2/4/2024,DEN vs POR,Christian Braun,braunch01,51,DEN,1,POR,4,3,2,1,0,0,27.71666667,2,1,1,4,0,0,2,3,0,1,5,6,7,9,13.6
2023-24,202402040BOS,2/4/2024,BOS vs MEM,Kristaps Porzingis,porzikr01,36,BOS,1,MEM,26,8,2,1,2,1,27.73333333,2,6,10,17,2,5,4,5,2,3,10,28,34,36,46.6
2023-24,202402040DET,2/4/2024,DET vs ORL,Jalen Suggs,suggsja01,46,ORL,0,DET,9,5,2,2,1,0,28.01666667,1,4,4,8,1,3,0,0,2,3,7,11,14,16,27
2023-24,202402040BOS,2/4/2024,BOS vs MEM,Derrick White,whitede01,46,BOS,1,MEM,15,3,3,1,1,1,28.06666667,1,2,5,10,4,8,1,2,1,2,6,18,18,21,28.1
2023-24,202402040MIA,2/4/2024,MIA vs LAC,Norman Powell,powelno01,48,LAC,0,MIA,16,1,1,0,0,0,28.25,0,1,6,12,2,7,2,2,1,0,2,17,17,18,18.7
2023-24,202402040MIN,2/4/2024,MIN vs HOU,Dillon Brooks,brookdi01,40,HOU,0,MIN,7,2,3,2,0,1,28.4,0,2,2,7,1,3,2,2,3,2,5,10,9,12,18.9
2023-24,202402040MIN,2/4/2024,MIN vs HOU,Jaden McDaniels,mcdanja02,40,MIN,1,HOU,5,4,2,0,1,2,29.26666667,2,2,2,7,1,3,0,0,1,1,6,7,9,11,13.8
2023-24,202402040BOS,2/4/2024,BOS vs MEM,Tosan Evbuomwan,evbuoto01,2,MEM,0,BOS,3,12,3,0,0,1,29.46666667,7,5,1,7,1,3,0,0,2,0,15,6,15,18,20.9
2023-24,202402040DEN,2/4/2024,DEN vs POR,Jabari Walker,walkeja01,46,POR,0,DEN,4,7,0,0,0,1,29.51666667,3,4,2,8,0,5,0,0,1,0,7,4,11,11,11.4
2023-24,202402040DEN,2/4/2024,DEN vs POR,Aaron Gordon,gordoaa01,45,DEN,1,POR,12,7,2,0,0,0,29.53333333,3,4,4,8,0,1,4,4,3,0,9,14,19,21,23.4
2023-24,202402040MIN,2/4/2024,MIN vs HOU,Jalen Green,greenja05,49,HOU,0,MIN,8,2,7,0,1,2,29.88333333,0,2,3,15,0,5,2,3,2,1,9,15,10,17,21.9
2023-24,202402040DEN,2/4/2024,DEN vs POR,Peyton Watson,watsope01,49,DEN,1,POR,12,6,1,2,1,1,29.88333333,3,3,5,6,2,3,0,0,1,3,7,13,18,19,28.7
2023-24,202402040UTA,2/4/2024,UTA vs MIL,Malik Beasley,beaslma01,48,MIL,0,UTA,16,3,2,1,0,0,29.91666667,1,2,6,8,4,6,0,0,4,1,5,18,19,21,25.6
2023-24,202402040BOS,2/4/2024,BOS vs MEM,Matthew Hurt,hurtma01,3,MEM,0,BOS,7,4,2,0,1,0,30.35,3,1,3,11,0,6,1,1,1,1,6,9,11,13,17.8
2023-24,202402040MIN,2/4/2024,MIN vs HOU,Alperen Sengun,sengual01,49,HOU,0,MIN,15,10,1,1,1,3,30.5,4,6,7,14,1,1,0,2,4,2,11,16,25,26,31.5
2023-24,202402040MIA,2/4/2024,MIA vs LAC,Caleb Martin,martica02,33,MIA,1,LAC,11,4,2,1,0,0,30.6,1,3,5,9,0,2,1,2,3,1,6,13,15,17,21.8
2023-24,202402040BOS,2/4/2024,BOS vs MEM,Jayson Tatum,tatumja01,47,BOS,1,MEM,34,8,7,1,0,2,30.8,1,7,12,22,6,12,4,4,1,1,15,41,42,49,55.1
2023-24,202402040DEN,2/4/2024,DEN vs POR,Kentavious Caldwell-Pope,caldwke01,49,DEN,1,POR,11,3,0,1,0,1,30.88333333,0,3,3,9,2,5,3,3,0,1,3,11,14,14,16.6
2023-24,202402040WAS,2/4/2024,WAS vs PHO,Bradley Beal,bealbr01,26,PHO,0,WAS,43,2,6,2,0,2,31.01666667,0,2,16,21,4,5,7,7,1,2,8,49,45,51,58.4
2023-24,202402040MIN,2/4/2024,MIN vs HOU,Rudy Gobert,goberru01,49,MIN,1,HOU,17,13,1,1,4,0,31.38333333,3,10,7,9,0,0,3,5,1,5,14,18,30,31,49.1
2023-24,202402040CHO,2/4/2024,CHO vs IND,P.J. Washington,washipj01,42,CHO,1,IND,22,9,2,2,1,0,31.78333333,3,6,9,16,1,6,3,5,3,3,11,24,31,33,44.8
2023-24,202402040DET,2/4/2024,DET vs ORL,Cade Cunningham,cunnica01,40,DET,1,ORL,18,5,7,2,0,1,31.85,0,5,6,14,1,3,5,7,2,2,12,25,23,30,39.5
2023-24,202402040MIN,2/4/2024,MIN vs HOU,Fred VanVleet,vanvlfr01,47,HOU,0,MIN,11,3,1,2,4,2,32.15,0,3,4,11,2,6,1,1,1,6,4,12,14,15,32.1
2023-24,202402040DET,2/4/2024,DET vs ORL,Bojan Bogdanovic,bogdabo02,28,DET,1,ORL,11,5,2,0,1,2,32.5,0,5,3,12,1,7,4,4,1,1,7,13,16,18,21
2023-24,202402040CHO,2/4/2024,CHO vs IND,Nick Richards,richani01,39,CHO,1,IND,12,10,2,0,0,5,32.5,3,7,5,7,0,0,2,2,3,0,12,14,22,24,22
2023-24,202402040BOS,2/4/2024,BOS vs MEM,David Roddy,roddyda01,47,MEM,0,BOS,14,8,1,0,0,3,32.56666667,1,7,6,16,0,5,2,3,0,0,9,15,22,23,22.1
2023-24,202402040MIA,2/4/2024,MIA vs LAC,Paul George,georgpa01,45,LAC,0,MIA,15,7,4,1,1,4,32.91666667,0,7,3,13,3,10,6,6,2,2,11,19,22,26,31.4
2023-24,202402040MIA,2/4/2024,MIA vs LAC,Josh Richardson,richajo01,40,MIA,1,LAC,14,3,4,0,0,0,33.18333333,0,3,6,13,2,8,0,0,2,0,7,18,17,21,23.6
2023-24,202402040OKC,2/4/2024,OKC vs TOR,Aaron Wiggins,wiggiaa01,47,OKC,1,TOR,20,6,2,0,0,1,33.3,4,2,8,17,4,11,0,0,1,0,8,22,26,28,29.2
2023-24,202402040OKC,2/4/2024,OKC vs TOR,Jakob Poeltl,poeltja01,38,TOR,0,OKC,19,12,3,0,2,2,33.33333333,3,9,8,9,0,0,3,4,5,2,15,22,31,34,41.9
2023-24,202402040DEN,2/4/2024,DEN vs POR,Scoot Henderson,hendesc01,41,POR,0,DEN,14,8,9,0,0,3,33.41666667,4,4,3,16,2,6,6,6,4,0,17,23,22,31,34.1
2023-24,202402040MIN,2/4/2024,MIN vs HOU,Anthony Edwards,edwaran01,47,MIN,1,HOU,32,6,1,1,1,4,33.5,1,5,11,22,4,8,6,8,3,2,7,33,38,39,42.7
2023-24,202402040CHO,2/4/2024,CHO vs IND,Aaron Nesmith,nesmiaa01,47,IND,0,CHO,22,8,4,1,0,2,33.58333333,1,7,8,11,3,5,3,3,3,1,12,26,30,34,38.6
2023-24,202402040DEN,2/4/2024,DEN vs POR,Matisse Thybulle,thybuma01,48,POR,0,DEN,6,1,3,3,0,0,33.91666667,0,1,2,7,1,5,1,2,1,3,4,9,7,10,20.7
2023-24,202402040DEN,2/4/2024,DEN vs POR,Nikola Jokic,jokicni01,49,DEN,1,POR,29,8,7,2,0,2,34.23333333,1,7,12,20,1,3,4,5,1,2,15,36,37,44,53.1
2023-24,202402040DEN,2/4/2024,DEN vs POR,Jamal Murray,murraja01,37,DEN,1,POR,21,5,10,1,2,1,34.4,2,3,8,16,4,6,1,2,2,3,15,31,26,36,50
2023-24,202402040DET,2/4/2024,DET vs ORL,Paolo Banchero,banchpa01,50,ORL,0,DET,20,6,7,1,0,1,34.51666667,1,5,6,16,2,5,6,6,2,1,13,27,26,33,39.7
2023-24,202402040MIA,2/4/2024,MIA vs LAC,Kawhi Leonard,leonaka01,44,LAC,0,MIA,25,11,4,2,2,3,34.83333333,3,8,8,16,3,6,6,6,2,4,15,29,36,40,53.2
2023-24,202402040MIA,2/4/2024,MIA vs LAC,Bam Adebayo,adebaba01,40,MIA,1,LAC,14,13,3,3,0,2,35.06666667,4,9,5,13,0,0,4,4,1,3,16,17,27,30,41.1
2023-24,202402040CHO,2/4/2024,CHO vs IND,Pascal Siakam,siakapa01,49,IND,0,CHO,25,8,9,1,1,0,35.26666667,3,5,11,20,1,4,2,3,3,2,17,34,33,42,54.1
2023-24,202402040DET,2/4/2024,DET vs ORL,Jaden Ivey,iveyja01,45,DET,1,ORL,18,3,3,1,1,3,35.4,0,3,7,12,2,4,2,2,3,2,6,21,21,24,29.1
2023-24,202402040UTA,2/4/2024,UTA vs MIL,Lauri Markkanen,markkla01,41,UTA,1,MIL,21,3,2,1,0,2,35.66666667,1,2,8,15,5,10,0,0,4,1,5,23,24,26,28.6
2023-24,202402040DET,2/4/2024,DET vs ORL,Franz Wagner,wagnefr01,42,ORL,0,DET,38,3,2,1,0,0,35.7,1,2,17,25,4,7,0,0,2,1,5,40,41,43,47.6
2023-24,202402040OKC,2/4/2024,OKC vs TOR,Dennis Schroder,schrode01,49,TOR,0,OKC,19,8,4,1,0,0,35.95,2,6,5,16,3,6,6,6,1,1,12,23,27,31,37.6
2023-24,202402040MIA,2/4/2024,MIA vs LAC,Jimmy Butler,butleji01,35,MIA,1,LAC,21,4,3,2,0,1,35.96666667,3,1,8,19,2,5,3,3,1,2,7,24,25,28,35.3
2023-24,202402040BOS,2/4/2024,BOS vs MEM,GG Jackson II,jacksgg01,18,MEM,0,BOS,18,7,1,2,0,4,36.23333333,2,5,8,24,2,10,0,0,0,2,8,19,25,26,29.9
2023-24,202402040BOS,2/4/2024,BOS vs MEM,Jacob Gilyard,gilyaja01,33,MEM,0,BOS,13,2,6,2,0,3,36.25,0,2,5,10,3,7,0,0,2,2,8,19,15,21,27.4
2023-24,202402040UTA,2/4/2024,UTA vs MIL,Bobby Portis,portibo01,50,MIL,0,UTA,27,7,0,3,0,1,36.35,1,6,11,20,4,7,1,1,2,3,7,27,34,34,43.4
2023-24,202402040CHO,2/4/2024,CHO vs IND,Brandon Miller,millebr02,42,CHO,1,IND,35,6,1,1,2,1,37.71666667,2,4,10,25,5,12,10,12,1,3,7,36,41,42,51.7
2023-24,202402040UTA,2/4/2024,UTA vs MIL,Damian Lillard,lillada01,47,MIL,0,UTA,12,0,6,1,2,3,37.75,0,0,5,18,1,8,1,2,5,3,6,18,12,18,27
2023-24,202402040MIA,2/4/2024,MIA vs LAC,Terry Rozier,roziete01,37,MIA,1,LAC,17,7,5,2,0,2,37.78333333,1,6,7,17,0,5,3,3,4,2,12,22,24,29,36.9
2023-24,202402040CHO,2/4/2024,CHO vs IND,Miles Bridges,bridgmi02,37,CHO,1,IND,19,6,3,0,1,2,38.01666667,1,5,8,23,1,5,2,2,2,1,9,22,25,28,31.7
2023-24,202402040DEN,2/4/2024,DEN vs POR,Deandre Ayton,aytonde01,34,POR,0,DEN,27,9,4,1,2,1,38.55,4,5,13,19,0,0,1,1,1,3,13,31,36,40,51.8
2023-24,202402040DEN,2/4/2024,DEN vs POR,Anfernee Simons,simonan01,28,POR,0,DEN,26,6,9,1,0,4,38.7,0,6,8,18,4,8,6,6,0,1,15,35,32,41,45.7
2023-24,202402040OKC,2/4/2024,OKC vs TOR,Gary Trent Jr.,trentga02,44,TOR,0,OKC,16,6,0,2,0,1,39.5,0,6,6,15,4,8,0,0,2,2,6,16,22,22,28.2
2023-24,202402040UTA,2/4/2024,UTA vs MIL,Giannis Antetokounmpo,antetgi01,48,MIL,0,UTA,33,7,13,0,1,5,39.6,2,5,11,15,0,2,11,15,3,1,20,46,40,53,58.9
2023-24,202402040UTA,2/4/2024,UTA vs MIL,Jae Crowder,crowdja01,19,MIL,0,UTA,6,2,3,1,0,0,40.05,0,2,2,10,2,7,0,0,2,1,5,9,8,11,15.9
2023-24,202402040OKC,2/4/2024,OKC vs TOR,Luguentz Dort,dortlu01,48,OKC,1,TOR,22,7,4,1,0,2,40.73333333,2,5,8,19,5,12,1,1,2,1,11,26,29,33,37.4
2023-24,202402040OKC,2/4/2024,OKC vs TOR,Josh Giddey,giddejo01,49,OKC,1,TOR,24,6,6,0,2,2,41.15,2,4,9,15,2,6,4,4,1,2,12,30,30,36,44.2
2023-24,202402040OKC,2/4/2024,OKC vs TOR,Chet Holmgren,holmgch01,50,OKC,1,TOR,22,5,4,2,2,2,41.25,0,5,9,17,4,10,0,0,1,4,9,26,27,31,44
2023-24,202402040MIA,2/4/2024,MIA vs LAC,James Harden,hardeja01,43,LAC,0,MIA,21,8,11,1,1,4,41.63333333,0,8,7,13,5,9,2,4,1,2,19,32,29,40,49.1
2023-24,202402040OKC,2/4/2024,OKC vs TOR,Immanuel Quickley,quickim01,44,TOR,0,OKC,17,3,11,1,0,1,42.61666667,1,2,7,20,2,9,1,2,1,1,14,28,20,31,39.1
2023-24,202402040OKC,2/4/2024,OKC vs TOR,RJ Barrett,barrerj01,40,TOR,0,OKC,23,7,4,1,1,4,43.4,1,6,9,16,2,5,3,4,3,2,11,27,30,34,39.4
2023-24,202402040OKC,2/4/2024,OKC vs TOR,Shai Gilgeous-Alexander,gilgesh01,49,OKC,1,TOR,23,9,14,2,3,2,47.88333333,1,8,9,17,2,5,3,3,5,5,23,37,32,46,67.8
2023-24,202402040OKC,2/4/2024,OKC vs TOR,Scottie Barnes,barnesc01,49,TOR,0,OKC,19,7,9,0,1,3,48.15,3,4,8,15,3,5,0,1,3,1,16,28,26,35,40.9
2023-24,202402030CHI,2/3/2024,CHI vs SAC,Jevon Carter,carteje01,48,CHI,1,SAC,4,0,0,3,0,1,10.43333333,0,0,2,4,0,1,0,0,1,3,0,4,4,4,12
2023-24,202402030DAL,2/3/2024,DAL vs MIL,Jaden Hardy,hardyja02,44,DAL,1,MIL,4,2,0,0,0,0,10.65,0,2,1,4,0,2,2,2,2,0,2,4,6,6,6.4
2023-24,202402030SAS,2/3/2024,SAS vs CLE,Blake Wesley,weslebl01,29,SAS,1,CLE,0,0,1,0,0,1,10.81666667,0,0,0,3,0,1,0,0,1,0,1,1,0,1,0.5
2023-24,202402030PHI,2/3/2024,PHI vs BRK,Ricky Council IV,councri01,8,PHI,1,BRK,5,5,1,0,0,0,11.76666667,1,4,2,4,1,1,0,1,0,0,6,6,10,11,12.5
2023-24,202402030NYK,2/3/2024,NYK vs LAL,Jaxson Hayes,hayesja02,41,LAL,0,NYK,10,1,3,1,0,0,12.5,0,1,3,3,0,0,4,5,0,1,4,13,11,14,18.7
2023-24,202402030CHI,2/3/2024,CHI vs SAC,Julian Phillips,phillju01,26,CHI,1,SAC,3,1,0,0,1,1,13.23333333,0,1,1,3,1,3,0,0,5,1,1,3,4,4,6.2
2023-24,202402030CHI,2/3/2024,CHI vs SAC,Andre Drummond,drumman01,50,CHI,1,SAC,2,8,0,0,0,0,13.56666667,4,4,1,4,0,0,0,0,0,0,8,2,10,10,11.6
2023-24,202402030PHI,2/3/2024,PHI vs BRK,Ben Simmons,simmobe01,8,BRK,0,PHI,0,9,5,0,0,1,13.65,1,8,0,0,0,0,0,0,4,0,14,5,9,14,17.3
2023-24,202402030SAS,2/3/2024,SAS vs CLE,Dean Wade,wadede01,40,CLE,0,SAS,0,2,1,0,1,0,13.68333333,0,2,0,2,0,2,0,0,2,1,3,1,2,3,6.9
2023-24,202402030CHI,2/3/2024,CHI vs SAC,Davion Mitchell,mitchda01,38,SAC,0,CHI,4,2,4,0,0,1,13.85,0,2,1,2,0,1,2,2,1,0,6,8,6,10,11.4
2023-24,202402030CHI,2/3/2024,CHI vs SAC,Torrey Craig,craigto01,28,CHI,1,SAC,5,3,0,0,0,0,14.06666667,0,3,2,5,1,4,0,0,1,0,3,5,8,8,8.6
2023-24,202402030SAS,2/3/2024,SAS vs CLE,Sam Merrill,merrisa01,32,CLE,0,SAS,3,1,3,1,0,1,14.26666667,0,1,1,3,1,3,0,0,2,1,4,6,4,7,10.7
2023-24,202402030ATL,2/3/2024,ATL vs GSW,Kevon Looney,looneke01,46,GSW,0,ATL,0,10,1,0,0,1,14.66666667,2,8,0,0,0,0,0,0,2,0,11,1,10,11,12.5
2023-24,202402030PHI,2/3/2024,PHI vs BRK,Paul Reed,reedpa01,48,PHI,1,BRK,2,4,0,0,0,0,14.71666667,2,2,1,5,0,0,0,0,2,0,4,2,6,6,6.8
2023-24,202402030NYK,2/3/2024,NYK vs LAL,Jericho Sims,simsje01,26,NYK,1,LAL,2,3,0,0,0,0,14.93333333,1,2,1,1,0,0,0,0,1,0,3,2,5,5,5.6
2023-24,202402030ATL,2/3/2024,ATL vs GSW,Gui Santos,santogu01,8,GSW,0,ATL,2,2,3,0,0,1,15.06666667,1,1,0,2,0,2,2,2,4,0,5,5,4,7,7.9
2023-24,202402030PHI,2/3/2024,PHI vs BRK,Mo Bamba,bambamo01,27,PHI,1,BRK,5,6,0,0,0,0,15.61666667,3,3,2,4,0,0,1,2,1,0,6,5,11,11,12.2
2023-24,202402030SAS,2/3/2024,SAS vs CLE,Cedi Osman,osmande01,50,SAS,1,CLE,7,1,0,0,0,1,15.73333333,0,1,2,5,2,4,1,2,1,0,1,7,8,8,7.2
2023-24,202402030ATL,2/3/2024,ATL vs GSW,De'Andre Hunter,huntede01,26,ATL,1,GSW,6,1,0,1,0,0,16.01666667,0,1,2,5,0,2,2,5,1,1,1,6,7,7,10.2
2023-24,202402030ATL,2/3/2024,ATL vs GSW,Garrison Mathews,mathega01,34,ATL,1,GSW,8,3,0,0,1,0,16.3,1,2,2,5,1,4,3,3,1,1,3,8,11,11,14.6
2023-24,202402030SAS,2/3/2024,SAS vs CLE,Georges Niang,niangge01,47,CLE,0,SAS,2,2,2,0,0,0,17.96666667,0,2,0,9,0,8,2,2,2,0,4,4,4,6,7.4
2023-24,202402030DAL,2/3/2024,DAL vs MIL,Pat Connaughton,connapa01,43,MIL,0,DAL,2,3,1,1,0,0,18.3,0,3,1,6,0,3,0,0,1,1,4,3,5,6,10.1
2023-24,202402030DAL,2/3/2024,DAL vs MIL,Dwight Powell,poweldw01,42,DAL,1,MIL,4,8,2,0,1,1,18.51666667,3,5,1,1,0,0,2,2,1,1,10,6,12,14,18.6
2023-24,202402030ATL,2/3/2024,ATL vs GSW,Andrew Wiggins,wiggian01,42,GSW,0,ATL,2,4,0,0,2,0,19.05,0,4,1,6,0,2,0,0,1,2,4,2,6,6,12.8
2023-24,202402030PHI,2/3/2024,PHI vs BRK,Marcus Morris,morrima03,36,PHI,1,BRK,4,3,1,1,0,1,19.2,0,3,2,5,0,1,0,0,1,1,4,5,7,8,11.1
2023-24,202402030NYK,2/3/2024,NYK vs LAL,Rui Hachimura,hachiru01,38,LAL,0,NYK,7,4,1,0,0,1,19.46666667,0,4,3,5,0,2,1,2,2,0,5,8,11,12,12.3
2023-24,202402030PHI,2/3/2024,PHI vs BRK,Patrick Beverley,beverpa01,45,PHI,1,BRK,9,3,9,0,1,2,19.6,0,3,4,8,1,3,0,0,1,1,12,18,12,21,27.1
2023-24,202402030NYK,2/3/2024,NYK vs LAL,Miles McBride,mcbrimi01,37,NYK,1,LAL,10,2,1,0,0,1,19.65,0,2,3,8,1,4,3,4,2,0,3,11,12,13,12.9
2023-24,202402030PHI,2/3/2024,PHI vs BRK,Danuel House Jr.,houseda01,33,PHI,1,BRK,8,3,1,0,0,0,19.95,0,3,4,6,0,1,0,0,2,0,4,9,11,12,13.1
2023-24,202402030SAS,2/3/2024,SAS vs CLE,Doug McDermott,mcderdo01,45,SAS,1,CLE,8,0,3,1,0,0,20.1,0,0,3,5,2,3,0,0,3,1,3,11,8,11,15.5
2023-24,202402030SAS,2/3/2024,SAS vs CLE,Zach Collins,colliza01,38,SAS,1,CLE,10,9,1,1,0,2,20.23333333,3,6,5,12,0,3,0,0,3,1,10,11,19,20,23.3
2023-24,202402030CHI,2/3/2024,CHI vs SAC,Kevin Huerter,huertke01,46,SAC,0,CHI,9,2,2,1,0,2,20.6,1,1,3,9,1,5,2,2,1,1,4,11,11,13,15.4
2023-24,202402030DAL,2/3/2024,DAL vs MIL,Jae Crowder,crowdja01,18,MIL,0,DAL,8,2,2,2,0,0,20.7,0,2,4,6,0,1,0,0,3,2,4,10,10,12,19.4
2023-24,202402030PHI,2/3/2024,PHI vs BRK,KJ Martin,martike04,34,PHI,1,BRK,11,4,4,0,0,0,21.35,0,4,5,9,1,2,0,0,1,0,8,15,15,19,21.8
2023-24,202402030SAS,2/3/2024,SAS vs CLE,Keldon Johnson,johnske04,46,SAS,1,CLE,17,5,0,1,0,1,22.06666667,2,3,7,11,2,3,1,2,2,1,5,17,22,22,25
2023-24,202402030SAS,2/3/2024,SAS vs CLE,Julian Champagnie,champju02,43,SAS,1,CLE,8,5,1,0,2,1,22.7,1,4,3,6,1,3,1,2,1,2,6,9,13,14,20.5
2023-24,202402030ATL,2/3/2024,ATL vs GSW,Lester Quinones,quinole01,12,GSW,0,ATL,17,5,0,0,0,1,22.7,4,1,6,11,4,8,1,2,2,0,5,17,22,22,22
2023-24,202402030SAS,2/3/2024,SAS vs CLE,Darius Garland,garlada01,23,CLE,0,SAS,4,3,4,1,0,3,23.2,0,3,1,3,0,2,2,2,2,1,7,8,7,11,13.6
2023-24,202402030DAL,2/3/2024,DAL vs MIL,Grant Williams,willigr01,45,DAL,1,MIL,2,5,1,1,0,4,23.4,2,3,1,6,0,2,0,0,2,1,6,3,7,8,8.5
2023-24,202402030CHI,2/3/2024,CHI vs SAC,Trey Lyles,lylestr01,34,SAC,0,CHI,16,5,3,2,0,2,23.95,2,3,5,8,5,7,1,1,1,2,8,19,21,24,30.5
2023-24,202402030SAS,2/3/2024,SAS vs CLE,Evan Mobley,mobleev01,24,CLE,0,SAS,28,10,3,0,0,0,23.95,2,8,11,15,3,3,3,4,5,0,13,31,38,41,44.5
2023-24,202402030SAS,2/3/2024,SAS vs CLE,Isaac Okoro,okorois01,38,CLE,0,SAS,7,1,2,0,0,0,24.9,0,1,3,8,1,5,0,0,1,0,3,9,8,10,11.2
2023-24,202402030SAS,2/3/2024,SAS vs CLE,Caris LeVert,leverca01,37,CLE,0,SAS,10,5,6,1,0,1,25.08333333,1,4,4,10,2,5,0,0,2,1,11,16,15,21,27
2023-24,202402030ATL,2/3/2024,ATL vs GSW,Clint Capela,capelca01,47,ATL,1,GSW,17,15,2,0,0,1,25.3,6,9,8,11,0,0,1,2,0,0,17,19,32,34,37
2023-24,202402030PHI,2/3/2024,PHI vs BRK,Kelly Oubre Jr.,oubreke01,36,PHI,1,BRK,16,4,0,1,0,0,25.41666667,1,3,3,14,0,5,10,10,3,1,4,16,20,20,23.8
2023-24,202402030PHI,2/3/2024,PHI vs BRK,Nic Claxton,claxtni01,38,BRK,0,PHI,12,15,4,0,4,1,25.6,3,12,4,4,0,0,4,6,1,4,19,16,27,31,47
2023-24,202402030PHI,2/3/2024,PHI vs BRK,Jaden Springer,sprinja01,30,PHI,1,BRK,11,5,3,1,0,1,25.63333333,3,2,4,7,0,1,3,3,1,1,8,14,16,19,23.5
2023-24,202402030PHI,2/3/2024,PHI vs BRK,Spencer Dinwiddie,dinwisp01,46,BRK,0,PHI,3,3,6,0,0,0,25.71666667,0,3,1,5,1,5,0,0,3,0,9,9,6,12,15.6
2023-24,202402030NYK,2/3/2024,NYK vs LAL,Max Christie,chrisma02,42,LAL,0,NYK,6,1,1,0,2,0,26.11666667,0,1,2,2,2,2,0,1,1,2,2,7,7,8,14.7
2023-24,202402030PHI,2/3/2024,PHI vs BRK,Royce O'Neale,onealro01,47,BRK,0,PHI,8,4,2,0,0,1,26.26666667,1,3,3,5,2,4,0,0,2,0,6,10,12,14,14.8
2023-24,202402030SAS,2/3/2024,SAS vs CLE,Victor Wembanyama,wembavi01,44,SAS,1,CLE,19,14,3,2,2,3,26.86666667,4,10,5,16,2,4,7,8,0,4,17,22,33,36,49.3
2023-24,202402030PHI,2/3/2024,PHI vs BRK,Furkan Korkmaz,korkmfu01,33,PHI,1,BRK,10,4,1,1,0,0,26.93333333,0,4,3,4,1,1,3,4,1,1,5,11,14,15,19.3
2023-24,202402030NYK,2/3/2024,NYK vs LAL,D'Angelo Russell,russeda01,48,LAL,0,NYK,16,1,4,0,1,0,26.98333333,0,1,5,14,2,7,4,4,4,1,5,20,17,21,26.2
2023-24,202402030SAS,2/3/2024,SAS vs CLE,Tre Jones,jonestr01,45,SAS,1,CLE,7,5,8,1,0,0,28.25,0,5,3,10,0,3,1,1,0,1,13,15,12,20,28
2023-24,202402030SAS,2/3/2024,SAS vs CLE,Max Strus,strusma01,47,CLE,0,SAS,6,3,3,1,1,1,28.56666667,0,3,2,9,2,7,0,0,0,2,6,9,9,12,19.1
2023-24,202402030SAS,2/3/2024,SAS vs CLE,Jeremy Sochan,sochaje01,50,SAS,1,CLE,2,9,2,0,1,1,29.21666667,4,5,1,9,0,5,0,0,1,1,11,4,11,13,17.8
2023-24,202402030PHI,2/3/2024,PHI vs BRK,Lonnie Walker IV,walkelo01,30,BRK,0,PHI,20,2,3,0,0,0,30.15,1,1,8,16,3,8,1,1,3,0,5,23,22,25,26.9
2023-24,202402030PHI,2/3/2024,PHI vs BRK,Tyrese Maxey,maxeyty01,44,PHI,1,BRK,23,3,5,3,0,1,30.63333333,1,2,8,23,3,8,4,6,2,3,8,28,26,31,42.1
2023-24,202402030SAS,2/3/2024,SAS vs CLE,Jarrett Allen,allenja01,42,CLE,0,SAS,26,16,0,0,0,1,30.73333333,4,12,12,18,0,0,2,2,1,0,16,26,42,42,44.2
2023-24,202402030CHI,2/3/2024,CHI vs SAC,Keegan Murray,murrake02,44,SAC,0,CHI,5,6,3,2,0,0,31.01666667,0,6,2,6,1,5,0,0,4,2,9,8,11,14,22.7
2023-24,202402030DAL,2/3/2024,DAL vs MIL,Bobby Portis,portibo01,49,MIL,0,DAL,12,10,2,1,0,0,31.18333333,3,7,4,10,0,3,4,5,3,1,12,14,22,24,30
2023-24,202402030PHI,2/3/2024,PHI vs BRK,Mikal Bridges,bridgmi01,48,BRK,0,PHI,23,3,4,0,0,1,32.25,1,2,7,16,5,12,4,5,1,0,7,27,26,30,31.6
2023-24,202402030DAL,2/3/2024,DAL vs MIL,Malik Beasley,beaslma01,47,MIL,0,DAL,9,7,0,2,0,1,32.53333333,0,7,3,9,3,8,0,2,1,2,7,9,16,16,22.4
2023-24,202402030NYK,2/3/2024,NYK vs LAL,Taurean Prince,princta02,49,LAL,0,NYK,16,2,2,0,1,2,32.65,0,2,6,10,3,6,1,1,3,1,4,18,18,20,22.4
2023-24,202402030PHI,2/3/2024,PHI vs BRK,Cameron Johnson,johnsca02,39,BRK,0,PHI,13,7,3,2,1,3,32.88333333,2,5,5,12,2,9,1,1,0,3,10,16,20,23,31.9
2023-24,202402030NYK,2/3/2024,NYK vs LAL,Isaiah Hartenstein,harteis01,48,NYK,1,LAL,6,15,2,0,2,0,33.06666667,6,9,2,9,0,0,2,2,5,2,17,8,21,23,33
2023-24,202402030CHI,2/3/2024,CHI vs SAC,Malik Monk,monkma01,47,SAC,0,CHI,22,5,7,0,1,1,33.81666667,0,5,7,14,2,4,6,7,3,1,12,29,27,34,40.5
2023-24,202402030DAL,2/3/2024,DAL vs MIL,Maxi Kleber,klebima01,14,DAL,1,MIL,21,3,2,2,0,2,33.83333333,0,3,8,11,4,7,1,1,5,2,5,23,24,26,31.6
2023-24,202402030SAS,2/3/2024,SAS vs CLE,Devin Vassell,vassede01,45,SAS,1,CLE,22,6,3,0,1,0,34.06666667,0,6,7,16,3,8,5,5,0,1,9,25,28,31,36.7
2023-24,202402030ATL,2/3/2024,ATL vs GSW,Jonathan Kuminga,kuminjo01,45,GSW,0,ATL,16,4,3,1,0,4,34.23333333,2,2,6,12,1,3,3,4,6,1,7,19,20,23,24.3
2023-24,202402030CHI,2/3/2024,CHI vs SAC,Nikola Vucevic,vucevni01,45,CHI,1,SAC,24,12,3,1,0,2,34.43333333,2,10,10,18,1,4,3,3,2,1,15,27,36,39,43.9
2023-24,202402030CHI,2/3/2024,CHI vs SAC,Harrison Barnes,barneha02,48,SAC,0,CHI,11,1,0,1,0,1,34.91666667,0,1,4,10,1,5,2,2,1,1,1,11,12,12,14.2
2023-24,202402030ATL,2/3/2024,ATL vs GSW,Draymond Green,greendr01,22,GSW,0,ATL,7,6,8,0,1,3,34.98333333,1,5,3,9,1,3,0,0,2,1,14,15,13,21,26.2
2023-24,202402030DAL,2/3/2024,DAL vs MIL,Derrick Jones Jr.,jonesde02,44,DAL,1,MIL,8,4,1,2,0,1,35.15,1,3,3,6,0,0,2,3,1,2,5,9,12,13,19.3
2023-24,202402030CHI,2/3/2024,CHI vs SAC,De'Aaron Fox,foxde01,42,SAC,0,CHI,41,4,4,5,0,3,35.41666667,0,4,13,24,5,11,10,12,5,5,8,45,45,49,63.8
2023-24,202402030SAS,2/3/2024,SAS vs CLE,Donovan Mitchell,mitchdo01,38,CLE,0,SAS,31,8,7,2,2,2,35.46666667,3,5,12,20,4,9,3,3,2,4,15,38,39,46,61.1
2023-24,202402030ATL,2/3/2024,ATL vs GSW,Klay Thompson,thompkl01,44,GSW,0,ATL,10,4,2,3,1,1,35.51666667,0,4,4,19,2,13,0,0,0,4,6,12,14,16,28.8
2023-24,202402030ATL,2/3/2024,ATL vs GSW,Onyeka Okongwu,okongon01,48,ATL,1,GSW,22,16,0,0,2,0,36.06666667,6,10,8,12,2,4,4,4,4,2,16,22,38,38,47.2
2023-24,202402030NYK,2/3/2024,NYK vs LAL,Anthony Davis,davisan02,48,LAL,0,NYK,12,18,5,1,4,0,36.41666667,2,16,4,12,0,1,4,4,2,5,23,17,30,35,56.1
2023-24,202402030CHI,2/3/2024,CHI vs SAC,Coby White,whiteco01,50,CHI,1,SAC,26,6,4,0,0,3,36.45,0,6,10,18,4,7,2,2,1,0,10,30,32,36,36.2
2023-24,202402030PHI,2/3/2024,PHI vs BRK,Cam Thomas,thomaca02,39,BRK,0,PHI,40,3,5,1,0,3,36.48333333,1,2,14,26,5,11,7,8,3,1,8,45,43,48,51.1
2023-24,202402030CHI,2/3/2024,CHI vs SAC,Alex Caruso,carusal01,43,CHI,1,SAC,7,5,6,3,2,4,37.13333333,2,3,3,7,1,4,0,0,5,5,11,13,12,18,33
2023-24,202402030DAL,2/3/2024,DAL vs MIL,Josh Green,greenjo02,36,DAL,1,MIL,20,9,3,1,0,3,37.78333333,0,9,7,12,4,8,2,2,0,1,12,23,29,32,35.3
2023-24,202402030ATL,2/3/2024,ATL vs GSW,Bogdan Bogdanovic,bogdabo01,47,ATL,1,GSW,13,4,4,2,0,2,37.85,0,4,5,16,2,10,1,1,3,2,8,17,17,21,27.8
2023-24,202402030DAL,2/3/2024,DAL vs MIL,Damian Lillard,lillada01,46,MIL,0,DAL,30,3,8,0,1,6,38.21666667,0,3,10,11,5,5,5,6,3,1,11,38,33,41,42.6
2023-24,202402030DAL,2/3/2024,DAL vs MIL,Tim Hardaway Jr.,hardati02,46,DAL,1,MIL,18,2,2,2,0,1,38.25,1,1,6,15,4,8,2,2,4,2,4,20,20,22,28.4
2023-24,202402030DAL,2/3/2024,DAL vs MIL,Khris Middleton,middlkh01,42,MIL,0,DAL,13,3,8,1,0,2,38.48333333,1,2,5,15,1,4,2,2,5,1,11,21,16,24,29.6
2023-24,202402030CHI,2/3/2024,CHI vs SAC,DeMar DeRozan,derozde01,48,CHI,1,SAC,24,7,6,4,0,3,38.61666667,1,6,5,14,0,2,14,15,2,4,13,30,31,37,50.4
2023-24,202402030NYK,2/3/2024,NYK vs LAL,Austin Reaves,reaveau01,52,LAL,0,NYK,22,6,7,0,2,1,38.78333333,0,6,6,13,3,6,7,8,3,2,13,29,28,35,44.7
2023-24,202402030ATL,2/3/2024,ATL vs GSW,Brandin Podziemski,podzibr01,40,GSW,0,ATL,15,11,5,0,1,0,38.86666667,2,9,6,12,0,2,3,5,4,1,16,20,26,31,38.7
2023-24,202402030CHI,2/3/2024,CHI vs SAC,Ayo Dosunmu,dosunay01,48,CHI,1,SAC,18,4,5,2,0,2,39.01666667,1,3,7,16,3,9,1,2,3,2,9,23,22,27,34.3
2023-24,202402030CHI,2/3/2024,CHI vs SAC,Domantas Sabonis,sabondo01,48,SAC,0,CHI,13,14,10,1,0,6,39.45,0,14,6,8,0,1,1,1,1,1,24,23,27,37,41.8
2023-24,202402030DAL,2/3/2024,DAL vs MIL,Giannis Antetokounmpo,antetgi01,47,MIL,0,DAL,48,6,10,5,1,1,40.16666667,1,5,20,28,2,5,6,10,3,6,16,58,54,64,87.2
2023-24,202402030NYK,2/3/2024,NYK vs LAL,Donte DiVincenzo,divindo01,50,NYK,1,LAL,26,6,4,0,1,0,40.3,1,5,10,22,6,16,0,0,6,1,10,30,32,36,42.2
2023-24,202402030NYK,2/3/2024,NYK vs LAL,LeBron James,jamesle01,46,LAL,0,NYK,24,5,5,2,1,1,40.3,1,4,10,19,2,5,2,2,1,3,10,29,29,34,45.5
2023-24,202402030ATL,2/3/2024,ATL vs GSW,Dejounte Murray,murrade01,48,ATL,1,GSW,19,5,7,1,0,2,40.96666667,0,5,9,24,0,6,1,1,5,1,12,26,24,31,36.5
2023-24,202402030ATL,2/3/2024,ATL vs GSW,Stephen Curry,curryst01,43,GSW,0,ATL,60,6,4,0,1,2,41.35,1,5,22,38,10,23,6,6,1,1,10,64,66,70,74.2
2023-24,202402030NYK,2/3/2024,NYK vs LAL,Josh Hart,hartjo01,49,NYK,1,LAL,12,11,4,1,0,2,41.58333333,4,7,5,16,2,6,0,0,3,1,15,16,23,27,32.2
2023-24,202402030ATL,2/3/2024,ATL vs GSW,Trae Young,youngtr01,44,ATL,1,GSW,35,0,6,1,0,3,42.26666667,0,0,12,21,7,11,4,5,3,1,6,41,35,41,44
2023-24,202402030DAL,2/3/2024,DAL vs MIL,Luka Doncic,doncilu01,41,DAL,1,MIL,40,9,11,1,0,9,42.41666667,1,8,13,26,4,12,10,11,4,1,20,51,49,60,61.3
2023-24,202402030NYK,2/3/2024,NYK vs LAL,Precious Achiuwa,achiupr01,43,NYK,1,LAL,10,8,0,0,1,1,42.46666667,4,4,4,11,0,3,2,2,2,1,8,10,18,18,21.6
2023-24,202402030ATL,2/3/2024,ATL vs GSW,Jalen Johnson,johnsja05,35,ATL,1,GSW,21,13,8,0,1,0,43.23333333,3,10,9,20,2,6,1,1,3,1,21,29,34,42,51.6
2023-24,202402030NYK,2/3/2024,NYK vs LAL,Jalen Brunson,brunsja01,48,NYK,1,LAL,36,6,10,0,0,3,44.71666667,2,4,15,31,1,6,5,6,1,0,16,46,42,52,55.2
2023-24,202402020DET,2/2/2024,DET vs LAC,Monte Morris,morrimo01,5,DET,1,LAC,0,1,1,0,0,0,10.4,0,1,0,4,0,2,0,0,0,0,2,1,1,2,2.7
2023-24,202402020OKC,2/2/2024,OKC vs CHO,Kenrich Williams,willike04,38,OKC,1,CHO,8,3,0,0,1,0,10.4,0,3,3,5,2,3,0,0,2,1,3,8,11,11,14.6
2023-24,202402020MEM,2/2/2024,MEM vs GSW,Gui Santos,santogu01,7,GSW,0,MEM,4,2,0,0,0,0,10.76666667,1,1,2,2,0,0,0,0,2,0,2,4,6,6,6.4
2023-24,202402020SAS,2/2/2024,SAS vs NOP,Jordan Hawkins,hawkijo01,44,NOP,0,SAS,2,0,0,0,0,0,10.81666667,0,0,1,5,0,4,0,0,0,0,0,2,2,2,2
2023-24,202402020MIN,2/2/2024,MIN vs ORL,Moritz Wagner,wagnemo01,47,ORL,0,MIN,8,3,0,0,0,2,11.03333333,0,3,2,3,0,0,4,4,3,0,3,8,11,11,9.6
2023-24,202402020MEM,2/2/2024,MEM vs GSW,Kevon Looney,looneke01,45,GSW,0,MEM,9,1,1,1,0,3,11.23333333,0,1,4,4,0,0,1,3,1,1,2,10,10,11,11.7
2023-24,202402020DEN,2/2/2024,DEN vs POR,Justin Holiday,holidju01,28,DEN,1,POR,0,0,1,1,0,0,11.56666667,0,0,0,2,0,1,0,0,0,1,1,1,0,1,4.5
2023-24,202402020MIN,2/2/2024,MIN vs ORL,Cole Anthony,anthoco01,48,ORL,0,MIN,4,3,2,2,0,2,11.71666667,0,3,1,3,0,0,2,2,0,2,5,6,7,9,14.6
2023-24,202402020SAS,2/2/2024,SAS vs NOP,Doug McDermott,mcderdo01,44,SAS,1,NOP,6,2,0,0,0,0,11.93333333,0,2,2,5,2,5,0,0,0,0,2,6,8,8,8.4
2023-24,202402020HOU,2/2/2024,HOU vs TOR,Aaron Holiday,holidaa01,45,HOU,1,TOR,3,0,2,1,0,2,12.11666667,0,0,1,2,1,2,0,0,1,1,2,5,3,5,7
2023-24,202402020ATL,2/2/2024,ATL vs PHO,Wesley Matthews,matthwe02,20,ATL,1,PHO,6,1,0,0,0,0,12.53333333,0,1,2,6,2,5,0,0,2,0,1,6,7,7,7.2
2023-24,202402020SAS,2/2/2024,SAS vs NOP,Blake Wesley,weslebl01,28,SAS,1,NOP,4,3,6,0,0,0,12.61666667,0,3,2,4,0,1,0,0,2,0,9,10,7,13,16.6
2023-24,202402020WAS,2/2/2024,WAS vs MIA,Landry Shamet,shamela01,31,WAS,1,MIA,5,2,1,0,0,1,13.15,0,2,1,5,0,2,3,3,1,0,3,6,7,8,7.9
2023-24,202402020MIN,2/2/2024,MIN vs ORL,Joe Ingles,inglejo01,35,ORL,0,MIN,6,0,2,0,0,0,13.46666667,0,0,2,4,2,4,0,0,1,0,2,8,6,8,9
2023-24,202402020HOU,2/2/2024,HOU vs TOR,Jalen McDaniels,mcdanja01,30,TOR,0,HOU,3,1,0,0,0,4,13.58333333,0,1,1,3,1,2,0,0,1,0,1,3,4,4,0.2
2023-24,202402020DEN,2/2/2024,DEN vs POR,Kris Murray,murrakr01,29,POR,0,DEN,0,2,0,1,0,1,13.61666667,1,1,0,1,0,0,0,0,0,1,2,0,2,2,4.4
2023-24,202402020OKC,2/2/2024,OKC vs CHO,Vasilije Micic,micicva01,28,OKC,1,CHO,2,0,4,0,0,3,14.06666667,0,0,1,2,0,1,0,0,0,0,4,6,2,6,5
2023-24,202402020ATL,2/2/2024,ATL vs PHO,Josh Okogie,okogijo01,43,PHO,0,ATL,3,0,0,0,1,0,14.55,0,0,1,3,1,1,0,0,0,1,0,3,3,3,6
2023-24,202402020IND,2/2/2024,IND vs SAC,Kessler Edwards,edwarke02,32,SAC,0,IND,0,4,1,2,1,0,14.6,0,4,0,0,0,0,0,0,1,3,5,1,4,5,15.3
2023-24,202402020DET,2/2/2024,DET vs LAC,Danilo Gallinari,gallida01,30,DET,1,LAC,11,1,2,0,1,0,14.6,1,0,1,3,1,2,8,9,3,1,3,13,12,14,18.2
2023-24,202402020WAS,2/2/2024,WAS vs MIA,Haywood Highsmith,highsha01,35,MIA,0,WAS,4,2,0,0,0,1,15.08333333,1,1,2,6,0,4,0,0,2,0,2,4,6,6,5.4
2023-24,202402020WAS,2/2/2024,WAS vs MIA,Kevin Love,loveke01,38,MIA,0,WAS,13,10,2,0,0,1,15.15,1,9,4,5,2,3,3,4,1,0,12,15,23,25,27
2023-24,202402020HOU,2/2/2024,HOU vs TOR,Jeff Green,greenje02,46,HOU,1,TOR,8,3,1,1,0,2,15.26666667,0,3,2,2,0,0,4,4,3,1,4,9,11,12,14.1
2023-24,202402020OKC,2/2/2024,OKC vs CHO,Ish Smith,smithis01,40,CHO,0,OKC,2,1,3,1,0,1,15.65,0,1,1,4,0,0,0,0,1,1,4,5,3,6,9.7
2023-24,202402020MEM,2/2/2024,MEM vs GSW,Derrick Rose,rosede01,18,MEM,1,GSW,12,1,4,0,0,0,15.66666667,0,1,5,9,1,3,1,1,1,0,5,16,13,17,19.2
2023-24,202402020SAS,2/2/2024,SAS vs NOP,Malaki Branham,branhma01,44,SAS,1,NOP,7,2,3,0,0,0,15.71666667,1,1,3,4,1,2,0,0,0,0,5,10,9,12,13.9
2023-24,202402020MIN,2/2/2024,MIN vs ORL,Kyle Anderson,anderky01,49,MIN,1,ORL,7,3,4,0,1,0,15.95,1,2,3,6,1,1,0,0,2,1,7,11,10,14,19.6
2023-24,202402020IND,2/2/2024,IND vs SAC,Trey Lyles,lylestr01,33,SAC,0,IND,13,3,0,0,0,0,15.98333333,1,2,4,5,3,4,2,2,1,0,3,13,16,16,16.6
2023-24,202402020MEM,2/2/2024,MEM vs GSW,GG Jackson II,jacksgg01,17,MEM,1,GSW,1,1,1,0,0,1,16.18333333,0,1,0,3,0,2,1,2,1,0,2,2,2,3,2.7
2023-24,202402020HOU,2/2/2024,HOU vs TOR,Jordan Nwora,nworajo01,23,TOR,0,HOU,8,1,0,2,1,0,16.38333333,0,1,3,5,0,1,2,2,2,3,1,8,9,9,18.2
2023-24,202402020IND,2/2/2024,IND vs SAC,Davion Mitchell,mitchda01,37,SAC,0,IND,4,2,1,1,0,1,16.41666667,0,2,2,5,0,2,0,0,0,1,3,5,6,7,9.9
2023-24,202402020IND,2/2/2024,IND vs SAC,Ben Sheppard,sheppbe01,29,IND,1,SAC,7,1,0,0,0,0,16.41666667,0,1,2,6,1,5,2,2,0,0,1,7,8,8,8.2
2023-24,202402020ATL,2/2/2024,ATL vs PHO,Saddiq Bey,beysa01,48,ATL,1,PHO,2,3,0,0,0,0,16.43333333,2,1,1,7,0,3,0,0,0,0,3,2,5,5,5.6
2023-24,202402020MEM,2/2/2024,MEM vs GSW,Tosan Evbuomwan,evbuoto01,1,MEM,1,GSW,3,1,1,0,0,0,16.45,1,0,1,2,1,2,0,0,1,0,2,4,4,5,5.7
2023-24,202402020SAS,2/2/2024,SAS vs NOP,Naji Marshall,marshna01,40,NOP,0,SAS,2,3,2,1,0,1,16.56666667,1,2,1,6,0,2,0,0,1,1,5,4,5,7,10.6
2023-24,202402020HOU,2/2/2024,HOU vs TOR,Jae'Sean Tate,tateja01,45,HOU,1,TOR,2,1,3,1,0,0,17.21666667,0,1,1,2,0,0,0,0,2,1,4,5,3,6,10.7
2023-24,202402020ATL,2/2/2024,ATL vs PHO,Drew Eubanks,eubandr01,43,PHO,0,ATL,6,4,1,0,0,1,17.38333333,2,2,3,3,0,0,0,0,1,0,5,7,10,11,11.3
2023-24,202402020DET,2/2/2024,DET vs LAC,Daniel Theis,theisda01,37,LAC,0,DET,5,3,2,1,2,2,17.5,0,3,2,3,0,1,1,2,3,3,5,7,8,10,18.6
2023-24,202402020OKC,2/2/2024,OKC vs CHO,Lindy Waters III,waterli01,19,OKC,1,CHO,6,5,1,0,0,2,17.58333333,0,5,2,5,2,5,0,0,1,0,6,7,11,12,11.5
2023-24,202402020OKC,2/2/2024,OKC vs CHO,Leaky Black,blackle01,18,CHO,0,OKC,11,1,2,0,0,0,17.68333333,0,1,4,7,3,3,0,0,0,0,3,13,12,14,15.2
2023-24,202402020IND,2/2/2024,IND vs SAC,Obi Toppin,toppiob01,51,IND,1,SAC,6,4,1,1,1,1,17.76666667,0,4,2,6,1,4,1,2,2,2,5,7,10,11,17.3
2023-24,202402020MIN,2/2/2024,MIN vs ORL,Gary Harris,harriga01,28,ORL,0,MIN,2,2,1,0,0,1,17.85,1,1,1,1,0,0,0,0,1,0,3,3,4,5,4.9
2023-24,202402020OKC,2/2/2024,OKC vs CHO,Jaylin Williams,willija07,41,OKC,1,CHO,7,8,0,0,1,0,18.25,1,7,2,4,1,3,2,2,1,1,8,7,15,15,19.6
2023-24,202402020MEM,2/2/2024,MEM vs GSW,Luke Kennard,kennalu01,22,MEM,1,GSW,6,2,2,0,0,1,18.26666667,1,1,2,5,2,3,0,0,1,0,4,8,8,10,10.4
2023-24,202402020DET,2/2/2024,DET vs LAC,Kevin Knox,knoxke01,30,DET,1,LAC,0,1,2,1,0,1,18.4,0,1,0,2,0,2,0,0,3,1,3,2,1,3,6.2
2023-24,202402020SAS,2/2/2024,SAS vs NOP,Jose Alvarado,alvarjo01,31,NOP,0,SAS,8,2,3,2,0,0,18.76666667,0,2,3,7,2,5,0,0,3,2,5,11,10,13,20.9
2023-24,202402020MEM,2/2/2024,MEM vs GSW,Lester Quinones,quinole01,11,GSW,0,MEM,10,6,1,0,0,2,19.08333333,1,5,3,6,2,4,2,2,3,0,7,11,16,17,16.7
2023-24,202402020OKC,2/2/2024,OKC vs CHO,Luguentz Dort,dortlu01,47,OKC,1,CHO,8,2,1,0,1,0,19.1,1,1,3,4,2,3,0,0,3,1,3,9,10,11,14.9
2023-24,202402020OKC,2/2/2024,OKC vs CHO,Josh Giddey,giddejo01,48,OKC,1,CHO,8,6,4,1,1,2,19.1,0,6,3,8,0,2,2,2,0,2,10,12,14,18,25.2
2023-24,202402020OKC,2/2/2024,OKC vs CHO,Aaron Wiggins,wiggiaa01,46,OKC,1,CHO,10,2,4,1,0,1,19.3,0,2,3,6,2,5,2,3,1,1,6,14,12,16,20.4
2023-24,202402020SAS,2/2/2024,SAS vs NOP,Cedi Osman,osmande01,49,SAS,1,NOP,3,0,0,2,2,2,19.38333333,0,0,1,6,1,5,0,0,3,4,0,3,3,3,13
2023-24,202402020SAS,2/2/2024,SAS vs NOP,Zach Collins,colliza01,37,SAS,1,NOP,9,2,3,0,0,1,19.56666667,1,1,4,9,0,0,1,2,3,0,5,12,11,14,14.9
2023-24,202402020OKC,2/2/2024,OKC vs CHO,Ousmane Dieng,diengou01,24,OKC,1,CHO,11,2,4,0,0,1,19.96666667,0,2,4,5,1,1,2,2,2,0,6,15,13,17,18.4
2023-24,202402020MIN,2/2/2024,MIN vs ORL,Jonathan Isaac,isaacjo01,31,ORL,0,MIN,3,8,0,2,1,0,19.98333333,2,6,1,4,0,0,1,2,1,3,8,3,11,11,21.6
2023-24,202402020HOU,2/2/2024,HOU vs TOR,Jakob Poeltl,poeltja01,37,TOR,0,HOU,6,5,1,0,2,3,20.36666667,0,5,3,5,0,0,0,0,6,2,6,7,11,12,16.5
2023-24,202402020DET,2/2/2024,DET vs LAC,Marcus Sasser,sassema01,43,DET,1,LAC,21,1,2,0,0,2,20.48333333,0,1,8,10,5,6,0,0,2,0,3,23,22,24,23.2
2023-24,202402020DEN,2/2/2024,DEN vs POR,Duop Reath,reathdu01,37,POR,0,DEN,10,4,1,1,1,1,20.51666667,1,3,3,4,2,2,2,4,3,2,5,11,14,15,21.3
2023-24,202402020DET,2/2/2024,DET vs LAC,Alec Burks,burksal01,41,DET,1,LAC,6,2,1,1,1,1,20.76666667,1,1,2,10,1,7,1,1,0,2,3,7,8,9,14.9
2023-24,202402020ATL,2/2/2024,ATL vs PHO,Clint Capela,capelca01,46,ATL,1,PHO,11,10,0,0,0,0,20.85,6,4,5,10,0,0,1,2,2,0,10,11,21,21,23
2023-24,202402020OKC,2/2/2024,OKC vs CHO,Nick Smith Jr.,smithni01,32,CHO,0,OKC,12,0,0,1,0,0,21.01666667,0,0,4,10,3,4,1,1,4,1,0,12,12,12,15
2023-24,202402020OKC,2/2/2024,OKC vs CHO,Cody Martin,martico01,17,CHO,0,OKC,7,1,4,0,0,1,21.05,0,1,3,5,1,3,0,0,0,0,5,11,8,12,13.2
2023-24,202402020MEM,2/2/2024,MEM vs GSW,Santi Aldama,aldamsa01,38,MEM,1,GSW,2,5,2,2,0,0,21.21666667,1,4,1,8,0,6,0,0,2,2,7,4,7,9,17
2023-24,202402020DEN,2/2/2024,DEN vs POR,Jabari Walker,walkeja01,45,POR,0,DEN,7,8,0,0,0,1,21.25,4,4,3,7,0,1,1,1,2,0,8,7,15,15,15.6
2023-24,202402020HOU,2/2/2024,HOU vs TOR,Cam Whitmore,whitmca01,25,HOU,1,TOR,25,6,1,2,0,2,21.38333333,3,3,10,17,3,7,2,2,1,2,7,26,31,32,37.7
2023-24,202402020SAS,2/2/2024,SAS vs NOP,Dyson Daniels,daniedy01,49,NOP,0,SAS,2,6,5,3,0,1,21.41666667,2,4,1,3,0,1,0,0,1,3,11,7,8,13,24.7
2023-24,202402020IND,2/2/2024,IND vs SAC,Tyrese Haliburton,halibty01,38,IND,1,SAC,14,3,1,1,0,5,21.53333333,1,2,6,10,1,3,1,1,1,1,4,15,17,18,17.1
2023-24,202402020MIN,2/2/2024,MIN vs ORL,Naz Reid,reidna01,49,MIN,1,ORL,9,5,1,0,0,2,21.55,0,5,4,5,1,2,0,0,1,0,6,10,14,15,14.5
2023-24,202402020DEN,2/2/2024,DEN vs POR,Peyton Watson,watsope01,48,DEN,1,POR,14,5,0,0,1,0,21.8,1,4,6,8,2,2,0,0,4,1,5,14,19,19,23
2023-24,202402020HOU,2/2/2024,HOU vs TOR,Dennis Schroder,schrode01,48,TOR,0,HOU,8,2,1,1,0,1,22.08333333,0,2,4,10,0,5,0,0,1,1,3,9,10,11,13.9
2023-24,202402020IND,2/2/2024,IND vs SAC,T.J. McConnell,mccontj01,40,IND,1,SAC,9,3,7,2,0,1,22.81666667,1,2,3,5,1,1,2,2,0,2,10,16,12,19,28.1
2023-24,202402020MIN,2/2/2024,MIN vs ORL,Markelle Fultz,fultzma01,16,ORL,0,MIN,10,3,5,2,1,1,22.96666667,0,3,5,9,0,0,0,0,1,3,8,15,13,18,29.1
2023-24,202402020DEN,2/2/2024,DEN vs POR,Matisse Thybulle,thybuma01,47,POR,0,DEN,3,1,0,1,1,0,23.08333333,0,1,1,5,1,4,0,0,2,2,1,3,4,4,10.2
2023-24,202402020ATL,2/2/2024,ATL vs PHO,Jusuf Nurkic,nurkiju01,46,PHO,0,ATL,14,9,3,1,1,1,23.16666667,1,8,7,9,0,0,0,1,2,2,12,17,23,26,34.3
2023-24,202402020OKC,2/2/2024,OKC vs CHO,Chet Holmgren,holmgch01,49,OKC,1,CHO,16,6,3,1,2,1,23.33333333,0,6,5,9,3,6,3,4,1,3,9,19,22,25,35.7
2023-24,202402020HOU,2/2/2024,HOU vs TOR,Dillon Brooks,brookdi01,39,HOU,1,TOR,6,5,0,0,1,0,23.68333333,0,5,2,6,1,2,1,2,1,1,5,6,11,11,15
2023-24,202402020DEN,2/2/2024,DEN vs POR,Toumani Camara,camarto01,48,POR,0,DEN,10,2,0,2,1,1,23.78333333,0,2,3,6,0,2,4,4,1,3,2,10,12,12,20.4
2023-24,202402020HOU,2/2/2024,HOU vs TOR,Gradey Dick,dickgr01,27,TOR,0,HOU,3,7,0,3,0,1,23.78333333,1,6,1,8,0,4,1,2,1,3,7,3,10,10,19.4
2023-24,202402020DET,2/2/2024,DET vs LAC,Terance Mann,mannte01,41,LAC,0,DET,12,1,0,0,0,1,23.85,1,0,4,4,0,0,4,4,1,0,1,12,13,13,12.2
2023-24,202402020DET,2/2/2024,DET vs LAC,Amir Coffey,coffeam01,35,LAC,0,DET,14,4,0,4,1,1,23.95,0,4,5,7,1,1,3,3,0,5,4,14,18,18,32.8
2023-24,202402020HOU,2/2/2024,HOU vs TOR,Jabari Smith Jr.,smithja05,43,HOU,1,TOR,11,3,1,0,0,1,24.1,1,2,4,9,2,5,1,1,0,0,4,12,14,15,15.1
2023-24,202402020HOU,2/2/2024,HOU vs TOR,Amen Thompson,thompam01,29,HOU,1,TOR,19,7,4,2,1,2,24.15,1,6,9,11,0,1,1,2,3,3,11,23,26,30,40.4
2023-24,202402020DEN,2/2/2024,DEN vs POR,Reggie Jackson,jacksre01,50,DEN,1,POR,13,0,3,0,0,0,24.3,0,0,5,9,1,3,2,3,3,0,3,16,13,16,17.5
2023-24,202402020WAS,2/2/2024,WAS vs MIA,Josh Richardson,richajo01,39,MIA,0,WAS,7,4,2,0,0,1,24.73333333,0,4,3,8,1,6,0,0,2,0,6,9,11,13,13.8
2023-24,202402020HOU,2/2/2024,HOU vs TOR,Fred VanVleet,vanvlfr01,46,HOU,1,TOR,10,2,6,0,1,1,24.75,0,2,4,7,2,4,0,0,3,1,8,16,12,18,23.4
2023-24,202402020OKC,2/2/2024,OKC vs CHO,Cason Wallace,wallaca01,49,OKC,1,CHO,12,2,1,1,0,1,24.8,0,2,5,7,2,4,0,0,1,1,3,13,14,15,17.9
2023-24,202402020OKC,2/2/2024,OKC vs CHO,Bryce McGowens,mcgowbr01,38,CHO,0,OKC,15,3,3,4,1,2,24.9,1,2,6,10,0,3,3,4,5,5,6,18,18,21,36.1
2023-24,202402020DET,2/2/2024,DET vs LAC,Russell Westbrook,westbru01,47,LAC,0,DET,23,3,9,2,0,2,25.15,1,2,10,13,2,3,1,2,2,2,12,32,26,35,44.1
2023-24,202402020WAS,2/2/2024,WAS vs MIA,Bilal Coulibaly,coulibi01,47,WAS,1,MIA,5,4,3,1,1,1,25.2,0,4,1,4,0,2,3,3,2,2,7,8,9,12,19.3
2023-24,202402020HOU,2/2/2024,HOU vs TOR,Thaddeus Young,youngth01,20,TOR,0,HOU,8,4,1,0,0,2,25.41666667,1,3,4,4,0,0,0,1,2,0,5,9,12,13,12.3
2023-24,202402020DET,2/2/2024,DET vs LAC,Norman Powell,powelno01,47,LAC,0,DET,15,5,2,0,0,0,25.45,1,4,6,11,3,6,0,0,5,0,7,17,20,22,24
2023-24,202402020HOU,2/2/2024,HOU vs TOR,Bruce Brown,brownbr01,41,TOR,0,HOU,5,5,4,2,2,1,25.71666667,1,4,2,9,1,2,0,0,1,4,9,9,10,14,28
2023-24,202402020WAS,2/2/2024,WAS vs MIA,Jaime Jaquez Jr.,jaqueja01,43,MIA,0,WAS,8,4,2,2,0,0,25.8,2,2,4,7,0,1,0,0,2,2,6,10,12,14,21.8
2023-24,202402020WAS,2/2/2024,WAS vs MIA,Tyus Jones,jonesty01,48,WAS,1,MIA,6,1,6,1,0,1,25.88333333,0,1,2,7,0,2,2,2,2,1,7,12,7,13,18.2
2023-24,202402020DET,2/2/2024,DET vs LAC,Mason Plumlee,plumlma01,17,LAC,0,DET,12,9,2,1,0,1,25.88333333,3,6,5,7,0,0,2,3,3,1,11,14,21,23,27.8
2023-24,202402020HOU,2/2/2024,HOU vs TOR,Gary Trent Jr.,trentga02,43,TOR,0,HOU,12,4,0,2,0,1,25.96666667,2,2,5,12,2,5,0,0,1,2,4,12,16,16,21.8
2023-24,202402020DET,2/2/2024,DET vs LAC,Ausar Thompson,thompau01,48,DET,1,LAC,3,7,1,2,1,1,26.13333333,4,3,1,4,0,1,1,2,1,3,8,4,10,11,20.9
2023-24,202402020OKC,2/2/2024,OKC vs CHO,P.J. Washington,washipj01,41,CHO,0,OKC,5,6,1,2,0,5,26.41666667,1,5,2,9,0,3,1,2,3,2,7,6,11,12,14.7
2023-24,202402020SAS,2/2/2024,SAS vs NOP,Trey Murphy III,murphtr02,24,NOP,0,SAS,9,1,0,2,0,1,26.53333333,0,1,4,9,1,2,0,0,0,2,1,9,10,10,15.2
2023-24,202402020DEN,2/2/2024,DEN vs POR,Deandre Ayton,aytonde01,33,POR,0,DEN,8,3,1,0,1,0,26.75,1,2,3,6,0,0,2,2,1,1,4,9,11,12,16.1
2023-24,202402020IND,2/2/2024,IND vs SAC,Aaron Nesmith,nesmiaa01,46,IND,1,SAC,6,4,2,1,1,1,26.78333333,1,3,3,7,0,2,0,0,6,2,6,8,10,12,18.8
2023-24,202402020MEM,2/2/2024,MEM vs GSW,Klay Thompson,thompkl01,43,GSW,0,MEM,14,2,0,0,1,0,26.86666667,0,2,6,15,2,9,0,0,0,1,2,14,16,16,19.4
2023-24,202402020MIN,2/2/2024,MIN vs ORL,Nickeil Alexander-Walker,alexani01,49,MIN,1,ORL,7,1,0,1,0,1,27,0,1,2,7,1,5,2,2,2,1,1,7,8,8,10.2
2023-24,202402020SAS,2/2/2024,SAS vs NOP,Jonas Valanciunas,valanjo01,49,NOP,0,SAS,18,9,4,0,0,0,27,3,6,9,12,0,0,0,0,2,0,13,22,27,31,34.8
2023-24,202402020IND,2/2/2024,IND vs SAC,Malik Monk,monkma01,46,SAC,0,IND,23,5,6,1,0,1,27.03333333,1,4,9,14,1,3,4,6,4,1,11,29,28,34,40
2023-24,202402020ATL,2/2/2024,ATL vs PHO,Onyeka Okongwu,okongon01,47,ATL,1,PHO,15,7,0,1,2,0,27.15,3,4,7,8,1,1,0,0,1,3,7,15,22,22,32.4
2023-24,202402020IND,2/2/2024,IND vs SAC,Isaiah Jackson,jacksis01,38,IND,1,SAC,10,8,2,2,0,2,27.16666667,2,6,3,8,0,0,4,4,3,2,10,12,18,20,26.6
2023-24,202402020DET,2/2/2024,DET vs LAC,Paul George,georgpa01,44,LAC,0,DET,18,4,7,3,1,0,27.33333333,0,4,8,16,2,5,0,0,3,4,11,25,22,29,45.3
2023-24,202402020MEM,2/2/2024,MEM vs GSW,David Roddy,roddyda01,46,MEM,1,GSW,16,2,4,0,0,2,27.38333333,0,2,6,10,1,3,3,4,3,0,6,20,18,22,22.4
2023-24,202402020HOU,2/2/2024,HOU vs TOR,Jalen Green,greenja05,48,HOU,1,TOR,14,4,3,0,0,1,27.45,0,4,7,14,0,4,0,1,1,0,7,17,18,21,22.3
2023-24,202402020DEN,2/2/2024,DEN vs POR,Aaron Gordon,gordoaa01,44,DEN,1,POR,18,4,5,0,0,3,27.68333333,2,2,7,9,1,1,3,3,4,0,9,23,22,27,27.3
2023-24,202402020MEM,2/2/2024,MEM vs GSW,Draymond Green,greendr01,21,GSW,0,MEM,9,12,6,0,3,4,27.7,2,10,4,7,1,2,0,0,4,3,18,15,21,27,37.4
2023-24,202402020ATL,2/2/2024,ATL vs PHO,Eric Gordon,gordoer01,41,PHO,0,ATL,6,3,1,1,0,2,27.75,0,3,2,5,2,5,0,0,1,1,4,7,9,10,12.1
2023-24,202402020MEM,2/2/2024,MEM vs GSW,John Konchar,konchjo01,39,MEM,1,GSW,3,12,5,1,0,2,27.86666667,4,8,1,7,1,3,0,0,2,1,17,8,15,20,25.9
2023-24,202402020MIN,2/2/2024,MIN vs ORL,Mike Conley,conlemi01,44,MIN,1,ORL,4,5,9,3,0,1,28.08333333,0,5,1,9,1,6,1,1,3,3,14,13,9,18,31.5
2023-24,202402020IND,2/2/2024,IND vs SAC,Keegan Murray,murrake02,43,SAC,0,IND,5,1,1,0,0,0,28.08333333,1,0,2,7,1,6,0,0,0,0,2,6,6,7,7.7
2023-24,202402020IND,2/2/2024,IND vs SAC,Buddy Hield,hieldbu01,51,IND,1,SAC,17,4,4,2,0,0,28.38333333,0,4,7,13,3,8,0,0,3,2,8,21,21,25,33.8
2023-24,202402020SAS,2/2/2024,SAS vs NOP,Victor Wembanyama,wembavi01,43,SAS,1,NOP,16,14,7,2,3,6,28.41666667,5,9,7,14,0,3,2,2,2,5,21,23,30,37,52.3
2023-24,202402020WAS,2/2/2024,WAS vs MIA,Caleb Martin,martica02,32,MIA,0,WAS,4,4,4,1,0,1,28.65,2,2,2,6,0,2,0,0,3,1,8,8,8,12,16.8
2023-24,202402020HOU,2/2/2024,HOU vs TOR,Alperen Sengun,sengual01,48,HOU,1,TOR,24,13,8,0,0,2,28.73333333,1,12,10,14,1,2,3,3,4,0,21,32,37,45,49.6
2023-24,202402020DET,2/2/2024,DET vs LAC,Bojan Bogdanovic,bogdabo02,27,DET,1,LAC,26,1,3,0,0,4,29.5,0,1,9,13,6,9,2,2,2,0,4,29,27,30,27.7
2023-24,202402020HOU,2/2/2024,HOU vs TOR,Immanuel Quickley,quickim01,43,TOR,0,HOU,25,1,6,0,0,0,29.63333333,0,1,7,16,6,11,5,7,2,0,7,31,26,32,35.2
2023-24,202402020OKC,2/2/2024,OKC vs CHO,Shai Gilgeous-Alexander,gilgesh01,48,OKC,1,CHO,31,3,9,5,3,3,29.88333333,0,3,11,15,1,1,8,10,2,8,12,40,34,43,69.1
2023-24,202402020MEM,2/2/2024,MEM vs GSW,Andrew Wiggins,wiggian01,41,GSW,0,MEM,9,2,0,1,2,0,30.11666667,0,2,3,8,1,2,2,2,0,3,2,9,11,11,20.4
2023-24,202402020SAS,2/2/2024,SAS vs NOP,Julian Champagnie,champju02,42,SAS,1,NOP,5,6,3,0,3,0,30.3,3,3,2,6,0,4,1,2,2,3,9,8,11,14,25.7
2023-24,202402020WAS,2/2/2024,WAS vs MIA,Terry Rozier,roziete01,36,MIA,0,WAS,15,8,5,0,0,0,30.36666667,2,6,2,13,0,6,11,11,3,0,13,20,23,28,32.1
2023-24,202402020IND,2/2/2024,IND vs SAC,Kevin Huerter,huertke01,45,SAC,0,IND,15,5,6,0,0,4,30.41666667,2,3,5,10,3,6,2,3,5,0,11,21,20,26,26
2023-24,202402020SAS,2/2/2024,SAS vs NOP,Jeremy Sochan,sochaje01,49,SAS,1,NOP,15,16,3,2,0,3,30.53333333,7,9,6,12,0,4,3,6,4,2,19,18,31,34,41.7
2023-24,202402020OKC,2/2/2024,OKC vs CHO,Nick Richards,richani01,38,CHO,0,OKC,8,11,1,0,1,0,30.91666667,3,8,3,5,0,0,2,4,1,1,12,9,19,20,25.7
2023-24,202402020DET,2/2/2024,DET vs LAC,Jalen Duren,durenja01,33,DET,1,LAC,11,13,2,0,0,0,31.16666667,2,11,5,7,0,0,1,2,1,0,15,13,24,26,29.6
2023-24,202402020ATL,2/2/2024,ATL vs PHO,Grayson Allen,allengr01,43,PHO,0,ATL,12,2,4,1,2,2,31.26666667,0,2,5,7,1,3,1,1,4,3,6,16,14,18,27.4
2023-24,202402020MEM,2/2/2024,MEM vs GSW,Jaren Jackson Jr.,jacksja02,47,MEM,1,GSW,27,5,2,2,2,2,31.38333333,0,5,8,21,2,9,9,11,2,4,7,29,32,34,46
2023-24,202402020WAS,2/2/2024,WAS vs MIA,Corey Kispert,kispeco01,47,WAS,1,MIA,26,4,2,0,0,0,31.46666667,0,4,10,18,6,14,0,1,3,0,6,28,30,32,33.8
2023-24,202402020MEM,2/2/2024,MEM vs GSW,Vince Williams Jr.,willivi01,38,MEM,1,GSW,15,6,4,0,1,4,31.48333333,1,5,6,12,1,5,2,5,5,1,10,19,21,25,27.2
2023-24,202402020OKC,2/2/2024,OKC vs CHO,Brandon Miller,millebr02,41,CHO,0,OKC,28,4,4,3,2,2,31.68333333,1,3,11,19,5,8,1,1,4,5,8,32,32,36,51.8
2023-24,202402020WAS,2/2/2024,WAS vs MIA,Tyler Herro,herroty01,30,MIA,0,WAS,15,4,5,0,0,2,31.81666667,0,4,6,19,3,8,0,0,2,0,9,20,19,24,25.3
2023-24,202402020DET,2/2/2024,DET vs LAC,Kawhi Leonard,leonaka01,43,LAC,0,DET,33,4,3,0,1,0,31.96666667,0,4,12,17,6,8,3,3,2,1,7,36,37,40,45.3
2023-24,202402020MIN,2/2/2024,MIN vs ORL,Jaden McDaniels,mcdanja02,39,MIN,1,ORL,10,4,1,1,0,3,32,2,2,4,10,2,6,0,0,5,1,5,11,14,15,16.3
2023-24,202402020OKC,2/2/2024,OKC vs CHO,Miles Bridges,bridgmi02,36,CHO,0,OKC,9,5,4,0,0,2,32.06666667,0,5,3,16,1,3,2,2,2,0,9,13,14,18,19
2023-24,202402020WAS,2/2/2024,WAS vs MIA,Daniel Gafford,gaffoda01,43,WAS,1,MIA,11,14,2,1,1,1,32.16666667,4,10,4,8,0,0,3,4,4,2,16,13,25,27,35.8
2023-24,202402020MEM,2/2/2024,MEM vs GSW,Stephen Curry,curryst01,42,GSW,0,MEM,20,6,6,1,0,3,32.26666667,0,6,6,16,4,9,4,4,1,1,12,26,26,32,36.2
2023-24,202402020MEM,2/2/2024,MEM vs GSW,Jacob Gilyard,gilyaja01,32,MEM,1,GSW,16,2,5,2,1,1,32.33333333,1,1,5,9,5,9,1,1,2,3,7,21,18,23,33.9
2023-24,202402020WAS,2/2/2024,WAS vs MIA,Jordan Poole,poolejo01,46,WAS,1,MIA,16,4,10,2,1,1,32.6,0,4,6,21,2,14,2,3,3,3,14,26,20,30,43.8
2023-24,202402020DEN,2/2/2024,DEN vs POR,Jamal Murray,murraja01,36,DEN,1,POR,13,9,10,0,2,2,32.73333333,4,5,5,21,3,15,0,0,1,2,19,23,22,32,42.8
2023-24,202402020DET,2/2/2024,DET vs LAC,Cade Cunningham,cunnica01,39,DET,1,LAC,16,3,11,1,0,4,32.78333333,0,3,7,17,1,3,1,1,4,1,14,27,19,30,35.1
2023-24,202402020WAS,2/2/2024,WAS vs MIA,Bam Adebayo,adebaba01,39,MIA,0,WAS,20,14,1,0,1,4,32.85,2,12,8,14,0,0,4,7,3,1,15,21,34,35,37.3
2023-24,202402020HOU,2/2/2024,HOU vs TOR,Scottie Barnes,barnesc01,48,TOR,0,HOU,28,7,4,1,0,1,33.25,3,4,10,17,1,2,7,8,1,1,11,32,35,39,44.4
2023-24,202402020DET,2/2/2024,DET vs LAC,Jaden Ivey,iveyja01,44,DET,1,LAC,28,7,3,0,0,3,33.5,5,2,11,18,3,8,3,6,2,0,10,31,35,38,37.9
2023-24,202402020DET,2/2/2024,DET vs LAC,James Harden,hardeja01,42,LAC,0,DET,4,3,6,1,0,1,33.6,1,2,1,10,0,5,2,2,1,1,9,10,7,13,18.6
2023-24,202402020DEN,2/2/2024,DEN vs POR,Kentavious Caldwell-Pope,caldwke01,48,DEN,1,POR,16,1,2,0,1,0,33.76666667,0,1,4,8,1,2,7,7,3,1,3,18,17,19,23.2
2023-24,202402020MEM,2/2/2024,MEM vs GSW,Brandin Podziemski,podzibr01,39,GSW,0,MEM,12,7,14,2,1,0,34.06666667,1,6,5,8,0,2,2,2,2,3,21,26,19,33,50.4
2023-24,202402020ATL,2/2/2024,ATL vs PHO,Bogdan Bogdanovic,bogdabo01,46,ATL,1,PHO,23,4,5,0,0,0,34.35,1,3,8,12,4,7,3,3,2,0,9,28,27,32,35.3
2023-24,202402020MIN,2/2/2024,MIN vs ORL,Franz Wagner,wagnefr01,41,ORL,0,MIN,19,4,5,2,1,1,34.53333333,2,2,7,17,0,5,5,6,3,3,9,24,23,28,39.3
2023-24,202402020IND,2/2/2024,IND vs SAC,Domantas Sabonis,sabondo01,47,SAC,0,IND,26,11,7,2,1,4,34.85,3,8,9,14,0,1,8,9,3,3,18,33,37,44,54.7
2023-24,202402020WAS,2/2/2024,WAS vs MIA,Deni Avdija,avdijde01,48,WAS,1,MIA,15,8,2,0,0,3,34.98333333,1,7,6,8,1,2,2,3,5,0,10,17,23,25,24.6
2023-24,202402020DEN,2/2/2024,DEN vs POR,Michael Porter Jr.,portemi01,50,DEN,1,POR,13,4,1,0,0,1,34.98333333,0,4,5,14,3,10,0,0,0,0,5,14,17,18,18.3
2023-24,202402020IND,2/2/2024,IND vs SAC,De'Aaron Fox,foxde01,41,SAC,0,IND,25,3,3,6,1,3,35.11666667,0,3,11,21,1,5,2,6,1,7,6,28,28,31,51.1
2023-24,202402020MIN,2/2/2024,MIN vs ORL,Paolo Banchero,banchpa01,49,ORL,0,MIN,23,1,6,1,0,3,35.2,0,1,10,20,1,1,2,2,2,1,7,29,24,30,33.2
2023-24,202402020SAS,2/2/2024,SAS vs NOP,Tre Jones,jonestr01,44,SAS,1,NOP,20,7,7,0,1,4,35.38333333,1,6,8,15,1,5,3,4,0,1,14,27,27,34,37.9
2023-24,202402020MIN,2/2/2024,MIN vs ORL,Karl-Anthony Towns,townska01,48,MIN,1,ORL,19,3,1,0,2,6,35.41666667,0,3,7,17,2,7,3,3,1,2,4,20,22,23,24.1
2023-24,202402020IND,2/2/2024,IND vs SAC,Pascal Siakam,siakapa01,48,IND,1,SAC,22,6,2,2,0,5,35.45,3,3,10,15,1,3,1,3,3,2,8,24,28,30,33.2
2023-24,202402020MIN,2/2/2024,MIN vs ORL,Anthony Edwards,edwaran01,46,MIN,1,ORL,22,1,5,1,0,3,35.46666667,0,1,9,18,2,8,2,3,1,1,6,27,23,28,30.7
2023-24,202402020DEN,2/2/2024,DEN vs POR,Malcolm Brogdon,brogdma01,39,POR,0,DEN,11,8,6,0,0,0,35.51666667,3,5,5,13,0,2,1,3,2,0,14,17,19,25,29.6
2023-24,202402020WAS,2/2/2024,WAS vs MIA,Jimmy Butler,butleji01,34,MIA,0,WAS,24,9,3,1,0,2,35.51666667,4,5,7,10,1,1,9,13,0,1,12,27,33,36,40.3
2023-24,202402020SAS,2/2/2024,SAS vs NOP,Zion Williamson,willizi01,39,NOP,0,SAS,33,8,4,1,1,1,35.86666667,3,5,12,21,0,0,9,13,2,2,12,37,41,45,53.6
2023-24,202402020SAS,2/2/2024,SAS vs NOP,Devin Vassell,vassede01,44,SAS,1,NOP,28,3,3,0,1,2,36.11666667,0,3,11,21,5,10,1,2,0,1,6,31,31,34,37.1
2023-24,202402020WAS,2/2/2024,WAS vs MIA,Kyle Kuzma,kuzmaky01,48,WAS,1,MIA,13,4,1,0,0,0,36.23333333,0,4,5,16,1,5,2,2,5,0,5,14,17,18,19.3
2023-24,202402020MIN,2/2/2024,MIN vs ORL,Jalen Suggs,suggsja01,45,ORL,0,MIN,15,6,2,2,1,3,36.28333333,2,4,4,12,4,9,3,4,2,3,8,17,21,23,31.2
2023-24,202402020SAS,2/2/2024,SAS vs NOP,Brandon Ingram,ingrabr01,45,NOP,0,SAS,19,4,6,2,1,2,36.4,2,2,7,15,1,2,4,4,4,3,10,25,23,29,39.8
2023-24,202402020DEN,2/2/2024,DEN vs POR,Anfernee Simons,simonan01,27,POR,0,DEN,29,4,4,2,0,2,36.86666667,1,3,11,23,4,10,3,4,2,2,8,33,33,37,43.8
2023-24,202402020MIN,2/2/2024,MIN vs ORL,Wendell Carter Jr.,cartewe01,23,ORL,0,MIN,18,12,1,0,0,0,36.96666667,3,9,6,12,2,6,4,6,3,0,13,19,30,31,33.9
2023-24,202402020MEM,2/2/2024,MEM vs GSW,Jonathan Kuminga,kuminjo01,44,GSW,0,MEM,29,6,4,2,0,2,36.96666667,1,5,11,15,1,1,6,7,3,2,10,33,35,39,46.2
2023-24,202402020IND,2/2/2024,IND vs SAC,Bennedict Mathurin,mathube01,49,IND,1,SAC,31,5,4,2,0,5,36.98333333,0,5,10,14,2,2,9,10,1,2,9,35,36,40,44
2023-24,202402020DEN,2/2/2024,DEN vs POR,Scoot Henderson,hendesc01,40,POR,0,DEN,30,5,2,0,0,2,37.15,2,3,8,15,3,7,11,12,3,0,7,32,35,37,37
2023-24,202402020IND,2/2/2024,IND vs SAC,Harrison Barnes,barneha02,47,SAC,0,IND,22,4,1,3,0,3,37.48333333,1,3,9,14,4,7,0,2,2,3,5,23,26,27,34.3
2023-24,202402020ATL,2/2/2024,ATL vs PHO,Jalen Johnson,johnsja05,34,ATL,1,PHO,16,7,4,1,1,1,37.73333333,0,7,6,14,2,6,2,3,2,2,11,20,23,27,35.4
2023-24,202402020ATL,2/2/2024,ATL vs PHO,Devin Booker,bookede01,40,PHO,0,ATL,24,6,4,1,0,2,38.13333333,2,4,8,16,3,8,5,6,4,1,10,28,30,34,38.2
2023-24,202402020ATL,2/2/2024,ATL vs PHO,Kevin Durant,duranke01,42,PHO,0,ATL,35,8,8,2,1,4,38.15,1,7,14,24,5,9,2,2,3,3,16,43,43,51,61.6
2023-24,202402020DEN,2/2/2024,DEN vs POR,Nikola Jokic,jokicni01,48,DEN,1,POR,27,22,12,1,2,4,38.26666667,7,15,11,16,1,1,4,4,3,3,34,39,49,61,76.4
2023-24,202402020SAS,2/2/2024,SAS vs NOP,CJ McCollum,mccolcj01,35,NOP,0,SAS,21,4,4,1,1,2,38.51666667,1,3,8,17,3,10,2,4,3,2,8,25,25,29,35.8
2023-24,202402020MIN,2/2/2024,MIN vs ORL,Rudy Gobert,goberru01,48,MIN,1,ORL,22,16,2,0,2,1,39.08333333,3,13,6,7,0,0,10,11,5,2,18,24,38,40,49.2
2023-24,202402020ATL,2/2/2024,ATL vs PHO,Dejounte Murray,murrade01,47,ATL,1,PHO,22,8,5,1,0,1,39.16666667,0,8,7,17,1,8,7,8,2,1,13,27,30,35,41.1
2023-24,202402020ATL,2/2/2024,ATL vs PHO,Bradley Beal,bealbr01,25,PHO,0,ATL,14,4,10,0,0,4,39.75,1,3,5,16,0,7,4,4,2,0,14,24,18,28,29.8
2023-24,202402020ATL,2/2/2024,ATL vs PHO,Trae Young,youngtr01,43,ATL,1,PHO,32,1,15,3,1,7,42.18333333,0,1,12,17,7,11,1,2,2,4,16,47,33,48,60.7
2023-24,202402010NYK,2/1/2024,NYK vs IND,Jericho Sims,simsje01,25,NYK,1,IND,2,4,1,0,3,1,12.5,4,0,1,1,0,0,0,0,0,3,5,3,6,7,16.3
2023-24,202402010UTA,2/1/2024,UTA vs PHI,Furkan Korkmaz,korkmfu01,32,PHI,0,UTA,5,2,2,0,0,0,12.51666667,0,2,2,7,1,4,0,0,1,0,4,7,7,9,10.4
2023-24,202402010BOS,2/1/2024,BOS vs LAL,Neemias Queta,quetane01,21,BOS,1,LAL,7,7,1,0,1,0,12.81666667,4,3,3,5,0,0,1,1,2,1,8,8,14,15,19.9
2023-24,202402010MEM,2/1/2024,MEM vs CLE,Trey Jemison,jemistr01,3,MEM,1,CLE,5,3,0,1,1,0,13.56666667,1,2,2,2,0,0,1,1,2,2,3,5,8,8,14.6
2023-24,202402010UTA,2/1/2024,UTA vs PHI,Walker Kessler,kesslwa01,42,UTA,1,PHI,8,7,2,0,4,1,14.35,3,4,4,4,0,0,0,0,2,4,9,10,15,17,30.4
2023-24,202402010MEM,2/1/2024,MEM vs CLE,Damian Jones,jonesda03,21,CLE,0,MEM,7,6,1,0,3,2,14.85,2,4,2,4,0,0,3,3,2,3,7,8,13,14,22.7
2023-24,202402010UTA,2/1/2024,UTA vs PHI,Kris Dunn,dunnkr01,42,UTA,1,PHI,3,3,4,0,2,1,16.01666667,0,3,1,4,1,1,0,0,0,2,7,7,6,10,17.6
2023-24,202402010BOS,2/1/2024,BOS vs LAL,Jarred Vanderbilt,vandeja01,30,LAL,0,BOS,10,7,2,3,0,3,16.06666667,3,4,3,7,2,3,2,2,0,3,9,12,17,19,27.4
2023-24,202402010UTA,2/1/2024,UTA vs PHI,Ochai Agbaji,agbajoc01,50,UTA,1,PHI,0,1,1,0,0,1,17.03333333,0,1,0,3,0,0,0,0,2,0,2,1,1,2,1.7
2023-24,202402010MEM,2/1/2024,MEM vs CLE,Sam Merrill,merrisa01,31,CLE,0,MEM,9,2,1,0,0,0,17.63333333,0,2,3,6,3,5,0,0,1,0,3,10,11,12,12.9
2023-24,202402010MEM,2/1/2024,MEM vs CLE,David Roddy,roddyda01,45,MEM,1,CLE,2,4,3,1,0,0,17.86666667,0,4,1,12,0,2,0,0,2,1,7,5,6,9,14.3
2023-24,202402010UTA,2/1/2024,UTA vs PHI,Mo Bamba,bambamo01,26,PHI,0,UTA,4,9,0,0,3,1,17.96666667,1,8,2,7,0,2,0,0,1,3,9,4,13,13,22.8
2023-24,202402010UTA,2/1/2024,UTA vs PHI,Patrick Beverley,beverpa01,44,PHI,0,UTA,8,4,5,0,0,2,18.31666667,0,4,2,2,2,2,2,2,2,0,9,13,12,17,18.3
2023-24,202402010UTA,2/1/2024,UTA vs PHI,Kelly Olynyk,olynyke01,48,UTA,1,PHI,14,3,3,0,0,0,18.81666667,0,3,3,4,1,2,7,7,1,0,6,17,17,20,22.1
2023-24,202402010BOS,2/1/2024,BOS vs LAL,Christian Wood,woodch01,44,LAL,0,BOS,4,4,1,1,0,0,18.88333333,2,2,1,9,1,4,1,2,0,1,5,5,8,9,13.3
2023-24,202402010UTA,2/1/2024,UTA vs PHI,Danuel House Jr.,houseda01,32,PHI,0,UTA,5,2,3,1,1,0,19.05,1,1,1,2,0,1,3,3,2,2,5,8,7,10,17.9
2023-24,202402010UTA,2/1/2024,UTA vs PHI,Jaden Springer,sprinja01,29,PHI,0,UTA,3,1,2,1,0,0,19.3,0,1,1,4,1,2,0,0,3,1,3,5,4,6,10.2
2023-24,202402010UTA,2/1/2024,UTA vs PHI,Keyonte George,georgke01,44,UTA,1,PHI,11,3,3,0,0,2,21,0,3,5,9,1,4,0,0,1,0,6,14,14,17,17.1
2023-24,202402010MEM,2/1/2024,MEM vs CLE,Isaac Okoro,okorois01,37,CLE,0,MEM,6,4,0,0,0,1,21.03333333,1,3,2,4,1,1,1,1,2,0,4,6,10,10,9.8
2023-24,202402010MEM,2/1/2024,MEM vs CLE,Jarrett Allen,allenja01,41,CLE,0,MEM,14,9,2,0,3,2,21.15,2,7,6,13,0,0,2,4,1,3,11,16,23,25,34.8
2023-24,202402010BOS,2/1/2024,BOS vs LAL,Payton Pritchard,pritcpa01,49,BOS,1,LAL,8,0,1,0,1,1,21.3,0,0,3,6,2,5,0,0,1,1,1,9,8,9,11.5
2023-24,202402010NYK,2/1/2024,NYK vs IND,Tyrese Haliburton,halibty01,37,IND,0,NYK,15,4,5,0,2,1,21.9,0,4,6,10,2,6,1,1,1,2,9,20,19,24,32.3
2023-24,202402010NYK,2/1/2024,NYK vs IND,Obi Toppin,toppiob01,50,IND,0,NYK,12,3,2,1,2,1,21.91666667,2,1,4,10,2,2,2,2,0,3,5,14,15,17,26.6
2023-24,202402010NYK,2/1/2024,NYK vs IND,Ben Sheppard,sheppbe01,28,IND,0,NYK,5,6,1,3,0,2,22.08333333,0,6,2,4,1,3,0,0,4,3,7,6,11,12,20.7
2023-24,202402010MEM,2/1/2024,MEM vs CLE,Scotty Pippen Jr.,pippesc02,5,MEM,1,CLE,10,4,4,3,1,2,22.36666667,1,3,4,9,2,5,0,0,3,4,8,14,14,18,30.8
2023-24,202402010MEM,2/1/2024,MEM vs CLE,Georges Niang,niangge01,46,CLE,0,MEM,5,5,0,0,0,0,22.43333333,1,4,2,7,1,4,0,0,4,0,5,5,10,10,11
2023-24,202402010MEM,2/1/2024,MEM vs CLE,Jacob Gilyard,gilyaja01,31,MEM,1,CLE,6,1,6,1,0,0,22.6,0,1,2,4,2,4,0,0,1,1,7,12,7,13,19.2
2023-24,202402010BOS,2/1/2024,BOS vs LAL,Sam Hauser,hausesa01,48,BOS,1,LAL,17,3,0,0,0,0,22.65,0,3,6,11,5,9,0,0,1,0,3,17,20,20,20.6
2023-24,202402010BOS,2/1/2024,BOS vs LAL,Max Christie,chrisma02,41,LAL,0,BOS,9,4,2,1,0,1,22.9,0,4,3,7,1,3,2,2,1,1,6,11,13,15,18.8
2023-24,202402010BOS,2/1/2024,BOS vs LAL,Al Horford,horfoal01,40,BOS,1,LAL,6,9,1,1,2,0,23.8,0,9,2,6,2,6,0,0,0,3,10,7,15,16,27.3
2023-24,202402010NYK,2/1/2024,NYK vs IND,Jalen Smith,smithja04,35,IND,0,NYK,20,9,0,2,2,1,23.8,1,8,9,11,2,3,0,1,0,4,9,20,29,29,41.8
2023-24,202402010MEM,2/1/2024,MEM vs CLE,Darius Garland,garlada01,22,CLE,0,MEM,9,2,7,1,0,3,24.1,0,2,4,10,1,3,0,0,0,1,9,16,11,18,21.9
2023-24,202402010NYK,2/1/2024,NYK vs IND,Myles Turner,turnemy01,48,IND,0,NYK,5,4,1,1,0,1,24.2,0,4,2,6,0,0,1,3,5,1,5,6,9,10,13.3
2023-24,202402010UTA,2/1/2024,UTA vs PHI,Collin Sexton,sextoco01,50,UTA,1,PHI,22,1,6,1,1,3,24.81666667,0,1,8,14,2,4,4,4,2,2,7,28,23,29,35.2
2023-24,202402010NYK,2/1/2024,NYK vs IND,Andrew Nembhard,nembhan01,35,IND,0,NYK,10,3,6,0,0,0,26.1,0,3,4,12,1,3,1,2,2,0,9,16,13,19,22.6
2023-24,202402010UTA,2/1/2024,UTA vs PHI,Simone Fontecchio,fontesi01,48,UTA,1,PHI,7,4,2,0,0,0,26.68333333,2,2,3,9,1,6,0,0,2,0,6,9,11,13,14.8
2023-24,202402010BOS,2/1/2024,BOS vs LAL,Jaylen Brown,brownja02,46,BOS,1,LAL,8,8,7,1,0,3,27.4,3,5,4,12,0,3,0,0,5,1,15,15,16,23,28.1
2023-24,202402010UTA,2/1/2024,UTA vs PHI,Paul Reed,reedpa01,47,PHI,0,UTA,7,10,4,1,2,1,27.65,4,6,3,9,0,1,1,1,2,3,14,11,17,21,33
2023-24,202402010MEM,2/1/2024,MEM vs CLE,Dean Wade,wadede01,39,CLE,0,MEM,6,5,1,2,2,0,27.83333333,0,5,2,5,2,5,0,0,1,4,6,7,11,12,25.5
2023-24,202402010NYK,2/1/2024,NYK vs IND,Buddy Hield,hieldbu01,50,IND,0,NYK,3,2,0,1,2,0,27.93333333,1,1,1,8,1,7,0,0,2,3,2,3,5,5,14.4
2023-24,202402010MEM,2/1/2024,MEM vs CLE,Max Strus,strusma01,46,CLE,0,MEM,11,10,4,1,0,0,28.55,4,6,4,8,2,4,1,2,1,1,14,15,21,25,32
2023-24,202402010MEM,2/1/2024,MEM vs CLE,GG Jackson II,jacksgg01,16,MEM,1,CLE,10,5,2,0,2,1,28.56666667,2,3,3,14,1,8,3,4,2,2,7,12,15,17,24
2023-24,202402010NYK,2/1/2024,NYK vs IND,Miles McBride,mcbrimi01,36,NYK,1,IND,16,1,0,2,0,1,29.01666667,0,1,6,13,3,8,1,1,1,2,1,16,17,17,22.2
2023-24,202402010MEM,2/1/2024,MEM vs CLE,Caris LeVert,leverca01,36,CLE,0,MEM,16,1,3,2,0,2,29.03333333,0,1,6,10,1,4,3,4,1,2,4,19,17,20,25.7
2023-24,202402010BOS,2/1/2024,BOS vs LAL,Jrue Holiday,holidjr01,45,BOS,1,LAL,8,7,7,0,0,4,29.16666667,2,5,4,9,0,2,0,0,3,0,14,15,15,22,22.9
2023-24,202402010BOS,2/1/2024,BOS vs LAL,Kristaps Porzingis,porzikr01,35,BOS,1,LAL,17,7,3,1,5,3,29.48333333,1,6,7,15,1,7,2,2,1,6,10,20,24,27,44.9
2023-24,202402010MEM,2/1/2024,MEM vs CLE,Vince Williams Jr.,willivi01,37,MEM,1,CLE,17,6,2,1,1,2,30.91666667,2,4,5,10,1,5,6,6,2,2,8,19,23,25,31.2
2023-24,202402010MEM,2/1/2024,MEM vs CLE,John Konchar,konchjo01,38,MEM,1,CLE,8,6,0,1,2,1,32.18333333,0,6,3,4,0,1,2,2,3,3,6,8,14,14,23.2
2023-24,202402010BOS,2/1/2024,BOS vs LAL,Derrick White,whitede01,45,BOS,1,LAL,9,4,6,0,2,2,32.73333333,1,3,4,11,1,5,0,0,3,2,10,15,13,19,26.8
2023-24,202402010BOS,2/1/2024,BOS vs LAL,Rui Hachimura,hachiru01,37,LAL,0,BOS,15,8,4,0,1,2,33.13333333,2,6,5,14,3,6,2,2,3,1,12,19,23,27,31.6
2023-24,202402010MEM,2/1/2024,MEM vs CLE,Donovan Mitchell,mitchdo01,37,CLE,0,MEM,25,4,7,0,0,4,33.38333333,0,4,10,19,3,9,2,4,3,0,11,32,29,36,36.3
2023-24,202402010UTA,2/1/2024,UTA vs PHI,Lauri Markkanen,markkla01,40,UTA,1,PHI,28,10,3,1,0,0,33.43333333,2,8,10,15,4,9,4,4,2,1,13,31,38,41,47.5
2023-24,202402010UTA,2/1/2024,UTA vs PHI,John Collins,collijo01,46,UTA,1,PHI,15,9,2,1,2,0,33.63333333,3,6,6,10,1,3,2,3,2,3,11,17,24,26,37.8
2023-24,202402010BOS,2/1/2024,BOS vs LAL,Jaxson Hayes,hayesja02,40,LAL,0,BOS,16,10,2,3,0,0,33.86666667,6,4,6,8,0,0,4,5,0,3,12,18,26,28,40
2023-24,202402010UTA,2/1/2024,UTA vs PHI,Jordan Clarkson,clarkjo01,40,UTA,1,PHI,16,2,10,0,0,1,34.18333333,0,2,5,15,1,7,5,7,1,0,12,26,18,28,32.4
2023-24,202402010MEM,2/1/2024,MEM vs CLE,Jaren Jackson Jr.,jacksja02,46,MEM,1,CLE,25,5,5,1,3,5,34.43333333,0,5,10,23,2,6,3,4,4,4,10,30,30,35,45.5
2023-24,202402010BOS,2/1/2024,BOS vs LAL,Austin Reaves,reaveau01,51,LAL,0,BOS,32,2,3,0,0,0,34.56666667,0,2,10,18,7,10,5,7,1,0,5,35,34,37,38.9
2023-24,202402010NYK,2/1/2024,NYK vs IND,Pascal Siakam,siakapa01,47,IND,0,NYK,18,7,5,0,1,5,35.45,4,3,8,19,1,3,1,2,5,1,12,23,25,30,31.9
2023-24,202402010NYK,2/1/2024,NYK vs IND,Isaiah Hartenstein,harteis01,47,NYK,1,IND,12,19,6,0,1,1,35.5,8,11,6,8,0,0,0,1,2,1,25,18,31,37,45.8
2023-24,202402010NYK,2/1/2024,NYK vs IND,Aaron Nesmith,nesmiaa01,45,IND,0,NYK,17,6,1,1,0,2,36.61666667,1,5,6,13,3,6,2,2,6,1,7,18,23,24,26.7
2023-24,202402010BOS,2/1/2024,BOS vs LAL,Jayson Tatum,tatumja01,46,BOS,1,LAL,23,7,3,1,1,2,36.61666667,2,5,8,21,5,10,2,2,3,2,10,26,30,33,39.9
2023-24,202402010NYK,2/1/2024,NYK vs IND,Jalen Brunson,brunsja01,47,NYK,1,IND,40,5,1,0,0,2,36.86666667,1,4,15,30,1,6,9,11,3,0,6,41,45,46,45.5
2023-24,202402010MEM,2/1/2024,MEM vs CLE,Santi Aldama,aldamsa01,37,MEM,1,CLE,18,9,3,0,2,1,37.5,1,8,7,12,4,7,0,0,0,2,12,21,27,30,38.3
2023-24,202402010NYK,2/1/2024,NYK vs IND,Donte DiVincenzo,divindo01,49,NYK,1,IND,20,2,3,2,0,1,37.93333333,0,2,8,26,4,16,0,0,1,2,5,23,22,25,31.9
2023-24,202402010NYK,2/1/2024,NYK vs IND,Josh Hart,hartjo01,48,NYK,1,IND,5,12,3,0,1,2,37.96666667,3,9,0,6,0,3,5,6,3,1,15,8,17,20,24.9
2023-24,202402010BOS,2/1/2024,BOS vs LAL,Taurean Prince,princta02,48,LAL,0,BOS,11,8,2,1,1,0,37.96666667,0,8,5,10,1,2,0,0,2,2,10,13,19,21,29.6
2023-24,202402010BOS,2/1/2024,BOS vs LAL,D'Angelo Russell,russeda01,47,LAL,0,BOS,16,8,14,2,0,1,39.03333333,2,6,5,20,4,8,2,4,1,2,22,30,24,38,51.6
2023-24,202402010UTA,2/1/2024,UTA vs PHI,Tobias Harris,harrito02,44,PHI,0,UTA,28,5,7,1,1,0,39.05,2,3,13,21,0,5,2,2,3,2,12,35,33,40,50.5
2023-24,202402010UTA,2/1/2024,UTA vs PHI,Kelly Oubre Jr.,oubreke01,35,PHI,0,UTA,16,4,2,2,3,0,39.58333333,1,3,6,14,3,6,1,2,4,5,6,18,20,22,38.8
2023-24,202402010UTA,2/1/2024,UTA vs PHI,Tyrese Maxey,maxeyty01,43,PHI,0,UTA,51,2,1,0,1,0,41.1,0,2,17,27,7,9,10,11,4,1,3,52,53,54,57.9
2023-24,202402010NYK,2/1/2024,NYK vs IND,Precious Achiuwa,achiupr01,42,NYK,1,IND,12,16,0,4,2,2,43.16666667,8,8,5,16,0,3,2,4,4,6,16,12,28,28,47.2
2023-24,202401310OKC,1/31/2024,OKC vs DEN,Justin Holiday,holidju01,27,DEN,0,OKC,5,1,0,1,1,0,11.36666667,0,1,2,3,1,2,0,0,3,2,1,5,6,6,12.2
2023-24,202401310CHO,1/31/2024,CHO vs CHI,Julian Phillips,phillju01,25,CHI,0,CHO,4,1,0,0,0,1,11.4,1,0,1,2,0,1,2,2,4,0,1,4,5,5,4.2
2023-24,202401310SAS,1/31/2024,SAS vs ORL,Blake Wesley,weslebl01,27,SAS,1,ORL,4,1,1,1,0,2,11.61666667,0,1,2,4,0,1,0,0,1,1,2,5,5,6,7.7
2023-24,202401310WAS,1/31/2024,WAS vs LAC,Johnny Davis,davisjo06,21,WAS,1,LAC,2,1,1,0,1,0,12,0,1,1,3,0,1,0,2,2,1,2,3,3,4,7.7
2023-24,202401310SAS,1/31/2024,SAS vs ORL,Doug McDermott,mcderdo01,43,SAS,1,ORL,2,1,0,0,0,1,12,0,1,1,6,0,4,0,2,0,0,1,2,3,3,2.2
2023-24,202401310MIA,1/31/2024,MIA vs SAC,Davion Mitchell,mitchda01,36,SAC,0,MIA,3,1,1,0,0,1,12.01666667,0,1,1,2,0,0,1,1,1,0,2,4,4,5,4.7
2023-24,202401310CLE,1/31/2024,CLE vs DET,Dean Wade,wadede01,38,CLE,1,DET,0,1,0,0,1,1,12.21666667,0,1,0,3,0,2,0,0,2,1,1,0,1,1,3.2
2023-24,202401310WAS,1/31/2024,WAS vs LAC,Patrick Baldwin Jr.,baldwpa01,16,WAS,1,LAC,3,6,0,0,0,1,12.33333333,2,4,1,6,1,4,0,0,3,0,6,3,9,9,9.2
2023-24,202401310CHO,1/31/2024,CHO vs CHI,Nick Smith Jr.,smithni01,31,CHO,1,CHI,5,2,1,0,0,1,12.46666667,1,1,2,5,1,3,0,0,0,0,3,6,7,8,7.9
2023-24,202401310CHO,1/31/2024,CHO vs CHI,Bryce McGowens,mcgowbr01,37,CHO,1,CHI,5,2,2,0,0,0,12.66666667,0,2,1,4,0,2,3,4,0,0,4,7,7,9,10.4
2023-24,202401310CHO,1/31/2024,CHO vs CHI,Leaky Black,blackle01,17,CHO,1,CHI,3,1,1,1,0,0,12.98333333,0,1,1,2,1,2,0,0,1,1,2,4,4,5,8.7
2023-24,202401310POR,1/31/2024,POR vs MIL,Duop Reath,reathdu01,36,POR,1,MIL,10,4,1,1,0,1,13,2,2,4,6,2,2,0,0,3,1,5,11,14,15,18.3
2023-24,202401310WAS,1/31/2024,WAS vs LAC,Delon Wright,wrighde01,26,WAS,1,LAC,4,0,0,0,0,0,13.56666667,0,0,2,5,0,2,0,0,1,0,0,4,4,4,4
2023-24,202401310MIA,1/31/2024,MIA vs SAC,Kevin Love,loveke01,37,MIA,1,SAC,8,3,3,0,0,0,13.7,1,2,2,4,2,3,2,2,0,0,6,11,11,14,16.1
2023-24,202401310MIN,1/31/2024,MIN vs DAL,Jordan McLaughlin,mclaujo01,27,MIN,1,DAL,0,3,5,3,0,0,13.8,1,2,0,3,0,2,0,0,0,3,8,5,3,8,20.1
2023-24,202401310MIN,1/31/2024,MIN vs DAL,Dwight Powell,poweldw01,41,DAL,0,MIN,1,2,3,0,0,4,14.1,1,1,0,0,0,0,1,4,3,0,5,4,3,6,3.9
2023-24,202401310MIA,1/31/2024,MIA vs SAC,Malik Monk,monkma01,45,SAC,0,MIA,6,0,0,0,0,3,14.28333333,0,0,3,8,0,4,0,0,2,0,0,6,6,6,3
2023-24,202401310HOU,1/31/2024,HOU vs NOP,Jose Alvarado,alvarjo01,30,NOP,0,HOU,7,1,0,0,0,0,14.3,0,1,2,3,2,3,1,2,3,0,1,7,8,8,8.2
2023-24,202401310POR,1/31/2024,POR vs MIL,Pat Connaughton,connapa01,42,MIL,0,POR,0,1,0,1,0,1,14.43333333,0,1,0,0,0,0,0,0,2,1,1,0,1,1,3.2
2023-24,202401310HOU,1/31/2024,HOU vs NOP,Jeff Green,greenje02,45,HOU,1,NOP,0,0,1,0,0,0,14.58333333,0,0,0,3,0,2,0,0,3,0,1,1,0,1,1.5
2023-24,202401310CHO,1/31/2024,CHO vs CHI,Andre Drummond,drumman01,49,CHI,0,CHO,10,8,1,0,0,0,15.21666667,3,5,5,8,0,0,0,1,2,0,9,11,18,19,21.1
2023-24,202401310SAS,1/31/2024,SAS vs ORL,Joe Ingles,inglejo01,34,ORL,0,SAS,0,4,2,1,0,2,15.23333333,0,4,0,2,0,2,0,0,2,1,6,2,4,6,8.8
2023-24,202401310SAS,1/31/2024,SAS vs ORL,Malaki Branham,branhma01,43,SAS,1,ORL,4,4,2,0,0,1,15.41666667,1,3,2,4,0,1,0,0,0,0,6,6,8,10,10.8
2023-24,202401310MIN,1/31/2024,MIN vs DAL,A.J. Lawson,lawsoaj01,22,DAL,0,MIN,3,2,1,0,1,0,15.45,1,1,1,5,0,2,1,2,2,1,3,4,5,6,9.9
2023-24,202401310HOU,1/31/2024,HOU vs NOP,Larry Nance Jr.,nancela02,31,NOP,0,HOU,0,5,3,1,0,0,15.48333333,1,4,0,3,0,2,0,0,3,1,8,3,5,8,13.5
2023-24,202401310MIN,1/31/2024,MIN vs DAL,Kyle Anderson,anderky01,48,MIN,1,DAL,5,3,3,0,0,1,15.71666667,1,2,2,2,0,0,1,2,0,0,6,8,8,11,12.1
2023-24,202401310SAS,1/31/2024,SAS vs ORL,Moritz Wagner,wagnemo01,46,ORL,0,SAS,10,4,1,0,1,2,15.73333333,1,3,5,9,0,0,0,0,2,1,5,11,14,15,17.3
2023-24,202401310CHO,1/31/2024,CHO vs CHI,Ish Smith,smithis01,39,CHO,1,CHI,3,0,2,0,0,0,15.93333333,0,0,1,3,1,1,0,0,2,0,2,5,3,5,6
2023-24,202401310CLE,1/31/2024,CLE vs DET,Monte Morris,morrimo01,4,DET,0,CLE,8,2,2,0,0,1,16.25,0,2,4,8,0,2,0,0,0,0,4,10,10,12,12.4
2023-24,202401310MIA,1/31/2024,MIA vs SAC,Haywood Highsmith,highsha01,34,MIA,1,SAC,4,2,1,0,0,1,16.33333333,1,1,2,4,0,1,0,0,1,0,3,5,6,7,6.9
2023-24,202401310SAS,1/31/2024,SAS vs ORL,Cole Anthony,anthoco01,47,ORL,0,SAS,11,3,2,0,0,1,16.38333333,0,3,3,7,1,3,4,4,1,0,5,13,14,16,16.6
2023-24,202401310CLE,1/31/2024,CLE vs DET,Sam Merrill,merrisa01,30,CLE,1,DET,11,2,1,1,0,0,16.38333333,0,2,4,6,3,5,0,0,1,1,3,12,13,14,17.9
2023-24,202401310OKC,1/31/2024,OKC vs DEN,Christian Braun,braunch01,49,DEN,0,OKC,10,5,0,1,0,0,16.45,1,4,4,7,2,4,0,0,0,1,5,10,15,15,19
2023-24,202401310POR,1/31/2024,POR vs MIL,Jabari Walker,walkeja01,44,POR,1,MIL,8,5,2,1,0,1,16.45,1,4,3,4,1,2,1,1,3,1,7,10,13,15,19
2023-24,202401310OKC,1/31/2024,OKC vs DEN,Vasilije Micic,micicva01,27,OKC,1,DEN,12,2,5,0,0,2,16.68333333,0,2,4,8,1,3,3,5,0,0,7,17,14,19,19.9
2023-24,202401310SAS,1/31/2024,SAS vs ORL,Anthony Black,blackan01,45,ORL,0,SAS,2,0,1,0,0,0,16.7,0,0,0,0,0,0,2,2,2,0,1,3,2,3,3.5
2023-24,202401310MIN,1/31/2024,MIN vs DAL,Seth Curry,curryse01,36,DAL,0,MIN,9,3,3,0,0,2,16.83333333,1,2,3,8,0,3,3,3,0,0,6,12,12,15,15.1
2023-24,202401310OKC,1/31/2024,OKC vs DEN,Kenrich Williams,willike04,37,OKC,1,DEN,0,5,0,0,0,0,16.98333333,3,2,0,1,0,0,0,0,2,0,5,0,5,5,6
2023-24,202401310HOU,1/31/2024,HOU vs NOP,Amen Thompson,thompam01,28,HOU,1,NOP,10,6,0,1,0,0,17.16666667,2,4,3,6,0,1,4,4,3,1,6,10,16,16,20.2
2023-24,202401310CLE,1/31/2024,CLE vs DET,Georges Niang,niangge01,45,CLE,1,DET,4,2,5,0,0,0,17.41666667,0,2,2,4,0,0,0,0,0,0,7,9,6,11,13.9
2023-24,202401310HOU,1/31/2024,HOU vs NOP,Aaron Holiday,holidaa01,44,HOU,1,NOP,0,1,1,0,0,0,17.46666667,1,0,0,4,0,4,0,0,1,0,2,1,1,2,2.7
2023-24,202401310CLE,1/31/2024,CLE vs DET,Ausar Thompson,thompau01,47,DET,0,CLE,4,6,2,2,0,2,17.7,1,5,2,3,0,1,0,0,0,2,8,6,10,12,18.2
2023-24,202401310MIA,1/31/2024,MIA vs SAC,Trey Lyles,lylestr01,32,SAC,0,MIA,5,4,2,1,0,0,17.8,2,2,2,6,1,4,0,0,1,1,6,7,9,11,15.8
2023-24,202401310WAS,1/31/2024,WAS vs LAC,Marvin Bagley III,baglema01,34,WAS,1,LAC,10,8,2,0,0,1,17.95,3,5,5,7,0,0,0,0,1,0,10,12,18,20,21.6
2023-24,202401310MIN,1/31/2024,MIN vs DAL,Maxi Kleber,klebima01,13,DAL,0,MIN,3,2,0,0,1,2,18.06666667,0,2,1,2,1,1,0,0,5,1,2,3,5,5,6.4
2023-24,202401310BRK,1/31/2024,BRK vs PHO,Drew Eubanks,eubandr01,42,PHO,0,BRK,6,6,2,0,1,0,18.21666667,0,6,3,4,0,0,0,2,1,1,8,8,12,14,19.2
2023-24,202401310SAS,1/31/2024,SAS vs ORL,Dominick Barlow,barlodo01,22,SAS,1,ORL,7,5,0,1,1,0,18.26666667,1,4,3,3,0,0,1,2,1,2,5,7,12,12,19
2023-24,202401310SAS,1/31/2024,SAS vs ORL,Jonathan Isaac,isaacjo01,30,ORL,0,SAS,8,4,0,0,4,1,18.26666667,2,2,4,7,0,0,0,0,1,4,4,8,12,12,23.8
2023-24,202401310OKC,1/31/2024,OKC vs DEN,Jaylin Williams,willija07,40,OKC,1,DEN,9,3,2,0,1,1,18.48333333,1,2,4,6,1,2,0,0,1,1,5,11,12,14,17.6
2023-24,202401310POR,1/31/2024,POR vs MIL,Jae Crowder,crowdja01,17,MIL,0,POR,6,5,2,0,1,0,18.53333333,2,3,2,6,1,5,1,2,1,1,7,8,11,13,18
2023-24,202401310BRK,1/31/2024,BRK vs PHO,Dennis Smith Jr.,smithde03,32,BRK,1,PHO,4,5,2,1,0,0,18.6,3,2,2,5,0,1,0,0,2,1,7,6,9,11,16
2023-24,202401310POR,1/31/2024,POR vs MIL,Matisse Thybulle,thybuma01,46,POR,1,MIL,6,3,1,1,0,0,18.75,1,2,2,6,2,6,0,0,2,1,4,7,9,10,14.1
2023-24,202401310BRK,1/31/2024,BRK vs PHO,Keita Bates-Diop,bateske01,37,PHO,0,BRK,5,4,1,0,0,1,18.85,2,2,2,2,1,1,0,0,0,0,5,6,9,10,10.3
2023-24,202401310WAS,1/31/2024,WAS vs LAC,Mason Plumlee,plumlma01,16,LAC,0,WAS,5,11,1,0,0,1,19.35,5,6,2,5,0,0,1,1,2,0,12,6,16,17,18.7
2023-24,202401310WAS,1/31/2024,WAS vs LAC,Daniel Theis,theisda01,36,LAC,0,WAS,4,2,0,1,1,0,19.5,1,1,2,5,0,1,0,0,3,2,2,4,6,6,12.4
2023-24,202401310MIN,1/31/2024,MIN vs DAL,Olivier-Maxence Prosper,prospol01,25,DAL,0,MIN,6,4,0,0,0,0,19.73333333,1,3,1,2,0,1,4,7,1,0,4,6,10,10,10.8
2023-24,202401310CLE,1/31/2024,CLE vs DET,Kevin Knox,knoxke01,29,DET,0,CLE,12,5,0,0,0,2,19.81666667,2,3,5,9,1,3,1,1,1,0,5,12,17,17,16
2023-24,202401310SAS,1/31/2024,SAS vs ORL,Julian Champagnie,champju02,41,SAS,1,ORL,0,1,1,2,0,1,20.03333333,0,1,0,4,0,2,0,0,1,2,2,1,1,2,7.7
2023-24,202401310OKC,1/31/2024,OKC vs DEN,Cason Wallace,wallaca01,48,OKC,1,DEN,5,2,1,0,0,0,20.16666667,1,1,2,7,1,3,0,0,3,0,3,6,7,8,8.9
2023-24,202401310HOU,1/31/2024,HOU vs NOP,Cam Whitmore,whitmca01,24,HOU,1,NOP,17,0,0,1,0,0,20.23333333,0,0,6,12,3,7,2,3,1,1,0,17,17,17,20
2023-24,202401310CHO,1/31/2024,CHO vs CHI,Terry Taylor,taylote01,17,CHI,0,CHO,3,6,2,1,0,0,20.33333333,1,5,1,4,1,2,0,0,0,1,8,5,9,11,16.2
2023-24,202401310CLE,1/31/2024,CLE vs DET,Darius Garland,garlada01,21,CLE,1,DET,19,0,3,2,0,1,20.48333333,0,0,7,12,2,6,3,3,1,2,3,22,19,22,28.5
2023-24,202401310BRK,1/31/2024,BRK vs PHO,Royce O'Neale,onealro01,46,BRK,1,PHO,3,1,1,0,0,0,20.51666667,0,1,1,3,1,3,0,0,5,0,2,4,4,5,5.7
2023-24,202401310WAS,1/31/2024,WAS vs LAC,Amir Coffey,coffeam01,34,LAC,0,WAS,17,1,1,1,0,1,20.85,0,1,5,7,2,2,5,5,1,1,2,18,18,19,21.7
2023-24,202401310OKC,1/31/2024,OKC vs DEN,Peyton Watson,watsope01,47,DEN,0,OKC,9,4,1,2,1,2,20.91666667,2,2,3,10,1,4,2,2,4,3,5,10,13,14,22.3
2023-24,202401310WAS,1/31/2024,WAS vs LAC,Russell Westbrook,westbru01,46,LAC,0,WAS,9,3,7,0,0,0,21.08333333,2,1,4,11,0,1,1,2,0,0,10,16,12,19,23.1
2023-24,202401310HOU,1/31/2024,HOU vs NOP,Jabari Smith Jr.,smithja05,42,HOU,1,NOP,0,1,0,1,0,0,21.8,0,1,0,6,0,4,0,0,2,1,1,0,1,1,4.2
2023-24,202401310POR,1/31/2024,POR vs MIL,Scoot Henderson,hendesc01,39,POR,1,MIL,15,0,4,0,0,2,22,0,0,6,11,1,2,2,2,1,0,4,19,15,19,19
2023-24,202401310POR,1/31/2024,POR vs MIL,Bobby Portis,portibo01,48,MIL,0,POR,11,6,0,0,0,1,22.06666667,2,4,5,7,1,2,0,0,0,0,6,11,17,17,17.2
2023-24,202401310WAS,1/31/2024,WAS vs LAC,Daniel Gafford,gaffoda01,42,WAS,1,LAC,6,8,2,1,5,1,22.45,4,4,2,5,0,0,2,2,3,6,10,8,14,16,35.6
2023-24,202401310CLE,1/31/2024,CLE vs DET,Evan Mobley,mobleev01,23,CLE,1,DET,8,3,4,1,0,0,22.45,1,2,3,7,0,1,2,2,2,1,7,12,11,15,20.6
2023-24,202401310CLE,1/31/2024,CLE vs DET,Danilo Gallinari,gallida01,29,DET,0,CLE,20,3,2,1,0,0,22.6,0,3,6,8,4,4,4,5,1,1,5,22,23,25,29.6
2023-24,202401310POR,1/31/2024,POR vs MIL,Toumani Camara,camarto01,47,POR,1,MIL,4,4,2,2,0,0,22.71666667,1,3,2,3,0,0,0,0,2,2,6,6,8,10,17.8
2023-24,202401310MIN,1/31/2024,MIN vs DAL,Nickeil Alexander-Walker,alexani01,48,MIN,1,DAL,9,0,3,0,0,0,23.05,0,0,3,7,1,5,2,2,5,0,3,12,9,12,13.5
2023-24,202401310HOU,1/31/2024,HOU vs NOP,Jordan Hawkins,hawkijo01,43,NOP,0,HOU,3,6,2,0,0,1,23.46666667,2,4,1,5,1,4,0,0,1,0,8,5,9,11,12.2
2023-24,202401310HOU,1/31/2024,HOU vs NOP,Dyson Daniels,daniedy01,48,NOP,0,HOU,9,2,3,1,0,2,23.73333333,0,2,4,6,1,3,0,0,2,1,5,12,11,14,16.9
2023-24,202401310MIN,1/31/2024,MIN vs DAL,Jaden McDaniels,mcdanja02,38,MIN,1,DAL,11,2,4,0,0,1,24.05,1,1,5,10,0,4,1,1,4,0,6,15,13,17,18.4
2023-24,202401310CHO,1/31/2024,CHO vs CHI,Nick Richards,richani01,37,CHO,1,CHI,10,6,1,0,1,0,24.53333333,3,3,3,4,0,0,4,4,5,1,7,11,16,17,21.7
2023-24,202401310CLE,1/31/2024,CLE vs DET,Caris LeVert,leverca01,35,CLE,1,DET,11,1,4,1,2,2,24.75,0,1,3,8,1,4,4,4,0,3,5,15,12,16,25.2
2023-24,202401310OKC,1/31/2024,OKC vs DEN,Aaron Wiggins,wiggiaa01,45,OKC,1,DEN,12,4,2,0,0,0,24.85,1,3,5,8,2,3,0,0,2,0,6,14,16,18,19.8
2023-24,202401310MIA,1/31/2024,MIA vs SAC,Jaime Jaquez Jr.,jaqueja01,42,MIA,1,SAC,8,4,1,0,0,2,24.93333333,0,4,3,9,0,1,2,2,2,0,5,9,12,13,12.3
2023-24,202401310OKC,1/31/2024,OKC vs DEN,Josh Giddey,giddejo01,47,OKC,1,DEN,8,9,5,0,1,2,25.23333333,3,6,2,11,0,2,4,4,0,1,14,13,17,22,27.3
2023-24,202401310MIN,1/31/2024,MIN vs DAL,Mike Conley,conlemi01,43,MIN,1,DAL,10,4,3,1,1,1,25.3,0,4,4,6,2,3,0,0,2,2,7,13,14,17,24.3
2023-24,202401310MIN,1/31/2024,MIN vs DAL,Grant Williams,willigr01,44,DAL,0,MIN,2,1,1,1,0,1,25.31666667,1,0,1,7,0,3,0,0,3,1,2,3,3,4,6.7
2023-24,202401310BRK,1/31/2024,BRK vs PHO,Josh Okogie,okogijo01,42,PHO,0,BRK,11,7,1,1,0,0,25.66666667,1,6,4,6,1,3,2,3,1,1,8,12,18,19,23.9
2023-24,202401310MIN,1/31/2024,MIN vs DAL,Naz Reid,reidna01,48,MIN,1,DAL,12,8,2,1,1,0,26.01666667,1,7,4,10,3,5,1,4,3,2,10,14,20,22,30.6
2023-24,202401310WAS,1/31/2024,WAS vs LAC,Deni Avdija,avdijde01,47,WAS,1,LAC,13,5,3,1,1,2,26.33333333,0,5,5,11,1,2,2,3,2,2,8,16,18,21,27.5
2023-24,202401310SAS,1/31/2024,SAS vs ORL,Wendell Carter Jr.,cartewe01,22,ORL,0,SAS,14,5,2,0,0,1,26.35,3,2,3,7,1,3,7,8,4,0,7,16,19,21,22
2023-24,202401310WAS,1/31/2024,WAS vs LAC,Norman Powell,powelno01,46,LAC,0,WAS,14,7,3,0,0,2,26.95,1,6,5,10,3,5,1,2,1,0,10,17,21,24,24.9
2023-24,202401310WAS,1/31/2024,WAS vs LAC,Corey Kispert,kispeco01,46,WAS,1,LAC,16,2,1,0,0,1,26.98333333,0,2,6,11,3,8,1,2,1,0,3,17,18,19,18.9
2023-24,202401310WAS,1/31/2024,WAS vs LAC,Brandon Boston Jr.,bostobr01,12,LAC,0,WAS,12,3,1,1,1,0,27.15,1,2,5,11,1,2,1,2,2,2,4,13,15,16,23.1
2023-24,202401310MIA,1/31/2024,MIA vs SAC,Josh Richardson,richajo01,38,MIA,1,SAC,24,5,3,0,1,0,27.28333333,0,5,9,15,6,10,0,0,2,1,8,27,29,32,37.5
2023-24,202401310HOU,1/31/2024,HOU vs NOP,Trey Murphy III,murphtr02,23,NOP,0,HOU,13,6,1,0,0,1,27.41666667,1,5,5,12,3,10,0,0,1,0,7,14,19,20,20.7
2023-24,202401310SAS,1/31/2024,SAS vs ORL,Cedi Osman,osmande01,48,SAS,1,ORL,8,2,3,0,0,2,27.85,0,2,3,8,2,6,0,0,4,0,5,11,10,13,12.9
2023-24,202401310CHO,1/31/2024,CHO vs CHI,Cody Martin,martico01,16,CHO,1,CHI,7,1,6,0,0,3,28.01666667,0,1,3,10,1,2,0,1,3,0,7,13,8,14,14.2
2023-24,202401310MIA,1/31/2024,MIA vs SAC,Caleb Martin,martica02,31,MIA,1,SAC,7,3,2,0,0,1,28.08333333,0,3,3,7,0,2,1,1,3,0,5,9,10,12,12.6
2023-24,202401310MIN,1/31/2024,MIN vs DAL,Rudy Gobert,goberru01,47,MIN,1,DAL,17,6,0,0,2,2,28.1,2,4,5,9,0,0,7,12,4,2,6,17,23,23,28.2
2023-24,202401310CLE,1/31/2024,CLE vs DET,Jaden Ivey,iveyja01,43,DET,0,CLE,14,1,4,2,1,4,28.6,0,1,5,7,2,3,2,3,5,3,5,18,15,19,26.2
2023-24,202401310POR,1/31/2024,POR vs MIL,Malik Beasley,beaslma01,46,MIL,0,POR,7,6,1,1,0,0,28.95,0,6,3,8,1,6,0,0,3,1,7,8,13,14,18.7
2023-24,202401310WAS,1/31/2024,WAS vs LAC,Tyus Jones,jonesty01,47,WAS,1,LAC,4,4,7,0,0,3,28.98333333,0,4,2,9,0,3,0,0,1,0,11,11,8,15,16.3
2023-24,202401310MIN,1/31/2024,MIN vs DAL,Josh Green,greenjo02,35,DAL,0,MIN,18,2,1,0,0,1,29.11666667,0,2,8,13,2,3,0,0,4,0,3,19,20,21,20.9
2023-24,202401310WAS,1/31/2024,WAS vs LAC,Kyle Kuzma,kuzmaky01,47,WAS,1,LAC,27,2,0,0,1,2,29.33333333,0,2,11,22,2,4,3,3,2,1,2,27,29,29,30.4
2023-24,202401310BRK,1/31/2024,BRK vs PHO,Cameron Johnson,johnsca02,38,BRK,1,PHO,18,2,1,2,1,3,29.46666667,0,2,6,12,3,7,3,3,3,3,3,19,20,21,27.9
2023-24,202401310MIA,1/31/2024,MIA vs SAC,Terry Rozier,roziete01,35,MIA,1,SAC,3,5,10,2,1,1,29.51666667,1,4,1,8,1,4,0,0,1,3,15,13,8,18,32
2023-24,202401310BRK,1/31/2024,BRK vs PHO,Spencer Dinwiddie,dinwisp01,45,BRK,1,PHO,16,2,5,0,0,0,29.6,0,2,6,10,2,4,2,3,1,0,7,21,18,23,25.9
2023-24,202401310OKC,1/31/2024,OKC vs DEN,Reggie Jackson,jacksre01,49,DEN,0,OKC,16,4,3,0,1,1,29.7,0,4,5,12,2,3,4,4,2,1,7,19,20,23,27.3
2023-24,202401310CLE,1/31/2024,CLE vs DET,Alec Burks,burksal01,40,DET,0,CLE,11,4,6,0,1,2,29.78333333,0,4,3,5,1,3,4,4,2,1,10,17,15,21,25.8
2023-24,202401310BRK,1/31/2024,BRK vs PHO,Jusuf Nurkic,nurkiju01,45,PHO,0,BRK,28,11,6,1,2,6,29.78333333,5,6,11,15,0,0,6,9,2,3,17,34,39,45,53.2
2023-24,202401310CLE,1/31/2024,CLE vs DET,Isaac Okoro,okorois01,36,CLE,1,DET,14,3,0,4,0,0,29.78333333,2,1,6,8,0,0,2,2,1,4,3,14,17,17,29.6
2023-24,202401310WAS,1/31/2024,WAS vs LAC,Kawhi Leonard,leonaka01,42,LAC,0,WAS,31,9,4,4,1,0,29.9,4,5,14,25,1,4,2,2,1,5,13,35,40,44,62.8
2023-24,202401310MIN,1/31/2024,MIN vs DAL,Anthony Edwards,edwaran01,45,MIN,1,DAL,9,5,5,0,0,2,29.93333333,0,5,3,5,1,2,2,2,1,0,10,14,14,19,20.5
2023-24,202401310SAS,1/31/2024,SAS vs ORL,Victor Wembanyama,wembavi01,42,SAS,1,ORL,21,8,3,2,5,3,30.18333333,0,8,7,15,2,5,5,5,3,7,11,24,29,32,53.1
2023-24,202401310MIN,1/31/2024,MIN vs DAL,Richaun Holmes,holmeri01,22,DAL,0,MIN,11,10,3,0,2,0,30.25,4,6,4,6,0,0,3,3,4,2,13,14,21,24,33.5
2023-24,202401310BRK,1/31/2024,BRK vs PHO,Nic Claxton,claxtni01,37,BRK,1,PHO,12,9,4,1,0,1,30.26666667,1,8,6,12,0,0,0,0,3,1,13,16,21,25,30.8
2023-24,202401310CLE,1/31/2024,CLE vs DET,Bojan Bogdanovic,bogdabo02,26,DET,0,CLE,17,2,0,1,0,4,30.3,0,2,5,12,4,8,3,4,1,1,2,17,19,19,18.4
2023-24,202401310CLE,1/31/2024,CLE vs DET,Jarrett Allen,allenja01,40,CLE,1,DET,14,11,0,1,1,1,30.4,5,6,7,10,0,0,0,0,2,2,11,14,25,25,32.2
2023-24,202401310CLE,1/31/2024,CLE vs DET,Jalen Duren,durenja01,32,DET,0,CLE,10,9,0,0,0,2,30.4,4,5,5,9,0,0,0,0,1,0,9,10,19,19,18.8
2023-24,202401310SAS,1/31/2024,SAS vs ORL,Markelle Fultz,fultzma01,15,ORL,0,SAS,11,7,4,2,0,0,30.5,3,4,5,11,0,0,1,2,0,2,11,15,18,22,31.4
2023-24,202401310BRK,1/31/2024,BRK vs PHO,Lonnie Walker IV,walkelo01,29,BRK,1,PHO,19,3,7,4,0,2,30.58333333,1,2,7,16,3,8,2,2,4,4,10,26,22,29,43.1
2023-24,202401310WAS,1/31/2024,WAS vs LAC,Terance Mann,mannte01,40,LAC,0,WAS,6,3,2,0,0,0,30.61666667,1,2,2,6,0,3,2,2,1,0,5,8,9,11,12.6
2023-24,202401310CLE,1/31/2024,CLE vs DET,Cade Cunningham,cunnica01,38,DET,0,CLE,19,2,7,2,1,0,30.73333333,0,2,8,16,2,4,1,2,4,3,9,26,21,28,40.9
2023-24,202401310CLE,1/31/2024,CLE vs DET,Max Strus,strusma01,45,CLE,1,DET,2,4,1,1,0,2,30.76666667,0,4,1,6,0,4,0,0,4,1,5,3,6,7,9.3
2023-24,202401310HOU,1/31/2024,HOU vs NOP,Naji Marshall,marshna01,39,NOP,0,HOU,10,7,2,0,1,0,31.01666667,0,7,3,4,1,1,3,4,2,1,9,12,17,19,24.4
2023-24,202401310MIN,1/31/2024,MIN vs DAL,Jaden Hardy,hardyja02,43,DAL,0,MIN,15,2,2,1,0,5,31.16666667,0,2,6,14,1,5,2,2,2,1,4,17,17,19,18.4
2023-24,202401310MIN,1/31/2024,MIN vs DAL,Karl-Anthony Towns,townska01,47,MIN,1,DAL,29,9,4,1,0,3,31.16666667,2,7,11,15,4,6,3,5,2,1,13,33,38,42,45.8
2023-24,202401310HOU,1/31/2024,HOU vs NOP,Dillon Brooks,brookdi01,38,HOU,1,NOP,13,3,1,0,0,0,31.25,0,3,4,11,3,7,2,2,4,0,4,14,16,17,18.1
2023-24,202401310MIA,1/31/2024,MIA vs SAC,Tyler Herro,herroty01,29,MIA,1,SAC,14,8,8,0,0,2,31.28333333,1,7,4,9,2,4,4,6,1,0,16,22,22,30,33.6
2023-24,202401310MIA,1/31/2024,MIA vs SAC,Bam Adebayo,adebaba01,38,MIA,1,SAC,16,11,4,0,0,0,31.61666667,2,9,8,14,0,0,0,0,4,0,15,20,27,31,35.2
2023-24,202401310MIN,1/31/2024,MIN vs DAL,Tim Hardaway Jr.,hardati02,45,DAL,0,MIN,14,3,2,2,0,1,31.7,0,3,5,16,2,10,2,2,0,2,5,16,17,19,25.6
2023-24,202401310BRK,1/31/2024,BRK vs PHO,Eric Gordon,gordoer01,40,PHO,0,BRK,17,2,4,1,0,0,32.01666667,0,2,6,10,5,9,0,0,1,1,6,21,19,23,28.4
2023-24,202401310OKC,1/31/2024,OKC vs DEN,Chet Holmgren,holmgch01,48,OKC,1,DEN,18,13,3,0,5,2,32.11666667,5,8,7,13,3,4,1,2,0,5,16,21,31,34,51.1
2023-24,202401310SAS,1/31/2024,SAS vs ORL,Jalen Suggs,suggsja01,44,ORL,0,SAS,7,1,5,4,0,1,32.51666667,0,1,3,9,1,4,0,0,3,4,6,12,8,13,26.7
2023-24,202401310HOU,1/31/2024,HOU vs NOP,Jonas Valanciunas,valanjo01,48,NOP,0,HOU,25,14,2,0,1,3,32.51666667,4,10,10,15,0,1,5,9,5,1,16,27,39,41,44.8
2023-24,202401310WAS,1/31/2024,WAS vs LAC,James Harden,hardeja01,41,LAC,0,WAS,25,9,5,2,4,2,32.55,1,8,7,15,5,10,6,6,2,6,14,30,34,39,59.3
2023-24,202401310SAS,1/31/2024,SAS vs ORL,Franz Wagner,wagnefr01,40,ORL,0,SAS,20,8,5,1,0,6,32.66666667,1,7,9,16,2,4,0,0,4,1,13,25,28,33,34.1
2023-24,202401310CHO,1/31/2024,CHO vs CHI,Nikola Vucevic,vucevni01,44,CHI,0,CHO,22,12,3,0,2,0,32.78333333,3,9,10,22,1,4,1,2,0,2,15,25,34,37,46.9
2023-24,202401310SAS,1/31/2024,SAS vs ORL,Jeremy Sochan,sochaje01,48,SAS,1,ORL,18,12,2,0,2,5,33.01666667,4,8,8,13,1,3,1,1,5,2,14,20,30,32,36.4
2023-24,202401310BRK,1/31/2024,BRK vs PHO,Cam Thomas,thomaca02,38,BRK,1,PHO,25,2,4,2,0,2,33.2,2,0,11,19,1,4,2,2,2,2,6,29,27,31,37.4
2023-24,202401310HOU,1/31/2024,HOU vs NOP,Alperen Sengun,sengual01,47,HOU,1,NOP,10,10,5,2,0,2,33.51666667,2,8,4,11,0,1,2,2,3,2,15,15,20,25,33.5
2023-24,202401310CHO,1/31/2024,CHO vs CHI,Alex Caruso,carusal01,42,CHI,0,CHO,10,5,3,0,3,0,33.68333333,2,3,4,7,2,4,0,0,2,3,8,13,15,18,29.5
2023-24,202401310POR,1/31/2024,POR vs MIL,Khris Middleton,middlkh01,41,MIL,0,POR,21,2,8,0,1,1,34.06666667,0,2,9,13,3,5,0,0,3,1,10,29,23,31,37.4
2023-24,202401310MIA,1/31/2024,MIA vs SAC,Jimmy Butler,butleji01,33,MIA,1,SAC,31,7,6,1,0,1,34.56666667,1,6,10,14,2,3,9,12,2,1,13,37,38,44,50.4
2023-24,202401310SAS,1/31/2024,SAS vs ORL,Tre Jones,jonestr01,43,SAS,1,ORL,8,3,8,3,0,1,34.58333333,1,2,2,5,1,1,3,4,4,3,11,16,11,19,31.6
2023-24,202401310POR,1/31/2024,POR vs MIL,Deandre Ayton,aytonde01,32,POR,1,MIL,20,11,1,1,1,1,35,3,8,10,17,0,0,0,0,3,2,12,21,31,32,39.7
2023-24,202401310CLE,1/31/2024,CLE vs DET,Donovan Mitchell,mitchdo01,36,CLE,1,DET,45,6,8,2,1,2,35.35,2,4,14,25,6,13,11,12,2,3,14,53,51,59,71.2
2023-24,202401310OKC,1/31/2024,OKC vs DEN,Shai Gilgeous-Alexander,gilgesh01,47,OKC,1,DEN,34,7,5,1,2,2,35.55,1,6,10,22,2,3,12,13,4,3,12,39,41,46,56.9
2023-24,202401310SAS,1/31/2024,SAS vs ORL,Paolo Banchero,banchpa01,48,ORL,0,SAS,25,9,7,2,0,1,35.65,2,7,9,18,2,4,5,7,1,2,16,32,34,41,51.3
2023-24,202401310POR,1/31/2024,POR vs MIL,Malcolm Brogdon,brogdma01,38,POR,1,MIL,14,6,6,1,0,3,35.73333333,1,5,5,12,2,6,2,2,3,1,12,20,20,26,30.2
2023-24,202401310CHO,1/31/2024,CHO vs CHI,P.J. Washington,washipj01,40,CHO,1,CHI,26,8,1,0,1,3,35.9,3,5,10,17,3,9,3,4,3,1,9,27,34,35,37.1
2023-24,202401310HOU,1/31/2024,HOU vs NOP,CJ McCollum,mccolcj01,34,NOP,0,HOU,19,5,3,1,2,3,35.91666667,0,5,7,15,3,7,2,2,1,3,8,22,24,27,35.5
2023-24,202401310BRK,1/31/2024,BRK vs PHO,Devin Booker,bookede01,39,PHO,0,BRK,22,3,8,2,1,2,36.05,0,3,9,17,4,6,0,0,5,3,11,30,25,33,44.6
2023-24,202401310HOU,1/31/2024,HOU vs NOP,Brandon Ingram,ingrabr01,44,NOP,0,HOU,24,10,4,0,2,6,36.15,4,6,9,19,0,3,6,7,4,2,14,28,34,38,42
2023-24,202401310POR,1/31/2024,POR vs MIL,Brook Lopez,lopezbr01,48,MIL,0,POR,19,4,3,1,2,0,36.18333333,0,4,7,14,4,10,1,1,1,3,7,22,23,26,37.3
2023-24,202401310OKC,1/31/2024,OKC vs DEN,Kentavious Caldwell-Pope,caldwke01,47,DEN,0,OKC,11,6,3,1,0,3,36.26666667,1,5,3,10,3,9,2,2,4,1,9,14,17,20,22.7
2023-24,202401310OKC,1/31/2024,OKC vs DEN,Luguentz Dort,dortlu01,46,OKC,1,DEN,7,7,1,1,0,1,36.46666667,0,7,3,11,1,6,0,1,2,1,8,8,14,15,18.9
2023-24,202401310BRK,1/31/2024,BRK vs PHO,Bradley Beal,bealbr01,24,PHO,0,BRK,12,4,5,0,0,3,36.5,1,3,3,8,1,3,5,6,1,0,9,17,16,21,21.3
2023-24,202401310MIA,1/31/2024,MIA vs SAC,Harrison Barnes,barneha02,46,SAC,0,MIA,9,5,1,0,0,1,36.85,2,3,4,13,0,6,1,2,1,0,6,10,14,15,15.5
2023-24,202401310MIA,1/31/2024,MIA vs SAC,De'Aaron Fox,foxde01,40,SAC,0,MIA,13,5,3,2,0,2,36.86666667,0,5,4,16,1,8,4,6,3,2,8,16,18,21,27.5
2023-24,202401310WAS,1/31/2024,WAS vs LAC,Bilal Coulibaly,coulibi01,46,WAS,1,LAC,19,4,2,1,2,1,37,2,2,8,16,1,4,2,3,2,3,6,21,23,25,34.8
2023-24,202401310SAS,1/31/2024,SAS vs ORL,Devin Vassell,vassede01,43,SAS,1,ORL,26,4,4,0,1,1,37.03333333,0,4,8,18,3,8,7,10,1,1,8,30,30,34,38.8
2023-24,202401310HOU,1/31/2024,HOU vs NOP,Fred VanVleet,vanvlfr01,45,HOU,1,NOP,16,3,5,2,0,0,37.23333333,0,3,6,12,2,6,2,2,1,2,8,21,19,24,33.1
2023-24,202401310CHO,1/31/2024,CHO vs CHI,DeMar DeRozan,derozde01,47,CHI,0,CHO,15,4,3,0,1,2,37.51666667,0,4,4,10,1,2,6,8,2,1,7,18,19,22,25.3
2023-24,202401310BRK,1/31/2024,BRK vs PHO,Kevin Durant,duranke01,41,PHO,0,BRK,33,5,8,0,2,3,37.58333333,0,5,10,16,2,6,11,12,1,2,13,41,38,46,54
2023-24,202401310POR,1/31/2024,POR vs MIL,Giannis Antetokounmpo,antetgi01,46,MIL,0,POR,27,8,4,3,1,6,37.76666667,3,5,10,16,0,2,7,11,5,4,12,31,35,39,48.6
2023-24,202401310POR,1/31/2024,POR vs MIL,Jerami Grant,grantje01,43,POR,1,MIL,18,3,4,2,0,0,37.86666667,0,3,7,14,0,1,4,4,3,2,7,22,21,25,33.6
2023-24,202401310MIA,1/31/2024,MIA vs SAC,Domantas Sabonis,sabondo01,46,SAC,0,MIA,19,17,13,1,1,1,37.98333333,4,13,7,14,1,1,4,6,0,2,30,32,36,49,63.9
2023-24,202401310HOU,1/31/2024,HOU vs NOP,Jalen Green,greenja05,47,HOU,1,NOP,31,4,4,3,2,3,38.23333333,0,4,11,20,5,12,4,4,3,5,8,35,35,39,53.8
2023-24,202401310CHO,1/31/2024,CHO vs CHI,Brandon Miller,millebr02,40,CHO,1,CHI,21,1,3,1,0,2,38.4,0,1,8,21,3,10,2,2,2,1,4,24,22,25,27.7
2023-24,202401310MIA,1/31/2024,MIA vs SAC,Keegan Murray,murrake02,42,SAC,0,MIA,33,5,2,1,2,0,38.48333333,1,4,12,18,7,11,2,2,5,3,7,35,38,40,51
2023-24,202401310POR,1/31/2024,POR vs MIL,Anfernee Simons,simonan01,26,POR,1,MIL,24,3,5,0,0,3,38.48333333,0,3,10,19,4,9,0,0,0,0,8,29,27,32,32.1
2023-24,202401310OKC,1/31/2024,OKC vs DEN,Jamal Murray,murraja01,35,DEN,0,OKC,16,3,4,0,2,0,38.51666667,1,2,6,14,2,3,2,2,3,2,7,20,19,23,31.6
2023-24,202401310MIA,1/31/2024,MIA vs SAC,Kevin Huerter,huertke01,44,SAC,0,MIA,14,3,4,1,0,1,38.71666667,1,2,6,12,2,6,0,0,4,1,7,18,17,21,25.6
2023-24,202401310OKC,1/31/2024,OKC vs DEN,Michael Porter Jr.,portemi01,49,DEN,0,OKC,15,8,2,1,0,0,38.78333333,1,7,6,17,3,9,0,0,4,1,10,17,23,25,30.6
2023-24,202401310CHO,1/31/2024,CHO vs CHI,Ayo Dosunmu,dosunay01,47,CHI,0,CHO,16,1,6,3,1,1,38.85,0,1,7,10,2,5,0,0,3,4,7,22,17,23,37.2
2023-24,202401310OKC,1/31/2024,OKC vs DEN,Aaron Gordon,gordoaa01,43,DEN,0,OKC,16,13,7,1,4,1,39.23333333,4,9,7,16,1,3,1,6,2,5,20,23,29,36,56.1
2023-24,202401310BRK,1/31/2024,BRK vs PHO,Mikal Bridges,bridgmi01,47,BRK,1,PHO,21,3,2,1,0,2,39.85,1,2,7,16,6,12,1,3,2,1,5,23,24,26,28.6
2023-24,202401310POR,1/31/2024,POR vs MIL,Damian Lillard,lillada01,45,MIL,0,POR,25,6,7,1,0,4,39.88333333,2,4,9,23,3,13,4,4,2,1,13,32,31,38,41.7
2023-24,202401310CHO,1/31/2024,CHO vs CHI,Miles Bridges,bridgmi02,35,CHO,1,CHI,30,15,5,1,3,0,40.51666667,2,13,11,20,6,13,2,2,1,4,20,35,45,50,67.5
2023-24,202401310CHO,1/31/2024,CHO vs CHI,Coby White,whiteco01,49,CHI,0,CHO,35,7,9,0,0,3,43.05,1,6,12,22,4,10,7,9,0,0,16,44,42,51,53.9
2023-24,202401300ATL,1/30/2024,ATL vs LAL,Max Christie,chrisma02,40,LAL,0,ATL,5,1,0,0,1,1,10.75,0,1,2,2,1,1,0,0,1,1,1,5,6,6,8.2
2023-24,202401300GSW,1/30/2024,GSW vs PHI,Lester Quinones,quinole01,10,GSW,1,PHI,3,0,0,0,0,0,11.45,0,0,1,2,1,2,0,0,2,0,0,3,3,3,3
2023-24,202401300BOS,1/30/2024,BOS vs IND,Ben Sheppard,sheppbe01,27,IND,0,BOS,0,2,0,0,0,0,11.55,0,2,0,2,0,2,0,0,2,0,2,0,2,2,2.4
2023-24,202401300GSW,1/30/2024,GSW vs PHI,Trayce Jackson-Davis,jackstr02,33,GSW,1,PHI,6,4,0,0,0,0,12.25,2,2,3,5,0,0,0,0,0,0,4,6,10,10,10.8
2023-24,202401300NYK,1/30/2024,NYK vs UTA,Ochai Agbaji,agbajoc01,49,UTA,0,NYK,3,1,0,1,0,0,12.7,0,1,1,1,1,1,0,0,0,1,1,3,4,4,7.2
2023-24,202401300CHI,1/30/2024,CHI vs TOR,Jevon Carter,carteje01,46,CHI,1,TOR,3,0,2,0,0,0,13.23333333,0,0,1,5,1,3,0,0,1,0,2,5,3,5,6
2023-24,202401300GSW,1/30/2024,GSW vs PHI,Cory Joseph,josepco01,25,GSW,1,PHI,2,1,2,0,0,1,13.31666667,1,0,1,4,0,2,0,0,3,0,3,4,3,5,5.2
2023-24,202401300BOS,1/30/2024,BOS vs IND,Neemias Queta,quetane01,20,BOS,1,IND,4,1,1,0,2,1,14.01666667,0,1,2,3,0,0,0,1,1,2,2,5,5,6,11.7
2023-24,202401300CHI,1/30/2024,CHI vs TOR,Jalen McDaniels,mcdanja01,29,TOR,0,CHI,8,3,2,1,0,1,14.03333333,1,2,3,6,2,3,0,0,1,1,5,10,11,13,16.6
2023-24,202401300CHI,1/30/2024,CHI vs TOR,Andre Drummond,drumman01,48,CHI,1,TOR,7,7,0,1,1,0,14.1,3,4,3,4,0,0,1,2,0,2,7,7,14,14,21.4
2023-24,202401300NYK,1/30/2024,NYK vs UTA,Walker Kessler,kesslwa01,41,UTA,0,NYK,6,7,0,0,4,1,16.25,3,4,2,4,0,0,2,2,0,4,7,6,13,13,25.4
2023-24,202401300ATL,1/30/2024,ATL vs LAL,De'Andre Hunter,huntede01,25,ATL,1,LAL,6,1,1,0,0,2,16.4,0,1,2,5,2,5,0,0,0,0,2,7,7,8,6.7
2023-24,202401300BOS,1/30/2024,BOS vs IND,Payton Pritchard,pritcpa01,48,BOS,1,IND,3,4,3,0,0,0,16.5,1,3,1,4,1,3,0,0,2,0,7,6,7,10,12.3
2023-24,202401300GSW,1/30/2024,GSW vs PHI,Dario Saric,saricda01,44,GSW,1,PHI,2,2,7,0,1,1,16.76666667,0,2,0,2,0,1,2,2,3,1,9,9,4,11,16.9
2023-24,202401300NYK,1/30/2024,NYK vs UTA,Kris Dunn,dunnkr01,41,UTA,0,NYK,6,3,6,1,0,3,16.9,2,1,3,5,0,0,0,0,2,1,9,12,9,15,18.6
2023-24,202401300NYK,1/30/2024,NYK vs UTA,Jericho Sims,simsje01,24,NYK,1,UTA,2,4,0,0,0,0,18.56666667,3,1,1,2,0,0,0,0,0,0,4,2,6,6,6.8
2023-24,202401300CHI,1/30/2024,CHI vs TOR,Jordan Nwora,nworajo01,22,TOR,0,CHI,17,2,0,0,1,0,18.85,0,2,5,7,4,5,3,3,2,1,2,17,19,19,22.4
2023-24,202401300CHI,1/30/2024,CHI vs TOR,Gradey Dick,dickgr01,26,TOR,0,CHI,0,3,4,1,0,0,20.11666667,0,3,0,1,0,1,0,0,2,1,7,4,3,7,12.6
2023-24,202401300CHI,1/30/2024,CHI vs TOR,Julian Phillips,phillju01,24,CHI,1,TOR,9,1,0,0,0,2,20.11666667,0,1,3,4,2,3,1,1,2,0,1,9,10,10,8.2
2023-24,202401300NYK,1/30/2024,NYK vs UTA,Quentin Grimes,grimequ01,45,NYK,1,UTA,12,6,2,1,0,0,20.4,0,6,4,10,2,6,2,2,1,1,8,14,18,20,25.2
2023-24,202401300NYK,1/30/2024,NYK vs UTA,Kelly Olynyk,olynyke01,47,UTA,0,NYK,1,5,3,0,0,1,20.71666667,1,4,0,3,0,1,1,2,2,0,8,4,6,9,10.5
2023-24,202401300BOS,1/30/2024,BOS vs IND,Jalen Smith,smithja04,34,IND,0,BOS,7,4,2,0,0,0,20.83333333,2,2,2,6,0,3,3,3,2,0,6,9,11,13,14.8
2023-24,202401300GSW,1/30/2024,GSW vs PHI,Jaden Springer,sprinja01,28,PHI,0,GSW,10,5,2,4,0,1,21.03333333,0,5,4,7,1,3,1,1,4,4,7,12,15,17,30
2023-24,202401300BOS,1/30/2024,BOS vs IND,Obi Toppin,toppiob01,49,IND,0,BOS,11,8,2,0,0,2,21.71666667,3,5,5,11,1,4,0,0,1,0,10,13,19,21,21.6
2023-24,202401300BOS,1/30/2024,BOS vs IND,Tyrese Haliburton,halibty01,36,IND,0,BOS,13,3,10,1,0,1,22.06666667,3,0,5,16,1,5,2,2,1,1,13,23,16,26,33.6
2023-24,202401300ATL,1/30/2024,ATL vs LAL,Christian Wood,woodch01,43,LAL,0,ATL,9,8,2,0,0,0,22.11666667,1,7,4,7,0,1,1,2,2,0,10,11,17,19,21.6
2023-24,202401300GSW,1/30/2024,GSW vs PHI,Furkan Korkmaz,korkmfu01,31,PHI,0,GSW,19,2,3,0,0,0,22.2,0,2,6,8,5,6,2,3,1,0,5,22,21,24,25.9
2023-24,202401300NYK,1/30/2024,NYK vs UTA,Keyonte George,georgke01,43,UTA,0,NYK,15,2,1,0,0,2,22.5,0,2,6,12,1,5,2,2,2,0,3,16,17,18,16.9
2023-24,202401300BOS,1/30/2024,BOS vs IND,Sam Hauser,hausesa01,47,BOS,1,IND,9,2,1,1,0,2,23.15,0,2,3,5,3,5,0,0,3,1,3,10,11,12,13.9
2023-24,202401300ATL,1/30/2024,ATL vs LAL,Rui Hachimura,hachiru01,36,LAL,0,ATL,16,4,0,2,0,1,23.48333333,2,2,7,11,2,4,0,2,0,2,4,16,20,20,25.8
2023-24,202401300ATL,1/30/2024,ATL vs LAL,Clint Capela,capelca01,45,ATL,1,LAL,13,12,1,1,1,1,24.35,5,7,6,10,0,0,1,2,3,2,13,14,25,26,33.9
2023-24,202401300ATL,1/30/2024,ATL vs LAL,Jaxson Hayes,hayesja02,39,LAL,0,ATL,6,6,1,4,1,2,24.46666667,1,5,3,4,0,0,0,0,4,5,7,7,12,13,27.7
2023-24,202401300ATL,1/30/2024,ATL vs LAL,Bogdan Bogdanovic,bogdabo01,45,ATL,1,LAL,18,1,1,0,0,1,24.66666667,0,1,7,15,4,9,0,0,1,0,2,19,19,20,19.7
2023-24,202401300ATL,1/30/2024,ATL vs LAL,Taurean Prince,princta02,47,LAL,0,ATL,7,2,0,1,0,1,24.8,0,2,3,7,1,4,0,0,1,1,2,7,9,9,11.4
2023-24,202401300ATL,1/30/2024,ATL vs LAL,Jarred Vanderbilt,vandeja01,29,LAL,0,ATL,12,4,3,2,0,2,25.68333333,1,3,6,6,0,0,0,1,2,2,7,15,16,19,25.3
2023-24,202401300ATL,1/30/2024,ATL vs LAL,Onyeka Okongwu,okongon01,46,ATL,1,LAL,11,4,1,2,1,0,25.7,1,3,4,4,1,1,2,2,1,3,5,12,15,16,26.3
2023-24,202401300BOS,1/30/2024,BOS vs IND,Myles Turner,turnemy01,47,IND,0,BOS,17,5,1,0,1,3,25.9,1,4,7,18,2,7,1,4,4,1,6,18,22,23,24.5
2023-24,202401300GSW,1/30/2024,GSW vs PHI,KJ Martin,martike04,32,PHI,0,GSW,2,2,0,1,1,2,26.41666667,0,2,1,2,0,1,0,3,3,2,2,2,4,4,8.4
2023-24,202401300ATL,1/30/2024,ATL vs LAL,D'Angelo Russell,russeda01,46,LAL,0,ATL,9,1,5,0,0,2,27.13333333,0,1,3,11,1,5,2,2,2,0,6,14,10,15,15.7
2023-24,202401300GSW,1/30/2024,GSW vs PHI,Patrick Beverley,beverpa01,43,PHI,0,GSW,12,5,2,2,1,1,27.58333333,2,3,4,12,2,4,2,2,4,3,7,14,17,19,29
2023-24,202401300NYK,1/30/2024,NYK vs UTA,Collin Sexton,sextoco01,49,UTA,0,NYK,22,3,7,0,0,2,27.96666667,2,1,7,13,2,4,6,8,2,0,10,29,25,32,34.1
2023-24,202401300NYK,1/30/2024,NYK vs UTA,John Collins,collijo01,45,UTA,0,NYK,11,11,3,0,0,1,28.4,3,8,5,12,1,4,0,1,4,0,14,14,22,25,27.7
2023-24,202401300BOS,1/30/2024,BOS vs IND,Andrew Nembhard,nembhan01,34,IND,0,BOS,15,4,5,0,0,0,28.48333333,1,3,6,13,1,5,2,2,2,0,9,20,19,24,27.3
2023-24,202401300GSW,1/30/2024,GSW vs PHI,Draymond Green,greendr01,20,GSW,1,PHI,9,6,6,0,1,2,29.06666667,1,5,3,8,2,4,1,1,3,1,12,15,15,21,26.2
2023-24,202401300GSW,1/30/2024,GSW vs PHI,Danuel House Jr.,houseda01,31,PHI,0,GSW,7,1,0,2,0,0,29.13333333,1,0,1,4,1,3,4,4,2,2,1,7,8,8,14.2
2023-24,202401300NYK,1/30/2024,NYK vs UTA,Simone Fontecchio,fontesi01,47,UTA,0,NYK,14,5,1,0,1,1,29.4,2,3,5,10,4,8,0,0,1,1,6,15,19,20,23.5
2023-24,202401300NYK,1/30/2024,NYK vs UTA,Isaiah Hartenstein,harteis01,46,NYK,1,UTA,14,12,2,2,1,1,29.43333333,7,5,6,10,0,0,2,2,4,3,14,16,26,28,39.4
2023-24,202401300GSW,1/30/2024,GSW vs PHI,Joel Embiid,embiijo01,34,PHI,0,GSW,14,7,2,2,0,8,29.8,1,6,5,18,2,6,2,2,5,2,9,16,21,23,23.4
2023-24,202401300NYK,1/30/2024,NYK vs UTA,Jordan Clarkson,clarkjo01,39,UTA,0,NYK,11,1,1,0,0,3,31.3,0,1,5,12,1,5,0,0,2,0,2,12,12,13,10.7
2023-24,202401300BOS,1/30/2024,BOS vs IND,Kristaps Porzingis,porzikr01,34,BOS,1,IND,17,12,2,0,1,4,31.38333333,4,8,6,17,2,6,3,4,5,1,14,19,29,31,33.4
2023-24,202401300CHI,1/30/2024,CHI vs TOR,Thaddeus Young,youngth01,19,TOR,0,CHI,16,6,6,0,0,1,31.61666667,4,2,8,13,0,1,0,0,5,0,12,22,22,28,31.2
2023-24,202401300BOS,1/30/2024,BOS vs IND,Pascal Siakam,siakapa01,46,IND,0,BOS,23,6,2,0,0,0,31.78333333,4,2,9,16,1,1,4,4,4,0,8,25,29,31,33.2
2023-24,202401300CHI,1/30/2024,CHI vs TOR,Gary Trent Jr.,trentga02,42,TOR,0,CHI,24,5,1,1,0,2,32.25,0,5,9,15,6,11,0,0,1,1,6,25,29,30,32.5
2023-24,202401300ATL,1/30/2024,ATL vs LAL,Austin Reaves,reaveau01,50,LAL,0,ATL,28,0,6,2,0,2,32.35,0,0,10,19,3,8,5,7,1,2,6,34,28,34,41
2023-24,202401300CHI,1/30/2024,CHI vs TOR,Alex Caruso,carusal01,41,CHI,1,TOR,11,3,2,1,2,3,32.61666667,0,3,3,9,1,6,4,6,2,3,5,13,14,16,23.6
2023-24,202401300ATL,1/30/2024,ATL vs LAL,Dejounte Murray,murrade01,46,ATL,1,LAL,24,4,9,2,0,3,33.33333333,0,4,11,19,0,4,2,2,1,2,13,33,28,37,45.3
2023-24,202401300NYK,1/30/2024,NYK vs UTA,Lauri Markkanen,markkla01,39,UTA,0,NYK,14,5,1,1,0,0,33.86666667,2,3,5,14,2,8,2,2,1,1,6,15,19,20,24.5
2023-24,202401300CHI,1/30/2024,CHI vs TOR,Dennis Schroder,schrode01,47,TOR,0,CHI,16,3,10,2,1,6,33.9,1,2,5,11,0,1,6,7,2,3,13,26,19,29,37.6
2023-24,202401300ATL,1/30/2024,ATL vs LAL,Trae Young,youngtr01,42,ATL,1,LAL,26,2,13,1,0,5,34.26666667,1,1,9,20,6,9,2,2,0,1,15,39,28,41,45.9
2023-24,202401300GSW,1/30/2024,GSW vs PHI,Kelly Oubre Jr.,oubreke01,34,PHI,0,GSW,15,6,0,1,0,2,34.6,3,3,7,14,0,3,1,2,2,1,6,15,21,21,23.2
2023-24,202401300ATL,1/30/2024,ATL vs LAL,Jalen Johnson,johnsja05,33,ATL,1,LAL,19,11,3,3,0,0,34.9,1,10,8,14,1,2,2,2,5,3,14,22,30,33,45.7
2023-24,202401300CHI,1/30/2024,CHI vs TOR,Coby White,whiteco01,48,CHI,1,TOR,13,2,6,1,0,1,35.01666667,0,2,5,10,1,4,2,2,3,1,8,19,15,21,26.4
2023-24,202401300ATL,1/30/2024,ATL vs LAL,Saddiq Bey,beysa01,47,ATL,1,LAL,18,8,2,1,0,0,35.13333333,4,4,5,10,1,5,7,8,3,1,10,20,26,28,33.6
2023-24,202401300GSW,1/30/2024,GSW vs PHI,Stephen Curry,curryst01,41,GSW,1,PHI,37,8,7,0,1,5,35.2,1,7,12,17,8,13,5,5,2,1,15,44,45,52,55.1
2023-24,202401300BOS,1/30/2024,BOS vs IND,Derrick White,whitede01,44,BOS,1,IND,24,2,5,1,1,0,35.26666667,0,2,8,16,4,7,4,4,2,2,7,29,26,31,39.9
2023-24,202401300BOS,1/30/2024,BOS vs IND,Jaylen Brown,brownja02,45,BOS,1,IND,25,6,2,2,0,0,35.7,2,4,9,15,0,3,7,8,0,2,8,27,31,33,41.2
2023-24,202401300ATL,1/30/2024,ATL vs LAL,LeBron James,jamesle01,45,LAL,0,ATL,20,9,8,1,1,3,35.81666667,2,7,7,17,2,6,4,9,1,2,17,28,29,37,45.8
2023-24,202401300CHI,1/30/2024,CHI vs TOR,Nikola Vucevic,vucevni01,43,CHI,1,TOR,14,9,3,2,1,1,36.06666667,1,8,5,11,2,5,2,2,2,3,12,17,23,26,37.3
2023-24,202401300BOS,1/30/2024,BOS vs IND,Buddy Hield,hieldbu01,49,IND,0,BOS,12,6,4,3,0,1,36.4,2,4,5,9,2,5,0,0,2,3,10,16,18,22,33.2
2023-24,202401300CHI,1/30/2024,CHI vs TOR,Scottie Barnes,barnesc01,47,TOR,0,CHI,13,4,7,1,0,5,36.51666667,1,3,4,14,0,3,5,6,1,1,11,20,17,24,26.3
2023-24,202401300GSW,1/30/2024,GSW vs PHI,Brandin Podziemski,podzibr01,38,GSW,1,PHI,11,6,3,0,0,3,36.55,1,5,5,11,1,5,0,1,2,0,9,14,17,20,19.7
2023-24,202401300CHI,1/30/2024,CHI vs TOR,Bruce Brown,brownbr01,40,TOR,0,CHI,19,7,3,3,2,2,37.61666667,1,6,7,13,1,3,4,4,3,5,10,22,26,29,44.9
2023-24,202401300GSW,1/30/2024,GSW vs PHI,Tobias Harris,harrito02,43,PHI,0,GSW,26,10,2,2,0,2,37.81666667,6,4,10,18,2,4,4,4,2,2,12,28,36,38,45
2023-24,202401300NYK,1/30/2024,NYK vs UTA,Jalen Brunson,brunsja01,46,NYK,1,UTA,29,3,9,0,1,0,38.01666667,0,3,10,23,2,6,7,8,2,1,12,38,32,41,49.1
2023-24,202401300GSW,1/30/2024,GSW vs PHI,Andrew Wiggins,wiggian01,40,GSW,1,PHI,23,5,4,3,1,1,38.31666667,0,5,8,10,1,2,6,6,2,4,9,27,28,32,46
2023-24,202401300BOS,1/30/2024,BOS vs IND,Jayson Tatum,tatumja01,45,BOS,1,IND,30,7,7,1,2,2,38.83333333,0,7,12,19,4,9,2,3,2,3,14,37,37,44,55.9
2023-24,202401300CHI,1/30/2024,CHI vs TOR,Ayo Dosunmu,dosunay01,46,CHI,1,TOR,21,5,2,0,1,4,39.05,1,4,8,11,4,5,1,2,4,1,7,23,26,28,29
2023-24,202401300GSW,1/30/2024,GSW vs PHI,Jonathan Kuminga,kuminjo01,43,GSW,1,PHI,26,7,2,3,1,3,39.05,2,5,11,19,1,3,3,4,3,4,9,28,33,35,46.4
2023-24,202401300NYK,1/30/2024,NYK vs UTA,Donte DiVincenzo,divindo01,48,NYK,1,UTA,33,5,4,4,1,0,39.38333333,2,3,11,22,9,15,2,2,3,5,9,37,38,42,60
2023-24,202401300BOS,1/30/2024,BOS vs IND,Jrue Holiday,holidjr01,44,BOS,1,IND,17,5,4,1,3,1,39.45,0,5,6,8,3,3,2,2,0,4,9,21,22,26,40
2023-24,202401300NYK,1/30/2024,NYK vs UTA,Precious Achiuwa,achiupr01,41,NYK,1,UTA,18,5,1,0,2,0,40.25,1,4,8,13,0,3,2,2,3,2,6,19,23,24,31.5
2023-24,202401300BOS,1/30/2024,BOS vs IND,Aaron Nesmith,nesmiaa01,44,IND,0,BOS,26,12,7,0,1,0,41.26666667,3,9,11,17,4,7,0,0,3,1,19,33,38,45,53.9
2023-24,202401300CHI,1/30/2024,CHI vs TOR,DeMar DeRozan,derozde01,46,CHI,1,TOR,25,2,5,3,4,5,41.55,1,1,8,17,0,5,9,12,1,7,7,30,27,32,50.9
2023-24,202401300NYK,1/30/2024,NYK vs UTA,Josh Hart,hartjo01,47,NYK,1,UTA,10,10,10,2,2,3,42.51666667,1,9,4,10,0,3,2,2,2,4,20,20,20,30,46
2023-24,202401290SAS,1/29/2024,SAS vs WAS,Landry Shamet,shamela01,30,WAS,0,SAS,6,0,2,0,0,0,10,0,0,2,4,2,4,0,0,0,0,2,8,6,8,9
2023-24,202401290MEM,1/29/2024,MEM vs SAC,JaVale McGee,mcgeeja01,35,SAC,0,MEM,8,4,0,0,0,0,10.01666667,2,2,4,5,0,0,0,0,3,0,4,8,12,12,12.8
2023-24,202401290HOU,1/29/2024,HOU vs LAL,Christian Wood,woodch01,42,LAL,0,HOU,2,2,0,2,0,2,10.01666667,0,2,1,6,0,2,0,0,2,2,2,2,4,4,8.4
2023-24,202401290BOS,1/29/2024,BOS vs NOP,Neemias Queta,quetane01,19,BOS,1,NOP,4,2,1,0,1,1,10.43333333,0,2,2,4,0,0,0,0,1,1,3,5,6,7,9.9
2023-24,202401290BOS,1/29/2024,BOS vs NOP,Oshae Brissett,brissos01,29,BOS,1,NOP,0,5,0,0,0,0,10.8,1,4,0,1,0,1,0,0,3,0,5,0,5,5,6
2023-24,202401290CHO,1/29/2024,CHO vs NYK,Frank Ntilikina,ntilila01,4,CHO,1,NYK,0,2,0,0,0,0,11.18333333,1,1,0,1,0,0,0,0,3,0,2,0,2,2,2.4
2023-24,202401290CHO,1/29/2024,CHO vs NYK,Ish Smith,smithis01,38,CHO,1,NYK,0,0,3,0,0,0,11.18333333,0,0,0,1,0,0,0,0,1,0,3,3,0,3,4.5
2023-24,202401290CHO,1/29/2024,CHO vs NYK,Nick Smith Jr.,smithni01,30,CHO,1,NYK,6,0,0,0,0,0,11.7,0,0,2,5,2,4,0,0,0,0,0,6,6,6,6
2023-24,202401290POR,1/29/2024,POR vs PHI,Duop Reath,reathdu01,35,POR,1,PHI,5,1,1,0,0,0,11.83333333,1,0,2,3,1,1,0,0,5,0,2,6,6,7,7.7
2023-24,202401290HOU,1/29/2024,HOU vs LAL,Amen Thompson,thompam01,27,HOU,1,LAL,0,7,3,1,0,5,11.9,1,6,0,1,0,0,0,0,3,1,10,3,7,10,10.9
2023-24,202401290CHO,1/29/2024,CHO vs NYK,Leaky Black,blackle01,16,CHO,1,NYK,0,3,1,0,0,0,11.91666667,0,3,0,0,0,0,0,0,0,0,4,1,3,4,5.1
2023-24,202401290SAS,1/29/2024,SAS vs WAS,Blake Wesley,weslebl01,26,SAS,1,WAS,7,1,2,3,1,1,11.98333333,0,1,2,4,1,1,2,2,3,4,3,9,8,10,22.2
2023-24,202401290DEN,1/29/2024,DEN vs MIL,Cameron Payne,payneca01,43,MIL,0,DEN,3,1,2,1,0,0,12.58333333,0,1,1,2,1,2,0,0,2,1,3,5,4,6,10.2
2023-24,202401290MIA,1/29/2024,MIA vs PHO,Kevin Love,loveke01,36,MIA,1,PHO,4,2,0,0,1,1,12.83333333,0,2,0,4,0,4,4,4,2,1,2,4,6,6,8.4
2023-24,202401290MIA,1/29/2024,MIA vs PHO,Grayson Allen,allengr01,42,PHO,0,MIA,3,2,1,0,0,1,13.41666667,0,2,0,2,0,0,3,4,0,0,3,4,5,6,5.9
2023-24,202401290HOU,1/29/2024,HOU vs LAL,Jaxson Hayes,hayesja02,38,LAL,0,HOU,9,2,0,1,1,1,13.7,1,1,4,4,0,0,1,1,2,2,2,9,11,11,16.4
2023-24,202401290BOS,1/29/2024,BOS vs NOP,Dyson Daniels,daniedy01,47,NOP,0,BOS,0,3,0,1,2,0,13.76666667,2,1,0,0,0,0,0,0,0,3,3,0,3,3,12.6
2023-24,202401290OKC,1/29/2024,OKC vs MIN,Jordan McLaughlin,mclaujo01,26,MIN,0,OKC,10,0,1,0,0,1,14,0,0,4,4,2,2,0,0,3,0,1,11,10,11,10.5
2023-24,202401290SAS,1/29/2024,SAS vs WAS,Dominick Barlow,barlodo01,21,SAS,1,WAS,4,2,5,0,0,1,14.28333333,1,1,1,3,0,0,2,2,6,0,7,9,6,11,12.9
2023-24,202401290BOS,1/29/2024,BOS vs NOP,Payton Pritchard,pritcpa01,47,BOS,1,NOP,5,0,0,1,0,1,14.36666667,0,0,2,5,1,4,0,0,3,1,0,5,5,5,7
2023-24,202401290BRK,1/29/2024,BRK vs UTA,Dennis Smith Jr.,smithde03,31,BRK,1,UTA,12,2,5,2,0,1,14.76666667,1,1,5,8,0,2,2,2,2,2,7,17,14,19,26.9
2023-24,202401290CHO,1/29/2024,CHO vs NYK,Miles McBride,mcbrimi01,34,NYK,0,CHO,11,0,1,1,0,1,14.93333333,0,0,4,7,3,6,0,0,3,1,1,12,11,12,14.5
2023-24,202401290MIA,1/29/2024,MIA vs PHO,Haywood Highsmith,highsha01,33,MIA,1,PHO,3,2,0,0,0,0,15.31666667,0,2,1,3,0,2,1,1,3,0,2,3,5,5,5.4
2023-24,202401290DAL,1/29/2024,DAL vs ORL,Joe Ingles,inglejo01,33,ORL,0,DAL,3,3,0,0,0,2,15.41666667,1,2,1,4,1,3,0,0,1,0,3,3,6,6,4.6
2023-24,202401290DEN,1/29/2024,DEN vs MIL,Pat Connaughton,connapa01,41,MIL,0,DEN,7,1,3,0,1,1,15.7,0,1,1,2,1,2,4,4,0,1,4,10,8,11,14.7
2023-24,202401290POR,1/29/2024,POR vs PHI,Toumani Camara,camarto01,46,POR,1,PHI,6,3,3,1,0,1,15.73333333,2,1,2,4,1,3,1,2,1,1,6,9,9,12,16.1
2023-24,202401290POR,1/29/2024,POR vs PHI,Danuel House Jr.,houseda01,30,PHI,0,POR,2,1,2,0,0,0,15.76666667,0,1,0,1,0,1,2,2,1,0,3,4,3,5,6.2
2023-24,202401290OKC,1/29/2024,OKC vs MIN,Jaylin Williams,willija07,39,OKC,1,MIN,2,3,2,1,2,0,16,0,3,1,3,0,1,0,1,0,3,5,4,5,7,17.6
2023-24,202401290OKC,1/29/2024,OKC vs MIN,Isaiah Joe,joeis01,47,OKC,1,MIN,5,4,0,0,0,1,16.26666667,2,2,2,2,1,1,0,0,1,0,4,5,9,9,8.8
2023-24,202401290BRK,1/29/2024,BRK vs UTA,Kelly Olynyk,olynyke01,46,UTA,0,BRK,5,4,4,0,0,2,16.35,0,4,1,1,0,0,3,4,0,0,8,9,9,13,13.8
2023-24,202401290CHO,1/29/2024,CHO vs NYK,Isaiah Hartenstein,harteis01,45,NYK,0,CHO,10,4,1,3,0,1,16.46666667,1,3,4,4,0,0,2,3,2,3,5,11,14,15,24.3
2023-24,202401290MEM,1/29/2024,MEM vs SAC,Jacob Gilyard,gilyaja01,30,MEM,1,SAC,3,2,5,1,0,0,16.48333333,0,2,1,3,1,2,0,0,1,1,7,8,5,10,15.9
2023-24,202401290MEM,1/29/2024,MEM vs SAC,Davion Mitchell,mitchda01,35,SAC,0,MEM,5,0,0,2,0,2,16.48333333,0,0,2,4,1,3,0,0,2,2,0,5,5,5,9
2023-24,202401290BRK,1/29/2024,BRK vs UTA,Kris Dunn,dunnkr01,40,UTA,0,BRK,9,2,2,2,0,4,16.55,0,2,3,5,3,3,0,0,1,2,4,11,11,13,16.4
2023-24,202401290DEN,1/29/2024,DEN vs MIL,Christian Braun,braunch01,48,DEN,1,MIL,0,6,1,0,0,0,16.56666667,2,4,0,1,0,0,0,0,2,0,7,1,6,7,8.7
2023-24,202401290OKC,1/29/2024,OKC vs MIN,Kenrich Williams,willike04,36,OKC,1,MIN,8,1,0,1,0,0,16.8,1,0,3,8,2,5,0,0,1,1,1,8,9,9,12.2
2023-24,202401290OKC,1/29/2024,OKC vs MIN,Kyle Anderson,anderky01,47,MIN,0,OKC,2,3,3,1,0,0,17.33333333,1,2,1,4,0,0,0,0,2,1,6,5,5,8,13.1
2023-24,202401290CLE,1/29/2024,CLE vs LAC,Daniel Theis,theisda01,35,LAC,0,CLE,0,4,5,0,0,1,17.35,1,3,0,1,0,1,0,0,3,0,9,5,4,9,11.3
2023-24,202401290POR,1/29/2024,POR vs PHI,KJ Martin,martike04,31,PHI,0,POR,6,1,1,0,0,2,17.55,0,1,2,4,0,0,2,2,5,0,2,7,7,8,6.7
2023-24,202401290HOU,1/29/2024,HOU vs LAL,Cam Whitmore,whitmca01,23,HOU,1,LAL,20,6,0,0,0,0,18.16666667,1,5,7,12,2,6,4,6,0,0,6,20,26,26,27.2
2023-24,202401290MIA,1/29/2024,MIA vs PHO,Josh Okogie,okogijo01,41,PHO,0,MIA,11,7,0,1,1,0,18.2,3,4,4,5,2,2,1,3,1,2,7,11,18,18,25.4
2023-24,202401290BRK,1/29/2024,BRK vs UTA,Royce O'Neale,onealro01,45,BRK,1,UTA,11,4,2,2,2,0,18.23333333,0,4,4,7,3,6,0,0,3,4,6,13,15,17,30.8
2023-24,202401290BRK,1/29/2024,BRK vs UTA,Ben Simmons,simmobe01,7,BRK,1,UTA,10,8,11,1,1,0,18.23333333,5,3,5,5,0,0,0,0,3,2,19,21,18,29,42.1
2023-24,202401290BOS,1/29/2024,BOS vs NOP,Naji Marshall,marshna01,38,NOP,0,BOS,4,4,3,1,0,0,18.5,0,4,2,3,0,1,0,0,0,1,7,7,8,11,16.3
2023-24,202401290POR,1/29/2024,POR vs PHI,Mo Bamba,bambamo01,25,PHI,0,POR,4,5,1,1,3,0,18.73333333,0,5,2,4,0,2,0,0,5,4,6,5,9,10,23.5
2023-24,202401290HOU,1/29/2024,HOU vs LAL,Jae'Sean Tate,tateja01,43,HOU,1,LAL,7,1,0,0,0,1,18.85,0,1,3,7,1,2,0,0,2,0,1,7,8,8,7.2
2023-24,202401290BRK,1/29/2024,BRK vs UTA,Walker Kessler,kesslwa01,40,UTA,0,BRK,11,7,0,0,1,0,18.95,4,3,4,5,0,0,3,4,1,1,7,11,18,18,22.4
2023-24,202401290OKC,1/29/2024,OKC vs MIN,Josh Giddey,giddejo01,46,OKC,1,MIN,13,4,2,0,1,1,19.16666667,1,3,5,10,3,7,0,1,1,1,6,15,17,19,22.8
2023-24,202401290DEN,1/29/2024,DEN vs MIL,Jae Crowder,crowdja01,16,MIL,0,DEN,3,0,1,1,0,0,19.23333333,0,0,1,3,1,3,0,0,1,1,1,4,3,4,7.5
2023-24,202401290CLE,1/29/2024,CLE vs LAC,Terance Mann,mannte01,39,LAC,0,CLE,5,0,1,2,0,0,19.43333333,0,0,2,4,1,2,0,0,2,2,1,6,5,6,12.5
2023-24,202401290POR,1/29/2024,POR vs PHI,Matisse Thybulle,thybuma01,45,POR,1,PHI,3,1,0,0,0,1,19.46666667,0,1,1,6,1,5,0,0,0,0,1,3,4,4,3.2
2023-24,202401290OKC,1/29/2024,OKC vs MIN,Aaron Wiggins,wiggiaa01,44,OKC,1,MIN,7,4,1,1,0,1,19.53333333,1,3,3,3,1,1,0,0,1,1,5,8,11,12,15.3
2023-24,202401290OKC,1/29/2024,OKC vs MIN,Cason Wallace,wallaca01,47,OKC,1,MIN,3,2,2,0,1,0,19.55,0,2,1,1,1,1,0,0,6,1,4,5,5,7,11.4
2023-24,202401290BOS,1/29/2024,BOS vs NOP,Jonas Valanciunas,valanjo01,47,NOP,0,BOS,11,7,2,1,1,0,19.61666667,1,6,4,9,0,2,3,4,1,2,9,13,18,20,28.4
2023-24,202401290BOS,1/29/2024,BOS vs NOP,Larry Nance Jr.,nancela02,30,NOP,0,BOS,3,3,1,0,1,0,19.66666667,1,2,1,3,1,2,0,0,0,1,4,4,6,7,11.1
2023-24,202401290SAS,1/29/2024,SAS vs WAS,Marvin Bagley III,baglema01,33,WAS,0,SAS,15,3,1,0,0,5,19.73333333,0,3,5,6,0,0,5,6,3,0,4,16,18,19,15.1
2023-24,202401290SAS,1/29/2024,SAS vs WAS,Corey Kispert,kispeco01,45,WAS,0,SAS,8,4,3,0,1,1,19.85,0,4,3,6,2,5,0,0,1,1,7,11,12,15,19.3
2023-24,202401290MEM,1/29/2024,MEM vs SAC,Malik Monk,monkma01,44,SAC,0,MEM,3,3,5,1,0,3,19.88333333,0,3,1,6,1,4,0,0,1,1,8,8,6,11,14.1
2023-24,202401290SAS,1/29/2024,SAS vs WAS,Julian Champagnie,champju02,40,SAS,1,WAS,3,1,1,0,2,1,20,0,1,1,2,1,1,0,1,0,2,2,4,4,5,10.7
2023-24,202401290HOU,1/29/2024,HOU vs LAL,Max Christie,chrisma02,39,LAL,0,HOU,7,6,1,0,1,0,20.18333333,0,6,3,6,1,2,0,0,0,1,7,8,13,14,18.7
2023-24,202401290DEN,1/29/2024,DEN vs MIL,Reggie Jackson,jacksre01,48,DEN,1,MIL,9,2,5,0,0,0,20.2,1,1,3,7,1,2,2,2,4,0,7,14,11,16,18.9
2023-24,202401290CLE,1/29/2024,CLE vs LAC,Georges Niang,niangge01,44,CLE,1,LAC,10,2,1,0,1,0,20.25,0,2,3,10,2,7,2,2,1,1,3,11,12,13,16.9
2023-24,202401290POR,1/29/2024,POR vs PHI,Tobias Harris,harrito02,42,PHI,0,POR,9,4,1,0,0,0,20.38333333,1,3,3,9,0,3,3,4,0,0,5,10,13,14,15.3
2023-24,202401290OKC,1/29/2024,OKC vs MIN,Naz Reid,reidna01,47,MIN,0,OKC,9,5,2,0,0,2,20.63333333,0,5,3,10,3,5,0,0,0,0,7,11,14,16,16
2023-24,202401290CLE,1/29/2024,CLE vs LAC,Evan Mobley,mobleev01,22,CLE,1,LAC,10,9,0,1,0,3,20.85,1,8,5,7,0,0,0,0,3,1,9,10,19,19,20.8
2023-24,202401290BRK,1/29/2024,BRK vs UTA,John Collins,collijo01,44,UTA,0,BRK,15,7,0,1,2,0,21.31666667,3,4,7,10,0,0,1,2,2,3,7,15,22,22,32.4
2023-24,202401290BRK,1/29/2024,BRK vs UTA,Ochai Agbaji,agbajoc01,48,UTA,0,BRK,4,3,2,0,2,0,21.38333333,0,3,2,5,0,2,0,0,0,2,5,6,7,9,16.6
2023-24,202401290MIA,1/29/2024,MIA vs PHO,Drew Eubanks,eubandr01,41,PHO,0,MIA,11,5,1,0,1,0,21.41666667,3,2,5,5,0,0,1,1,2,1,6,12,16,17,21.5
2023-24,202401290POR,1/29/2024,POR vs PHI,Marcus Morris,morrima03,35,PHI,0,POR,9,2,0,0,0,3,21.71666667,0,2,3,7,1,3,2,2,1,0,2,9,11,11,8.4
2023-24,202401290POR,1/29/2024,POR vs PHI,Scoot Henderson,hendesc01,38,POR,1,PHI,22,2,4,2,1,2,21.91666667,1,1,5,9,3,4,9,9,4,3,6,26,24,28,37.4
2023-24,202401290BRK,1/29/2024,BRK vs UTA,Simone Fontecchio,fontesi01,46,UTA,0,BRK,5,4,0,0,1,0,22.08333333,0,4,2,9,1,4,0,0,2,1,4,5,9,9,12.8
2023-24,202401290CLE,1/29/2024,CLE vs LAC,Russell Westbrook,westbru01,45,LAC,0,CLE,13,4,3,0,0,4,22.11666667,0,4,5,8,0,2,3,4,1,0,7,16,17,20,18.3
2023-24,202401290HOU,1/29/2024,HOU vs LAL,Rui Hachimura,hachiru01,35,LAL,0,HOU,16,5,1,1,0,0,22.28333333,0,5,4,5,2,3,6,8,0,1,6,17,21,22,26.5
2023-24,202401290DAL,1/29/2024,DAL vs ORL,Maxi Kleber,klebima01,12,DAL,1,ORL,1,1,1,0,0,1,22.33333333,0,1,0,1,0,0,1,2,1,0,2,2,2,3,2.7
2023-24,202401290CLE,1/29/2024,CLE vs LAC,Mason Plumlee,plumlma01,15,LAC,0,CLE,5,5,0,0,1,1,22.36666667,1,4,1,1,0,0,3,4,2,1,5,5,10,10,13
2023-24,202401290DEN,1/29/2024,DEN vs MIL,Peyton Watson,watsope01,46,DEN,1,MIL,6,4,2,1,0,0,23.08333333,0,4,3,4,0,0,0,0,3,1,6,8,10,12,16.8
2023-24,202401290CLE,1/29/2024,CLE vs LAC,Caris LeVert,leverca01,34,CLE,1,LAC,13,2,3,1,0,1,23.2,1,1,6,12,1,4,0,0,1,1,5,16,15,18,21.9
2023-24,202401290BRK,1/29/2024,BRK vs UTA,Jordan Clarkson,clarkjo01,38,UTA,0,BRK,13,1,1,0,0,4,23.3,0,1,5,10,0,4,3,4,1,0,2,14,14,15,11.7
2023-24,202401290MEM,1/29/2024,MEM vs SAC,Matthew Hurt,hurtma01,1,MEM,1,SAC,10,2,1,0,0,0,23.45,1,1,3,6,2,3,2,2,1,0,3,11,12,13,13.9
2023-24,202401290BRK,1/29/2024,BRK vs UTA,Collin Sexton,sextoco01,48,UTA,0,BRK,6,1,7,0,0,2,23.56666667,0,1,1,10,0,2,4,4,1,0,8,13,7,14,15.7
2023-24,202401290CHO,1/29/2024,CHO vs NYK,Jericho Sims,simsje01,23,NYK,0,CHO,6,7,2,0,0,2,23.61666667,3,4,3,3,0,0,0,0,1,0,9,8,13,15,15.4
2023-24,202401290MIA,1/29/2024,MIA vs PHO,Josh Richardson,richajo01,37,MIA,1,PHO,12,4,2,2,0,1,23.9,1,3,4,8,2,4,2,2,1,2,6,14,16,18,24.8
2023-24,202401290POR,1/29/2024,POR vs PHI,Nicolas Batum,batumni01,34,PHI,0,POR,3,4,1,0,0,0,24.18333333,3,1,1,5,1,4,0,0,1,0,5,4,7,8,9.3
2023-24,202401290POR,1/29/2024,POR vs PHI,Paul Reed,reedpa01,45,PHI,0,POR,11,6,3,1,2,2,24.28333333,3,3,5,8,1,1,0,1,3,3,9,14,17,20,29.7
2023-24,202401290MEM,1/29/2024,MEM vs SAC,Trey Lyles,lylestr01,31,SAC,0,MEM,10,1,1,1,0,2,24.38333333,1,0,4,7,2,5,0,0,3,1,2,11,11,12,13.7
2023-24,202401290MIA,1/29/2024,MIA vs PHO,Caleb Martin,martica02,30,MIA,1,PHO,12,6,1,0,0,2,24.53333333,2,4,5,9,1,1,1,1,3,0,7,13,18,19,18.7
2023-24,202401290DAL,1/29/2024,DAL vs ORL,Moritz Wagner,wagnemo01,45,ORL,0,DAL,16,3,1,1,0,0,24.55,0,3,7,12,2,4,0,0,4,1,4,17,19,20,24.1
2023-24,202401290MEM,1/29/2024,MEM vs SAC,Keegan Murray,murrake02,41,SAC,0,MEM,5,5,2,2,0,4,24.61666667,1,4,2,7,1,4,0,0,2,2,7,7,10,12,16
2023-24,202401290DEN,1/29/2024,DEN vs MIL,Bobby Portis,portibo01,47,MIL,0,DEN,9,12,2,0,0,0,24.75,2,10,2,13,2,6,3,4,3,0,14,11,21,23,26.4
2023-24,202401290OKC,1/29/2024,OKC vs MIN,Luguentz Dort,dortlu01,45,OKC,1,MIN,2,3,1,0,0,0,24.76666667,0,3,0,7,0,6,2,2,2,0,4,3,5,6,7.1
2023-24,202401290SAS,1/29/2024,SAS vs WAS,Deni Avdija,avdijde01,46,WAS,0,SAS,9,8,5,1,1,3,25.15,2,6,3,6,0,0,3,5,3,2,13,14,17,22,29.1
2023-24,202401290MIA,1/29/2024,MIA vs PHO,Jaime Jaquez Jr.,jaqueja01,41,MIA,1,PHO,2,3,1,1,0,2,25.25,0,3,0,6,0,4,2,2,1,1,4,3,5,6,8.1
2023-24,202401290DEN,1/29/2024,DEN vs MIL,Aaron Gordon,gordoaa01,42,DEN,1,MIL,8,6,2,0,1,2,25.35,2,4,2,6,1,2,3,4,6,1,8,10,14,16,19.2
2023-24,202401290HOU,1/29/2024,HOU vs LAL,Taurean Prince,princta02,46,LAL,0,HOU,5,3,1,0,1,2,25.45,0,3,2,6,1,4,0,0,1,1,4,6,8,9,11.1
2023-24,202401290CLE,1/29/2024,CLE vs LAC,Dean Wade,wadede01,37,CLE,1,LAC,6,4,2,0,0,1,25.51666667,2,2,2,8,2,8,0,0,1,0,6,8,10,12,12.8
2023-24,202401290DAL,1/29/2024,DAL vs ORL,Jalen Suggs,suggsja01,43,ORL,0,DAL,11,2,1,3,0,2,25.65,0,2,4,8,3,6,0,0,4,3,3,12,13,14,21.9
2023-24,202401290BOS,1/29/2024,BOS vs NOP,Sam Hauser,hausesa01,46,BOS,1,NOP,11,0,1,1,0,0,25.68333333,0,0,4,8,3,7,0,0,0,1,1,12,11,12,15.5
2023-24,202401290BRK,1/29/2024,BRK vs UTA,Nic Claxton,claxtni01,36,BRK,1,UTA,11,10,2,1,3,2,26.25,4,6,5,11,0,0,1,1,1,4,12,13,21,23,36
2023-24,202401290SAS,1/29/2024,SAS vs WAS,Jeremy Sochan,sochaje01,47,SAS,1,WAS,2,5,1,1,0,0,26.28333333,2,3,1,7,0,2,0,0,2,1,6,3,7,8,12.5
2023-24,202401290BRK,1/29/2024,BRK vs UTA,Spencer Dinwiddie,dinwisp01,44,BRK,1,UTA,2,2,8,2,0,0,26.31666667,2,0,0,5,0,2,2,2,3,2,10,10,4,12,22.4
2023-24,202401290DAL,1/29/2024,DAL vs ORL,Jaden Hardy,hardyja02,42,DAL,1,ORL,20,1,7,1,1,1,26.56666667,0,1,8,9,4,5,0,0,2,2,8,27,21,28,36.7
2023-24,202401290MIA,1/29/2024,MIA vs PHO,Jusuf Nurkic,nurkiju01,44,PHO,0,MIA,6,8,2,2,0,1,26.58333333,0,8,3,5,0,1,0,1,6,2,10,8,14,16,23.6
2023-24,202401290BRK,1/29/2024,BRK vs UTA,Lauri Markkanen,markkla01,38,UTA,0,BRK,13,9,2,0,0,3,26.61666667,4,5,4,12,1,4,4,4,2,0,11,15,22,24,23.8
2023-24,202401290BRK,1/29/2024,BRK vs UTA,Keyonte George,georgke01,42,UTA,0,BRK,21,4,3,0,0,1,26.68333333,0,4,6,11,3,7,6,7,1,0,7,24,25,28,29.3
2023-24,202401290CLE,1/29/2024,CLE vs LAC,Paul George,georgpa01,43,LAC,0,CLE,13,5,3,2,1,2,27.18333333,1,4,3,11,0,5,7,8,6,3,8,16,18,21,30.5
2023-24,202401290CLE,1/29/2024,CLE vs LAC,Amir Coffey,coffeam01,33,LAC,0,CLE,13,1,1,1,0,0,27.2,0,1,5,9,2,5,1,2,1,1,2,14,14,15,18.7
2023-24,202401290BRK,1/29/2024,BRK vs UTA,Lonnie Walker IV,walkelo01,28,BRK,1,UTA,19,2,4,1,1,0,27.2,1,1,7,14,4,9,1,2,2,2,6,23,21,25,33.4
2023-24,202401290DAL,1/29/2024,DAL vs ORL,Cole Anthony,anthoco01,46,ORL,0,DAL,11,2,9,0,0,2,27.31666667,0,2,2,4,0,1,7,7,4,0,11,20,13,22,24.9
2023-24,202401290MIA,1/29/2024,MIA vs PHO,Terry Rozier,roziete01,34,MIA,1,PHO,21,2,3,0,1,1,27.38333333,0,2,8,14,4,6,1,1,2,1,5,24,23,26,29.9
2023-24,202401290BOS,1/29/2024,BOS vs NOP,Herbert Jones,joneshe01,44,NOP,0,BOS,9,3,4,0,0,2,27.45,2,1,3,4,3,4,0,0,4,0,7,13,12,16,16.6
2023-24,202401290CLE,1/29/2024,CLE vs LAC,Norman Powell,powelno01,45,LAC,0,CLE,18,3,2,0,0,0,27.65,0,3,6,13,4,7,2,4,2,0,5,20,21,23,24.6
2023-24,202401290BOS,1/29/2024,BOS vs NOP,Trey Murphy III,murphtr02,22,NOP,0,BOS,15,4,0,0,0,1,28.03333333,2,2,6,14,3,10,0,0,3,0,4,15,19,19,18.8
2023-24,202401290POR,1/29/2024,POR vs PHI,Anfernee Simons,simonan01,25,POR,1,PHI,15,1,6,0,1,1,28.11666667,1,0,6,12,1,7,2,2,3,1,7,21,16,22,27.2
2023-24,202401290SAS,1/29/2024,SAS vs WAS,Daniel Gafford,gaffoda01,41,WAS,0,SAS,16,13,2,2,1,1,28.25,8,5,6,8,0,0,4,8,2,3,15,18,29,31,42.6
2023-24,202401290HOU,1/29/2024,HOU vs LAL,Dillon Brooks,brookdi01,37,HOU,1,LAL,17,3,1,1,0,1,28.48333333,3,0,7,12,2,4,1,2,5,1,4,18,20,21,24.1
2023-24,202401290DAL,1/29/2024,DAL vs ORL,Grant Williams,willigr01,43,DAL,1,ORL,3,2,1,0,0,2,28.5,0,2,1,2,1,2,0,0,3,0,3,4,5,6,4.9
2023-24,202401290SAS,1/29/2024,SAS vs WAS,Cedi Osman,osmande01,47,SAS,1,WAS,20,3,2,2,0,0,28.53333333,2,1,8,12,4,6,0,0,1,2,5,22,23,25,32.6
2023-24,202401290DAL,1/29/2024,DAL vs ORL,Wendell Carter Jr.,cartewe01,21,ORL,0,DAL,9,8,2,0,0,1,28.75,5,3,2,7,1,4,4,5,6,0,10,11,17,19,20.6
2023-24,202401290HOU,1/29/2024,HOU vs LAL,Anthony Davis,davisan02,47,LAL,0,HOU,23,7,2,2,1,3,28.8,2,5,10,20,3,3,0,1,2,3,9,25,30,32,40.4
2023-24,202401290HOU,1/29/2024,HOU vs LAL,Austin Reaves,reaveau01,49,LAL,0,HOU,8,3,5,1,0,2,29.73333333,1,2,3,8,1,3,1,2,1,1,8,13,11,16,20.1
2023-24,202401290BRK,1/29/2024,BRK vs UTA,Cameron Johnson,johnsca02,37,BRK,1,UTA,17,6,3,1,0,1,29.88333333,0,6,6,10,3,4,2,2,0,1,9,20,23,26,30.7
2023-24,202401290DEN,1/29/2024,DEN vs MIL,Khris Middleton,middlkh01,40,MIL,0,DEN,14,8,3,0,1,4,29.91666667,0,8,6,10,2,6,0,0,5,1,11,17,22,25,27.1
2023-24,202401290DAL,1/29/2024,DAL vs ORL,Anthony Black,blackan01,44,ORL,0,DAL,20,3,1,0,1,1,30.06666667,0,3,7,9,4,4,2,2,3,1,4,21,23,24,27.1
2023-24,202401290POR,1/29/2024,POR vs PHI,Patrick Beverley,beverpa01,42,PHI,0,POR,14,1,5,1,0,2,30.36666667,0,1,5,10,0,3,4,4,2,1,6,19,15,20,23.7
2023-24,202401290MEM,1/29/2024,MEM vs SAC,GG Jackson II,jacksgg01,15,MEM,1,SAC,12,6,2,1,0,2,30.45,1,5,4,14,3,10,1,1,0,1,8,14,18,20,23.2
2023-24,202401290SAS,1/29/2024,SAS vs WAS,Bilal Coulibaly,coulibi01,45,WAS,0,SAS,13,1,1,2,1,1,30.61666667,1,0,5,6,2,2,1,1,2,3,2,14,14,15,23.7
2023-24,202401290SAS,1/29/2024,SAS vs WAS,Keldon Johnson,johnske04,45,SAS,1,WAS,14,5,3,3,0,2,30.68333333,0,5,5,10,2,5,2,2,1,3,8,17,19,22,31.5
2023-24,202401290BOS,1/29/2024,BOS vs NOP,Zion Williamson,willizi01,38,NOP,0,BOS,26,4,3,2,0,3,30.73333333,0,4,11,18,0,1,4,5,0,2,7,29,30,33,38.3
2023-24,202401290SAS,1/29/2024,SAS vs WAS,Victor Wembanyama,wembavi01,41,SAS,1,WAS,22,11,4,1,3,4,30.76666667,3,8,9,19,0,4,4,4,1,4,15,26,33,37,49.2
2023-24,202401290CHO,1/29/2024,CHO vs NYK,Cody Martin,martico01,15,CHO,1,NYK,14,6,8,1,0,5,30.8,0,6,5,10,3,5,1,1,2,1,14,22,20,28,31.2
2023-24,202401290POR,1/29/2024,POR vs PHI,Jabari Walker,walkeja01,43,POR,1,PHI,8,12,0,1,0,1,30.81666667,2,10,3,6,1,1,1,2,1,1,12,8,20,20,24.4
2023-24,202401290POR,1/29/2024,POR vs PHI,Jerami Grant,grantje01,42,POR,1,PHI,27,5,3,0,1,3,30.93333333,3,2,7,13,1,2,12,13,4,1,8,30,32,35,37.5
2023-24,202401290POR,1/29/2024,POR vs PHI,Deandre Ayton,aytonde01,31,POR,1,PHI,18,6,2,1,0,0,30.98333333,0,6,9,14,0,0,0,0,2,1,8,20,24,26,31.2
2023-24,202401290OKC,1/29/2024,OKC vs MIN,Jaden McDaniels,mcdanja02,37,MIN,0,OKC,14,3,1,1,0,0,31.1,3,0,6,11,2,5,0,0,5,1,4,15,17,18,22.1
2023-24,202401290DEN,1/29/2024,DEN vs MIL,Malik Beasley,beaslma01,45,MIL,0,DEN,5,1,2,0,1,0,31.2,0,1,2,9,1,7,0,0,1,1,3,7,6,8,12.2
2023-24,202401290POR,1/29/2024,POR vs PHI,Kelly Oubre Jr.,oubreke01,33,PHI,0,POR,25,6,1,0,0,1,31.2,2,4,11,20,0,5,3,3,3,0,7,26,31,32,32.7
2023-24,202401290BRK,1/29/2024,BRK vs UTA,Cam Thomas,thomaca02,37,BRK,1,UTA,25,7,0,1,1,2,31.38333333,1,6,8,16,4,5,5,5,3,2,7,25,32,32,37.4
2023-24,202401290MEM,1/29/2024,MEM vs SAC,Scotty Pippen Jr.,pippesc02,4,MEM,1,SAC,12,2,5,3,1,3,31.51666667,1,1,3,8,2,4,4,7,3,4,7,17,14,19,30.9
2023-24,202401290SAS,1/29/2024,SAS vs WAS,Kyle Kuzma,kuzmaky01,46,WAS,0,SAS,18,11,5,0,2,2,31.63333333,2,9,7,18,0,4,4,4,2,2,16,23,29,34,42.7
2023-24,202401290CHO,1/29/2024,CHO vs NYK,Quentin Grimes,grimequ01,44,NYK,0,CHO,7,2,2,0,0,0,31.85,0,2,3,11,1,6,0,0,1,0,4,9,9,11,12.4
2023-24,202401290OKC,1/29/2024,OKC vs MIN,Chet Holmgren,holmgch01,47,OKC,1,MIN,4,7,2,0,3,2,32,1,6,2,9,0,2,0,0,0,3,9,6,11,13,22.4
2023-24,202401290DAL,1/29/2024,DAL vs ORL,Franz Wagner,wagnefr01,39,ORL,0,DAL,21,5,6,1,0,0,32.18333333,3,2,8,16,3,6,2,3,5,1,11,27,26,32,39
2023-24,202401290MEM,1/29/2024,MEM vs SAC,Jaren Jackson Jr.,jacksja02,45,MEM,1,SAC,22,3,2,0,0,3,32.21666667,0,3,6,18,0,4,10,12,5,0,5,24,25,27,25.6
2023-24,202401290POR,1/29/2024,POR vs PHI,Malcolm Brogdon,brogdma01,37,POR,1,PHI,24,5,9,1,1,3,32.35,0,5,10,14,3,5,1,1,2,2,14,33,29,38,46.5
2023-24,202401290SAS,1/29/2024,SAS vs WAS,Tyus Jones,jonesty01,46,WAS,0,SAS,15,2,9,2,1,1,32.48333333,1,1,7,16,1,4,0,0,0,3,11,24,17,26,38.9
2023-24,202401290SAS,1/29/2024,SAS vs WAS,Tre Jones,jonestr01,42,SAS,1,WAS,11,2,8,0,0,0,32.51666667,0,2,5,12,1,2,0,0,0,0,10,19,13,21,25.4
2023-24,202401290CHO,1/29/2024,CHO vs NYK,Precious Achiuwa,achiupr01,40,NYK,0,CHO,9,5,0,0,1,0,32.61666667,1,4,4,6,1,1,0,0,4,1,5,9,14,14,18
2023-24,202401290OKC,1/29/2024,OKC vs MIN,Jalen Williams,willija06,44,OKC,1,MIN,20,2,3,0,0,2,33,0,2,8,17,4,7,0,2,3,0,5,23,22,25,24.9
2023-24,202401290BOS,1/29/2024,BOS vs NOP,Jrue Holiday,holidjr01,43,BOS,1,NOP,20,3,2,1,0,1,33.05,2,1,7,11,3,5,3,4,1,1,5,22,23,25,28.6
2023-24,202401290DAL,1/29/2024,DAL vs ORL,Josh Green,greenjo02,34,DAL,1,ORL,2,2,1,1,0,2,33.25,0,2,1,6,0,3,0,0,5,1,3,3,4,5,6.9
2023-24,202401290SAS,1/29/2024,SAS vs WAS,Jordan Poole,poolejo01,45,WAS,0,SAS,13,1,3,2,1,4,33.25,0,1,6,13,1,5,0,0,2,3,4,16,14,17,23.7
2023-24,202401290CLE,1/29/2024,CLE vs LAC,Isaac Okoro,okorois01,35,CLE,1,LAC,17,1,3,1,0,1,33.43333333,1,0,5,10,3,4,4,4,0,1,4,20,18,21,24.7
2023-24,202401290MIA,1/29/2024,MIA vs PHO,Eric Gordon,gordoer01,39,PHO,0,MIA,23,4,5,2,2,3,33.5,2,2,8,17,5,12,2,2,2,4,9,28,27,32,44.3
2023-24,202401290DEN,1/29/2024,DEN vs MIL,Kentavious Caldwell-Pope,caldwke01,46,DEN,1,MIL,12,1,2,1,0,0,33.78333333,0,1,5,9,0,3,2,2,1,1,3,14,13,15,19.2
2023-24,202401290MEM,1/29/2024,MEM vs SAC,De'Aaron Fox,foxde01,39,SAC,0,MEM,23,5,4,2,0,3,34.03333333,1,4,8,14,1,4,6,10,1,2,9,27,28,32,38
2023-24,202401290CHO,1/29/2024,CHO vs NYK,Jalen Brunson,brunsja01,45,NYK,0,CHO,32,4,7,1,0,2,34.23333333,0,4,13,24,2,6,4,5,1,1,11,39,36,43,48.3
2023-24,202401290DEN,1/29/2024,DEN vs MIL,Brook Lopez,lopezbr01,47,MIL,0,DEN,19,2,2,0,2,1,34.33333333,1,1,7,13,5,9,0,0,4,2,4,21,21,23,29.4
2023-24,202401290MIA,1/29/2024,MIA vs PHO,Tyler Herro,herroty01,28,MIA,1,PHO,17,6,4,0,0,0,34.4,0,6,5,18,5,12,2,2,1,0,10,21,23,27,30.2
2023-24,202401290MEM,1/29/2024,MEM vs SAC,Santi Aldama,aldamsa01,36,MEM,1,SAC,16,7,2,2,0,2,34.43333333,2,5,5,14,5,8,1,1,2,2,9,18,23,25,31.4
2023-24,202401290CLE,1/29/2024,CLE vs LAC,Max Strus,strusma01,44,CLE,1,LAC,14,7,4,0,0,2,34.51666667,1,6,4,8,3,7,3,3,5,0,11,18,21,25,26.4
2023-24,202401290MEM,1/29/2024,MEM vs SAC,David Roddy,roddyda01,44,MEM,1,SAC,9,10,2,1,0,4,34.58333333,2,8,3,9,0,4,3,5,0,1,12,11,19,21,23
2023-24,202401290BOS,1/29/2024,BOS vs NOP,Derrick White,whitede01,43,BOS,1,NOP,17,1,4,1,1,1,34.91666667,0,1,6,14,4,10,1,2,2,2,5,21,18,22,29.2
2023-24,202401290SAS,1/29/2024,SAS vs WAS,Devin Vassell,vassede01,42,SAS,1,WAS,24,5,4,0,1,5,34.98333333,1,4,9,19,1,5,5,6,1,1,9,28,29,33,34
2023-24,202401290OKC,1/29/2024,OKC vs MIN,Nickeil Alexander-Walker,alexani01,47,MIN,0,OKC,12,2,3,2,0,1,35.03333333,0,2,4,12,2,7,2,2,2,2,5,15,14,17,23.9
2023-24,202401290CHO,1/29/2024,CHO vs NYK,P.J. Washington,washipj01,39,CHO,1,NYK,16,2,2,0,1,1,35.11666667,0,2,7,19,2,9,0,0,0,1,4,18,18,20,23.4
2023-24,202401290MIA,1/29/2024,MIA vs PHO,Bam Adebayo,adebaba01,37,MIA,1,PHO,8,11,5,1,3,4,35.16666667,0,11,3,9,0,0,2,2,2,4,16,13,19,24,36.7
2023-24,202401290MEM,1/29/2024,MEM vs SAC,Harrison Barnes,barneha02,45,SAC,0,MEM,12,3,4,0,0,1,35.31666667,0,3,5,15,2,10,0,0,1,0,7,16,15,19,20.6
2023-24,202401290DEN,1/29/2024,DEN vs MIL,Damian Lillard,lillada01,44,MIL,0,DEN,18,3,5,0,1,4,35.36666667,2,1,5,13,2,4,6,6,2,1,8,23,21,26,28.1
2023-24,202401290DEN,1/29/2024,DEN vs MIL,Jamal Murray,murraja01,34,DEN,1,MIL,35,2,5,2,0,2,35.85,1,1,13,22,0,2,9,10,1,2,7,40,37,42,48.9
2023-24,202401290HOU,1/29/2024,HOU vs LAL,Jabari Smith Jr.,smithja05,41,HOU,1,LAL,18,9,4,3,1,1,36.11666667,2,7,8,13,2,5,0,0,1,4,13,22,27,31,45.8
2023-24,202401290CLE,1/29/2024,CLE vs LAC,Jarrett Allen,allenja01,39,CLE,1,LAC,20,17,3,1,1,3,36.21666667,4,13,6,9,0,0,8,11,3,2,20,23,37,40,47.9
2023-24,202401290BOS,1/29/2024,BOS vs NOP,Brandon Ingram,ingrabr01,43,NOP,0,BOS,28,7,6,1,1,2,36.31666667,1,6,12,24,2,8,2,3,2,2,13,34,35,41,49.4
2023-24,202401290BOS,1/29/2024,BOS vs NOP,Al Horford,horfoal01,39,BOS,1,NOP,11,8,4,0,1,0,36.4,1,7,4,9,3,6,0,0,1,1,12,15,19,23,29.6
2023-24,202401290OKC,1/29/2024,OKC vs MIN,Rudy Gobert,goberru01,46,MIN,0,OKC,12,18,1,1,1,3,36.41666667,4,14,6,6,0,0,0,1,0,2,19,13,30,31,38.1
2023-24,202401290DAL,1/29/2024,DAL vs ORL,Tim Hardaway Jr.,hardati02,44,DAL,1,ORL,36,8,1,1,0,1,36.6,0,8,11,17,5,9,9,11,2,1,9,37,44,45,49.1
2023-24,202401290BOS,1/29/2024,BOS vs NOP,CJ McCollum,mccolcj01,33,NOP,0,BOS,16,2,2,0,1,4,36.68333333,0,2,7,14,1,5,1,1,3,1,4,18,18,20,20.4
2023-24,202401290HOU,1/29/2024,HOU vs LAL,LeBron James,jamesle01,44,LAL,0,HOU,23,6,10,1,1,1,36.78333333,0,6,9,15,2,5,3,8,4,2,16,33,29,39,50.2
2023-24,202401290BOS,1/29/2024,BOS vs NOP,Jaylen Brown,brownja02,44,BOS,1,NOP,22,11,7,0,1,0,36.85,2,9,8,15,1,5,5,7,3,1,18,29,33,40,48.7
2023-24,202401290MEM,1/29/2024,MEM vs SAC,Xavier Tillman Sr.,tillmxa01,34,MEM,1,SAC,10,5,3,3,0,0,36.86666667,2,3,5,8,0,1,0,0,4,3,8,13,15,18,29.5
2023-24,202401290CLE,1/29/2024,CLE vs LAC,Kawhi Leonard,leonaka01,41,LAC,0,CLE,30,8,3,2,0,1,36.88333333,3,5,13,25,2,7,2,2,2,2,11,33,38,41,49.1
2023-24,202401290DEN,1/29/2024,DEN vs MIL,Giannis Antetokounmpo,antetgi01,45,MIL,0,DEN,29,12,4,1,1,2,36.91666667,2,10,11,19,1,1,6,11,4,2,16,33,41,45,53.4
2023-24,202401290CHO,1/29/2024,CHO vs NYK,Nick Richards,richani01,36,CHO,1,NYK,5,8,1,0,2,3,37.23333333,4,4,2,2,0,0,1,4,3,2,9,6,13,14,19.1
2023-24,202401290DEN,1/29/2024,DEN vs MIL,Michael Porter Jr.,portemi01,48,DEN,1,MIL,13,8,0,0,0,1,37.25,2,6,6,14,1,3,0,0,2,0,8,13,21,21,21.6
2023-24,202401290MEM,1/29/2024,MEM vs SAC,Kevin Huerter,huertke01,43,SAC,0,MEM,17,4,3,2,1,1,37.28333333,0,4,7,15,3,8,0,0,1,3,7,20,21,24,34.3
2023-24,202401290MIA,1/29/2024,MIA vs PHO,Jimmy Butler,butleji01,32,MIA,1,PHO,26,8,4,1,0,0,37.3,5,3,7,12,2,2,10,10,1,1,12,30,34,38,44.6
2023-24,202401290BRK,1/29/2024,BRK vs UTA,Mikal Bridges,bridgmi01,46,BRK,1,UTA,33,3,4,1,0,1,37.38333333,1,2,12,24,6,14,3,3,3,1,7,37,36,40,44.6
2023-24,202401290HOU,1/29/2024,HOU vs LAL,Fred VanVleet,vanvlfr01,44,HOU,1,LAL,3,4,14,2,0,2,37.41666667,1,3,0,4,0,4,3,4,3,2,18,17,7,21,32.8
2023-24,202401290BOS,1/29/2024,BOS vs NOP,Jayson Tatum,tatumja01,44,BOS,1,NOP,28,10,8,3,1,7,37.5,0,10,10,18,2,8,6,7,1,4,18,36,38,46,57
2023-24,202401290MEM,1/29/2024,MEM vs SAC,Domantas Sabonis,sabondo01,45,SAC,0,MEM,20,26,5,0,0,3,37.98333333,6,20,10,11,0,0,0,0,3,0,31,25,46,51,55.7
2023-24,202401290CLE,1/29/2024,CLE vs LAC,Donovan Mitchell,mitchdo01,35,CLE,1,LAC,28,4,12,2,1,2,38.73333333,1,3,11,21,2,10,4,6,3,3,16,40,32,44,57.8
2023-24,202401290CLE,1/29/2024,CLE vs LAC,James Harden,hardeja01,40,LAC,0,CLE,11,7,10,1,1,3,38.75,0,7,3,8,2,5,3,4,2,2,17,21,18,28,37.4
2023-24,202401290CHO,1/29/2024,CHO vs NYK,Brandon Miller,millebr02,39,CHO,1,NYK,29,7,3,0,1,1,38.8,1,6,11,19,3,6,4,5,1,1,10,32,36,39,43.9
2023-24,202401290MIA,1/29/2024,MIA vs PHO,Bradley Beal,bealbr01,23,PHO,0,MIA,19,5,7,1,0,1,38.83333333,0,5,8,21,2,9,1,1,3,1,12,26,24,31,37.5
2023-24,202401290CHO,1/29/2024,CHO vs NYK,Miles Bridges,bridgmi02,34,CHO,1,NYK,21,10,5,3,1,3,38.9,1,9,10,20,1,6,0,2,2,4,15,26,31,36,49.5
2023-24,202401290OKC,1/29/2024,OKC vs MIN,Shai Gilgeous-Alexander,gilgesh01,46,OKC,1,MIN,37,7,8,2,0,4,38.9,2,5,10,18,2,3,15,16,2,2,15,45,44,52,59.4
2023-24,202401290DAL,1/29/2024,DAL vs ORL,Paolo Banchero,banchpa01,47,ORL,0,DAL,36,9,7,2,0,3,38.95,3,6,13,25,4,8,6,11,3,2,16,43,45,52,60.3
2023-24,202401290OKC,1/29/2024,OKC vs MIN,Karl-Anthony Towns,townska01,46,MIN,0,OKC,21,10,6,1,1,2,38.95,1,9,6,15,2,4,7,8,2,2,16,27,31,37,46
2023-24,202401290CHO,1/29/2024,CHO vs NYK,Josh Hart,hartjo01,46,NYK,0,CHO,8,12,7,0,0,1,39.21666667,2,10,3,7,0,3,2,2,0,0,19,15,20,27,31.9
2023-24,202401290HOU,1/29/2024,HOU vs LAL,Alperen Sengun,sengual01,46,HOU,1,LAL,31,12,7,2,1,4,39.5,3,9,14,23,1,4,2,4,4,3,19,38,43,50,60.9
2023-24,202401290DEN,1/29/2024,DEN vs MIL,Nikola Jokic,jokicni01,47,DEN,1,MIL,25,16,12,3,2,3,39.51666667,1,15,10,25,1,6,4,5,1,5,28,37,41,53,74.2
2023-24,202401290OKC,1/29/2024,OKC vs MIN,Anthony Edwards,edwaran01,44,MIN,0,OKC,27,4,4,1,0,4,40.36666667,0,4,10,20,3,5,4,4,4,1,8,31,31,35,36.8
2023-24,202401290MIA,1/29/2024,MIA vs PHO,Devin Booker,bookede01,38,PHO,0,MIA,22,8,7,1,1,0,40.58333333,0,8,9,23,2,10,2,3,2,2,15,29,30,37,48.1
2023-24,202401290DAL,1/29/2024,DAL vs ORL,Dereck Lively II,livelde01,36,DAL,1,ORL,20,11,1,1,1,2,40.63333333,3,8,8,9,0,0,4,9,5,2,12,21,31,32,38.7
2023-24,202401290HOU,1/29/2024,HOU vs LAL,Jalen Green,greenja05,46,HOU,1,LAL,34,12,7,1,0,1,40.68333333,3,9,12,23,4,10,6,6,1,1,19,41,46,53,60.9
2023-24,202401290HOU,1/29/2024,HOU vs LAL,D'Angelo Russell,russeda01,45,LAL,0,HOU,23,1,5,1,0,1,41.16666667,0,1,8,19,3,12,4,5,0,1,6,28,24,29,33.7
2023-24,202401290MIA,1/29/2024,MIA vs PHO,Kevin Durant,duranke01,40,PHO,0,MIA,20,8,7,1,2,1,41.75,2,6,8,15,2,5,2,2,0,3,15,27,28,35,48.1
2023-24,202401290CHO,1/29/2024,CHO vs NYK,Donte DiVincenzo,divindo01,47,NYK,0,CHO,28,6,5,0,1,2,41.86666667,0,6,10,22,5,15,3,4,3,1,11,33,34,39,43.7
2023-24,202401290DAL,1/29/2024,DAL vs ORL,Luka Doncic,doncilu01,40,DAL,1,ORL,45,9,15,2,0,4,43,0,9,12,23,3,8,18,21,4,2,24,60,54,69,80.3
2023-24,202401280ORL,1/28/2024,ORL vs PHO,Cole Anthony,anthoco01,45,ORL,1,PHO,5,1,1,2,0,0,10.43333333,0,1,2,5,1,2,0,0,3,2,2,6,6,7,13.7
2023-24,202401280POR,1/28/2024,POR vs CHI,Duop Reath,reathdu01,34,POR,1,CHI,3,3,0,0,0,0,10.56666667,0,3,1,7,1,7,0,0,2,0,3,3,6,6,6.6
2023-24,202401280ORL,1/28/2024,ORL vs PHO,Udoka Azubuike,azubuud01,12,PHO,0,ORL,2,6,0,0,0,0,10.61666667,2,4,1,3,0,0,0,2,1,0,6,2,8,8,9.2
2023-24,202401280POR,1/28/2024,POR vs CHI,Jevon Carter,carteje01,45,CHI,0,POR,6,2,0,1,1,0,10.73333333,0,2,2,4,2,4,0,0,0,2,2,6,8,8,14.4
2023-24,202401280DET,1/28/2024,DET vs OKC,Mike Muscala,muscami01,30,DET,1,OKC,3,3,0,0,0,0,11.03333333,0,3,1,1,1,1,0,0,0,0,3,3,6,6,6.6
2023-24,202401280DET,1/28/2024,DET vs OKC,Isaiah Joe,joeis01,46,OKC,0,DET,4,1,0,0,0,1,11.31666667,0,1,2,4,0,2,0,0,1,0,1,4,5,5,4.2
2023-24,202401280DET,1/28/2024,DET vs OKC,Keyontae Johnson,johnske08,6,OKC,0,DET,5,2,0,0,0,0,12.7,1,1,2,3,1,1,0,0,1,0,2,5,7,7,7.4
2023-24,202401280ATL,1/28/2024,ATL vs TOR,Chris Boucher,bouchch01,43,TOR,0,ATL,5,4,0,0,0,1,13.06666667,1,3,1,2,0,1,3,3,2,0,4,5,9,9,8.8
2023-24,202401280ORL,1/28/2024,ORL vs PHO,Anthony Black,blackan01,43,ORL,1,PHO,4,1,1,0,1,0,13.25,0,1,1,2,0,1,2,2,1,1,2,5,5,6,9.7
2023-24,202401280ORL,1/28/2024,ORL vs PHO,Joe Ingles,inglejo01,32,ORL,1,PHO,6,2,2,0,0,0,13.3,0,2,2,4,2,4,0,0,3,0,4,8,8,10,11.4
2023-24,202401280DET,1/28/2024,DET vs OKC,Monte Morris,morrimo01,3,DET,1,OKC,9,1,2,1,0,0,13.51666667,0,1,4,8,1,2,0,0,0,1,3,11,10,12,16.2
2023-24,202401280IND,1/28/2024,IND vs MEM,Ziaire Williams,willizi02,44,MEM,0,IND,4,3,3,0,0,2,13.75,0,3,2,6,0,3,0,0,1,0,6,7,7,10,10.1
2023-24,202401280DET,1/28/2024,DET vs OKC,Kenrich Williams,willike04,35,OKC,0,DET,2,1,0,1,0,0,13.8,0,1,1,4,0,2,0,0,1,1,1,2,3,3,6.2
2023-24,202401280DET,1/28/2024,DET vs OKC,Killian Hayes,hayeski01,41,DET,1,OKC,2,3,3,0,0,1,13.81666667,0,3,1,2,0,0,0,0,0,0,6,5,5,8,9.1
2023-24,202401280IND,1/28/2024,IND vs MEM,Isaiah Jackson,jacksis01,37,IND,1,MEM,10,7,1,0,1,0,13.88333333,5,2,4,6,0,1,2,2,4,1,8,11,17,18,22.9
2023-24,202401280DET,1/28/2024,DET vs OKC,Kevin Knox,knoxke01,28,DET,1,OKC,6,3,1,1,0,2,14.3,1,2,3,5,0,0,0,0,3,1,4,7,9,10,12.1
2023-24,202401280ATL,1/28/2024,ATL vs TOR,Patty Mills,millspa02,15,ATL,1,TOR,0,3,1,1,0,1,14.68333333,2,1,0,2,0,2,0,0,1,1,4,1,3,4,7.1
2023-24,202401280DET,1/28/2024,DET vs OKC,Jaylin Williams,willija07,38,OKC,0,DET,2,3,2,1,1,1,14.75,1,2,1,4,0,3,0,0,2,2,5,4,5,7,13.6
2023-24,202401280IND,1/28/2024,IND vs MEM,Obi Toppin,toppiob01,48,IND,1,MEM,3,0,2,1,0,2,16.78333333,0,0,1,5,0,2,1,1,2,1,2,5,3,5,7
2023-24,202401280IND,1/28/2024,IND vs MEM,Xavier Tillman Sr.,tillmxa01,33,MEM,0,IND,3,4,1,1,2,0,17.1,3,1,0,3,0,0,3,6,2,3,5,4,7,8,18.3
2023-24,202401280POR,1/28/2024,POR vs CHI,Andre Drummond,drumman01,47,CHI,0,POR,15,7,0,1,1,0,17.15,4,3,6,11,0,0,3,3,3,2,7,15,22,22,29.4
2023-24,202401280IND,1/28/2024,IND vs MEM,Scotty Pippen Jr.,pippesc02,3,MEM,0,IND,4,3,4,0,0,3,17.35,1,2,1,5,1,2,1,2,3,0,7,8,7,11,10.6
2023-24,202401280DET,1/28/2024,DET vs OKC,Marcus Sasser,sassema01,41,DET,1,OKC,12,2,4,0,0,1,18.95,0,2,5,9,2,3,0,0,1,0,6,16,14,18,19.4
2023-24,202401280IND,1/28/2024,IND vs MEM,Buddy Hield,hieldbu01,48,IND,1,MEM,3,3,3,0,1,1,19.3,0,3,1,8,1,4,0,0,1,1,6,6,6,9,13.1
2023-24,202401280ATL,1/28/2024,ATL vs TOR,Jontay Porter,portejo01,13,TOR,0,ATL,12,7,3,2,0,0,19.3,2,5,3,6,3,4,3,4,2,2,10,15,19,22,30.9
2023-24,202401280ORL,1/28/2024,ORL vs PHO,Keita Bates-Diop,bateske01,35,PHO,0,ORL,5,1,0,0,1,1,19.58333333,0,1,2,6,0,1,1,2,1,1,1,5,6,6,8.2
2023-24,202401280DET,1/28/2024,DET vs OKC,Ausar Thompson,thompau01,46,DET,1,OKC,9,4,1,1,1,0,19.71666667,2,2,3,7,0,1,3,3,1,2,5,10,13,14,21.3
2023-24,202401280IND,1/28/2024,IND vs MEM,Ben Sheppard,sheppbe01,26,IND,1,MEM,6,0,1,1,0,1,19.86666667,0,0,2,6,2,4,0,0,2,1,1,7,6,7,9.5
2023-24,202401280ATL,1/28/2024,ATL vs TOR,Onyeka Okongwu,okongon01,45,ATL,1,TOR,10,3,1,0,1,0,20.15,2,1,5,7,0,1,0,0,3,1,4,11,13,14,18.1
2023-24,202401280DET,1/28/2024,DET vs OKC,Aaron Wiggins,wiggiaa01,43,OKC,0,DET,7,1,0,2,0,2,20.4,1,0,3,8,1,3,0,0,2,2,1,7,8,8,12.2
2023-24,202401280DET,1/28/2024,DET vs OKC,Cason Wallace,wallaca01,46,OKC,0,DET,4,4,1,2,0,0,21.26666667,1,3,2,4,0,1,0,0,1,2,5,5,8,9,16.3
2023-24,202401280ORL,1/28/2024,ORL vs PHO,Eric Gordon,gordoer01,38,PHO,0,ORL,9,1,1,0,0,2,21.76666667,0,1,4,5,1,2,0,0,1,0,2,10,10,11,9.7
2023-24,202401280ATL,1/28/2024,ATL vs TOR,Thaddeus Young,youngth01,18,TOR,0,ATL,4,4,1,0,0,0,22.01666667,1,3,2,3,0,0,0,0,2,0,5,5,8,9,10.3
2023-24,202401280POR,1/28/2024,POR vs CHI,Scoot Henderson,hendesc01,37,POR,1,CHI,4,4,4,0,1,2,22.21666667,1,3,2,4,0,1,0,0,3,1,8,8,8,12,15.8
2023-24,202401280ORL,1/28/2024,ORL vs PHO,Moritz Wagner,wagnemo01,44,ORL,1,PHO,16,12,1,1,1,0,22.75,5,7,5,13,0,0,6,8,1,2,13,17,28,29,37.9
2023-24,202401280DET,1/28/2024,DET vs OKC,Luguentz Dort,dortlu01,44,OKC,0,DET,6,1,1,0,1,0,22.86666667,0,1,2,5,2,5,0,0,3,1,2,7,7,8,11.7
2023-24,202401280ORL,1/28/2024,ORL vs PHO,Jonathan Isaac,isaacjo01,28,ORL,1,PHO,9,3,1,1,2,1,22.93333333,1,2,3,7,1,2,2,4,2,3,4,10,12,13,22.1
2023-24,202401280DET,1/28/2024,DET vs OKC,Chet Holmgren,holmgch01,46,OKC,0,DET,9,12,1,0,1,1,23.18333333,1,11,4,11,1,5,0,1,0,1,13,10,21,22,26.9
2023-24,202401280ORL,1/28/2024,ORL vs PHO,Wendell Carter Jr.,cartewe01,20,ORL,1,PHO,9,3,1,0,1,0,23.31666667,0,3,4,8,1,4,0,0,1,1,4,10,12,13,17.1
2023-24,202401280POR,1/28/2024,POR vs CHI,Julian Phillips,phillju01,23,CHI,0,POR,11,2,1,0,1,0,23.43333333,1,1,4,7,1,3,2,4,3,1,3,12,13,14,17.9
2023-24,202401280POR,1/28/2024,POR vs CHI,Jabari Walker,walkeja01,42,POR,1,CHI,7,6,0,0,1,3,24.3,1,5,3,10,0,3,1,1,4,1,6,7,13,13,14.2
2023-24,202401280ATL,1/28/2024,ATL vs TOR,Gradey Dick,dickgr01,25,TOR,0,ATL,15,5,3,1,0,2,25.05,3,2,5,12,3,5,2,3,3,1,8,18,20,23,26.5
2023-24,202401280DET,1/28/2024,DET vs OKC,Isaiah Stewart,stewais01,35,DET,1,OKC,11,1,0,0,0,0,25.33333333,0,1,5,10,1,4,0,0,1,0,1,11,12,12,12.2
2023-24,202401280DET,1/28/2024,DET vs OKC,Alec Burks,burksal01,39,DET,1,OKC,10,6,2,3,0,3,25.96666667,0,6,3,5,2,3,2,2,1,3,8,12,16,18,26.2
2023-24,202401280ATL,1/28/2024,ATL vs TOR,Gary Trent Jr.,trentga02,41,TOR,0,ATL,16,1,0,2,0,1,26.21666667,0,1,6,12,4,8,0,0,5,2,1,16,17,17,22.2
2023-24,202401280DET,1/28/2024,DET vs OKC,Josh Giddey,giddejo01,45,OKC,0,DET,12,9,5,0,1,2,27.16666667,2,7,5,10,0,1,2,2,0,1,14,17,21,26,31.3
2023-24,202401280ORL,1/28/2024,ORL vs PHO,Markelle Fultz,fultzma01,14,ORL,1,PHO,14,2,4,5,0,0,27.38333333,1,1,7,10,0,0,0,0,3,5,6,18,16,20,37.4
2023-24,202401280IND,1/28/2024,IND vs MEM,Santi Aldama,aldamsa01,35,MEM,0,IND,10,6,1,0,0,1,27.81666667,1,5,4,11,2,5,0,0,0,0,7,11,16,17,17.7
2023-24,202401280ATL,1/28/2024,ATL vs TOR,Clint Capela,capelca01,44,ATL,1,TOR,19,14,0,0,1,0,27.85,6,8,9,13,0,0,1,2,2,1,14,19,33,33,38.8
2023-24,202401280DET,1/28/2024,DET vs OKC,Jalen Williams,willija06,43,OKC,0,DET,20,1,3,0,0,0,27.95,0,1,8,16,2,3,2,4,2,0,4,23,21,24,25.7
2023-24,202401280IND,1/28/2024,IND vs MEM,GG Jackson II,jacksgg01,14,MEM,0,IND,18,4,1,1,1,0,28.86666667,1,3,6,9,2,4,4,5,0,2,5,19,22,23,30.3
2023-24,202401280ORL,1/28/2024,ORL vs PHO,Drew Eubanks,eubandr01,40,PHO,0,ORL,4,8,3,1,1,2,29.06666667,1,7,2,2,0,0,0,0,3,2,11,7,12,15,22.1
2023-24,202401280ATL,1/28/2024,ATL vs TOR,Dennis Schroder,schrode01,46,TOR,0,ATL,14,3,6,4,0,4,29.15,0,3,5,12,1,4,3,4,6,4,9,20,17,23,34.6
2023-24,202401280DET,1/28/2024,DET vs OKC,Shai Gilgeous-Alexander,gilgesh01,45,OKC,0,DET,31,5,4,1,0,3,29.23333333,3,2,13,20,1,1,4,5,3,1,9,35,36,40,43
2023-24,202401280IND,1/28/2024,IND vs MEM,John Konchar,konchjo01,37,MEM,0,IND,9,7,4,0,2,2,29.68333333,2,5,4,5,1,2,0,0,1,2,11,13,16,20,27.4
2023-24,202401280IND,1/28/2024,IND vs MEM,Jalen Smith,smithja04,33,IND,1,MEM,19,10,2,0,2,1,30.08333333,3,7,8,13,3,6,0,0,4,2,12,21,29,31,39
2023-24,202401280IND,1/28/2024,IND vs MEM,Bennedict Mathurin,mathube01,48,IND,1,MEM,24,7,1,1,1,2,30.18333333,0,7,9,14,3,5,3,3,4,2,8,25,31,32,37.9
2023-24,202401280DET,1/28/2024,DET vs OKC,Jalen Duren,durenja01,31,DET,1,OKC,22,21,6,0,1,1,30.6,9,12,9,13,0,0,4,5,2,1,27,28,43,49,58.2
2023-24,202401280ATL,1/28/2024,ATL vs TOR,Jordan Nwora,nworajo01,21,TOR,0,ATL,24,9,6,1,0,1,30.83333333,3,6,7,16,3,7,7,8,4,1,15,30,33,39,45.8
2023-24,202401280ORL,1/28/2024,ORL vs PHO,Franz Wagner,wagnefr01,38,ORL,1,PHO,11,8,7,1,0,2,30.96666667,2,6,3,11,2,7,3,3,2,1,15,18,19,26,32.1
2023-24,202401280IND,1/28/2024,IND vs MEM,Jaren Jackson Jr.,jacksja02,44,MEM,0,IND,25,5,4,2,1,4,31.58333333,0,5,7,17,0,3,11,12,5,3,9,29,30,34,42
2023-24,202401280DET,1/28/2024,DET vs OKC,Bojan Bogdanovic,bogdabo02,25,DET,1,OKC,17,1,2,0,0,1,31.63333333,0,1,6,15,1,5,4,4,0,0,3,19,18,20,20.2
2023-24,202401280POR,1/28/2024,POR vs CHI,Alex Caruso,carusal01,40,CHI,0,POR,9,5,3,1,1,0,32.18333333,0,5,3,7,2,5,1,2,5,2,8,12,14,17,25.5
2023-24,202401280ORL,1/28/2024,ORL vs PHO,Jalen Suggs,suggsja01,42,ORL,1,PHO,10,4,5,2,1,2,32.25,1,3,4,11,2,8,0,0,4,3,9,15,14,19,29.3
2023-24,202401280POR,1/28/2024,POR vs CHI,Matisse Thybulle,thybuma01,44,POR,1,CHI,7,2,1,0,1,3,32.36666667,0,2,3,5,1,3,0,0,3,1,3,8,9,10,10.9
2023-24,202401280IND,1/28/2024,IND vs MEM,David Roddy,roddyda01,43,MEM,0,IND,14,5,1,1,1,0,32.43333333,1,4,5,13,2,7,2,2,4,2,6,15,19,20,27.5
2023-24,202401280POR,1/28/2024,POR vs CHI,Ayo Dosunmu,dosunay01,45,CHI,0,POR,11,5,3,0,3,1,32.96666667,0,5,5,12,1,4,0,0,1,3,8,14,16,19,29.5
2023-24,202401280ORL,1/28/2024,ORL vs PHO,Grayson Allen,allengr01,41,PHO,0,ORL,8,5,1,0,0,1,33.01666667,0,5,3,3,1,1,1,2,2,0,6,9,13,14,14.5
2023-24,202401280POR,1/28/2024,POR vs CHI,Nikola Vucevic,vucevni01,42,CHI,0,POR,14,7,3,0,3,0,33.51666667,0,7,6,14,0,4,2,2,2,3,10,17,21,24,35.9
2023-24,202401280DET,1/28/2024,DET vs OKC,Jaden Ivey,iveyja01,42,DET,1,OKC,19,8,6,0,0,0,35.13333333,3,5,7,20,3,7,2,5,2,0,14,25,27,33,37.6
2023-24,202401280POR,1/28/2024,POR vs CHI,Anfernee Simons,simonan01,24,POR,1,CHI,11,7,8,0,0,1,35.18333333,2,5,4,15,2,7,1,1,5,0,15,19,18,26,30.4
2023-24,202401280IND,1/28/2024,IND vs MEM,Pascal Siakam,siakapa01,45,IND,1,MEM,19,6,6,2,0,1,35.25,0,6,8,13,0,2,3,3,3,2,12,25,25,31,40.2
2023-24,202401280ORL,1/28/2024,ORL vs PHO,Bradley Beal,bealbr01,22,PHO,0,ORL,9,5,6,1,0,4,35.43333333,1,4,4,13,0,5,1,4,4,1,11,15,14,20,23
2023-24,202401280ORL,1/28/2024,ORL vs PHO,Paolo Banchero,banchpa01,46,ORL,1,PHO,26,4,7,0,0,2,35.68333333,1,3,9,18,2,5,6,9,1,0,11,33,30,37,39.3
2023-24,202401280IND,1/28/2024,IND vs MEM,Vince Williams Jr.,willivi01,36,MEM,0,IND,20,8,1,0,0,0,36.05,4,4,8,12,2,3,2,4,3,0,9,21,28,29,31.1
2023-24,202401280ORL,1/28/2024,ORL vs PHO,Devin Booker,bookede01,37,PHO,0,ORL,44,4,3,1,2,4,36.21666667,1,3,17,26,1,2,9,11,3,3,7,47,48,51,58.3
2023-24,202401280POR,1/28/2024,POR vs CHI,Jerami Grant,grantje01,41,POR,1,CHI,24,7,2,0,1,2,36.65,0,7,5,12,1,6,13,16,2,1,9,26,31,33,36.4
2023-24,202401280ATL,1/28/2024,ATL vs TOR,Bruce Brown,brownbr01,39,TOR,0,ATL,11,9,2,2,1,0,36.76666667,4,5,4,12,1,2,2,2,4,3,11,13,20,22,33.8
2023-24,202401280ORL,1/28/2024,ORL vs PHO,Kevin Durant,duranke01,39,PHO,0,ORL,15,4,5,0,1,7,37.1,0,4,7,12,1,3,0,0,3,1,9,20,19,24,23.3
2023-24,202401280IND,1/28/2024,IND vs MEM,Andrew Nembhard,nembhan01,33,IND,1,MEM,16,4,9,1,0,1,37.3,2,2,5,14,2,5,4,4,3,1,13,25,20,29,36.3
2023-24,202401280IND,1/28/2024,IND vs MEM,Aaron Nesmith,nesmiaa01,43,IND,1,MEM,16,7,6,2,1,1,37.35,1,6,6,11,2,6,2,3,3,3,13,22,23,29,41.4
2023-24,202401280POR,1/28/2024,POR vs CHI,Deandre Ayton,aytonde01,30,POR,1,CHI,22,12,1,0,1,0,37.43333333,1,11,9,12,0,0,4,4,0,1,13,23,34,35,40.9
2023-24,202401280ATL,1/28/2024,ATL vs TOR,Scottie Barnes,barnesc01,46,TOR,0,ATL,24,4,8,0,2,5,37.6,1,3,8,14,0,0,8,8,2,2,12,32,28,36,41.8
2023-24,202401280POR,1/28/2024,POR vs CHI,Malcolm Brogdon,brogdma01,36,POR,1,CHI,16,6,6,2,0,2,38.48333333,2,4,4,13,1,6,7,7,2,2,12,22,22,28,36.2
2023-24,202401280ATL,1/28/2024,ATL vs TOR,Bogdan Bogdanovic,bogdabo01,44,ATL,1,TOR,24,4,2,2,2,5,38.61666667,0,4,7,11,4,8,6,7,4,4,6,26,28,30,38.8
2023-24,202401280POR,1/28/2024,POR vs CHI,DeMar DeRozan,derozde01,45,CHI,0,POR,20,7,6,1,0,0,40.18333333,0,7,8,14,1,2,3,3,2,1,13,26,27,33,40.4
2023-24,202401280ATL,1/28/2024,ATL vs TOR,Saddiq Bey,beysa01,46,ATL,1,TOR,26,13,3,0,0,1,41.01666667,7,6,8,18,0,6,10,15,1,0,16,29,39,42,45.1
2023-24,202401280POR,1/28/2024,POR vs CHI,Coby White,whiteco01,47,CHI,0,POR,15,5,9,1,0,3,41.66666667,0,5,7,19,1,9,0,1,1,1,14,24,20,29,34.5
2023-24,202401280ATL,1/28/2024,ATL vs TOR,Trae Young,youngtr01,41,ATL,1,TOR,30,2,12,2,0,5,41.73333333,0,2,9,24,1,4,11,12,3,2,14,42,32,44,51.4
2023-24,202401280ATL,1/28/2024,ATL vs TOR,Jalen Johnson,johnsja05,32,ATL,1,TOR,17,12,5,2,0,2,41.96666667,3,9,6,17,1,4,4,4,4,2,17,22,29,34,42.9
2023-24,202401270DAL,1/27/2024,DAL vs SAC,JaVale McGee,mcgeeja01,34,SAC,0,DAL,6,2,0,1,0,0,10.38333333,0,2,3,4,0,0,0,0,0,1,2,6,8,8,11.4
2023-24,202401270BOS,1/27/2024,BOS vs LAC,Brandon Boston Jr.,bostobr01,10,LAC,0,BOS,3,2,0,0,1,0,10.45,2,0,1,5,1,1,0,0,1,1,2,3,5,5,8.4
2023-24,202401270BOS,1/27/2024,BOS vs LAC,Kobe Brown,brownko01,27,LAC,0,BOS,0,3,1,0,0,1,10.45,2,1,0,2,0,2,0,0,2,0,4,1,3,4,4.1
2023-24,202401270BOS,1/27/2024,BOS vs LAC,Bones Hyland,hylanbo01,18,LAC,0,BOS,2,1,4,2,0,1,10.45,0,1,1,8,0,6,0,0,2,2,5,6,3,7,14.2
2023-24,202401270DAL,1/27/2024,DAL vs SAC,Davion Mitchell,mitchda01,34,SAC,0,DAL,0,2,1,0,0,1,10.63333333,0,2,0,0,0,0,0,0,2,0,3,1,2,3,2.9
2023-24,202401270GSW,1/27/2024,GSW vs LAL,Christian Wood,woodch01,41,LAL,0,GSW,8,1,1,0,0,1,10.78333333,0,1,3,4,0,1,2,2,1,0,2,9,9,10,9.7
2023-24,202401270DET,1/27/2024,DET vs WAS,Kevin Knox,knoxke01,27,DET,1,WAS,4,0,0,0,0,0,10.96666667,0,0,1,3,0,2,2,2,1,0,0,4,4,4,4
2023-24,202401270DEN,1/27/2024,DEN vs PHI,DeAndre Jordan,jordade01,23,DEN,1,PHI,2,6,0,0,1,0,11.33333333,3,3,1,1,0,0,0,0,2,1,6,2,8,8,12.2
2023-24,202401270DET,1/27/2024,DET vs WAS,Delon Wright,wrighde01,24,WAS,0,DET,2,2,3,1,0,0,11.41666667,0,2,1,2,0,0,0,0,0,1,5,5,4,7,11.9
2023-24,202401270DAL,1/27/2024,DAL vs SAC,Seth Curry,curryse01,34,DAL,1,SAC,7,2,1,0,0,0,11.43333333,1,1,3,5,1,3,0,0,1,0,3,8,9,10,10.9
2023-24,202401270DET,1/27/2024,DET vs WAS,Mike Muscala,muscami01,29,DET,1,WAS,0,1,1,0,1,0,11.95,0,1,0,4,0,3,0,0,3,1,2,1,1,2,5.7
2023-24,202401270BOS,1/27/2024,BOS vs LAC,Dalano Banton,bantoda01,22,BOS,1,LAC,2,0,3,0,0,1,12,0,0,1,4,0,2,0,0,0,0,3,5,2,5,5.5
2023-24,202401270BOS,1/27/2024,BOS vs LAC,Neemias Queta,quetane01,18,BOS,1,LAC,8,5,1,0,2,0,12.23333333,2,3,4,4,0,0,0,0,0,2,6,9,13,14,21.5
2023-24,202401270CHO,1/27/2024,CHO vs UTA,Keyonte George,georgke01,41,UTA,0,CHO,10,0,1,0,0,1,12.65,0,0,2,5,1,4,5,5,1,0,1,11,10,11,10.5
2023-24,202401270DET,1/27/2024,DET vs WAS,Landry Shamet,shamela01,29,WAS,0,DET,3,5,0,0,0,1,12.7,3,2,1,8,0,2,1,1,2,0,5,3,8,8,8
2023-24,202401270DAL,1/27/2024,DAL vs SAC,Maxi Kleber,klebima01,11,DAL,1,SAC,5,2,0,0,0,0,12.91666667,1,1,2,6,1,3,0,0,0,0,2,5,7,7,7.4
2023-24,202401270BRK,1/27/2024,BRK vs HOU,Lonnie Walker IV,walkelo01,27,BRK,1,HOU,0,1,0,1,0,0,13.63333333,0,1,0,4,0,3,0,0,1,1,1,0,1,1,4.2
2023-24,202401270NYK,1/27/2024,NYK vs MIA,Kevin Love,loveke01,35,MIA,0,NYK,2,2,2,0,0,0,13.83333333,0,2,1,2,0,1,0,0,0,0,4,4,4,6,7.4
2023-24,202401270GSW,1/27/2024,GSW vs LAL,Cory Joseph,josepco01,24,GSW,1,LAL,3,2,2,0,0,0,14.91666667,0,2,1,2,1,2,0,0,1,0,4,5,5,7,8.4
2023-24,202401270BOS,1/27/2024,BOS vs LAC,Russell Westbrook,westbru01,44,LAC,0,BOS,4,4,5,0,0,1,15.18333333,1,3,2,9,0,2,0,0,0,0,9,9,8,13,15.3
2023-24,202401270MIL,1/27/2024,MIL vs NOP,Naji Marshall,marshna01,37,NOP,0,MIL,8,1,1,1,0,1,15.23333333,1,0,3,6,0,0,2,6,2,1,2,9,9,10,12.7
2023-24,202401270BRK,1/27/2024,BRK vs HOU,Amen Thompson,thompam01,26,HOU,0,BRK,5,4,2,3,2,2,15.4,1,3,2,3,1,2,0,0,3,5,6,7,9,11,25.8
2023-24,202401270GSW,1/27/2024,GSW vs LAL,Dario Saric,saricda01,43,GSW,1,LAL,5,4,2,1,0,2,15.45,2,2,2,8,1,3,0,0,3,1,6,7,9,11,13.8
2023-24,202401270CHO,1/27/2024,CHO vs UTA,Ochai Agbaji,agbajoc01,47,UTA,0,CHO,5,2,2,0,0,0,15.5,1,1,2,5,1,3,0,0,0,0,4,7,7,9,10.4
2023-24,202401270NYK,1/27/2024,NYK vs MIA,Isaiah Hartenstein,harteis01,44,NYK,1,MIA,4,6,1,0,0,0,15.61666667,2,4,2,2,0,0,0,0,2,0,7,5,10,11,12.7
2023-24,202401270SAS,1/27/2024,SAS vs MIN,Cedi Osman,osmande01,46,SAS,1,MIN,2,3,4,1,0,1,15.68333333,0,3,1,4,0,3,0,0,1,1,7,6,5,9,13.6
2023-24,202401270NYK,1/27/2024,NYK vs MIA,Caleb Martin,martica02,29,MIA,0,NYK,6,3,0,0,1,0,15.73333333,0,3,2,4,1,3,1,2,2,1,3,6,9,9,12.6
2023-24,202401270BRK,1/27/2024,BRK vs HOU,Jeff Green,greenje02,43,HOU,0,BRK,2,2,0,0,0,1,16.05,0,2,1,5,0,1,0,0,0,0,2,2,4,4,3.4
2023-24,202401270BOS,1/27/2024,BOS vs LAC,Oshae Brissett,brissos01,28,BOS,1,LAC,5,5,2,0,0,1,16.21666667,1,4,2,5,0,1,1,2,0,0,7,7,10,12,13
2023-24,202401270SAS,1/27/2024,SAS vs MIN,Shake Milton,miltosh01,36,MIN,0,SAS,7,1,2,0,0,1,16.23333333,0,1,3,5,1,1,0,0,1,0,3,9,8,10,10.2
2023-24,202401270CHO,1/27/2024,CHO vs UTA,Walker Kessler,kesslwa01,39,UTA,0,CHO,10,4,0,0,3,2,16.25,1,3,5,6,0,0,0,0,1,3,4,10,14,14,21.8
2023-24,202401270CHO,1/27/2024,CHO vs UTA,Kris Dunn,dunnkr01,39,UTA,0,CHO,7,4,6,1,1,1,16.68333333,2,2,3,4,1,1,0,0,1,2,10,13,11,17,25.8
2023-24,202401270SAS,1/27/2024,SAS vs MIN,Doug McDermott,mcderdo01,41,SAS,1,MIN,9,1,1,0,0,0,16.8,0,1,3,5,3,5,0,0,0,0,2,10,10,11,11.7
2023-24,202401270DEN,1/27/2024,DEN vs PHI,Christian Braun,braunch01,47,DEN,1,PHI,2,0,2,0,0,0,16.93333333,0,0,0,2,0,1,2,2,2,0,2,4,2,4,5
2023-24,202401270DET,1/27/2024,DET vs WAS,Ausar Thompson,thompau01,45,DET,1,WAS,8,2,0,1,2,1,17.18333333,2,0,4,6,0,2,0,0,0,3,2,8,10,10,18.4
2023-24,202401270DAL,1/27/2024,DAL vs SAC,Trey Lyles,lylestr01,30,SAC,0,DAL,1,4,1,0,1,1,17.35,0,4,0,2,0,1,1,2,2,1,5,2,5,6,9.3
2023-24,202401270BRK,1/27/2024,BRK vs HOU,Jae'Sean Tate,tateja01,42,HOU,0,BRK,6,5,2,0,0,1,17.35,1,4,3,5,0,1,0,0,5,0,7,8,11,13,14
2023-24,202401270MIL,1/27/2024,MIL vs NOP,Andre Jackson Jr.,jacksan01,39,MIL,1,NOP,3,2,2,1,0,0,17.4,0,2,1,1,1,1,0,0,3,1,4,5,5,7,11.4
2023-24,202401270BOS,1/27/2024,BOS vs LAC,Norman Powell,powelno01,44,LAC,0,BOS,4,4,2,1,0,0,17.4,0,4,2,7,0,2,0,0,2,1,6,6,8,10,14.8
2023-24,202401270MIL,1/27/2024,MIL vs NOP,Larry Nance Jr.,nancela02,29,NOP,0,MIL,10,5,0,0,0,0,17.5,2,3,3,6,2,3,2,2,2,0,5,10,15,15,16
2023-24,202401270BOS,1/27/2024,BOS vs LAC,Luke Kornet,kornelu01,33,BOS,1,LAC,11,5,0,0,1,0,17.56666667,4,1,5,10,0,0,1,1,2,1,5,11,16,16,20
2023-24,202401270CHO,1/27/2024,CHO vs UTA,Kelly Olynyk,olynyke01,45,UTA,0,CHO,6,9,8,1,0,4,17.68333333,1,8,2,2,1,1,1,2,2,1,17,14,15,23,27.8
2023-24,202401270MIL,1/27/2024,MIL vs NOP,Cameron Payne,payneca01,42,MIL,1,NOP,11,2,5,2,0,0,17.68333333,0,2,4,7,3,4,0,0,0,2,7,16,13,18,26.9
2023-24,202401270BRK,1/27/2024,BRK vs HOU,Dennis Smith Jr.,smithde03,30,BRK,1,HOU,5,3,4,2,0,1,17.71666667,1,2,2,4,0,1,1,2,2,2,7,9,8,12,19.6
2023-24,202401270SAS,1/27/2024,SAS vs MIN,Julian Champagnie,champju02,39,SAS,1,MIN,4,3,0,0,0,0,17.81666667,2,1,1,4,1,3,1,2,1,0,3,4,7,7,7.6
2023-24,202401270GSW,1/27/2024,GSW vs LAL,Rui Hachimura,hachiru01,34,LAL,0,GSW,11,4,0,0,0,1,17.85,0,4,4,4,1,1,2,2,1,0,4,11,15,15,14.8
2023-24,202401270DET,1/27/2024,DET vs WAS,Alec Burks,burksal01,38,DET,1,WAS,8,4,0,0,0,0,17.96666667,0,4,2,9,1,5,3,4,1,0,4,8,12,12,12.8
2023-24,202401270MIL,1/27/2024,MIL vs NOP,Dyson Daniels,daniedy01,46,NOP,0,MIL,0,2,3,1,1,2,17.98333333,0,2,0,1,0,0,0,0,1,2,5,3,2,5,10.9
2023-24,202401270BRK,1/27/2024,BRK vs HOU,Aaron Holiday,holidaa01,43,HOU,0,BRK,6,3,1,0,0,2,18.05,1,2,3,6,0,0,0,0,2,0,4,7,9,10,9.1
2023-24,202401270SAS,1/27/2024,SAS vs MIN,Dominick Barlow,barlodo01,20,SAS,1,MIN,9,4,1,0,1,0,18.25,2,2,4,5,0,0,1,2,1,1,5,10,13,14,18.3
2023-24,202401270DEN,1/27/2024,DEN vs PHI,Reggie Jackson,jacksre01,47,DEN,1,PHI,3,3,0,0,0,0,18.28333333,0,3,1,6,1,4,0,0,0,0,3,3,6,6,6.6
2023-24,202401270DEN,1/27/2024,DEN vs PHI,KJ Martin,martike04,30,PHI,0,DEN,7,4,1,0,0,2,18.68333333,0,4,3,5,0,1,1,2,4,0,5,8,11,12,11.3
2023-24,202401270DAL,1/27/2024,DAL vs SAC,Jaden Hardy,hardyja02,41,DAL,1,SAC,3,5,7,0,0,1,18.9,2,3,1,7,1,5,0,0,2,0,12,10,8,15,18.5
2023-24,202401270BOS,1/27/2024,BOS vs LAC,Al Horford,horfoal01,38,BOS,1,LAC,0,2,1,0,0,1,19.21666667,0,2,0,5,0,4,0,0,1,0,3,1,2,3,2.9
2023-24,202401270SAS,1/27/2024,SAS vs MIN,Kyle Anderson,anderky01,46,MIN,0,SAS,4,3,1,1,0,1,19.33333333,2,1,2,6,0,0,0,2,0,1,4,5,7,8,11.1
2023-24,202401270CHO,1/27/2024,CHO vs UTA,Nick Smith Jr.,smithni01,29,CHO,1,UTA,3,0,4,1,0,0,19.38333333,0,0,1,4,1,3,0,0,3,1,4,7,3,7,12
2023-24,202401270SAS,1/27/2024,SAS vs MIN,Blake Wesley,weslebl01,25,SAS,1,MIN,2,0,3,0,1,1,19.5,0,0,1,2,0,0,0,0,1,1,3,5,2,5,8.5
2023-24,202401270DAL,1/27/2024,DAL vs SAC,Malik Monk,monkma01,43,SAC,0,DAL,9,3,6,0,0,3,19.53333333,0,3,2,5,0,2,5,7,0,0,9,15,12,18,18.6
2023-24,202401270NYK,1/27/2024,NYK vs MIA,Donte DiVincenzo,divindo01,46,NYK,1,MIA,11,1,2,1,0,0,19.61666667,1,0,4,10,3,6,0,0,1,1,3,13,12,14,18.2
2023-24,202401270MIL,1/27/2024,MIL vs NOP,Herbert Jones,joneshe01,43,NOP,0,MIL,9,0,0,0,1,0,19.61666667,0,0,4,9,1,4,0,0,3,1,0,9,9,9,12
2023-24,202401270MIL,1/27/2024,MIL vs NOP,Pat Connaughton,connapa01,40,MIL,1,NOP,5,3,4,1,0,1,19.66666667,2,1,2,4,1,3,0,0,1,1,7,9,8,12,16.6
2023-24,202401270BOS,1/27/2024,BOS vs LAC,Sam Hauser,hausesa01,45,BOS,1,LAC,6,3,1,0,1,0,19.91666667,0,3,2,5,2,4,0,0,1,1,4,7,9,10,14.1
2023-24,202401270DET,1/27/2024,DET vs WAS,Marvin Bagley III,baglema01,32,WAS,0,DET,13,8,2,1,0,3,19.93333333,5,3,3,7,0,0,7,8,4,1,10,15,21,23,25.6
2023-24,202401270MIL,1/27/2024,MIL vs NOP,Jose Alvarado,alvarjo01,29,NOP,0,MIL,4,1,2,2,0,0,20.76666667,0,1,1,2,0,0,2,2,4,2,3,6,5,7,14.2
2023-24,202401270DEN,1/27/2024,DEN vs PHI,Peyton Watson,watsope01,45,DEN,1,PHI,9,3,3,1,1,0,20.85,0,3,3,7,0,3,3,6,1,2,6,12,12,15,23.1
2023-24,202401270BOS,1/27/2024,BOS vs LAC,Payton Pritchard,pritcpa01,46,BOS,1,LAC,12,4,2,0,0,0,21.01666667,0,4,4,8,3,7,1,1,1,0,6,14,16,18,19.8
2023-24,202401270NYK,1/27/2024,NYK vs MIA,Haywood Highsmith,highsha01,32,MIA,0,NYK,8,4,2,0,2,0,21.05,1,3,3,5,2,4,0,0,2,2,6,10,12,14,21.8
2023-24,202401270BOS,1/27/2024,BOS vs LAC,Mason Plumlee,plumlma01,14,LAC,0,BOS,8,7,0,0,1,0,21.15,2,5,4,4,0,0,0,0,2,1,7,8,15,15,19.4
2023-24,202401270SAS,1/27/2024,SAS vs MIN,Naz Reid,reidna01,46,MIN,0,SAS,13,2,0,0,3,1,21.85,0,2,5,12,2,5,1,2,2,3,2,13,15,15,23.4
2023-24,202401270DET,1/27/2024,DET vs WAS,Corey Kispert,kispeco01,44,WAS,0,DET,8,2,1,0,0,2,22.03333333,0,2,3,7,2,5,0,0,2,0,3,9,10,11,9.9
2023-24,202401270MIL,1/27/2024,MIL vs NOP,Bobby Portis,portibo01,46,MIL,1,NOP,20,7,2,1,0,1,22.15,1,6,9,15,2,5,0,0,6,1,9,22,27,29,33.4
2023-24,202401270MIL,1/27/2024,MIL vs NOP,Jae Crowder,crowdja01,15,MIL,1,NOP,5,4,1,0,0,0,22.4,1,3,2,5,1,4,0,0,3,0,5,6,9,10,11.3
2023-24,202401270BOS,1/27/2024,BOS vs LAC,Paul George,georgpa01,42,LAC,0,BOS,17,6,1,2,0,1,22.48333333,1,5,5,11,3,6,4,4,2,2,7,18,23,24,30.7
2023-24,202401270MIL,1/27/2024,MIL vs NOP,CJ McCollum,mccolcj01,32,NOP,0,MIL,7,1,4,0,1,2,22.55,0,1,2,7,1,4,2,2,2,1,5,11,8,12,15.2
2023-24,202401270BRK,1/27/2024,BRK vs HOU,Royce O'Neale,onealro01,44,BRK,1,HOU,6,6,0,0,1,2,23.36666667,0,6,2,3,2,3,0,0,2,1,6,6,12,12,14.2
2023-24,202401270NYK,1/27/2024,NYK vs MIA,Jaime Jaquez Jr.,jaqueja01,40,MIA,0,NYK,6,1,4,2,1,0,23.68333333,0,1,1,3,1,2,3,4,4,3,5,10,7,11,22.2
2023-24,202401270MIL,1/27/2024,MIL vs NOP,Jonas Valanciunas,valanjo01,46,NOP,0,MIL,13,10,6,0,0,0,23.7,1,9,6,8,1,3,0,0,3,0,16,19,23,29,34
2023-24,202401270DET,1/27/2024,DET vs WAS,Deni Avdija,avdijde01,45,WAS,0,DET,10,5,2,0,1,0,23.85,1,4,4,8,1,1,1,2,3,1,7,12,15,17,22
2023-24,202401270BOS,1/27/2024,BOS vs LAC,Terance Mann,mannte01,38,LAC,0,BOS,14,6,3,0,0,0,24,3,3,6,12,1,3,1,2,2,0,9,17,20,23,25.7
2023-24,202401270BOS,1/27/2024,BOS vs LAC,Jaylen Brown,brownja02,43,BOS,1,LAC,8,6,2,0,1,1,24.16666667,5,1,3,13,0,2,2,2,3,1,8,10,14,16,20.2
2023-24,202401270GSW,1/27/2024,GSW vs LAL,Taurean Prince,princta02,45,LAL,0,GSW,0,3,1,1,0,1,24.25,0,3,0,2,0,1,0,0,4,1,4,1,3,4,7.1
2023-24,202401270NYK,1/27/2024,NYK vs MIA,Quentin Grimes,grimequ01,43,NYK,1,MIA,12,4,1,1,0,0,24.35,1,3,3,6,2,5,4,8,2,1,5,13,16,17,21.3
2023-24,202401270BOS,1/27/2024,BOS vs LAC,Derrick White,whitede01,42,BOS,1,LAC,2,2,2,0,3,1,24.48333333,0,2,0,8,0,4,2,2,2,3,4,4,4,6,15.4
2023-24,202401270DEN,1/27/2024,DEN vs PHI,Nicolas Batum,batumni01,33,PHI,0,DEN,0,4,2,0,0,1,25.9,0,4,0,1,0,0,0,0,3,0,6,2,4,6,6.8
2023-24,202401270DET,1/27/2024,DET vs WAS,Jaden Ivey,iveyja01,41,DET,1,WAS,10,4,1,0,2,3,26,2,2,4,8,2,3,0,0,3,2,5,11,14,15,19.3
2023-24,202401270BOS,1/27/2024,BOS vs LAC,Daniel Theis,theisda01,34,LAC,0,BOS,18,7,2,1,2,0,26.15,1,6,8,9,2,3,0,1,4,3,9,20,25,27,38.4
2023-24,202401270NYK,1/27/2024,NYK vs MIA,Duncan Robinson,robindu01,44,MIA,0,NYK,19,1,3,1,0,3,26.43333333,0,1,6,14,5,11,2,2,4,1,4,22,20,23,24.7
2023-24,202401270BOS,1/27/2024,BOS vs LAC,Amir Coffey,coffeam01,32,LAC,0,BOS,10,3,1,0,2,0,26.46666667,1,2,4,9,0,4,2,2,0,2,4,11,13,14,21.1
2023-24,202401270BOS,1/27/2024,BOS vs LAC,James Harden,hardeja01,39,LAC,0,BOS,9,8,7,0,0,1,26.8,1,7,2,11,0,6,5,6,2,0,15,16,17,24,28.1
2023-24,202401270SAS,1/27/2024,SAS vs MIN,Keldon Johnson,johnske04,44,SAS,1,MIN,14,7,2,2,2,1,27,5,2,6,14,1,3,1,2,2,4,9,16,21,23,36.4
2023-24,202401270CHO,1/27/2024,CHO vs UTA,Simone Fontecchio,fontesi01,45,UTA,0,CHO,5,3,3,1,0,0,27.18333333,1,2,2,6,1,4,0,0,1,1,6,8,8,11,16.1
2023-24,202401270BRK,1/27/2024,BRK vs HOU,Alperen Sengun,sengual01,45,HOU,0,BRK,15,11,2,0,0,3,27.5,5,6,6,13,0,1,3,4,2,0,13,17,26,28,28.2
2023-24,202401270DET,1/27/2024,DET vs WAS,Daniel Gafford,gaffoda01,40,WAS,0,DET,15,13,1,3,0,0,27.56666667,6,7,7,10,0,0,1,2,2,3,14,16,28,29,41.1
2023-24,202401270BOS,1/27/2024,BOS vs LAC,Jrue Holiday,holidjr01,42,BOS,1,LAC,7,3,4,1,0,2,27.61666667,0,3,2,11,1,7,2,2,1,1,7,11,10,14,17.6
2023-24,202401270DEN,1/27/2024,DEN vs PHI,Danuel House Jr.,houseda01,29,PHI,0,DEN,6,3,0,2,1,0,27.78333333,1,2,3,7,0,3,0,1,4,3,3,6,9,9,18.6
2023-24,202401270MIL,1/27/2024,MIL vs NOP,Brandon Ingram,ingrabr01,42,NOP,0,MIL,26,6,1,0,0,1,27.86666667,0,6,9,18,2,2,6,8,0,0,7,27,32,33,33.7
2023-24,202401270GSW,1/27/2024,GSW vs LAL,Brandin Podziemski,podzibr01,37,GSW,1,LAL,10,7,5,1,0,1,27.96666667,4,3,4,9,1,3,1,1,1,1,12,15,17,22,27.9
2023-24,202401270MIL,1/27/2024,MIL vs NOP,Malik Beasley,beaslma01,44,MIL,1,NOP,8,4,2,2,0,2,28.36666667,1,3,3,10,1,7,1,2,2,2,6,10,12,14,19.8
2023-24,202401270SAS,1/27/2024,SAS vs MIN,Tre Jones,jonestr01,41,SAS,1,MIN,12,3,11,0,0,2,28.5,3,0,5,7,2,3,0,0,3,0,14,23,15,26,30.1
2023-24,202401270MIL,1/27/2024,MIL vs NOP,Damian Lillard,lillada01,43,MIL,1,NOP,26,6,9,2,0,0,28.53333333,0,6,7,14,3,7,9,10,1,2,15,35,32,41,52.7
2023-24,202401270CHO,1/27/2024,CHO vs UTA,Ish Smith,smithis01,37,CHO,1,UTA,0,3,12,1,0,0,28.68333333,0,3,0,5,0,0,0,0,3,1,15,12,3,15,24.6
2023-24,202401270MIL,1/27/2024,MIL vs NOP,Giannis Antetokounmpo,antetgi01,44,MIL,1,NOP,30,12,4,2,0,1,28.91666667,1,11,11,16,1,1,7,11,3,2,16,34,42,46,55.4
2023-24,202401270BRK,1/27/2024,BRK vs HOU,Cam Whitmore,whitmca01,22,HOU,0,BRK,19,9,1,0,1,0,28.95,3,6,6,16,3,7,4,4,1,1,10,20,28,29,34.3
2023-24,202401270BOS,1/27/2024,BOS vs LAC,Kawhi Leonard,leonaka01,40,LAC,0,BOS,26,7,2,2,2,2,29.01666667,1,6,10,15,3,5,3,3,1,4,9,28,33,35,47.4
2023-24,202401270MIL,1/27/2024,MIL vs NOP,Zion Williamson,willizi01,37,NOP,0,MIL,23,2,2,1,0,5,29.06666667,1,1,8,14,0,0,7,7,0,1,4,25,25,27,26.4
2023-24,202401270DET,1/27/2024,DET vs WAS,Jordan Poole,poolejo01,44,WAS,0,DET,17,1,2,1,0,0,29.16666667,1,0,6,12,3,6,2,2,1,1,3,19,18,20,24.2
2023-24,202401270MIL,1/27/2024,MIL vs NOP,Jordan Hawkins,hawkijo01,41,NOP,0,MIL,8,7,1,0,0,3,29.33333333,1,6,2,10,2,6,2,2,0,0,8,9,15,16,14.9
2023-24,202401270CHO,1/27/2024,CHO vs UTA,Cody Martin,martico01,14,CHO,1,UTA,9,7,6,0,0,1,29.35,0,7,3,8,1,3,2,4,2,0,13,15,16,22,25.4
2023-24,202401270SAS,1/27/2024,SAS vs MIN,Victor Wembanyama,wembavi01,40,SAS,1,MIN,23,10,6,2,2,6,29.75,0,10,9,17,3,6,2,5,3,4,16,29,33,39,50
2023-24,202401270BOS,1/27/2024,BOS vs LAC,Jayson Tatum,tatumja01,43,BOS,1,LAC,21,11,1,0,1,3,30.03333333,3,8,8,18,2,4,3,3,2,1,12,22,32,33,35.7
2023-24,202401270DET,1/27/2024,DET vs WAS,Tyus Jones,jonesty01,45,WAS,0,DET,12,1,9,2,1,1,30.05,0,1,5,12,1,4,1,1,1,3,10,21,13,22,34.7
2023-24,202401270DAL,1/27/2024,DAL vs SAC,Kevin Huerter,huertke01,42,SAC,0,DAL,18,4,5,0,2,0,30.11666667,0,4,7,11,4,8,0,0,2,2,9,23,22,27,36.3
2023-24,202401270BRK,1/27/2024,BRK vs HOU,Dorian Finney-Smith,finnedo01,42,BRK,1,HOU,19,7,3,2,2,3,30.58333333,0,7,7,12,4,8,1,4,2,4,10,22,26,29,40.9
2023-24,202401270SAS,1/27/2024,SAS vs MIN,Jeremy Sochan,sochaje01,46,SAS,1,MIN,13,4,2,0,1,2,30.66666667,2,2,5,9,0,1,3,4,0,1,6,15,17,19,21.8
2023-24,202401270DAL,1/27/2024,DAL vs SAC,Dereck Lively II,livelde01,35,DAL,1,SAC,13,9,0,1,0,1,31.05,4,5,6,9,0,0,1,2,5,1,9,13,22,22,25.8
2023-24,202401270DEN,1/27/2024,DEN vs PHI,Aaron Gordon,gordoaa01,41,DEN,1,PHI,18,4,2,1,0,1,31.06666667,2,2,6,8,2,3,4,6,1,1,6,20,22,24,27.8
2023-24,202401270DET,1/27/2024,DET vs WAS,Bilal Coulibaly,coulibi01,44,WAS,0,DET,8,7,2,1,1,1,31.16666667,0,7,2,7,1,3,3,3,3,2,9,10,15,17,24.4
2023-24,202401270NYK,1/27/2024,NYK vs MIA,Precious Achiuwa,achiupr01,39,NYK,1,MIA,4,10,1,1,2,0,31.2,3,7,2,7,0,0,0,0,2,3,11,5,14,15,26.5
2023-24,202401270CHO,1/27/2024,CHO vs UTA,Jordan Clarkson,clarkjo01,37,UTA,0,CHO,14,1,2,0,0,0,31.31666667,1,0,6,15,1,5,1,1,3,0,3,16,15,17,18.2
2023-24,202401270CHO,1/27/2024,CHO vs UTA,John Collins,collijo01,43,UTA,0,CHO,20,10,0,0,2,0,31.75,3,7,9,13,1,4,1,2,4,2,10,20,30,30,38
2023-24,202401270NYK,1/27/2024,NYK vs MIA,Josh Hart,hartjo01,45,NYK,1,MIA,14,9,5,0,0,1,32.03333333,1,8,5,7,2,3,2,2,1,0,14,19,23,28,31.3
2023-24,202401270NYK,1/27/2024,NYK vs MIA,Julius Randle,randlju01,46,NYK,1,MIA,19,9,3,0,0,4,32.08333333,3,6,6,14,3,4,4,4,2,0,12,22,28,31,30.3
2023-24,202401270DET,1/27/2024,DET vs WAS,Kyle Kuzma,kuzmaky01,45,WAS,0,DET,30,6,4,1,1,1,32.1,0,6,13,27,3,13,1,2,1,2,10,34,36,40,48.2
2023-24,202401270DET,1/27/2024,DET vs WAS,Isaiah Stewart,stewais01,34,DET,1,WAS,11,7,2,0,0,0,32.1,4,3,3,7,0,2,5,6,2,0,9,13,18,20,22.4
2023-24,202401270SAS,1/27/2024,SAS vs MIN,Karl-Anthony Towns,townska01,45,MIN,0,SAS,19,5,4,1,2,3,32.23333333,0,5,9,16,1,4,0,1,3,3,9,23,24,28,37
2023-24,202401270NYK,1/27/2024,NYK vs MIA,Terry Rozier,roziete01,33,MIA,0,NYK,10,5,7,0,0,2,32.26666667,0,5,4,12,0,2,2,2,1,0,12,17,15,22,24.5
2023-24,202401270SAS,1/27/2024,SAS vs MIN,Nickeil Alexander-Walker,alexani01,46,MIN,0,SAS,11,4,7,1,0,1,32.65,1,3,4,7,3,4,0,0,1,1,11,18,15,22,28.3
2023-24,202401270DEN,1/27/2024,DEN vs PHI,Kentavious Caldwell-Pope,caldwke01,45,DEN,1,PHI,8,1,2,0,0,0,32.93333333,0,1,2,8,0,3,4,4,3,0,3,10,9,11,12.2
2023-24,202401270DEN,1/27/2024,DEN vs PHI,Marcus Morris,morrima03,34,PHI,0,DEN,17,4,2,0,0,1,32.98333333,0,4,7,16,1,5,2,2,2,0,6,19,21,23,23.8
2023-24,202401270NYK,1/27/2024,NYK vs MIA,Bam Adebayo,adebaba01,36,MIA,0,NYK,12,13,1,0,0,2,33.2,3,10,6,10,0,0,0,0,1,0,14,13,25,26,27.1
2023-24,202401270BRK,1/27/2024,BRK vs HOU,Jalen Green,greenja05,45,HOU,0,BRK,19,10,1,1,0,1,33.3,1,9,5,14,4,9,5,5,3,1,11,20,29,30,34.5
2023-24,202401270SAS,1/27/2024,SAS vs MIN,Jaden McDaniels,mcdanja02,36,MIN,0,SAS,7,3,2,4,0,0,33.35,0,3,2,5,1,3,2,2,2,4,5,9,10,12,25.6
2023-24,202401270DAL,1/27/2024,DAL vs SAC,Josh Green,greenjo02,33,DAL,1,SAC,11,3,5,0,0,2,33.43333333,0,3,4,9,2,6,1,2,2,0,8,16,14,19,20.1
2023-24,202401270NYK,1/27/2024,NYK vs MIA,OG Anunoby,anunoog01,41,NYK,1,MIA,19,1,4,2,0,1,33.55,0,1,8,14,2,5,1,3,2,2,5,23,20,24,31.2
2023-24,202401270MIL,1/27/2024,MIL vs NOP,Brook Lopez,lopezbr01,46,MIL,1,NOP,24,3,0,1,0,2,34.6,0,3,8,11,6,9,2,2,2,1,3,24,27,27,28.6
2023-24,202401270DET,1/27/2024,DET vs WAS,Cade Cunningham,cunnica01,37,DET,1,WAS,20,4,12,0,0,7,34.68333333,0,4,7,17,2,3,4,6,3,0,16,32,24,36,35.8
2023-24,202401270DEN,1/27/2024,DEN vs PHI,Michael Porter Jr.,portemi01,47,DEN,1,PHI,20,8,2,0,0,1,35.13333333,3,5,8,19,4,12,0,0,2,0,10,22,28,30,31.6
2023-24,202401270CHO,1/27/2024,CHO vs UTA,Collin Sexton,sextoco01,47,UTA,0,CHO,24,4,13,2,0,3,35.35,2,2,9,19,3,7,3,5,0,2,17,37,28,41,51.3
2023-24,202401270NYK,1/27/2024,NYK vs MIA,Tyler Herro,herroty01,27,MIA,0,NYK,18,1,3,0,0,1,35.4,0,1,7,18,4,11,0,0,2,0,4,21,19,22,22.7
2023-24,202401270BRK,1/27/2024,BRK vs HOU,Spencer Dinwiddie,dinwisp01,43,BRK,1,HOU,10,2,9,1,1,2,35.41666667,0,2,3,11,0,4,4,6,3,2,11,19,12,21,29.9
2023-24,202401270CHO,1/27/2024,CHO vs UTA,P.J. Washington,washipj01,38,CHO,1,UTA,43,2,3,2,0,2,35.55,1,1,17,22,7,9,2,3,1,2,5,46,45,48,53.9
2023-24,202401270DET,1/27/2024,DET vs WAS,Bojan Bogdanovic,bogdabo02,24,DET,1,WAS,30,3,3,1,0,2,35.6,0,3,10,19,4,10,6,7,1,1,6,33,33,36,39.1
2023-24,202401270CHO,1/27/2024,CHO vs UTA,Lauri Markkanen,markkla01,37,UTA,0,CHO,33,12,3,1,0,2,35.63333333,3,9,12,18,7,12,2,2,5,1,15,36,45,48,52.9
2023-24,202401270DAL,1/27/2024,DAL vs SAC,Tim Hardaway Jr.,hardati02,43,DAL,1,SAC,19,4,1,0,0,1,35.78333333,0,4,8,17,3,9,0,0,2,0,5,20,23,24,24.3
2023-24,202401270NYK,1/27/2024,NYK vs MIA,Jimmy Butler,butleji01,31,MIA,0,NYK,28,8,4,3,0,0,36.03333333,4,4,11,20,1,3,5,6,2,3,12,32,36,40,52.6
2023-24,202401270SAS,1/27/2024,SAS vs MIN,Devin Vassell,vassede01,41,SAS,1,MIN,25,4,5,2,0,2,36.03333333,0,4,11,17,3,6,0,0,2,2,9,30,29,34,41.3
2023-24,202401270DET,1/27/2024,DET vs WAS,Jalen Duren,durenja01,30,DET,1,WAS,10,18,3,0,0,1,36.05,3,15,5,6,0,0,0,0,4,0,21,13,28,31,35.1
2023-24,202401270DAL,1/27/2024,DAL vs SAC,Domantas Sabonis,sabondo01,44,SAC,0,DAL,17,11,4,0,0,6,36.28333333,3,8,7,10,1,1,2,2,6,0,15,21,28,32,30.2
2023-24,202401270CHO,1/27/2024,CHO vs UTA,Nick Richards,richani01,35,CHO,1,UTA,26,13,1,0,4,4,36.41666667,7,6,10,11,0,0,6,8,4,4,14,27,39,40,51.1
2023-24,202401270DEN,1/27/2024,DEN vs PHI,Patrick Beverley,beverpa01,41,PHI,0,DEN,17,4,11,0,2,4,36.63333333,0,4,6,12,1,3,4,4,3,2,15,28,21,32,40.3
2023-24,202401270DEN,1/27/2024,DEN vs PHI,Nikola Jokic,jokicni01,46,DEN,1,PHI,26,16,7,2,0,3,36.66666667,5,11,8,16,0,1,10,16,3,2,23,33,42,49,58.7
2023-24,202401270DEN,1/27/2024,DEN vs PHI,Jamal Murray,murraja01,33,DEN,1,PHI,23,3,7,1,1,2,36.8,0,3,8,15,6,10,1,4,1,2,10,30,26,33,41.1
2023-24,202401270SAS,1/27/2024,SAS vs MIN,Rudy Gobert,goberru01,45,MIN,0,SAS,19,7,1,1,1,1,36.83333333,2,5,8,9,0,0,3,4,4,2,8,20,26,27,33.9
2023-24,202401270CHO,1/27/2024,CHO vs UTA,Brandon Miller,millebr02,38,CHO,1,UTA,12,1,3,1,0,1,36.91666667,0,1,6,18,0,7,0,0,3,1,4,15,13,16,19.7
2023-24,202401270BRK,1/27/2024,BRK vs HOU,Nic Claxton,claxtni01,35,BRK,1,HOU,10,13,4,1,1,3,37.1,1,12,5,7,0,1,0,4,5,2,17,14,23,27,34.6
2023-24,202401270DAL,1/27/2024,DAL vs SAC,De'Aaron Fox,foxde01,38,SAC,0,DAL,34,3,5,2,2,2,37.36666667,1,2,13,24,1,5,7,8,3,4,8,39,37,42,55.1
2023-24,202401270DAL,1/27/2024,DAL vs SAC,Harrison Barnes,barneha02,44,SAC,0,DAL,20,6,3,1,1,0,38.05,1,5,6,11,4,7,4,5,1,2,9,23,26,29,37.7
2023-24,202401270NYK,1/27/2024,NYK vs MIA,Jalen Brunson,brunsja01,44,NYK,1,MIA,32,5,8,1,1,0,38.26666667,0,5,12,22,4,8,4,5,2,2,13,40,37,45,56
2023-24,202401270DAL,1/27/2024,DAL vs SAC,Grant Williams,willigr01,42,DAL,1,SAC,27,8,3,3,1,0,38.36666667,3,5,9,16,7,10,2,2,5,4,11,30,35,38,53.1
2023-24,202401270SAS,1/27/2024,SAS vs MIN,Anthony Edwards,edwaran01,43,MIN,0,SAS,32,6,12,1,0,4,38.4,1,5,12,18,6,8,2,4,0,1,18,44,38,50,56.2
2023-24,202401270BRK,1/27/2024,BRK vs HOU,Dillon Brooks,brookdi01,36,HOU,0,BRK,19,5,2,1,0,2,38.58333333,1,4,7,18,1,7,4,4,6,1,7,21,24,26,29
2023-24,202401270BRK,1/27/2024,BRK vs HOU,Fred VanVleet,vanvlfr01,43,HOU,0,BRK,13,4,8,1,0,4,38.88333333,0,4,4,12,1,9,4,6,5,1,12,21,17,25,28.8
2023-24,202401270DAL,1/27/2024,DAL vs SAC,Keegan Murray,murrake02,40,SAC,0,DAL,15,4,2,0,3,0,39.56666667,1,3,5,13,1,6,4,6,4,3,6,17,19,21,31.8
2023-24,202401270DEN,1/27/2024,DEN vs PHI,Kelly Oubre Jr.,oubreke01,32,PHI,0,DEN,25,5,4,0,2,1,39.83333333,2,3,9,17,1,4,6,7,5,2,9,29,30,34,42
2023-24,202401270BRK,1/27/2024,BRK vs HOU,Mikal Bridges,bridgmi01,45,BRK,1,HOU,19,5,1,3,1,3,40.7,0,5,6,14,3,8,4,6,3,4,6,20,24,25,35.5
2023-24,202401270CHO,1/27/2024,CHO vs UTA,Miles Bridges,bridgmi02,33,CHO,1,UTA,21,9,6,2,2,1,40.9,1,8,8,19,3,8,2,2,2,4,15,27,30,36,51.8
2023-24,202401270GSW,1/27/2024,GSW vs LAL,Jarred Vanderbilt,vandeja01,27,LAL,0,GSW,14,9,5,4,0,2,41,2,7,4,7,0,0,6,8,1,4,14,19,23,28,42.3
2023-24,202401270GSW,1/27/2024,GSW vs LAL,Andrew Wiggins,wiggian01,39,GSW,1,LAL,22,5,3,2,1,2,41.36666667,1,4,8,12,3,4,3,5,6,3,8,25,27,30,39.5
2023-24,202401270BRK,1/27/2024,BRK vs HOU,Cam Thomas,thomaca02,36,BRK,1,HOU,37,3,3,1,0,5,41.43333333,0,3,11,19,3,6,12,15,4,1,6,40,40,43,43.1
2023-24,202401270DEN,1/27/2024,DEN vs PHI,Paul Reed,reedpa01,44,PHI,0,DEN,30,13,1,2,0,0,42.06666667,3,10,14,21,2,4,0,0,5,2,14,31,43,44,53.1
2023-24,202401270GSW,1/27/2024,GSW vs LAL,Jonathan Kuminga,kuminjo01,42,GSW,1,LAL,22,9,2,0,0,2,43.18333333,4,5,8,16,2,3,4,6,5,0,11,24,31,33,33.8
2023-24,202401270GSW,1/27/2024,GSW vs LAL,Stephen Curry,curryst01,40,GSW,1,LAL,46,3,7,1,0,4,43.41666667,0,3,17,35,9,21,3,3,4,1,10,53,49,56,59.1
2023-24,202401270GSW,1/27/2024,GSW vs LAL,Anthony Davis,davisan02,46,LAL,0,GSW,29,13,3,0,4,2,44.56666667,3,10,11,24,0,4,7,9,4,4,16,32,42,45,59.1
2023-24,202401270GSW,1/27/2024,GSW vs LAL,Draymond Green,greendr01,19,GSW,1,LAL,8,14,11,3,2,2,45.7,0,14,4,9,0,4,0,0,5,5,25,19,22,33,54.3
2023-24,202401270DAL,1/27/2024,DAL vs SAC,Luka Doncic,doncilu01,39,DAL,1,SAC,28,10,17,2,1,3,46.13333333,2,8,9,26,1,9,9,12,3,3,27,45,38,55,71.5
2023-24,202401270GSW,1/27/2024,GSW vs LAL,Austin Reaves,reaveau01,48,LAL,0,GSW,17,2,6,2,0,5,46.76666667,0,2,4,14,1,7,8,9,3,2,8,23,19,25,29.4
2023-24,202401270GSW,1/27/2024,GSW vs LAL,Klay Thompson,thompkl01,42,GSW,1,LAL,24,4,4,2,0,2,46.96666667,0,4,9,24,6,17,0,0,6,2,8,28,28,32,38.8
2023-24,202401270GSW,1/27/2024,GSW vs LAL,LeBron James,jamesle01,43,LAL,0,GSW,36,20,12,0,0,3,47.66666667,1,19,14,25,2,4,6,6,2,0,32,48,56,68,75
2023-24,202401270GSW,1/27/2024,GSW vs LAL,D'Angelo Russell,russeda01,44,LAL,0,GSW,28,3,5,2,1,4,48.8,1,2,8,19,5,8,7,7,4,3,8,33,31,36,44.1
2023-24,202401260SAS,1/26/2024,SAS vs POR,Jerami Grant,grantje01,40,POR,0,SAS,4,1,2,0,0,1,10.35,0,1,2,6,0,1,0,0,1,0,3,6,5,7,7.2
2023-24,202401260CHO,1/26/2024,CHO vs HOU,Jae'Sean Tate,tateja01,41,HOU,0,CHO,2,1,0,0,0,1,10.81666667,0,1,1,3,0,1,0,0,1,0,1,2,3,3,2.2
2023-24,202401260MIL,1/26/2024,MIL vs CLE,Cameron Payne,payneca01,41,MIL,1,CLE,4,2,0,0,1,0,11.03333333,0,2,1,3,1,2,1,2,2,1,2,4,6,6,9.4
2023-24,202401260MEM,1/26/2024,MEM vs ORL,GG Jackson II,jacksgg01,13,MEM,1,ORL,5,0,1,0,0,0,11.16666667,0,0,2,2,0,0,1,1,2,0,1,6,5,6,6.5
2023-24,202401260MIL,1/26/2024,MIL vs CLE,Damian Jones,jonesda03,20,CLE,0,MIL,4,7,1,0,2,1,12.2,3,4,1,3,0,1,2,2,2,2,8,5,11,12,18.9
2023-24,202401260NOP,1/26/2024,NOP vs OKC,Jose Alvarado,alvarjo01,28,NOP,1,OKC,5,2,3,2,0,1,12.43333333,0,2,2,7,1,6,0,0,0,2,5,8,7,10,16.9
2023-24,202401260NOP,1/26/2024,NOP vs OKC,Isaiah Joe,joeis01,45,OKC,0,NOP,2,1,0,1,0,1,12.51666667,1,0,0,3,0,2,2,2,0,1,1,2,3,3,5.2
2023-24,202401260MEM,1/26/2024,MEM vs ORL,Moritz Wagner,wagnemo01,43,ORL,0,MEM,12,3,0,1,0,0,12.6,0,3,4,6,1,1,3,4,1,1,3,12,15,15,18.6
2023-24,202401260SAS,1/26/2024,SAS vs POR,Duop Reath,reathdu01,33,POR,0,SAS,3,3,0,0,0,0,12.63333333,1,2,1,4,0,2,1,2,2,0,3,3,6,6,6.6
2023-24,202401260MEM,1/26/2024,MEM vs ORL,Xavier Tillman Sr.,tillmxa01,32,MEM,1,ORL,5,2,0,1,2,0,12.66666667,0,2,2,7,0,1,1,2,2,3,2,5,7,7,16.4
2023-24,202401260NOP,1/26/2024,NOP vs OKC,Kenrich Williams,willike04,34,OKC,0,NOP,8,4,0,1,0,1,13.05,1,3,4,5,0,1,0,0,0,1,4,8,12,12,14.8
2023-24,202401260NOP,1/26/2024,NOP vs OKC,Naji Marshall,marshna01,36,NOP,1,OKC,0,1,0,1,0,1,13.08333333,0,1,0,4,0,3,0,0,1,1,1,0,1,1,3.2
2023-24,202401260IND,1/26/2024,IND vs PHO,Josh Okogie,okogijo01,39,PHO,0,IND,0,3,1,1,0,0,13.1,2,1,0,1,0,0,0,0,1,1,4,1,3,4,8.1
2023-24,202401260CHO,1/26/2024,CHO vs HOU,Leaky Black,blackle01,14,CHO,1,HOU,1,4,0,0,0,0,13.11666667,2,2,0,3,0,1,1,2,4,0,4,1,5,5,5.8
2023-24,202401260MEM,1/26/2024,MEM vs ORL,Jacob Gilyard,gilyaja01,28,MEM,1,ORL,0,1,2,1,0,0,13.15,0,1,0,3,0,3,0,0,0,1,3,2,1,3,7.2
2023-24,202401260SAS,1/26/2024,SAS vs POR,Doug McDermott,mcderdo01,40,SAS,1,POR,0,0,2,0,0,0,13.6,0,0,0,2,0,2,0,0,1,0,2,2,0,2,3
2023-24,202401260ATL,1/26/2024,ATL vs DAL,Jaden Hardy,hardyja02,40,DAL,0,ATL,8,1,1,1,0,0,13.75,1,0,2,6,1,3,3,4,1,1,2,9,9,10,13.7
2023-24,202401260ATL,1/26/2024,ATL vs DAL,Richaun Holmes,holmeri01,19,DAL,0,ATL,4,3,1,0,1,0,13.85,1,2,2,2,0,0,0,0,2,1,4,5,7,8,12.1
2023-24,202401260MIL,1/26/2024,MIL vs CLE,Pat Connaughton,connapa01,39,MIL,1,CLE,6,0,0,0,0,0,13.96666667,0,0,2,3,2,3,0,0,2,0,0,6,6,6,6
2023-24,202401260ATL,1/26/2024,ATL vs DAL,Garrison Mathews,mathega01,31,ATL,1,DAL,8,2,0,0,0,0,14.01666667,1,1,2,2,2,2,2,2,1,0,2,8,10,10,10.4
2023-24,202401260IND,1/26/2024,IND vs PHO,Buddy Hield,hieldbu01,47,IND,1,PHO,2,2,4,0,0,1,14.33333333,1,1,1,3,0,2,0,0,2,0,6,6,4,8,9.4
2023-24,202401260NOP,1/26/2024,NOP vs OKC,Jaylin Williams,willija07,37,OKC,0,NOP,0,6,1,1,0,0,14.68333333,1,5,0,2,0,1,0,0,2,1,7,1,6,7,11.7
2023-24,202401260CHO,1/26/2024,CHO vs HOU,Jock Landale,landajo01,26,HOU,0,CHO,6,6,2,1,1,0,15.18333333,4,2,3,5,0,0,0,0,2,2,8,8,12,14,22.2
2023-24,202401260IND,1/26/2024,IND vs PHO,Drew Eubanks,eubandr01,39,PHO,0,IND,8,5,1,0,0,1,15.93333333,2,3,4,4,0,0,0,0,1,0,6,9,13,14,14.5
2023-24,202401260NOP,1/26/2024,NOP vs OKC,Vasilije Micic,micicva01,25,OKC,0,NOP,3,2,1,0,0,2,16.63333333,0,2,1,2,0,0,1,1,0,0,3,4,5,6,4.9
2023-24,202401260TOR,1/26/2024,TOR vs LAC,Chris Boucher,bouchch01,42,TOR,1,LAC,9,5,0,0,0,0,16.76666667,3,2,4,8,0,3,1,2,1,0,5,9,14,14,15
2023-24,202401260MEM,1/26/2024,MEM vs ORL,David Roddy,roddyda01,42,MEM,1,ORL,3,10,3,0,0,1,17.11666667,3,7,1,4,0,1,1,2,2,0,13,6,13,16,18.5
2023-24,202401260MEM,1/26/2024,MEM vs ORL,Joe Ingles,inglejo01,31,ORL,0,MEM,2,0,0,0,0,0,17.2,0,0,1,5,0,4,0,0,0,0,0,2,2,2,2
2023-24,202401260NOP,1/26/2024,NOP vs OKC,Aaron Wiggins,wiggiaa01,42,OKC,0,NOP,8,2,1,0,0,1,17.23333333,0,2,3,5,2,2,0,0,1,0,3,9,10,11,10.9
2023-24,202401260CHO,1/26/2024,CHO vs HOU,Jeff Green,greenje02,42,HOU,0,CHO,0,1,0,0,0,0,17.28333333,0,1,0,1,0,1,0,0,1,0,1,0,1,1,1.2
2023-24,202401260NOP,1/26/2024,NOP vs OKC,Dyson Daniels,daniedy01,45,NOP,1,OKC,5,1,0,0,1,4,17.33333333,1,0,2,4,1,1,0,0,0,1,1,5,6,6,5.2
2023-24,202401260SAS,1/26/2024,SAS vs POR,Kris Murray,murrakr01,27,POR,0,SAS,2,2,0,1,0,0,17.33333333,0,2,1,9,0,6,0,1,3,1,2,2,4,4,7.4
2023-24,202401260CHO,1/26/2024,CHO vs HOU,Nick Smith Jr.,smithni01,28,CHO,1,HOU,10,1,0,0,0,3,17.35,0,1,4,6,2,2,0,0,2,0,1,10,11,11,8.2
2023-24,202401260MIL,1/26/2024,MIL vs CLE,Sam Merrill,merrisa01,28,CLE,0,MIL,7,0,0,0,0,0,17.4,0,0,3,6,1,4,0,0,3,0,0,7,7,7,7
2023-24,202401260SAS,1/26/2024,SAS vs POR,Cedi Osman,osmande01,45,SAS,1,POR,7,3,1,1,1,2,17.5,0,3,3,4,0,1,1,1,1,2,4,8,10,11,16.1
2023-24,202401260IND,1/26/2024,IND vs PHO,Myles Turner,turnemy01,46,IND,1,PHO,5,3,2,0,0,2,17.81666667,0,3,2,6,0,2,1,1,2,0,5,7,8,10,9.6
2023-24,202401260ATL,1/26/2024,ATL vs DAL,Derrick Jones Jr.,jonesde02,43,DAL,0,ATL,2,1,1,0,0,1,17.85,0,1,1,1,0,0,0,0,3,0,2,3,3,4,3.7
2023-24,202401260IND,1/26/2024,IND vs PHO,Ben Sheppard,sheppbe01,25,IND,1,PHO,2,2,2,0,0,1,18.03333333,0,2,1,4,0,3,0,0,2,0,4,4,4,6,6.4
2023-24,202401260SAS,1/26/2024,SAS vs POR,Zach Collins,colliza01,36,SAS,1,POR,4,3,0,0,0,1,18.15,2,1,1,6,0,4,2,2,4,0,3,4,7,7,6.6
2023-24,202401260TOR,1/26/2024,TOR vs LAC,Daniel Theis,theisda01,33,LAC,0,TOR,6,4,1,0,0,2,18.26666667,2,2,3,4,0,0,0,0,1,0,5,7,10,11,10.3
2023-24,202401260IND,1/26/2024,IND vs PHO,T.J. McConnell,mccontj01,39,IND,1,PHO,2,1,8,1,0,0,18.43333333,0,1,1,5,0,0,0,0,1,1,9,10,3,11,18.2
2023-24,202401260CHO,1/26/2024,CHO vs HOU,Aaron Holiday,holidaa01,42,HOU,0,CHO,10,1,6,0,0,2,18.6,0,1,4,6,2,4,0,0,2,0,7,16,11,17,18.2
2023-24,202401260SAS,1/26/2024,SAS vs POR,Julian Champagnie,champju02,38,SAS,1,POR,5,4,3,1,0,1,18.96666667,0,4,2,4,0,2,1,1,0,1,7,8,9,12,16.3
2023-24,202401260TOR,1/26/2024,TOR vs LAC,Amir Coffey,coffeam01,31,LAC,0,TOR,5,2,2,0,0,1,19.26666667,0,2,1,2,0,1,3,3,6,0,4,7,7,9,9.4
2023-24,202401260CHO,1/26/2024,CHO vs HOU,Cody Martin,martico01,13,CHO,1,HOU,6,1,0,0,0,0,19.28333333,0,1,3,8,0,1,0,1,2,0,1,6,7,7,7.2
2023-24,202401260CHO,1/26/2024,CHO vs HOU,Brandon Miller,millebr02,37,CHO,1,HOU,5,1,2,0,0,0,19.61666667,0,1,2,8,1,3,0,0,4,0,3,7,6,8,9.2
2023-24,202401260CHO,1/26/2024,CHO vs HOU,Ish Smith,smithis01,36,CHO,1,HOU,0,5,2,0,0,1,19.8,0,5,0,3,0,0,0,0,3,0,7,2,5,7,8
2023-24,202401260NOP,1/26/2024,NOP vs OKC,Jordan Hawkins,hawkijo01,40,NOP,1,OKC,9,1,4,0,0,1,19.88333333,0,1,2,5,2,4,3,3,1,0,5,13,10,14,15.2
2023-24,202401260IND,1/26/2024,IND vs PHO,Jusuf Nurkic,nurkiju01,43,PHO,0,IND,2,4,5,3,0,2,20.13333333,0,4,1,3,0,0,0,0,2,3,9,7,6,11,21.3
2023-24,202401260CHO,1/26/2024,CHO vs HOU,Cam Whitmore,whitmca01,21,HOU,0,CHO,24,11,2,0,0,0,20.26666667,2,9,9,18,4,9,2,2,2,0,13,26,35,37,40.2
2023-24,202401260IND,1/26/2024,IND vs PHO,Jalen Smith,smithja04,32,IND,1,PHO,13,10,0,1,1,2,20.41666667,5,5,6,11,1,3,0,1,2,2,10,13,23,23,29
2023-24,202401260NOP,1/26/2024,NOP vs OKC,Jonas Valanciunas,valanjo01,45,NOP,1,OKC,14,9,0,0,0,2,20.48333333,5,4,6,12,0,0,2,2,1,0,9,14,23,23,22.8
2023-24,202401260NOP,1/26/2024,NOP vs OKC,Cason Wallace,wallaca01,45,OKC,0,NOP,12,2,1,4,0,0,20.66666667,1,1,5,10,2,5,0,0,1,4,3,13,14,15,27.9
2023-24,202401260TOR,1/26/2024,TOR vs LAC,Gradey Dick,dickgr01,24,TOR,1,LAC,6,4,2,1,0,0,21.13333333,1,3,3,7,0,3,0,0,3,1,6,8,10,12,16.8
2023-24,202401260MEM,1/26/2024,MEM vs ORL,Markelle Fultz,fultzma01,13,ORL,0,MEM,10,3,3,0,0,1,21.26666667,1,2,5,7,0,0,0,0,1,0,6,13,13,16,17.1
2023-24,202401260MIL,1/26/2024,MIL vs CLE,Dean Wade,wadede01,36,CLE,0,MIL,9,5,0,0,1,0,21.36666667,0,5,3,5,3,4,0,0,1,1,5,9,14,14,18
2023-24,202401260IND,1/26/2024,IND vs PHO,Bennedict Mathurin,mathube01,47,IND,1,PHO,11,5,0,1,0,1,21.41666667,3,2,5,14,1,3,0,0,0,1,5,11,16,16,19
2023-24,202401260NOP,1/26/2024,NOP vs OKC,Larry Nance Jr.,nancela02,28,NOP,1,OKC,4,5,3,1,1,0,21.53333333,1,4,2,3,0,0,0,0,1,2,8,7,9,12,20.5
2023-24,202401260MIL,1/26/2024,MIL vs CLE,Bobby Portis,portibo01,45,MIL,1,CLE,12,8,0,1,0,1,21.66666667,1,7,4,8,3,3,1,2,3,1,8,12,20,20,23.6
2023-24,202401260SAS,1/26/2024,SAS vs POR,Justin Minaya,minayju01,12,POR,0,SAS,0,2,1,1,1,1,22.03333333,0,2,0,3,0,3,0,0,1,2,3,1,2,3,8.9
2023-24,202401260MEM,1/26/2024,MEM vs ORL,Jonathan Isaac,isaacjo01,27,ORL,0,MEM,10,5,0,0,0,0,22.15,2,3,4,5,0,1,2,2,0,0,5,10,15,15,16
2023-24,202401260MIL,1/26/2024,MIL vs CLE,Jae Crowder,crowdja01,14,MIL,1,CLE,6,3,0,0,0,0,22.18333333,0,3,2,4,2,4,0,0,2,0,3,6,9,9,9.6
2023-24,202401260NOP,1/26/2024,NOP vs OKC,Josh Giddey,giddejo01,44,OKC,0,NOP,4,5,6,1,1,1,22.66666667,0,5,2,4,0,1,0,0,0,2,11,10,9,15,24
2023-24,202401260CHO,1/26/2024,CHO vs HOU,Amen Thompson,thompam01,25,HOU,0,CHO,13,6,8,2,0,1,22.73333333,2,4,4,6,1,1,4,6,2,2,14,21,19,27,37.2
2023-24,202401260SAS,1/26/2024,SAS vs POR,Toumani Camara,camarto01,44,POR,0,SAS,12,4,1,2,1,3,23.13333333,2,2,4,9,0,1,4,4,0,3,5,13,16,17,24.3
2023-24,202401260CHO,1/26/2024,CHO vs HOU,LaMelo Ball,ballla01,22,CHO,1,HOU,15,2,8,2,0,3,23.26666667,0,2,6,16,2,9,1,2,4,2,10,23,17,25,32.4
2023-24,202401260MEM,1/26/2024,MEM vs ORL,Cole Anthony,anthoco01,44,ORL,0,MEM,5,7,4,2,0,0,23.36666667,0,7,2,8,0,4,1,2,0,2,11,9,12,16,25.4
2023-24,202401260ATL,1/26/2024,ATL vs DAL,Onyeka Okongwu,okongon01,44,ATL,1,DAL,8,6,2,1,0,1,23.43333333,2,4,2,5,0,0,4,4,4,1,8,10,14,16,20.2
2023-24,202401260SAS,1/26/2024,SAS vs POR,Blake Wesley,weslebl01,24,SAS,1,POR,1,2,8,2,0,1,23.71666667,0,2,0,5,0,1,1,2,1,2,10,9,3,11,20.4
2023-24,202401260TOR,1/26/2024,TOR vs LAC,Thaddeus Young,youngth01,17,TOR,1,LAC,12,6,4,1,1,0,23.96666667,4,2,6,6,0,0,0,2,3,2,10,16,18,22,31.2
2023-24,202401260SAS,1/26/2024,SAS vs POR,Tre Jones,jonestr01,40,SAS,1,POR,9,1,7,3,0,1,24.28333333,0,1,3,4,1,1,2,2,0,3,8,16,10,17,28.7
2023-24,202401260MIL,1/26/2024,MIL vs CLE,Caris LeVert,leverca01,33,CLE,0,MIL,12,4,5,1,0,1,24.36666667,1,3,3,10,1,4,5,6,5,1,9,17,16,21,26.3
2023-24,202401260ATL,1/26/2024,ATL vs DAL,Clint Capela,capelca01,43,ATL,1,DAL,10,8,2,0,1,1,24.56666667,3,5,4,7,0,0,2,3,2,1,10,12,18,20,24.6
2023-24,202401260CHO,1/26/2024,CHO vs HOU,Dillon Brooks,brookdi01,35,HOU,0,CHO,12,0,1,0,1,0,24.76666667,0,0,3,7,1,3,5,6,3,1,1,13,12,13,16.5
2023-24,202401260CHO,1/26/2024,CHO vs HOU,Alperen Sengun,sengual01,44,HOU,0,CHO,11,6,7,0,1,2,25.16666667,2,4,5,7,0,0,1,2,2,1,13,18,17,24,29.7
2023-24,202401260TOR,1/26/2024,TOR vs LAC,Mason Plumlee,plumlma01,13,LAC,0,TOR,12,12,3,0,0,1,25.21666667,4,8,6,12,0,0,0,0,1,0,15,15,24,27,29.9
2023-24,202401260NOP,1/26/2024,NOP vs OKC,Luguentz Dort,dortlu01,43,OKC,0,NOP,4,2,0,0,1,0,25.58333333,0,2,1,6,0,3,2,2,3,1,2,4,6,6,9.4
2023-24,202401260TOR,1/26/2024,TOR vs LAC,Norman Powell,powelno01,43,LAC,0,TOR,17,4,0,1,0,2,25.76666667,0,4,6,13,2,7,3,4,2,1,4,17,21,21,22.8
2023-24,202401260TOR,1/26/2024,TOR vs LAC,Russell Westbrook,westbru01,43,LAC,0,TOR,20,5,3,2,2,0,25.96666667,3,2,7,14,0,2,6,6,3,4,8,23,25,28,42.5
2023-24,202401260MEM,1/26/2024,MEM vs ORL,John Konchar,konchjo01,36,MEM,1,ORL,7,1,2,3,2,1,26.11666667,1,0,3,5,1,2,0,0,2,5,3,9,8,10,25.2
2023-24,202401260MIL,1/26/2024,MIL vs CLE,Georges Niang,niangge01,43,CLE,0,MIL,10,5,2,0,0,1,26.55,0,5,3,5,0,2,4,4,2,0,7,12,15,17,18
2023-24,202401260SAS,1/26/2024,SAS vs POR,Matisse Thybulle,thybuma01,43,POR,0,SAS,5,1,4,2,0,1,26.58333333,1,0,2,5,1,4,0,0,4,2,5,9,6,10,17.2
2023-24,202401260MEM,1/26/2024,MEM vs ORL,Anthony Black,blackan01,42,ORL,0,MEM,2,3,1,0,0,1,26.66666667,2,1,0,3,0,1,2,4,5,0,4,3,5,6,6.1
2023-24,202401260CHO,1/26/2024,CHO vs HOU,Nick Richards,richani01,34,CHO,1,HOU,14,7,1,0,3,0,26.83333333,2,5,3,6,0,0,8,11,1,3,8,15,21,22,32.9
2023-24,202401260MIL,1/26/2024,MIL vs CLE,Malik Beasley,beaslma01,43,MIL,1,CLE,3,3,1,0,0,2,26.85,1,2,1,2,1,2,0,0,4,0,4,4,6,7,6.1
2023-24,202401260ATL,1/26/2024,ATL vs DAL,Dante Exum,exumda01,32,DAL,0,ATL,9,0,3,0,0,1,26.86666667,0,0,3,6,2,2,1,2,2,0,3,12,9,12,12.5
2023-24,202401260ATL,1/26/2024,ATL vs DAL,Bogdan Bogdanovic,bogdabo01,43,ATL,1,DAL,24,4,2,2,0,0,27.26666667,2,2,9,22,4,9,2,2,2,2,6,26,28,30,37.8
2023-24,202401260ATL,1/26/2024,ATL vs DAL,Dereck Lively II,livelde01,34,DAL,0,ATL,9,11,4,1,4,1,27.55,2,9,4,7,0,0,1,2,5,5,15,13,20,24,42.2
2023-24,202401260ATL,1/26/2024,ATL vs DAL,Grant Williams,willigr01,41,DAL,0,ATL,9,5,4,0,0,1,28.01666667,0,5,3,6,1,3,2,2,4,0,9,13,14,18,20
2023-24,202401260NOP,1/26/2024,NOP vs OKC,Trey Murphy III,murphtr02,21,NOP,1,OKC,6,7,1,0,0,0,28.18333333,0,7,2,7,1,6,1,2,1,0,8,7,13,14,15.9
2023-24,202401260TOR,1/26/2024,TOR vs LAC,Dennis Schroder,schrode01,45,TOR,1,LAC,13,4,5,2,1,1,28.23333333,0,4,4,9,1,4,4,5,2,3,9,18,17,22,33.3
2023-24,202401260CHO,1/26/2024,CHO vs HOU,Jalen Green,greenja05,44,HOU,0,CHO,36,10,4,2,0,3,28.3,0,10,12,20,1,7,11,12,0,2,14,40,46,50,57
2023-24,202401260TOR,1/26/2024,TOR vs LAC,Paul George,georgpa01,41,LAC,0,TOR,21,2,1,1,2,2,28.31666667,0,2,6,15,3,9,6,7,0,3,3,22,23,24,31.9
2023-24,202401260NOP,1/26/2024,NOP vs OKC,Herbert Jones,joneshe01,42,NOP,1,OKC,14,4,1,0,1,2,28.5,0,4,6,12,2,7,0,0,4,1,5,15,18,19,21.3
2023-24,202401260CHO,1/26/2024,CHO vs HOU,P.J. Washington,washipj01,37,CHO,1,HOU,12,2,2,0,3,2,28.56666667,0,2,4,9,0,2,4,5,1,3,4,14,14,16,24.4
2023-24,202401260SAS,1/26/2024,SAS vs POR,Victor Wembanyama,wembavi01,39,SAS,1,POR,23,12,4,2,2,7,28.6,3,9,7,18,3,7,6,6,1,4,16,27,35,39,48.4
2023-24,202401260TOR,1/26/2024,TOR vs LAC,Terance Mann,mannte01,37,LAC,0,TOR,6,3,2,0,0,0,28.63333333,1,2,3,6,0,1,0,0,1,0,5,8,9,11,12.6
2023-24,202401260MEM,1/26/2024,MEM vs ORL,Santi Aldama,aldamsa01,34,MEM,1,ORL,14,7,5,0,0,1,28.93333333,2,5,6,9,2,5,0,0,2,0,12,19,21,26,28.9
2023-24,202401260TOR,1/26/2024,TOR vs LAC,Gary Trent Jr.,trentga02,40,TOR,1,LAC,13,1,3,0,0,0,28.98333333,0,1,5,13,3,8,0,0,1,0,4,16,14,17,18.7
2023-24,202401260IND,1/26/2024,IND vs PHO,Andrew Nembhard,nembhan01,32,IND,1,PHO,22,1,8,1,0,1,29.56666667,1,0,10,16,1,2,1,1,1,1,9,30,23,31,37.2
2023-24,202401260CHO,1/26/2024,CHO vs HOU,Fred VanVleet,vanvlfr01,42,HOU,0,CHO,14,3,3,1,6,0,29.75,0,3,5,9,3,5,1,1,3,7,6,17,17,20,43.1
2023-24,202401260MEM,1/26/2024,MEM vs ORL,Ziaire Williams,willizi02,43,MEM,1,ORL,17,4,5,2,0,3,29.76666667,0,4,7,10,3,6,0,0,3,2,9,22,21,26,32.3
2023-24,202401260MEM,1/26/2024,MEM vs ORL,Luke Kennard,kennalu01,21,MEM,1,ORL,15,5,6,1,0,3,29.88333333,0,5,5,11,5,10,0,0,1,1,11,21,20,26,30
2023-24,202401260SAS,1/26/2024,SAS vs POR,Keldon Johnson,johnske04,43,SAS,1,POR,21,16,1,1,2,1,29.95,8,8,9,15,0,2,3,4,2,3,17,22,37,38,49.7
2023-24,202401260NOP,1/26/2024,NOP vs OKC,Chet Holmgren,holmgch01,45,OKC,0,NOP,20,13,0,1,2,0,30.26666667,2,11,9,16,2,6,0,0,1,3,13,20,33,33,44.6
2023-24,202401260IND,1/26/2024,IND vs PHO,Eric Gordon,gordoer01,37,PHO,0,IND,14,2,2,1,0,2,30.41666667,0,2,5,9,2,6,2,3,0,1,4,16,16,18,20.4
2023-24,202401260TOR,1/26/2024,TOR vs LAC,Kawhi Leonard,leonaka01,39,LAC,0,TOR,16,7,3,1,2,1,30.5,1,6,7,13,2,4,0,0,0,3,10,19,23,26,36.9
2023-24,202401260NOP,1/26/2024,NOP vs OKC,Jalen Williams,willija06,42,OKC,0,NOP,15,4,7,0,0,1,30.66666667,0,4,7,14,1,4,0,0,3,0,11,22,19,26,29.3
2023-24,202401260MIL,1/26/2024,MIL vs CLE,Isaac Okoro,okorois01,34,CLE,0,MIL,3,1,1,2,2,0,30.91666667,0,1,1,6,1,2,0,4,1,4,2,4,4,5,17.7
2023-24,202401260NOP,1/26/2024,NOP vs OKC,Shai Gilgeous-Alexander,gilgesh01,44,OKC,0,NOP,31,4,5,2,1,4,31.53333333,0,4,10,21,3,8,8,9,0,3,9,36,35,40,48.3
2023-24,202401260TOR,1/26/2024,TOR vs LAC,Bruce Brown,brownbr01,38,TOR,1,LAC,9,9,2,0,1,3,31.58333333,2,7,4,8,1,2,0,0,3,1,11,11,18,20,22.8
2023-24,202401260SAS,1/26/2024,SAS vs POR,Jeremy Sochan,sochaje01,45,SAS,1,POR,31,14,2,2,0,2,31.8,4,10,12,20,4,7,3,3,0,2,16,33,45,47,54.8
2023-24,202401260ATL,1/26/2024,ATL vs DAL,Tim Hardaway Jr.,hardati02,42,DAL,0,ATL,13,4,3,0,0,2,32.15,1,3,3,12,3,9,4,4,2,0,7,16,17,20,20.3
2023-24,202401260SAS,1/26/2024,SAS vs POR,Devin Vassell,vassede01,40,SAS,1,POR,15,4,2,0,0,1,32.18333333,0,4,5,14,2,7,3,5,1,0,6,17,19,21,21.8
2023-24,202401260IND,1/26/2024,IND vs PHO,Pascal Siakam,siakapa01,44,IND,1,PHO,31,7,4,2,0,2,32.73333333,4,3,14,22,2,3,1,3,1,2,11,35,38,42,49.4
2023-24,202401260ATL,1/26/2024,ATL vs DAL,Trae Young,youngtr01,40,ATL,1,DAL,30,1,11,3,0,2,33.18333333,0,1,9,18,2,7,10,11,3,3,12,41,31,42,54.7
2023-24,202401260IND,1/26/2024,IND vs PHO,Obi Toppin,toppiob01,47,IND,1,PHO,23,11,3,1,1,1,33.3,6,5,10,15,0,2,3,5,2,2,14,26,34,37,45.7
2023-24,202401260NOP,1/26/2024,NOP vs OKC,Brandon Ingram,ingrabr01,41,NOP,1,OKC,12,4,9,0,2,5,33.53333333,0,4,5,9,0,0,2,5,3,2,13,21,16,25,31.3
2023-24,202401260IND,1/26/2024,IND vs PHO,Aaron Nesmith,nesmiaa01,42,IND,1,PHO,22,6,3,1,1,1,33.95,1,5,8,13,3,6,3,4,4,2,9,25,28,31,38.7
2023-24,202401260SAS,1/26/2024,SAS vs POR,Deandre Ayton,aytonde01,29,POR,0,SAS,20,12,2,2,0,2,34.11666667,2,10,10,17,0,0,0,0,2,2,14,22,32,34,41.4
2023-24,202401260MEM,1/26/2024,MEM vs ORL,Paolo Banchero,banchpa01,45,ORL,0,MEM,27,5,6,2,1,3,34.18333333,0,5,8,20,2,9,9,11,3,3,11,33,32,38,48
2023-24,202401260IND,1/26/2024,IND vs PHO,Bradley Beal,bealbr01,21,PHO,0,IND,12,4,3,1,1,6,34.36666667,1,3,5,13,1,5,1,1,5,2,7,15,16,19,21.3
2023-24,202401260NOP,1/26/2024,NOP vs OKC,CJ McCollum,mccolcj01,31,NOP,1,OKC,12,6,3,2,0,4,34.68333333,1,5,4,15,2,7,2,2,4,2,9,15,18,21,25.7
2023-24,202401260MIL,1/26/2024,MIL vs CLE,Brook Lopez,lopezbr01,45,MIL,1,CLE,11,12,0,1,2,2,34.73333333,5,7,4,14,0,4,3,3,3,3,12,11,23,23,32.4
2023-24,202401260TOR,1/26/2024,TOR vs LAC,Scottie Barnes,barnesc01,45,TOR,1,LAC,23,5,4,1,0,1,34.75,1,4,9,21,1,5,4,5,1,1,9,27,28,32,37
2023-24,202401260MIL,1/26/2024,MIL vs CLE,Max Strus,strusma01,43,CLE,0,MIL,11,7,4,2,0,1,34.86666667,2,5,3,10,2,7,3,4,2,2,11,15,18,22,30.4
2023-24,202401260TOR,1/26/2024,TOR vs LAC,James Harden,hardeja01,38,LAC,0,TOR,22,10,13,1,1,1,34.96666667,0,10,8,14,2,7,4,4,3,2,23,35,32,45,58.5
2023-24,202401260ATL,1/26/2024,ATL vs DAL,Josh Green,greenjo02,32,DAL,0,ATL,21,2,4,0,0,3,35.25,1,1,8,12,4,5,1,2,5,0,6,25,23,27,26.4
2023-24,202401260MEM,1/26/2024,MEM vs ORL,Wendell Carter Jr.,cartewe01,19,ORL,0,MEM,20,9,2,2,2,1,35.4,3,6,8,9,2,3,2,3,3,4,11,22,29,31,44.8
2023-24,202401260MEM,1/26/2024,MEM vs ORL,Jaren Jackson Jr.,jacksja02,43,MEM,1,ORL,30,8,2,1,1,3,35.4,3,5,13,30,1,5,3,4,3,2,10,32,38,40,45.6
2023-24,202401260MIL,1/26/2024,MIL vs CLE,Khris Middleton,middlkh01,39,MIL,1,CLE,14,8,8,2,0,3,35.6,2,6,5,16,2,6,2,2,3,2,16,22,22,30,38.6
2023-24,202401260MIL,1/26/2024,MIL vs CLE,Giannis Antetokounmpo,antetgi01,43,MIL,1,CLE,22,11,9,1,1,6,35.78333333,2,9,9,13,0,0,4,9,5,2,20,31,33,42,48.7
2023-24,202401260CHO,1/26/2024,CHO vs HOU,Miles Bridges,bridgmi02,32,CHO,1,HOU,21,7,3,1,0,4,35.78333333,1,6,7,11,2,4,5,5,1,1,10,24,28,31,32.9
2023-24,202401260MIL,1/26/2024,MIL vs CLE,Jarrett Allen,allenja01,38,CLE,0,MIL,24,14,1,1,2,4,35.8,8,6,9,20,0,0,6,7,4,3,15,25,38,39,47.3
2023-24,202401260MEM,1/26/2024,MEM vs ORL,Vince Williams Jr.,willivi01,35,MEM,1,ORL,11,5,4,0,2,1,35.8,0,5,3,9,3,8,2,4,4,2,9,15,16,20,28
2023-24,202401260TOR,1/26/2024,TOR vs LAC,RJ Barrett,barrerj01,39,TOR,1,LAC,22,6,4,1,0,3,36,2,4,9,19,0,2,4,8,1,1,10,26,28,32,35.2
2023-24,202401260MIL,1/26/2024,MIL vs CLE,Donovan Mitchell,mitchdo01,34,CLE,0,MIL,32,8,6,1,1,5,36.53333333,1,7,12,27,6,12,2,4,2,2,14,38,40,46,51.6
2023-24,202401260SAS,1/26/2024,SAS vs POR,Jabari Walker,walkeja01,41,POR,0,SAS,3,9,2,2,1,0,36.85,2,7,1,5,0,2,1,4,2,3,11,5,12,14,25.8
2023-24,202401260ATL,1/26/2024,ATL vs DAL,Dejounte Murray,murrade01,45,ATL,1,DAL,22,5,7,0,0,3,37.05,1,4,9,18,3,7,1,2,3,0,12,29,27,34,35.5
2023-24,202401260ATL,1/26/2024,ATL vs DAL,Jalen Johnson,johnsja05,31,ATL,1,DAL,25,3,3,1,1,0,37.25,0,3,10,12,2,3,3,4,6,2,6,28,28,31,39.1
2023-24,202401260IND,1/26/2024,IND vs PHO,Grayson Allen,allengr01,40,PHO,0,IND,11,3,1,0,1,2,37.33333333,0,3,4,5,2,3,1,1,5,1,4,12,14,15,17.1
2023-24,202401260ATL,1/26/2024,ATL vs DAL,Saddiq Bey,beysa01,45,ATL,1,DAL,16,7,5,0,0,0,37.88333333,3,4,6,13,2,6,2,2,3,0,12,21,23,28,31.9
2023-24,202401260MEM,1/26/2024,MEM vs ORL,Franz Wagner,wagnefr01,37,ORL,0,MEM,18,5,4,1,1,5,38.01666667,1,4,6,15,4,8,2,3,1,2,9,22,23,27,31
2023-24,202401260MIL,1/26/2024,MIL vs CLE,Damian Lillard,lillada01,42,MIL,1,CLE,22,4,3,1,0,4,38.18333333,1,3,7,24,2,10,6,6,0,1,7,25,26,29,30.3
2023-24,202401260IND,1/26/2024,IND vs PHO,Devin Booker,bookede01,36,PHO,0,IND,62,5,4,1,2,4,38.3,0,5,22,37,6,12,12,13,2,3,9,66,67,71,79
2023-24,202401260IND,1/26/2024,IND vs PHO,Kevin Durant,duranke01,38,PHO,0,IND,20,7,6,1,1,2,39.23333333,1,6,9,15,2,4,0,0,1,2,13,26,27,33,41.4
2023-24,202401260SAS,1/26/2024,SAS vs POR,Anfernee Simons,simonan01,23,POR,0,SAS,40,2,10,1,0,5,40.85,0,2,14,27,7,15,5,5,3,1,12,50,42,52,55.4
2023-24,202401260ATL,1/26/2024,ATL vs DAL,Luka Doncic,doncilu01,38,DAL,0,ATL,73,10,7,1,0,4,44.71666667,0,10,25,33,8,13,15,16,1,1,17,80,83,90,94.5
2023-24,202401250WAS,1/25/2024,WAS vs UTA,Landry Shamet,shamela01,28,WAS,1,UTA,2,0,1,0,0,0,10.51666667,0,0,1,4,0,3,0,0,2,0,1,3,2,3,3.5
2023-24,202401250BRK,1/25/2024,BRK vs MIN,Jordan McLaughlin,mclaujo01,24,MIN,0,BRK,2,0,1,0,0,1,10.56666667,0,0,1,2,0,0,0,0,0,0,1,3,2,3,2.5
2023-24,202401250NYK,1/25/2024,NYK vs DEN,DeAndre Jordan,jordade01,22,DEN,0,NYK,0,5,0,0,0,0,11.2,2,3,0,2,0,0,0,0,0,0,5,0,5,5,6
2023-24,202401250LAL,1/25/2024,LAL vs CHI,Christian Wood,woodch01,40,LAL,1,CHI,2,0,0,0,1,0,11.9,0,0,0,1,0,0,2,2,3,1,0,2,2,2,5
2023-24,202401250IND,1/25/2024,IND vs PHI,Ricky Council IV,councri01,5,PHI,0,IND,11,1,0,1,0,0,12,1,0,3,6,1,1,4,6,0,1,1,11,12,12,15.2
2023-24,202401250NYK,1/25/2024,NYK vs DEN,Justin Holiday,holidju01,26,DEN,0,NYK,4,1,0,1,0,0,12,0,1,2,4,0,2,0,0,2,1,1,4,5,5,8.2
2023-24,202401250IND,1/25/2024,IND vs PHI,Terquavion Smith,smithte01,4,PHI,0,IND,2,0,5,3,0,1,12,0,0,0,6,0,4,2,2,0,3,5,7,2,7,17.5
2023-24,202401250MIA,1/25/2024,MIA vs BOS,Sam Hauser,hausesa01,44,BOS,0,MIA,5,0,1,0,0,1,12.3,0,0,2,2,1,1,0,0,0,0,1,6,5,6,5.5
2023-24,202401250MIA,1/25/2024,MIA vs BOS,Thomas Bryant,bryanth01,24,MIA,1,BOS,7,5,2,0,0,0,12.61666667,3,2,3,4,0,1,1,2,1,0,7,9,12,14,16
2023-24,202401250IND,1/25/2024,IND vs PHI,Furkan Korkmaz,korkmfu01,28,PHI,0,IND,2,1,2,1,0,0,12.91666667,0,1,1,2,0,1,0,1,0,1,3,4,3,5,9.2
2023-24,202401250BRK,1/25/2024,BRK vs MIN,Lonnie Walker IV,walkelo01,26,BRK,1,MIN,2,0,1,1,0,2,13.96666667,0,0,1,5,0,3,0,0,2,1,1,3,2,3,4.5
2023-24,202401250NYK,1/25/2024,NYK vs DEN,Christian Braun,braunch01,46,DEN,0,NYK,4,3,0,0,0,1,14.56666667,1,2,1,4,0,1,2,2,1,0,3,4,7,7,6.6
2023-24,202401250IND,1/25/2024,IND vs PHI,Jaden Springer,sprinja01,25,PHI,0,IND,8,2,0,0,0,0,14.81666667,0,2,2,3,0,0,4,4,0,0,2,8,10,10,10.4
2023-24,202401250IND,1/25/2024,IND vs PHI,Ben Sheppard,sheppbe01,24,IND,1,PHI,2,5,2,0,0,0,14.86666667,0,5,1,4,0,2,0,0,5,0,7,4,7,9,11
2023-24,202401250GSW,1/25/2024,GSW vs SAC,Trey Lyles,lylestr01,29,SAC,0,GSW,8,0,2,1,0,0,15.01666667,0,0,3,7,2,4,0,0,1,1,2,10,8,10,14
2023-24,202401250WAS,1/25/2024,WAS vs UTA,Walker Kessler,kesslwa01,38,UTA,0,WAS,4,3,0,0,1,0,15.2,0,3,2,3,0,0,0,0,5,1,3,4,7,7,10.6
2023-24,202401250GSW,1/25/2024,GSW vs SAC,Davion Mitchell,mitchda01,33,SAC,0,GSW,10,2,4,0,0,0,15.31666667,1,1,3,5,3,5,1,2,2,0,6,14,12,16,18.4
2023-24,202401250BRK,1/25/2024,BRK vs MIN,Dennis Smith Jr.,smithde03,29,BRK,1,MIN,0,2,2,0,0,1,15.85,2,0,0,4,0,0,0,0,1,0,4,2,2,4,4.4
2023-24,202401250WAS,1/25/2024,WAS vs UTA,Marvin Bagley III,baglema01,31,WAS,1,UTA,14,3,1,0,0,1,16.18333333,1,2,4,5,0,0,6,9,2,0,4,15,17,18,18.1
2023-24,202401250GSW,1/25/2024,GSW vs SAC,Kevon Looney,looneke01,42,GSW,1,SAC,4,3,2,0,1,1,16.38333333,0,3,2,2,0,0,0,0,2,1,5,6,7,9,12.6
2023-24,202401250IND,1/25/2024,IND vs PHI,Paul Reed,reedpa01,43,PHI,0,IND,7,6,1,3,0,1,16.71666667,1,5,3,5,1,2,0,0,2,3,7,8,13,14,23.7
2023-24,202401250LAL,1/25/2024,LAL vs CHI,Andre Drummond,drumman01,46,CHI,0,LAL,11,9,1,1,0,1,16.85,5,4,5,7,0,0,1,2,0,1,10,12,20,21,25.3
2023-24,202401250WAS,1/25/2024,WAS vs UTA,Kris Dunn,dunnkr01,38,UTA,0,WAS,4,1,3,1,0,0,16.86666667,0,1,2,4,0,1,0,0,1,1,4,7,5,8,12.7
2023-24,202401250WAS,1/25/2024,WAS vs UTA,Collin Sexton,sextoco01,46,UTA,0,WAS,11,3,6,1,0,2,16.86666667,1,2,4,11,1,2,2,2,2,1,9,17,14,20,24.6
2023-24,202401250GSW,1/25/2024,GSW vs SAC,Cory Joseph,josepco01,23,GSW,1,SAC,6,5,0,0,0,0,16.98333333,1,4,2,3,2,2,0,0,1,0,5,6,11,11,12
2023-24,202401250BRK,1/25/2024,BRK vs MIN,Nickeil Alexander-Walker,alexani01,45,MIN,0,BRK,6,1,4,0,0,0,17.15,0,1,2,4,1,3,1,2,2,0,5,10,7,11,13.2
2023-24,202401250BRK,1/25/2024,BRK vs MIN,Royce O'Neale,onealro01,43,BRK,1,MIN,3,4,2,0,1,1,17.85,1,3,1,4,1,4,0,0,2,1,6,5,7,9,12.8
2023-24,202401250BRK,1/25/2024,BRK vs MIN,Kyle Anderson,anderky01,45,MIN,0,BRK,3,3,5,2,0,1,18.01666667,1,2,1,3,0,0,1,2,0,2,8,8,6,11,19.1
2023-24,202401250MIA,1/25/2024,MIA vs BOS,Luke Kornet,kornelu01,32,BOS,0,MIA,12,5,1,0,0,0,18.83333333,1,4,4,4,0,0,4,4,1,0,6,13,17,18,19.5
2023-24,202401250IND,1/25/2024,IND vs PHI,Danuel House Jr.,houseda01,28,PHI,0,IND,10,2,1,2,1,2,18.86666667,1,1,4,6,0,0,2,3,2,3,3,11,12,13,20.9
2023-24,202401250IND,1/25/2024,IND vs PHI,Patrick Beverley,beverpa01,40,PHI,0,IND,4,3,5,0,1,2,19.05,0,3,1,6,0,3,2,3,3,1,8,9,7,12,16.1
2023-24,202401250IND,1/25/2024,IND vs PHI,Obi Toppin,toppiob01,46,IND,1,PHI,13,5,0,0,1,3,19.15,2,3,6,11,1,4,0,0,2,1,5,13,18,18,19
2023-24,202401250GSW,1/25/2024,GSW vs SAC,Malik Monk,monkma01,42,SAC,0,GSW,4,2,3,0,0,3,19.23333333,1,1,2,5,0,2,0,0,3,0,5,7,6,9,7.9
2023-24,202401250LAL,1/25/2024,LAL vs CHI,Rui Hachimura,hachiru01,33,LAL,1,CHI,10,3,2,1,0,1,19.35,0,3,3,3,2,2,2,2,3,1,5,12,13,15,18.6
2023-24,202401250GSW,1/25/2024,GSW vs SAC,Dario Saric,saricda01,42,GSW,1,SAC,14,4,5,0,0,2,19.8,2,2,5,6,4,4,0,0,2,0,9,19,18,23,24.3
2023-24,202401250WAS,1/25/2024,WAS vs UTA,Ochai Agbaji,agbajoc01,46,UTA,0,WAS,0,4,0,0,1,1,20.01666667,0,4,0,3,0,1,0,0,1,1,4,0,4,4,6.8
2023-24,202401250MIA,1/25/2024,MIA vs BOS,Duncan Robinson,robindu01,43,MIA,1,BOS,5,0,2,0,0,0,20.01666667,0,0,2,6,1,5,0,0,3,0,2,7,5,7,8
2023-24,202401250WAS,1/25/2024,WAS vs UTA,Corey Kispert,kispeco01,43,WAS,1,UTA,8,0,1,3,0,0,20.3,0,0,4,9,0,4,0,0,0,3,1,9,8,9,18.5
2023-24,202401250MIA,1/25/2024,MIA vs BOS,Kristaps Porzingis,porzikr01,33,BOS,0,MIA,19,4,1,0,0,0,20.61666667,0,4,6,9,3,4,4,4,1,0,5,20,23,24,25.3
2023-24,202401250WAS,1/25/2024,WAS vs UTA,Kelly Olynyk,olynyke01,44,UTA,0,WAS,19,4,2,0,0,1,21.01666667,2,2,8,11,3,4,0,0,3,0,6,21,23,25,25.8
2023-24,202401250WAS,1/25/2024,WAS vs UTA,Simone Fontecchio,fontesi01,44,UTA,0,WAS,10,7,2,0,0,0,21.21666667,2,5,4,7,2,3,0,0,1,0,9,12,17,19,21.4
2023-24,202401250NYK,1/25/2024,NYK vs DEN,Miles McBride,mcbrimi01,32,NYK,1,DEN,13,1,1,2,0,0,21.45,0,1,4,9,4,5,1,2,2,2,2,14,14,15,21.7
2023-24,202401250IND,1/25/2024,IND vs PHI,Nicolas Batum,batumni01,32,PHI,0,IND,10,3,1,0,0,1,21.5,0,3,4,5,2,3,0,0,2,0,4,11,13,14,14.1
2023-24,202401250IND,1/25/2024,IND vs PHI,Kelly Oubre Jr.,oubreke01,31,PHI,0,IND,4,2,2,1,3,0,21.5,1,1,2,5,0,2,0,1,4,4,4,6,6,8,21.4
2023-24,202401250NYK,1/25/2024,NYK vs DEN,Michael Porter Jr.,portemi01,46,DEN,0,NYK,5,6,0,0,0,2,21.58333333,3,3,2,4,0,0,1,1,2,0,6,5,11,11,10.2
2023-24,202401250MIA,1/25/2024,MIA vs BOS,Caleb Martin,martica02,28,MIA,1,BOS,8,3,2,1,0,0,21.68333333,1,2,2,12,2,8,2,2,0,1,5,10,11,13,17.6
2023-24,202401250BRK,1/25/2024,BRK vs MIN,Cameron Johnson,johnsca02,36,BRK,1,MIN,5,4,3,0,0,1,21.85,0,4,2,5,1,3,0,0,2,0,7,8,9,12,13.3
2023-24,202401250NYK,1/25/2024,NYK vs DEN,Kentavious Caldwell-Pope,caldwke01,44,DEN,0,NYK,5,0,0,0,0,1,22.31666667,0,0,2,6,1,3,0,0,4,0,0,5,5,5,4
2023-24,202401250MIA,1/25/2024,MIA vs BOS,Al Horford,horfoal01,37,BOS,0,MIA,8,7,6,0,1,1,22.5,0,7,3,4,2,3,0,0,2,1,13,14,15,21,27.4
2023-24,202401250NYK,1/25/2024,NYK vs DEN,Precious Achiuwa,achiupr01,38,NYK,1,DEN,2,10,3,0,1,0,22.53333333,6,4,1,4,0,0,0,0,1,1,13,5,12,15,21.5
2023-24,202401250BRK,1/25/2024,BRK vs MIN,Naz Reid,reidna01,45,MIN,0,BRK,5,4,2,0,1,1,22.7,1,3,2,7,1,3,0,0,3,1,6,7,9,11,14.8
2023-24,202401250NYK,1/25/2024,NYK vs DEN,Quentin Grimes,grimequ01,42,NYK,1,DEN,19,5,0,0,0,2,22.91666667,0,5,7,11,2,5,3,3,0,0,5,19,24,24,23
2023-24,202401250NYK,1/25/2024,NYK vs DEN,Peyton Watson,watsope01,44,DEN,0,NYK,7,4,3,0,2,2,23.13333333,1,3,3,8,0,4,1,2,2,2,7,10,11,14,20.3
2023-24,202401250MIA,1/25/2024,MIA vs BOS,Payton Pritchard,pritcpa01,45,BOS,0,MIA,11,3,3,0,0,0,23.18333333,0,3,4,7,1,2,2,2,0,0,6,14,14,17,19.1
2023-24,202401250NYK,1/25/2024,NYK vs DEN,Reggie Jackson,jacksre01,46,DEN,0,NYK,2,1,3,0,0,0,23.55,1,0,1,7,0,1,0,0,2,0,4,5,3,6,7.7
2023-24,202401250MIA,1/25/2024,MIA vs BOS,Josh Richardson,richajo01,36,MIA,1,BOS,8,2,3,1,0,0,23.65,1,1,4,9,0,4,0,0,1,1,5,11,10,13,17.9
2023-24,202401250IND,1/25/2024,IND vs PHI,T.J. McConnell,mccontj01,38,IND,1,PHI,8,4,5,2,0,3,23.9,1,3,4,6,0,0,0,0,4,2,9,13,12,17,23.3
2023-24,202401250LAL,1/25/2024,LAL vs CHI,Patrick Williams,willipa01,43,CHI,0,LAL,6,6,2,0,2,2,24.33333333,0,6,2,9,0,5,2,2,5,2,8,8,12,14,20.2
2023-24,202401250IND,1/25/2024,IND vs PHI,Bennedict Mathurin,mathube01,46,IND,1,PHI,13,5,4,0,0,3,25.23333333,1,4,5,13,0,2,3,3,2,0,9,17,18,22,22
2023-24,202401250NYK,1/25/2024,NYK vs DEN,Jericho Sims,simsje01,21,NYK,1,DEN,2,8,0,0,1,1,25.46666667,1,7,1,1,0,0,0,0,4,1,8,2,10,10,13.6
2023-24,202401250IND,1/25/2024,IND vs PHI,Buddy Hield,hieldbu01,46,IND,1,PHI,11,3,2,2,0,1,25.8,0,3,4,6,3,5,0,0,1,2,5,13,14,16,22.6
2023-24,202401250NYK,1/25/2024,NYK vs DEN,Donte DiVincenzo,divindo01,45,NYK,1,DEN,16,3,6,1,0,0,26.05,2,1,5,10,4,9,2,2,2,1,9,22,19,25,31.6
2023-24,202401250NYK,1/25/2024,NYK vs DEN,Josh Hart,hartjo01,44,NYK,1,DEN,4,7,3,1,1,0,26.11666667,0,7,2,5,0,2,0,0,0,2,10,7,11,14,22.9
2023-24,202401250MIA,1/25/2024,MIA vs BOS,Haywood Highsmith,highsha01,31,MIA,1,BOS,14,3,1,0,0,1,26.31666667,1,2,5,7,4,4,0,0,3,0,4,15,17,18,18.1
2023-24,202401250NYK,1/25/2024,NYK vs DEN,Jalen Brunson,brunsja01,43,NYK,1,DEN,21,1,4,0,0,2,26.55,0,1,7,10,1,2,6,6,0,0,5,25,22,26,26.2
2023-24,202401250LAL,1/25/2024,LAL vs CHI,Jarred Vanderbilt,vandeja01,26,LAL,1,CHI,17,5,0,3,1,2,26.83333333,0,5,8,11,1,1,0,1,2,4,5,17,22,22,33
2023-24,202401250GSW,1/25/2024,GSW vs SAC,Brandin Podziemski,podzibr01,36,GSW,1,SAC,7,3,2,0,0,1,26.9,1,2,3,5,1,2,0,0,2,0,5,9,10,12,12.6
2023-24,202401250WAS,1/25/2024,WAS vs UTA,Deni Avdija,avdijde01,44,WAS,1,UTA,13,6,5,1,1,3,27.11666667,0,6,5,9,1,1,2,2,1,2,11,18,19,24,30.7
2023-24,202401250IND,1/25/2024,IND vs PHI,Myles Turner,turnemy01,45,IND,1,PHI,20,9,1,1,2,1,27.15,3,6,7,12,3,6,3,4,4,3,10,21,29,30,40.3
2023-24,202401250MIA,1/25/2024,MIA vs BOS,Jaylen Brown,brownja02,42,BOS,0,MIA,18,4,5,3,0,3,27.33333333,1,3,7,11,4,8,0,0,1,3,9,23,22,27,36.3
2023-24,202401250NYK,1/25/2024,NYK vs DEN,Nikola Jokic,jokicni01,45,DEN,0,NYK,31,11,3,0,0,7,27.48333333,4,7,13,18,2,3,3,3,1,0,14,34,42,45,41.7
2023-24,202401250WAS,1/25/2024,WAS vs UTA,Jordan Poole,poolejo01,43,WAS,1,UTA,18,2,2,2,2,0,28.33333333,0,2,6,12,3,7,3,4,5,4,4,20,20,22,35.4
2023-24,202401250BRK,1/25/2024,BRK vs MIN,Cam Thomas,thomaca02,35,BRK,1,MIN,25,6,3,2,0,5,28.43333333,0,6,7,15,1,4,10,10,0,2,9,28,31,34,37.7
2023-24,202401250IND,1/25/2024,IND vs PHI,Tyrese Maxey,maxeyty01,42,PHI,0,IND,22,1,2,0,1,1,28.5,0,1,7,17,1,8,7,7,2,1,3,24,23,25,28.2
2023-24,202401250MIA,1/25/2024,MIA vs BOS,Jrue Holiday,holidjr01,41,BOS,0,MIA,17,5,5,0,1,3,28.51666667,0,5,7,8,3,4,0,0,1,1,10,22,22,27,30.5
2023-24,202401250MIA,1/25/2024,MIA vs BOS,Bam Adebayo,adebaba01,35,MIA,1,BOS,19,5,2,1,1,0,28.76666667,1,4,8,14,0,0,3,4,0,2,7,21,24,26,34
2023-24,202401250MIA,1/25/2024,MIA vs BOS,Terry Rozier,roziete01,32,MIA,1,BOS,7,2,3,1,0,0,28.76666667,0,2,3,10,1,4,0,0,2,1,5,10,9,12,16.9
2023-24,202401250IND,1/25/2024,IND vs PHI,Andrew Nembhard,nembhan01,31,IND,1,PHI,19,2,8,1,1,6,28.83333333,0,2,8,15,1,3,2,2,3,2,10,27,21,29,33.4
2023-24,202401250WAS,1/25/2024,WAS vs UTA,Bilal Coulibaly,coulibi01,43,WAS,1,UTA,2,1,2,3,0,2,28.88333333,0,1,0,5,0,2,2,2,1,3,3,4,3,5,13.2
2023-24,202401250IND,1/25/2024,IND vs PHI,Aaron Nesmith,nesmiaa01,41,IND,1,PHI,16,8,3,0,0,1,28.88333333,1,7,6,8,3,3,1,1,2,0,11,19,24,27,29.1
2023-24,202401250MIA,1/25/2024,MIA vs BOS,Jimmy Butler,butleji01,30,MIA,1,BOS,17,3,4,2,0,1,29.16666667,1,2,7,11,2,3,1,1,1,2,7,21,20,24,31.6
2023-24,202401250MIA,1/25/2024,MIA vs BOS,Tyler Herro,herroty01,26,MIA,1,BOS,19,3,6,1,0,1,29.16666667,0,3,7,14,5,10,0,0,0,1,9,25,22,28,33.6
2023-24,202401250MIA,1/25/2024,MIA vs BOS,Derrick White,whitede01,41,BOS,0,MIA,15,6,6,0,2,1,29.18333333,2,4,6,12,3,9,0,0,0,2,12,21,21,27,36.2
2023-24,202401250NYK,1/25/2024,NYK vs DEN,OG Anunoby,anunoog01,40,NYK,1,DEN,26,2,1,6,0,1,29.31666667,0,2,10,18,3,9,3,5,2,6,3,27,28,29,46.9
2023-24,202401250LAL,1/25/2024,LAL vs CHI,Ayo Dosunmu,dosunay01,44,CHI,0,LAL,18,2,1,2,1,2,29.51666667,1,1,6,11,2,5,4,4,2,3,3,19,20,21,28.9
2023-24,202401250NYK,1/25/2024,NYK vs DEN,Aaron Gordon,gordoaa01,40,DEN,0,NYK,12,5,2,1,0,1,29.51666667,1,4,5,10,0,1,2,2,2,1,7,14,17,19,23
2023-24,202401250NYK,1/25/2024,NYK vs DEN,Jamal Murray,murraja01,32,DEN,0,NYK,9,2,7,0,0,3,29.55,0,2,3,11,1,3,2,3,1,0,9,16,11,18,18.9
2023-24,202401250IND,1/25/2024,IND vs PHI,Pascal Siakam,siakapa01,43,IND,1,PHI,26,13,10,0,0,2,30.06666667,3,10,9,13,1,2,7,10,3,0,23,36,39,49,54.6
2023-24,202401250WAS,1/25/2024,WAS vs UTA,Jordan Clarkson,clarkjo01,36,UTA,0,WAS,19,3,8,0,0,4,30.15,0,3,7,17,1,4,4,4,1,0,11,27,22,30,30.6
2023-24,202401250GSW,1/25/2024,GSW vs SAC,Jonathan Kuminga,kuminjo01,41,GSW,1,SAC,31,3,3,2,0,2,30.18333333,1,2,12,19,2,4,5,6,2,2,6,34,34,37,43.1
2023-24,202401250LAL,1/25/2024,LAL vs CHI,Taurean Prince,princta02,44,LAL,1,CHI,14,4,2,2,0,0,30.3,0,4,5,8,4,7,0,0,3,2,6,16,18,20,27.8
2023-24,202401250NYK,1/25/2024,NYK vs DEN,Julius Randle,randlju01,45,NYK,1,DEN,17,7,8,1,0,2,30.43333333,3,4,7,15,1,5,2,2,2,1,15,25,24,32,38.4
2023-24,202401250IND,1/25/2024,IND vs PHI,KJ Martin,martike04,29,PHI,0,IND,11,3,2,2,0,2,30.85,1,2,4,6,0,1,3,6,4,2,5,13,14,16,21.6
2023-24,202401250GSW,1/25/2024,GSW vs SAC,Andrew Wiggins,wiggian01,38,GSW,1,SAC,17,4,4,0,0,2,30.88333333,0,4,6,8,2,3,3,4,2,0,8,21,21,25,25.8
2023-24,202401250WAS,1/25/2024,WAS vs UTA,Daniel Gafford,gaffoda01,39,WAS,1,UTA,13,9,1,1,4,0,30.98333333,2,7,6,7,0,0,1,2,2,5,10,14,22,23,40.3
2023-24,202401250GSW,1/25/2024,GSW vs SAC,Klay Thompson,thompkl01,41,GSW,1,SAC,16,1,1,1,1,1,31.11666667,0,1,5,14,2,7,4,4,5,2,2,17,17,18,23.7
2023-24,202401250WAS,1/25/2024,WAS vs UTA,Keyonte George,georgke01,40,UTA,0,WAS,5,4,7,0,0,3,31.13333333,0,4,1,6,0,2,3,4,0,0,11,12,9,16,17.3
2023-24,202401250IND,1/25/2024,IND vs PHI,Joel Embiid,embiijo01,33,PHI,0,IND,31,7,3,0,0,2,31.28333333,1,6,11,20,2,4,7,10,1,0,10,34,38,41,41.9
2023-24,202401250GSW,1/25/2024,GSW vs SAC,Draymond Green,greendr01,18,GSW,1,SAC,5,4,11,3,1,2,31.4,0,4,0,3,0,1,5,8,3,4,15,16,9,20,36.3
2023-24,202401250BRK,1/25/2024,BRK vs MIN,Spencer Dinwiddie,dinwisp01,42,BRK,1,MIN,14,2,2,0,0,0,32.18333333,0,2,5,10,3,6,1,1,3,0,4,16,16,18,19.4
2023-24,202401250MIA,1/25/2024,MIA vs BOS,Jayson Tatum,tatumja01,42,BOS,0,MIA,26,8,4,0,0,1,32.2,1,7,7,15,3,7,9,10,1,0,12,30,34,38,40.6
2023-24,202401250BRK,1/25/2024,BRK vs MIN,Mike Conley,conlemi01,42,MIN,0,BRK,10,2,4,2,1,1,32.6,0,2,3,6,2,4,2,2,1,3,6,14,12,16,26.4
2023-24,202401250BRK,1/25/2024,BRK vs MIN,Rudy Gobert,goberru01,44,MIN,0,BRK,10,13,1,1,2,1,32.73333333,1,12,4,9,0,0,2,2,3,3,14,11,23,24,35.1
2023-24,202401250WAS,1/25/2024,WAS vs UTA,Lauri Markkanen,markkla01,36,UTA,0,WAS,29,7,5,3,0,3,32.76666667,1,6,11,20,6,12,1,2,3,3,12,34,36,41,50.9
2023-24,202401250WAS,1/25/2024,WAS vs UTA,John Collins,collijo01,42,UTA,0,WAS,22,16,1,1,0,1,32.8,7,9,11,15,0,2,0,0,2,1,17,23,38,39,44.7
2023-24,202401250GSW,1/25/2024,GSW vs SAC,Kevin Huerter,huertke01,41,SAC,0,GSW,12,10,4,3,0,2,33.08333333,3,7,4,10,3,8,1,3,4,3,14,16,22,26,37
2023-24,202401250LAL,1/25/2024,LAL vs CHI,Austin Reaves,reaveau01,47,LAL,1,CHI,20,3,8,0,0,1,33.21666667,0,3,7,9,2,3,4,4,4,0,11,28,23,31,34.6
2023-24,202401250BRK,1/25/2024,BRK vs MIN,Jaden McDaniels,mcdanja02,35,MIN,0,BRK,9,4,1,0,0,0,33.35,1,3,4,6,1,1,0,0,2,0,5,10,13,14,15.3
2023-24,202401250WAS,1/25/2024,WAS vs UTA,Tyus Jones,jonesty01,44,WAS,1,UTA,12,6,14,1,0,0,34.15,0,6,5,12,2,4,0,0,1,1,20,26,18,32,43.2
2023-24,202401250WAS,1/25/2024,WAS vs UTA,Kyle Kuzma,kuzmaky01,44,WAS,1,UTA,26,6,5,0,0,5,34.3,2,4,12,24,1,8,1,1,0,0,11,31,32,37,35.7
2023-24,202401250GSW,1/25/2024,GSW vs SAC,Domantas Sabonis,sabondo01,43,SAC,0,GSW,18,8,13,0,1,3,35.15,1,7,8,11,2,2,0,0,5,1,21,31,26,39,47.1
2023-24,202401250BRK,1/25/2024,BRK vs MIN,Mikal Bridges,bridgmi01,44,BRK,1,MIN,21,1,3,2,0,3,35.35,0,1,8,18,2,8,3,5,1,2,4,24,22,25,29.7
2023-24,202401250LAL,1/25/2024,LAL vs CHI,Alex Caruso,carusal01,39,CHI,0,LAL,17,4,6,2,2,2,35.36666667,1,3,6,12,3,9,2,2,4,4,10,23,21,27,40.8
2023-24,202401250GSW,1/25/2024,GSW vs SAC,De'Aaron Fox,foxde01,37,SAC,0,GSW,29,1,5,1,1,1,35.56666667,0,1,9,16,3,7,8,8,3,2,6,34,30,35,42.7
2023-24,202401250BRK,1/25/2024,BRK vs MIN,Anthony Edwards,edwaran01,42,MIN,0,BRK,24,1,3,1,0,3,35.68333333,0,1,8,23,3,7,5,6,3,1,4,27,25,28,29.7
2023-24,202401250LAL,1/25/2024,LAL vs CHI,LeBron James,jamesle01,42,LAL,1,CHI,25,4,12,2,0,5,35.7,0,4,10,19,3,4,2,2,2,2,16,37,29,41,48.8
2023-24,202401250BRK,1/25/2024,BRK vs MIN,Dorian Finney-Smith,finnedo01,41,BRK,1,MIN,8,2,2,0,0,0,35.76666667,0,2,3,6,2,5,0,0,2,0,4,10,10,12,13.4
2023-24,202401250LAL,1/25/2024,LAL vs CHI,Anthony Davis,davisan02,45,LAL,1,CHI,22,11,6,0,1,0,36.1,5,6,10,18,0,1,2,5,1,1,17,28,33,39,47.2
2023-24,202401250GSW,1/25/2024,GSW vs SAC,Stephen Curry,curryst01,39,GSW,1,SAC,33,6,2,1,0,2,36.33333333,1,5,13,26,6,14,1,1,0,1,8,35,39,41,44.2
2023-24,202401250BRK,1/25/2024,BRK vs MIN,Karl-Anthony Towns,townska01,44,MIN,0,BRK,27,10,3,0,0,6,37.2,1,9,12,15,2,3,1,2,3,0,13,30,37,40,37.5
2023-24,202401250LAL,1/25/2024,LAL vs CHI,D'Angelo Russell,russeda01,43,LAL,1,CHI,29,0,4,1,1,2,37.71666667,0,0,10,18,8,13,1,2,3,2,4,33,29,33,39
2023-24,202401250GSW,1/25/2024,GSW vs SAC,Keegan Murray,murrake02,39,SAC,0,GSW,14,6,1,1,2,0,37.98333333,1,5,5,12,2,7,2,2,2,3,7,15,20,21,31.7
2023-24,202401250BRK,1/25/2024,BRK vs MIN,Nic Claxton,claxtni01,34,BRK,1,MIN,16,11,4,2,2,0,38.75,2,9,8,10,0,0,0,0,2,4,15,20,27,31,47.2
2023-24,202401250LAL,1/25/2024,LAL vs CHI,Nikola Vucevic,vucevni01,41,CHI,0,LAL,20,8,1,0,1,2,39.18333333,3,5,9,12,2,3,0,0,2,1,9,21,28,29,32.1
2023-24,202401250GSW,1/25/2024,GSW vs SAC,Harrison Barnes,barneha02,43,SAC,0,GSW,39,4,0,2,1,1,39.83333333,1,3,14,24,7,12,4,4,0,3,4,39,43,43,51.8
2023-24,202401250LAL,1/25/2024,LAL vs CHI,DeMar DeRozan,derozde01,44,CHI,0,LAL,32,2,10,2,0,3,40.71666667,0,2,10,14,1,1,11,12,2,2,12,42,34,44,52.4
2023-24,202401250LAL,1/25/2024,LAL vs CHI,Coby White,whiteco01,46,CHI,0,LAL,25,7,3,0,0,4,42.9,2,5,8,18,3,10,6,7,1,0,10,28,32,35,33.9
2023-24,202401240MIL,1/24/2024,MIL vs CLE,Damian Jones,jonesda03,19,CLE,0,MIL,5,0,2,0,0,0,10.21666667,0,0,2,2,0,0,1,1,0,0,2,7,5,7,8
2023-24,202401240SAS,1/24/2024,SAS vs OKC,Kenrich Williams,willike04,33,OKC,0,SAS,7,3,0,1,1,0,10.31666667,1,2,3,4,1,2,0,0,1,2,3,7,10,10,16.6
2023-24,202401240SAS,1/24/2024,SAS vs OKC,Jaylin Williams,willija07,36,OKC,0,SAS,6,4,0,0,0,1,11.08333333,1,3,2,3,2,2,0,0,2,0,4,6,10,10,9.8
2023-24,202401240DET,1/24/2024,DET vs CHO,Monte Morris,morrimo01,1,DET,1,CHO,7,3,3,0,0,0,11.41666667,0,3,3,4,1,1,0,0,0,0,6,10,10,13,15.1
2023-24,202401240DAL,1/24/2024,DAL vs PHO,Grant Williams,willigr01,40,DAL,1,PHO,8,1,1,0,0,3,11.41666667,0,1,3,6,2,4,0,0,3,0,2,9,9,10,7.7
2023-24,202401240HOU,1/24/2024,HOU vs POR,Duop Reath,reathdu01,32,POR,0,HOU,9,2,2,0,0,0,12.26666667,1,1,4,7,1,3,0,0,0,0,4,11,11,13,14.4
2023-24,202401240DET,1/24/2024,DET vs CHO,Marcus Sasser,sassema01,40,DET,1,CHO,5,2,2,0,0,1,12.28333333,0,2,2,5,1,4,0,0,1,0,4,7,7,9,9.4
2023-24,202401240WAS,1/24/2024,WAS vs MIN,Landry Shamet,shamela01,27,WAS,1,MIN,9,1,2,0,0,0,12.4,0,1,1,3,1,1,6,6,0,0,3,11,10,12,13.2
2023-24,202401240DET,1/24/2024,DET vs CHO,Ish Smith,smithis01,35,CHO,0,DET,2,4,5,0,1,0,12.7,1,3,1,1,0,0,0,0,0,1,9,7,6,11,17.3
2023-24,202401240SAS,1/24/2024,SAS vs OKC,Isaiah Joe,joeis01,44,OKC,0,SAS,9,1,0,0,1,0,12.81666667,1,0,3,5,3,5,0,0,0,1,1,9,10,10,13.2
2023-24,202401240DET,1/24/2024,DET vs CHO,Kevin Knox,knoxke01,26,DET,1,CHO,0,4,0,0,0,0,12.86666667,0,4,0,4,0,2,0,0,0,0,4,0,4,4,4.8
2023-24,202401240WAS,1/24/2024,WAS vs MIN,Jordan McLaughlin,mclaujo01,23,MIN,0,WAS,5,2,2,1,0,0,13.01666667,1,1,2,4,1,1,0,0,1,1,4,7,7,9,13.4
2023-24,202401240HOU,1/24/2024,HOU vs POR,Jock Landale,landajo01,25,HOU,1,POR,6,3,2,0,0,0,13.38333333,3,0,2,2,0,0,2,3,2,0,5,8,9,11,12.6
2023-24,202401240DET,1/24/2024,DET vs CHO,Mike Muscala,muscami01,28,DET,1,CHO,5,5,1,0,0,0,13.4,2,3,2,5,1,4,0,0,1,0,6,6,10,11,12.5
2023-24,202401240MIL,1/24/2024,MIL vs CLE,Cameron Payne,payneca01,40,MIL,1,CLE,5,2,0,1,0,1,13.43333333,0,2,2,6,1,3,0,0,1,1,2,5,7,7,9.4
2023-24,202401240HOU,1/24/2024,HOU vs POR,Cam Whitmore,whitmca01,20,HOU,1,POR,12,4,0,0,0,0,13.6,0,4,5,10,2,6,0,0,2,0,4,12,16,16,16.8
2023-24,202401240DAL,1/24/2024,DAL vs PHO,Chimezie Metu,metuch01,33,PHO,0,DAL,2,7,1,0,0,0,13.71666667,1,6,1,1,0,0,0,0,1,0,8,3,9,10,11.9
2023-24,202401240SAS,1/24/2024,SAS vs OKC,Vasilije Micic,micicva01,24,OKC,0,SAS,2,1,3,1,0,3,13.78333333,0,1,1,2,0,1,0,0,0,1,4,5,3,6,7.7
2023-24,202401240SAS,1/24/2024,SAS vs OKC,Cedi Osman,osmande01,44,SAS,1,OKC,9,0,0,0,1,0,14.05,0,0,3,5,1,3,2,3,0,1,0,9,9,9,12
2023-24,202401240HOU,1/24/2024,HOU vs POR,Amen Thompson,thompam01,24,HOU,1,POR,6,3,2,0,1,0,14.31666667,1,2,3,5,0,0,0,0,3,1,5,8,9,11,15.6
2023-24,202401240DAL,1/24/2024,DAL vs PHO,Keita Bates-Diop,bateske01,33,PHO,0,DAL,11,2,1,1,0,1,14.63333333,2,0,5,7,1,2,0,0,0,1,3,12,13,14,16.9
2023-24,202401240GSW,1/24/2024,GSW vs ATL,Trent Forrest,forretr01,18,ATL,0,GSW,0,0,5,2,0,1,14.78333333,0,0,0,1,0,0,0,0,1,2,5,5,0,5,12.5
2023-24,202401240DAL,1/24/2024,DAL vs PHO,Jaden Hardy,hardyja02,39,DAL,1,PHO,11,3,2,0,0,0,15.16666667,0,3,4,9,3,4,0,0,1,0,5,13,14,16,17.6
2023-24,202401240GSW,1/24/2024,GSW vs ATL,Trayce Jackson-Davis,jackstr02,31,GSW,1,ATL,4,6,1,0,2,0,15.28333333,2,4,2,4,0,0,0,4,2,2,7,5,10,11,18.7
2023-24,202401240MIA,1/24/2024,MIA vs MEM,Duncan Robinson,robindu01,42,MIA,1,MEM,7,3,0,0,0,2,15.85,0,3,3,9,1,5,0,0,4,0,3,7,10,10,8.6
2023-24,202401240WAS,1/24/2024,WAS vs MIN,Corey Kispert,kispeco01,42,WAS,1,MIN,7,4,0,0,0,3,16,0,4,3,6,0,0,1,1,0,0,4,7,11,11,8.8
2023-24,202401240GSW,1/24/2024,GSW vs ATL,Dario Saric,saricda01,41,GSW,1,ATL,10,3,3,1,0,0,16.25,1,2,4,6,2,3,0,0,0,1,6,13,13,16,21.1
2023-24,202401240DET,1/24/2024,DET vs CHO,Nick Smith Jr.,smithni01,27,CHO,0,DET,3,0,1,0,0,0,16.76666667,0,0,1,2,1,1,0,0,0,0,1,4,3,4,4.5
2023-24,202401240SAS,1/24/2024,SAS vs OKC,Doug McDermott,mcderdo01,39,SAS,1,OKC,8,1,3,0,0,3,17.05,0,1,3,6,2,4,0,0,1,0,4,11,9,12,10.7
2023-24,202401240HOU,1/24/2024,HOU vs POR,Toumani Camara,camarto01,43,POR,0,HOU,4,4,1,2,0,0,17.11666667,1,3,1,4,0,0,2,2,3,2,5,5,8,9,16.3
2023-24,202401240SAS,1/24/2024,SAS vs OKC,Zach Collins,colliza01,35,SAS,1,OKC,10,3,2,1,2,2,17.4,2,1,3,8,1,2,3,4,1,3,5,12,13,15,23.6
2023-24,202401240MIA,1/24/2024,MIA vs MEM,Ziaire Williams,willizi02,42,MEM,0,MIA,0,6,1,1,0,1,17.43333333,1,5,0,8,0,4,0,0,1,1,7,1,6,7,10.7
2023-24,202401240MIL,1/24/2024,MIL vs CLE,Pat Connaughton,connapa01,38,MIL,1,CLE,6,1,0,2,0,0,17.45,0,1,2,4,2,3,0,0,1,2,1,6,7,7,13.2
2023-24,202401240MIL,1/24/2024,MIL vs CLE,Jae Crowder,crowdja01,13,MIL,1,CLE,3,3,1,0,0,3,17.6,1,2,1,2,1,2,0,0,2,0,4,4,6,7,5.1
2023-24,202401240MIA,1/24/2024,MIA vs MEM,Josh Richardson,richajo01,35,MIA,1,MEM,9,3,2,0,1,1,18.11666667,0,3,4,7,1,4,0,0,2,1,5,11,12,14,17.6
2023-24,202401240MIA,1/24/2024,MIA vs MEM,Xavier Tillman Sr.,tillmxa01,31,MEM,0,MIA,6,4,1,1,3,1,18.13333333,1,3,2,2,1,1,1,2,3,4,5,7,10,11,23.3
2023-24,202401240SAS,1/24/2024,SAS vs OKC,Aaron Wiggins,wiggiaa01,41,OKC,0,SAS,22,3,1,0,1,0,18.53333333,0,3,9,11,4,6,0,0,1,1,4,23,25,26,30.1
2023-24,202401240DAL,1/24/2024,DAL vs PHO,Dante Exum,exumda01,31,DAL,1,PHO,6,2,2,0,0,0,18.55,0,2,2,4,1,1,1,2,1,0,4,8,8,10,11.4
2023-24,202401240WAS,1/24/2024,WAS vs MIN,Shake Milton,miltosh01,35,MIN,0,WAS,2,3,3,1,1,1,18.56666667,2,1,1,5,0,1,0,0,1,2,6,5,5,8,15.1
2023-24,202401240SAS,1/24/2024,SAS vs OKC,Keldon Johnson,johnske04,42,SAS,1,OKC,7,0,1,1,1,2,19.03333333,0,0,3,8,0,2,1,1,0,2,1,8,7,8,12.5
2023-24,202401240GSW,1/24/2024,GSW vs ATL,Garrison Mathews,mathega01,30,ATL,0,GSW,3,0,1,0,0,1,20.15,0,0,1,7,0,6,1,2,3,0,1,4,3,4,3.5
2023-24,202401240WAS,1/24/2024,WAS vs MIN,Bilal Coulibaly,coulibi01,42,WAS,1,MIN,4,0,1,0,0,3,20.41666667,0,0,2,7,0,3,0,0,1,0,1,5,4,5,2.5
2023-24,202401240GSW,1/24/2024,GSW vs ATL,Cory Joseph,josepco01,22,GSW,1,ATL,8,2,1,0,0,0,20.6,0,2,3,3,2,2,0,0,1,0,3,9,10,11,11.9
2023-24,202401240MIL,1/24/2024,MIL vs CLE,Georges Niang,niangge01,42,CLE,0,MIL,14,4,2,0,0,0,20.6,1,3,5,7,2,3,2,2,2,0,6,16,18,20,21.8
2023-24,202401240SAS,1/24/2024,SAS vs OKC,Julian Champagnie,champju02,37,SAS,1,OKC,3,2,1,2,0,2,20.75,0,2,1,5,1,5,0,0,1,2,3,4,5,6,10.9
2023-24,202401240WAS,1/24/2024,WAS vs MIN,Naz Reid,reidna01,44,MIN,0,WAS,5,3,2,1,1,0,20.75,0,3,2,9,1,3,0,0,1,2,5,7,8,10,17.6
2023-24,202401240DAL,1/24/2024,DAL vs PHO,Jusuf Nurkic,nurkiju01,42,PHO,0,DAL,8,5,3,2,0,4,21.13333333,3,2,3,5,0,1,2,2,4,2,8,11,13,16,20.5
2023-24,202401240WAS,1/24/2024,WAS vs MIN,Daniel Gafford,gaffoda01,38,WAS,1,MIN,10,4,1,1,2,2,21.35,1,3,5,5,0,0,0,0,6,3,5,11,14,15,23.3
2023-24,202401240DET,1/24/2024,DET vs CHO,Jaden Ivey,iveyja01,40,DET,1,CHO,9,1,2,1,0,2,21.58333333,0,1,4,10,1,3,0,0,2,1,3,11,10,12,14.2
2023-24,202401240GSW,1/24/2024,GSW vs ATL,Patty Mills,millspa02,13,ATL,0,GSW,13,2,3,1,0,2,21.61666667,1,1,5,11,3,6,0,0,0,1,5,16,15,18,20.9
2023-24,202401240WAS,1/24/2024,WAS vs MIN,Kyle Anderson,anderky01,44,MIN,0,WAS,3,5,5,0,0,0,21.81666667,1,4,1,4,0,0,1,2,1,0,10,8,8,13,16.5
2023-24,202401240DET,1/24/2024,DET vs CHO,Jalen Duren,durenja01,29,DET,1,CHO,14,8,2,0,0,1,21.91666667,2,6,7,9,0,0,0,1,3,0,10,16,22,24,25.6
2023-24,202401240SAS,1/24/2024,SAS vs OKC,Josh Giddey,giddejo01,43,OKC,0,SAS,12,8,4,0,0,2,22.08333333,5,3,6,13,0,3,0,0,1,0,12,16,20,24,25.6
2023-24,202401240DAL,1/24/2024,DAL vs PHO,Maxi Kleber,klebima01,10,DAL,1,PHO,2,3,3,0,0,1,22.3,2,1,1,2,0,1,0,0,3,0,6,5,5,8,9.1
2023-24,202401240HOU,1/24/2024,HOU vs POR,Matisse Thybulle,thybuma01,42,POR,0,HOU,13,4,1,3,0,1,22.36666667,1,3,5,7,3,4,0,0,3,3,5,14,17,18,27.3
2023-24,202401240SAS,1/24/2024,SAS vs OKC,Cason Wallace,wallaca01,44,OKC,0,SAS,13,3,4,1,0,0,22.6,1,2,5,7,2,3,1,1,4,1,7,17,16,20,25.6
2023-24,202401240MIL,1/24/2024,MIL vs CLE,Dean Wade,wadede01,35,CLE,0,MIL,6,5,0,0,1,1,22.73333333,0,5,2,4,2,4,0,0,1,1,5,6,11,11,14
2023-24,202401240GSW,1/24/2024,GSW vs ATL,Draymond Green,greendr01,17,GSW,1,ATL,12,5,3,2,1,2,22.78333333,1,4,5,6,2,3,0,0,3,3,8,15,17,20,29.5
2023-24,202401240MIA,1/24/2024,MIA vs MEM,Jacob Gilyard,gilyaja01,27,MEM,0,MIA,6,0,7,1,0,2,23.63333333,0,0,2,5,2,4,0,0,1,1,7,13,6,13,17.5
2023-24,202401240HOU,1/24/2024,HOU vs POR,Jabari Walker,walkeja01,40,POR,0,HOU,9,7,1,0,0,2,23.76666667,1,6,2,4,1,2,4,4,4,0,8,10,16,17,16.9
2023-24,202401240HOU,1/24/2024,HOU vs POR,Scoot Henderson,hendesc01,35,POR,0,HOU,11,1,3,0,0,2,23.81666667,0,1,4,12,1,5,2,2,0,0,4,14,12,15,14.7
2023-24,202401240DAL,1/24/2024,DAL vs PHO,Josh Okogie,okogijo01,38,PHO,0,DAL,6,4,3,2,1,2,23.93333333,1,3,2,7,1,3,1,1,2,3,7,9,10,13,22.3
2023-24,202401240MIA,1/24/2024,MIA vs MEM,Haywood Highsmith,highsha01,30,MIA,1,MEM,8,4,1,2,1,1,24.01666667,1,3,3,6,2,4,0,0,1,3,5,9,12,13,22.3
2023-24,202401240DAL,1/24/2024,DAL vs PHO,Derrick Jones Jr.,jonesde02,42,DAL,1,PHO,6,2,1,0,0,3,24.05,1,1,3,8,0,3,0,1,3,0,3,7,8,9,6.9
2023-24,202401240MIL,1/24/2024,MIL vs CLE,Isaac Okoro,okorois01,33,CLE,0,MIL,10,1,0,0,0,0,24.23333333,1,0,3,5,0,1,4,4,2,0,1,10,11,11,11.2
2023-24,202401240SAS,1/24/2024,SAS vs OKC,Jeremy Sochan,sochaje01,44,SAS,1,OKC,2,5,4,0,0,2,24.3,2,3,1,7,0,3,0,0,3,0,9,6,7,11,12
2023-24,202401240MIA,1/24/2024,MIA vs MEM,Scotty Pippen Jr.,pippesc02,2,MEM,0,MIA,15,6,6,0,0,2,24.36666667,0,6,5,7,1,1,4,4,1,0,12,21,21,27,29.2
2023-24,202401240GSW,1/24/2024,GSW vs ATL,Clint Capela,capelca01,42,ATL,0,GSW,11,11,1,0,1,0,24.66666667,3,8,3,9,0,0,5,7,2,1,12,12,22,23,28.7
2023-24,202401240DET,1/24/2024,DET vs CHO,Cody Martin,martico01,12,CHO,0,DET,5,3,3,1,0,0,24.83333333,1,2,1,4,0,2,3,4,2,1,6,8,8,11,16.1
2023-24,202401240GSW,1/24/2024,GSW vs ATL,Onyeka Okongwu,okongon01,43,ATL,0,GSW,6,7,1,0,1,3,25.28333333,2,5,3,5,0,1,0,0,3,1,8,7,13,14,15.9
2023-24,202401240MIL,1/24/2024,MIL vs CLE,Bobby Portis,portibo01,44,MIL,1,CLE,8,6,0,0,0,1,25.31666667,0,6,2,6,0,1,4,4,1,0,6,8,14,14,14.2
2023-24,202401240SAS,1/24/2024,SAS vs OKC,Luguentz Dort,dortlu01,42,OKC,0,SAS,2,3,1,2,1,1,25.36666667,1,2,1,6,0,5,0,0,2,3,4,3,5,6,15.1
2023-24,202401240DAL,1/24/2024,DAL vs PHO,Dereck Lively II,livelde01,33,DAL,1,PHO,8,2,1,1,1,0,25.48333333,1,1,4,5,0,0,0,0,2,2,3,9,10,11,17.9
2023-24,202401240DET,1/24/2024,DET vs CHO,Alec Burks,burksal01,37,DET,1,CHO,15,0,1,0,0,0,25.85,0,0,4,11,4,9,3,4,1,0,1,16,15,16,16.5
2023-24,202401240WAS,1/24/2024,WAS vs MIN,Marvin Bagley III,baglema01,30,WAS,1,MIN,17,15,0,1,0,1,25.98333333,6,9,7,8,0,0,3,8,3,1,15,17,32,32,37
2023-24,202401240MIA,1/24/2024,MIA vs MEM,GG Jackson II,jacksgg01,12,MEM,0,MIA,17,4,2,0,0,1,26,0,4,5,9,4,6,3,4,3,0,6,19,21,23,23.8
2023-24,202401240GSW,1/24/2024,GSW vs ATL,Saddiq Bey,beysa01,44,ATL,0,GSW,18,7,3,1,0,0,26.68333333,3,4,6,12,3,6,3,3,0,1,10,21,25,28,33.9
2023-24,202401240GSW,1/24/2024,GSW vs ATL,Brandin Podziemski,podzibr01,35,GSW,1,ATL,10,3,2,0,0,2,26.7,0,3,5,9,0,1,0,0,1,0,5,12,13,15,14.6
2023-24,202401240MIL,1/24/2024,MIL vs CLE,Sam Merrill,merrisa01,27,CLE,0,MIL,12,2,3,0,0,1,26.76666667,0,2,4,9,4,9,0,0,1,0,5,15,14,17,17.9
2023-24,202401240DET,1/24/2024,DET vs CHO,Ausar Thompson,thompau01,44,DET,1,CHO,7,2,1,2,0,2,26.76666667,0,2,3,4,0,1,1,2,4,2,3,8,9,10,14.9
2023-24,202401240DET,1/24/2024,DET vs CHO,Nick Richards,richani01,33,CHO,0,DET,21,10,0,0,1,0,26.91666667,5,5,9,13,0,0,3,4,1,1,10,21,31,31,36
2023-24,202401240DET,1/24/2024,DET vs CHO,Killian Hayes,hayeski01,39,DET,1,CHO,6,7,8,0,0,1,26.96666667,0,7,2,3,1,2,1,3,1,0,15,14,13,21,25.4
2023-24,202401240SAS,1/24/2024,SAS vs OKC,Malaki Branham,branhma01,42,SAS,1,OKC,11,3,2,2,1,0,27.5,0,3,3,5,1,2,4,4,1,3,5,13,14,16,26.6
2023-24,202401240MIL,1/24/2024,MIL vs CLE,Malik Beasley,beaslma01,42,MIL,1,CLE,9,1,1,1,0,1,27.56666667,0,1,3,5,3,5,0,0,3,1,2,10,10,11,13.7
2023-24,202401240SAS,1/24/2024,SAS vs OKC,Victor Wembanyama,wembavi01,38,SAS,1,OKC,24,12,4,1,4,3,27.76666667,6,6,9,18,0,3,6,8,2,5,16,28,36,40,56.4
2023-24,202401240MIL,1/24/2024,MIL vs CLE,Caris LeVert,leverca01,32,CLE,0,MIL,9,4,4,2,1,2,27.9,0,4,4,10,1,4,0,0,2,3,8,13,13,17,26.8
2023-24,202401240WAS,1/24/2024,WAS vs MIN,Jordan Poole,poolejo01,42,WAS,1,MIN,7,2,3,0,0,4,28.18333333,0,2,2,11,1,4,2,2,3,0,5,10,9,12,9.9
2023-24,202401240SAS,1/24/2024,SAS vs OKC,Blake Wesley,weslebl01,23,SAS,1,OKC,12,4,6,0,1,4,28.36666667,1,3,5,5,1,1,1,3,4,1,10,18,16,22,24.8
2023-24,202401240DET,1/24/2024,DET vs CHO,P.J. Washington,washipj01,36,CHO,0,DET,12,6,5,1,1,2,28.5,0,6,4,6,4,6,0,0,4,2,11,17,18,23,30.7
2023-24,202401240MIA,1/24/2024,MIA vs MEM,Caleb Martin,martica02,27,MIA,1,MEM,15,4,1,2,1,2,28.65,2,2,4,8,3,5,4,4,2,3,5,16,19,20,28.3
2023-24,202401240GSW,1/24/2024,GSW vs ATL,Jonathan Kuminga,kuminjo01,40,GSW,1,ATL,25,9,2,2,2,1,28.85,0,9,11,11,0,0,3,5,1,4,11,27,34,36,49.8
2023-24,202401240SAS,1/24/2024,SAS vs OKC,Jalen Williams,willija06,41,OKC,0,SAS,13,5,7,2,0,0,29.28333333,0,5,6,12,1,5,0,0,3,2,12,20,18,25,35.5
2023-24,202401240MIA,1/24/2024,MIA vs MEM,Terry Rozier,roziete01,31,MIA,1,MEM,9,4,5,2,0,3,29.38333333,2,2,3,11,1,5,2,2,2,2,9,14,13,18,24.3
2023-24,202401240GSW,1/24/2024,GSW vs ATL,Andrew Wiggins,wiggian01,37,GSW,1,ATL,12,5,1,0,2,0,29.45,2,3,4,11,0,4,4,4,4,2,6,13,17,18,25.5
2023-24,202401240SAS,1/24/2024,SAS vs OKC,Shai Gilgeous-Alexander,gilgesh01,43,OKC,0,SAS,32,6,10,2,1,4,29.46666667,2,4,9,15,2,2,12,12,3,3,16,42,38,48,59.2
2023-24,202401240HOU,1/24/2024,HOU vs POR,Aaron Holiday,holidaa01,41,HOU,1,POR,12,3,2,1,0,0,29.53333333,0,3,2,4,2,3,6,6,0,1,5,14,15,17,21.6
2023-24,202401240SAS,1/24/2024,SAS vs OKC,Chet Holmgren,holmgch01,44,OKC,0,SAS,17,9,4,1,3,3,30.13333333,4,5,7,13,2,4,1,3,3,4,13,21,26,30,42.8
2023-24,202401240GSW,1/24/2024,GSW vs ATL,Klay Thompson,thompkl01,40,GSW,1,ATL,24,2,3,0,1,2,30.15,1,1,8,18,5,10,3,3,2,1,5,27,26,29,31.9
2023-24,202401240WAS,1/24/2024,WAS vs MIN,Jaden McDaniels,mcdanja02,34,MIN,0,WAS,13,5,0,2,0,1,30.36666667,2,3,5,11,1,4,2,2,4,2,5,13,18,18,24
2023-24,202401240MIA,1/24/2024,MIA vs MEM,John Konchar,konchjo01,35,MEM,0,MIA,11,10,2,1,1,2,30.66666667,3,7,5,7,1,3,0,0,4,2,12,13,21,23,30
2023-24,202401240WAS,1/24/2024,WAS vs MIN,Nickeil Alexander-Walker,alexani01,44,MIN,0,WAS,6,5,5,1,0,0,30.8,1,4,2,4,1,3,1,2,2,1,10,11,11,16,22.5
2023-24,202401240DAL,1/24/2024,DAL vs PHO,Josh Green,greenjo02,31,DAL,1,PHO,8,4,3,0,0,1,31.03333333,3,1,3,8,2,6,0,0,1,0,7,11,12,15,16.3
2023-24,202401240GSW,1/24/2024,GSW vs ATL,Stephen Curry,curryst01,38,GSW,1,ATL,25,3,8,0,0,1,31.3,0,3,7,16,5,8,6,6,3,0,11,33,28,36,39.6
2023-24,202401240DET,1/24/2024,DET vs CHO,LaMelo Ball,ballla01,21,CHO,0,DET,17,4,7,1,0,4,31.55,1,3,6,21,1,8,4,4,6,1,11,24,21,28,31.3
2023-24,202401240MIL,1/24/2024,MIL vs CLE,Jarrett Allen,allenja01,37,CLE,0,MIL,21,12,5,0,0,1,31.56666667,4,8,10,19,0,0,1,2,0,0,17,26,33,38,41.9
2023-24,202401240MIA,1/24/2024,MIA vs MEM,David Roddy,roddyda01,41,MEM,0,MIA,10,3,4,2,1,3,31.63333333,2,1,4,11,2,4,0,0,2,3,7,14,13,17,25.6
2023-24,202401240HOU,1/24/2024,HOU vs POR,Dillon Brooks,brookdi01,34,HOU,1,POR,14,4,4,0,0,3,31.95,0,4,5,11,3,6,1,1,3,0,8,18,18,22,21.8
2023-24,202401240MIL,1/24/2024,MIL vs CLE,Khris Middleton,middlkh01,38,MIL,1,CLE,24,5,5,2,0,0,31.98333333,2,3,8,15,1,4,7,8,3,2,10,29,29,34,43.5
2023-24,202401240WAS,1/24/2024,WAS vs MIN,Tyus Jones,jonesty01,43,WAS,1,MIN,5,2,6,0,0,0,32.46666667,0,2,2,7,0,2,1,2,1,0,8,11,7,13,16.4
2023-24,202401240GSW,1/24/2024,GSW vs ATL,Bogdan Bogdanovic,bogdabo01,42,ATL,0,GSW,17,0,3,1,0,1,32.51666667,0,0,6,11,4,9,1,1,1,1,3,20,17,20,23.5
2023-24,202401240MIA,1/24/2024,MIA vs MEM,Vince Williams Jr.,willivi01,34,MEM,0,MIA,25,5,4,1,0,1,32.68333333,0,5,8,10,5,6,4,4,3,1,9,29,30,34,39
2023-24,202401240GSW,1/24/2024,GSW vs ATL,Dejounte Murray,murrade01,44,ATL,0,GSW,23,7,7,1,0,2,33.21666667,3,4,7,19,2,7,7,8,2,1,14,30,30,37,42.9
2023-24,202401240DET,1/24/2024,DET vs CHO,Bojan Bogdanovic,bogdabo02,23,DET,1,CHO,34,4,4,0,0,2,33.23333333,0,4,12,23,5,10,5,6,1,0,8,38,38,42,42.8
2023-24,202401240DAL,1/24/2024,DAL vs PHO,Grayson Allen,allengr01,39,PHO,0,DAL,15,5,4,1,0,2,33.61666667,1,4,5,8,3,5,2,2,3,1,9,19,20,24,28
2023-24,202401240DET,1/24/2024,DET vs CHO,Isaiah Stewart,stewais01,33,DET,1,CHO,11,8,2,1,0,2,33.71666667,1,7,4,8,1,2,2,4,3,1,10,13,19,21,24.6
2023-24,202401240MIL,1/24/2024,MIL vs CLE,Max Strus,strusma01,42,CLE,0,MIL,14,4,2,2,0,1,33.9,0,4,6,11,2,6,0,0,5,2,6,16,18,20,26.8
2023-24,202401240WAS,1/24/2024,WAS vs MIN,Anthony Edwards,edwaran01,41,MIN,0,WAS,38,3,5,1,0,4,34.03333333,1,2,11,28,3,10,13,14,4,1,8,43,41,46,48.1
2023-24,202401240DAL,1/24/2024,DAL vs PHO,Tim Hardaway Jr.,hardati02,41,DAL,1,PHO,17,5,2,2,0,1,34.25,0,5,6,16,4,10,1,2,1,2,7,19,22,24,31
2023-24,202401240SAS,1/24/2024,SAS vs OKC,Devin Vassell,vassede01,39,SAS,1,OKC,21,5,7,0,1,0,34.43333333,1,4,9,14,1,4,2,2,1,1,12,28,26,33,40.5
2023-24,202401240MIL,1/24/2024,MIL vs CLE,Giannis Antetokounmpo,antetgi01,42,MIL,1,CLE,35,18,10,0,2,2,34.55,2,16,16,24,1,1,2,3,3,2,28,45,53,63,75.6
2023-24,202401240MIL,1/24/2024,MIL vs CLE,Damian Lillard,lillada01,41,MIL,1,CLE,28,1,4,2,0,2,34.56666667,0,1,8,21,2,9,10,11,1,2,5,32,29,33,39.2
2023-24,202401240WAS,1/24/2024,WAS vs MIN,Karl-Anthony Towns,townska01,43,MIN,0,WAS,27,6,3,0,1,1,34.58333333,0,6,11,24,2,10,3,3,4,1,9,30,33,36,40.7
2023-24,202401240DAL,1/24/2024,DAL vs PHO,Devin Booker,bookede01,35,PHO,0,DAL,46,7,3,2,0,2,34.65,1,6,17,23,6,10,6,8,0,2,10,49,53,56,62.9
2023-24,202401240WAS,1/24/2024,WAS vs MIN,Rudy Gobert,goberru01,43,MIN,0,WAS,19,16,1,0,4,0,34.73333333,7,9,7,11,0,0,5,6,4,4,17,20,35,36,51.7
2023-24,202401240WAS,1/24/2024,WAS vs MIN,Kyle Kuzma,kuzmaky01,43,WAS,1,MIN,17,14,8,0,1,5,34.73333333,0,14,5,11,3,8,4,4,4,1,22,25,31,39,43.8
2023-24,202401240MIL,1/24/2024,MIL vs CLE,Brook Lopez,lopezbr01,44,MIL,1,CLE,8,9,3,1,1,1,34.73333333,5,4,3,7,0,1,2,2,1,2,12,11,17,20,28.3
2023-24,202401240MIA,1/24/2024,MIA vs MEM,Jimmy Butler,butleji01,29,MIA,1,MEM,15,4,3,2,0,4,34.85,3,1,4,10,1,2,6,8,1,2,7,18,19,22,26.3
2023-24,202401240MIA,1/24/2024,MIA vs MEM,Jaren Jackson Jr.,jacksja02,42,MEM,0,MIA,15,6,3,1,1,5,35.45,0,6,5,21,1,7,4,5,1,2,9,18,21,24,27.7
2023-24,202401240DAL,1/24/2024,DAL vs PHO,Bradley Beal,bealbr01,20,PHO,0,DAL,20,7,7,1,1,2,36.16666667,2,5,8,15,3,7,1,2,4,2,14,27,27,34,42.9
2023-24,202401240GSW,1/24/2024,GSW vs ATL,Jalen Johnson,johnsja05,30,ATL,0,GSW,21,9,6,1,0,0,36.25,1,8,8,16,2,6,3,5,4,1,15,27,30,36,43.8
2023-24,202401240WAS,1/24/2024,WAS vs MIN,Deni Avdija,avdijde01,43,WAS,1,MIN,24,6,6,0,0,2,37.53333333,0,6,7,12,4,5,6,6,3,0,12,30,30,36,38.2
2023-24,202401240DAL,1/24/2024,DAL vs PHO,Kevin Durant,duranke01,37,PHO,0,DAL,12,10,7,1,2,1,37.65,0,10,4,10,0,4,4,7,4,3,17,19,22,29,42.5
2023-24,202401240MIA,1/24/2024,MIA vs MEM,Tyler Herro,herroty01,25,MIA,1,MEM,18,6,3,0,0,4,37.71666667,0,6,8,15,2,6,0,0,1,0,9,21,24,27,25.7
2023-24,202401240HOU,1/24/2024,HOU vs POR,Jeff Green,greenje02,41,HOU,1,POR,4,4,1,2,1,0,38.16666667,0,4,2,4,0,2,0,0,2,3,5,5,8,9,19.3
2023-24,202401240DAL,1/24/2024,DAL vs PHO,Luka Doncic,doncilu01,37,DAL,1,PHO,34,8,9,1,2,5,38.53333333,1,7,11,24,4,11,8,12,1,3,17,43,42,51,61.1
2023-24,202401240DET,1/24/2024,DET vs CHO,Brandon Miller,millebr02,36,CHO,0,DET,23,7,4,0,1,2,38.78333333,1,6,8,17,5,10,2,3,4,1,11,27,30,34,38.4
2023-24,202401240HOU,1/24/2024,HOU vs POR,Jalen Green,greenja05,43,HOU,1,POR,29,0,3,1,1,1,38.81666667,0,0,12,24,2,7,3,4,1,2,3,32,29,32,38.5
2023-24,202401240MIL,1/24/2024,MIL vs CLE,Donovan Mitchell,mitchdo01,33,CLE,0,MIL,23,7,8,1,0,6,39.31666667,0,7,10,24,2,11,1,4,5,1,15,31,30,38,40.4
2023-24,202401240MIA,1/24/2024,MIA vs MEM,Bam Adebayo,adebaba01,34,MIA,1,MEM,15,15,6,1,6,0,39.51666667,3,12,4,13,0,1,7,11,3,7,21,21,30,36,63
2023-24,202401240HOU,1/24/2024,HOU vs POR,Alperen Sengun,sengual01,43,HOU,1,POR,30,10,8,1,0,2,39.56666667,4,6,11,17,1,2,7,8,5,1,18,38,40,48,55
2023-24,202401240HOU,1/24/2024,HOU vs POR,Deandre Ayton,aytonde01,28,POR,0,HOU,18,17,3,1,2,1,40.73333333,6,11,8,13,0,0,2,2,3,3,20,21,35,38,50.9
2023-24,202401240HOU,1/24/2024,HOU vs POR,Anfernee Simons,simonan01,22,POR,0,HOU,33,6,5,0,0,3,40.73333333,2,4,13,20,4,9,3,3,3,0,11,38,39,44,44.7
2023-24,202401240DET,1/24/2024,DET vs CHO,Miles Bridges,bridgmi02,31,CHO,0,DET,20,10,2,2,0,3,40.81666667,0,10,7,21,3,9,3,4,1,2,12,22,30,32,38
2023-24,202401240HOU,1/24/2024,HOU vs POR,Malcolm Brogdon,brogdma01,35,POR,0,HOU,19,2,6,0,0,2,41.45,1,1,8,19,3,7,0,0,2,0,8,25,21,27,28.4
2023-24,202401240HOU,1/24/2024,HOU vs POR,Jerami Grant,grantje01,39,POR,0,HOU,21,5,9,0,2,1,42.73333333,0,5,5,12,2,5,9,11,0,2,14,30,26,35,45.5
2023-24,202401240HOU,1/24/2024,HOU vs POR,Fred VanVleet,vanvlfr01,41,HOU,1,POR,18,6,7,3,3,2,45.61666667,0,6,8,17,2,10,0,0,1,6,13,25,24,31,51.7
2023-24,202401230LAC,1/23/2024,LAC vs LAL,Max Christie,chrisma02,36,LAL,0,LAC,0,0,0,0,0,0,10.15,0,0,0,1,0,1,0,0,0,0,0,0,0,0,0
2023-24,202401230IND,1/23/2024,IND vs DEN,DeAndre Jordan,jordade01,21,DEN,0,IND,2,3,1,0,1,1,10.73333333,2,1,1,1,0,0,0,2,2,1,4,3,5,6,9.1
2023-24,202401230IND,1/23/2024,IND vs DEN,Ben Sheppard,sheppbe01,23,IND,1,DEN,5,1,1,1,0,0,12,1,0,2,2,1,1,0,0,1,1,2,6,6,7,10.7
2023-24,202401230OKC,1/23/2024,OKC vs POR,Cason Wallace,wallaca01,43,OKC,1,POR,3,4,0,0,0,2,12.18333333,0,4,1,2,1,2,0,0,0,0,4,3,7,7,5.8
2023-24,202401230BRK,1/23/2024,BRK vs NYK,Lonnie Walker IV,walkelo01,25,BRK,1,NYK,5,1,0,0,0,0,12.2,1,0,2,8,1,5,0,0,0,0,1,5,6,6,6.2
2023-24,202401230BRK,1/23/2024,BRK vs NYK,Miles McBride,mcbrimi01,31,NYK,0,BRK,8,1,2,0,1,0,12.21666667,0,1,3,5,2,3,0,0,1,1,3,10,9,11,15.2
2023-24,202401230OKC,1/23/2024,OKC vs POR,Kenrich Williams,willike04,32,OKC,1,POR,5,4,0,1,0,1,13.31666667,1,3,2,5,1,2,0,0,0,1,4,5,9,9,11.8
2023-24,202401230LAC,1/23/2024,LAC vs LAL,Christian Wood,woodch01,39,LAL,0,LAC,6,7,3,0,0,1,13.55,0,7,2,2,0,0,2,5,0,0,10,9,13,16,17.9
2023-24,202401230NOP,1/23/2024,NOP vs UTA,Kelly Olynyk,olynyke01,43,UTA,0,NOP,9,3,2,0,0,1,14.11666667,0,3,4,5,0,1,1,2,3,0,5,11,12,14,14.6
2023-24,202401230OKC,1/23/2024,OKC vs POR,Toumani Camara,camarto01,42,POR,0,OKC,0,5,1,2,0,0,14.41666667,2,3,0,2,0,0,0,0,2,2,6,1,5,6,13.5
2023-24,202401230IND,1/23/2024,IND vs DEN,Christian Braun,braunch01,45,DEN,0,IND,2,4,0,1,1,0,14.68333333,3,1,1,3,0,2,0,0,0,2,4,2,6,6,12.8
2023-24,202401230OKC,1/23/2024,OKC vs POR,Jaylin Williams,willija07,35,OKC,1,POR,7,2,1,1,1,0,14.83333333,0,2,3,5,1,2,0,1,1,2,3,8,9,10,16.9
2023-24,202401230LAC,1/23/2024,LAC vs LAL,Cam Reddish,reddica01,36,LAL,0,LAC,9,0,1,1,3,1,16.41666667,0,0,3,5,2,4,1,4,1,4,1,10,9,10,21.5
2023-24,202401230NOP,1/23/2024,NOP vs UTA,Jordan Hawkins,hawkijo01,39,NOP,1,UTA,6,2,0,0,1,0,16.48333333,0,2,2,4,2,4,0,0,1,1,2,6,8,8,11.4
2023-24,202401230NOP,1/23/2024,NOP vs UTA,Naji Marshall,marshna01,35,NOP,1,UTA,3,2,4,1,0,1,16.53333333,1,1,1,3,1,1,0,0,3,1,6,7,5,9,13.4
2023-24,202401230IND,1/23/2024,IND vs DEN,Obi Toppin,toppiob01,45,IND,1,DEN,4,2,0,0,0,0,16.91666667,0,2,2,4,0,0,0,0,0,0,2,4,6,6,6.4
2023-24,202401230NOP,1/23/2024,NOP vs UTA,Dyson Daniels,daniedy01,44,NOP,1,UTA,0,5,3,1,0,0,17.33333333,0,5,0,2,0,1,0,0,2,1,8,3,5,8,13.5
2023-24,202401230NOP,1/23/2024,NOP vs UTA,Kris Dunn,dunnkr01,37,UTA,0,NOP,10,3,4,0,0,1,17.41666667,2,1,4,7,2,4,0,0,3,0,7,14,13,17,18.6
2023-24,202401230OKC,1/23/2024,OKC vs POR,Aaron Wiggins,wiggiaa01,40,OKC,1,POR,13,3,0,0,0,1,17.43333333,2,1,6,8,1,1,0,0,3,0,3,13,16,16,15.6
2023-24,202401230LAC,1/23/2024,LAC vs LAL,Russell Westbrook,westbru01,42,LAC,1,LAL,16,6,3,2,0,3,17.68333333,0,6,6,11,3,3,1,1,1,2,9,19,22,25,30.7
2023-24,202401230BRK,1/23/2024,BRK vs NYK,Spencer Dinwiddie,dinwisp01,41,BRK,1,NYK,0,0,4,0,0,1,18.56666667,0,0,0,4,0,4,0,0,1,0,4,4,0,4,5
2023-24,202401230IND,1/23/2024,IND vs DEN,Peyton Watson,watsope01,43,DEN,0,IND,7,2,0,1,2,2,18.65,0,2,2,4,1,2,2,2,1,3,2,7,9,9,16.4
2023-24,202401230LAC,1/23/2024,LAC vs LAL,Mason Plumlee,plumlma01,12,LAC,1,LAL,0,2,2,0,0,1,19.08333333,0,2,0,1,0,0,0,0,0,0,4,2,2,4,4.4
2023-24,202401230NOP,1/23/2024,NOP vs UTA,Larry Nance Jr.,nancela02,27,NOP,1,UTA,12,8,3,1,1,1,19.58333333,0,8,5,6,1,2,1,1,2,2,11,15,20,23,31.1
2023-24,202401230OKC,1/23/2024,OKC vs POR,Isaiah Joe,joeis01,43,OKC,1,POR,9,1,2,0,0,0,19.86666667,0,1,4,5,1,2,0,0,2,0,3,11,10,12,13.2
2023-24,202401230OKC,1/23/2024,OKC vs POR,Matisse Thybulle,thybuma01,41,POR,0,OKC,8,3,1,1,1,0,19.9,1,2,3,6,2,5,0,0,2,2,4,9,11,12,19.1
2023-24,202401230BRK,1/23/2024,BRK vs NYK,Quentin Grimes,grimequ01,41,NYK,0,BRK,5,1,2,1,0,0,20.06666667,0,1,2,5,1,4,0,0,2,1,3,7,6,8,12.2
2023-24,202401230BRK,1/23/2024,BRK vs NYK,Royce O'Neale,onealro01,42,BRK,1,NYK,8,4,3,1,1,1,20.48333333,2,2,3,4,2,3,0,0,3,2,7,11,12,15,22.3
2023-24,202401230OKC,1/23/2024,OKC vs POR,Duop Reath,reathdu01,31,POR,0,OKC,10,4,3,1,1,2,20.73333333,1,3,3,5,2,3,2,2,3,2,7,13,14,17,23.3
2023-24,202401230LAC,1/23/2024,LAC vs LAL,Daniel Theis,theisda01,32,LAC,1,LAL,3,2,2,1,0,0,20.81666667,1,1,1,3,0,2,1,1,5,1,4,5,5,7,11.4
2023-24,202401230IND,1/23/2024,IND vs DEN,T.J. McConnell,mccontj01,37,IND,1,DEN,17,1,7,0,0,3,20.96666667,0,1,7,11,1,1,2,2,3,0,8,24,18,25,25.7
2023-24,202401230BRK,1/23/2024,BRK vs NYK,Precious Achiuwa,achiupr01,37,NYK,0,BRK,6,9,2,0,0,0,21.45,4,5,3,6,0,1,0,0,1,0,11,8,15,17,19.8
2023-24,202401230NOP,1/23/2024,NOP vs UTA,Jordan Clarkson,clarkjo01,35,UTA,0,NOP,9,1,1,0,0,2,22.05,0,1,4,9,0,3,1,1,0,0,2,10,10,11,9.7
2023-24,202401230BRK,1/23/2024,BRK vs NYK,Cam Thomas,thomaca02,34,BRK,1,NYK,14,1,2,0,1,1,22.13333333,0,1,6,11,0,3,2,2,3,1,3,16,15,17,20.2
2023-24,202401230IND,1/23/2024,IND vs DEN,Buddy Hield,hieldbu01,45,IND,1,DEN,3,1,1,2,1,0,22.16666667,0,1,1,3,0,2,1,1,1,3,2,4,4,5,14.7
2023-24,202401230NOP,1/23/2024,NOP vs UTA,Ochai Agbaji,agbajoc01,45,UTA,0,NOP,5,2,0,0,0,0,23.16666667,1,1,2,4,1,1,0,0,0,0,2,5,7,7,7.4
2023-24,202401230LAC,1/23/2024,LAC vs LAL,Terance Mann,mannte01,36,LAC,1,LAL,17,1,1,1,0,2,23.25,1,0,7,10,2,4,1,2,4,1,2,18,18,19,20.7
2023-24,202401230NOP,1/23/2024,NOP vs UTA,Jonas Valanciunas,valanjo01,44,NOP,1,UTA,17,12,3,0,0,1,23.26666667,3,9,7,13,1,5,2,4,2,0,15,20,29,32,34.9
2023-24,202401230NOP,1/23/2024,NOP vs UTA,Collin Sexton,sextoco01,45,UTA,0,NOP,22,3,7,0,1,1,23.6,0,3,9,12,2,4,2,3,0,1,10,29,25,32,38.1
2023-24,202401230OKC,1/23/2024,OKC vs POR,Luguentz Dort,dortlu01,41,OKC,1,POR,6,3,1,0,0,3,23.66666667,1,2,2,6,1,5,1,2,4,0,4,7,9,10,8.1
2023-24,202401230LAC,1/23/2024,LAC vs LAL,Amir Coffey,coffeam01,30,LAC,1,LAL,9,2,0,1,0,0,24.15,0,2,3,4,3,3,0,0,2,1,2,9,11,11,14.4
2023-24,202401230NOP,1/23/2024,NOP vs UTA,John Collins,collijo01,41,UTA,0,NOP,14,9,2,0,3,1,24.45,1,8,5,12,0,3,4,4,5,3,11,16,23,25,35.8
2023-24,202401230IND,1/23/2024,IND vs DEN,Reggie Jackson,jacksre01,45,DEN,0,IND,13,2,2,2,1,2,24.45,0,2,6,11,1,4,0,0,3,3,4,15,15,17,25.4
2023-24,202401230NOP,1/23/2024,NOP vs UTA,Trey Murphy III,murphtr02,20,NOP,1,UTA,14,4,2,0,0,0,24.71666667,1,3,6,14,2,10,0,1,2,0,6,16,18,20,21.8
2023-24,202401230NOP,1/23/2024,NOP vs UTA,Keyonte George,georgke01,39,UTA,0,NOP,12,1,5,1,0,0,24.81666667,0,1,1,8,1,4,9,10,2,1,6,17,13,18,23.7
2023-24,202401230NOP,1/23/2024,NOP vs UTA,Simone Fontecchio,fontesi01,43,UTA,0,NOP,18,4,2,2,0,1,24.83333333,0,4,6,9,5,8,1,1,1,2,6,20,22,24,30.8
2023-24,202401230OKC,1/23/2024,OKC vs POR,Josh Giddey,giddejo01,42,OKC,1,POR,7,5,3,0,0,0,24.86666667,2,3,3,6,0,0,1,2,2,0,8,10,12,15,17.5
2023-24,202401230LAC,1/23/2024,LAC vs LAL,Jarred Vanderbilt,vandeja01,25,LAL,0,LAC,12,9,2,3,1,2,25.15,6,3,4,10,0,1,4,4,3,4,11,14,21,23,35.8
2023-24,202401230BRK,1/23/2024,BRK vs NYK,Donte DiVincenzo,divindo01,44,NYK,0,BRK,11,5,0,1,0,3,25.3,1,4,4,10,3,8,0,0,0,1,5,11,16,16,17
2023-24,202401230NOP,1/23/2024,NOP vs UTA,Walker Kessler,kesslwa01,37,UTA,0,NOP,6,5,1,0,4,0,25.35,0,5,2,3,0,0,2,5,1,4,6,7,11,12,25.5
2023-24,202401230BRK,1/23/2024,BRK vs NYK,Cameron Johnson,johnsca02,35,BRK,1,NYK,19,5,2,0,0,0,25.4,2,3,7,14,4,6,1,1,1,0,7,21,24,26,28
2023-24,202401230NOP,1/23/2024,NOP vs UTA,Herbert Jones,joneshe01,41,NOP,1,UTA,22,5,5,1,1,0,25.8,2,3,8,9,4,4,2,2,4,2,10,27,27,32,41.5
2023-24,202401230OKC,1/23/2024,OKC vs POR,Scoot Henderson,hendesc01,34,POR,0,OKC,19,4,7,1,0,1,25.93333333,0,4,7,18,2,6,3,3,5,1,11,26,23,30,36.3
2023-24,202401230BRK,1/23/2024,BRK vs NYK,Jericho Sims,simsje01,20,NYK,0,BRK,6,4,2,0,4,0,26.55,2,2,3,4,0,0,0,0,1,4,6,8,10,12,25.8
2023-24,202401230NOP,1/23/2024,NOP vs UTA,Zion Williamson,willizi01,36,NOP,1,UTA,17,3,11,0,0,2,26.8,1,2,8,12,0,0,1,2,2,0,14,28,20,31,35.1
2023-24,202401230LAC,1/23/2024,LAC vs LAL,Norman Powell,powelno01,42,LAC,1,LAL,17,5,2,0,2,1,26.96666667,0,5,8,14,1,4,0,0,0,2,7,19,22,24,31
2023-24,202401230IND,1/23/2024,IND vs DEN,Andrew Nembhard,nembhan01,30,IND,1,DEN,15,1,7,0,0,2,27.03333333,0,1,7,9,1,3,0,0,1,0,8,22,16,23,24.7
2023-24,202401230OKC,1/23/2024,OKC vs POR,Deandre Ayton,aytonde01,27,POR,0,OKC,5,7,2,0,0,3,27.06666667,2,5,2,7,0,0,1,2,2,0,9,7,12,14,13.4
2023-24,202401230NOP,1/23/2024,NOP vs UTA,Lauri Markkanen,markkla01,35,UTA,0,NOP,11,4,1,0,0,1,27.26666667,2,2,4,15,1,5,2,2,0,0,5,12,15,16,16.3
2023-24,202401230IND,1/23/2024,IND vs DEN,Bennedict Mathurin,mathube01,45,IND,1,DEN,11,5,3,0,0,1,28.03333333,0,5,3,8,1,2,4,5,2,0,8,14,16,19,20.5
2023-24,202401230BRK,1/23/2024,BRK vs NYK,Josh Hart,hartjo01,43,NYK,0,BRK,2,5,1,2,1,1,28.23333333,1,4,1,7,0,3,0,0,1,3,6,3,7,8,17.5
2023-24,202401230BRK,1/23/2024,BRK vs NYK,Dennis Smith Jr.,smithde03,28,BRK,1,NYK,8,5,5,2,1,5,29.01666667,0,5,4,9,0,1,0,0,5,3,10,13,13,18,25.5
2023-24,202401230NOP,1/23/2024,NOP vs UTA,CJ McCollum,mccolcj01,30,NOP,1,UTA,33,5,2,1,1,2,29.21666667,1,4,11,17,9,13,2,3,3,2,7,35,38,40,46
2023-24,202401230LAC,1/23/2024,LAC vs LAL,Paul George,georgpa01,40,LAC,1,LAL,17,5,3,0,1,4,29.6,1,4,8,12,1,2,0,0,2,1,8,20,22,25,26.5
2023-24,202401230LAC,1/23/2024,LAC vs LAL,Rui Hachimura,hachiru01,32,LAL,0,LAC,11,3,2,1,1,0,29.73333333,1,2,5,8,1,1,0,0,1,2,5,13,14,16,23.6
2023-24,202401230OKC,1/23/2024,OKC vs POR,Jerami Grant,grantje01,38,POR,0,OKC,18,5,1,1,1,1,29.8,0,5,6,10,4,5,2,4,0,2,6,19,23,24,30.5
2023-24,202401230NOP,1/23/2024,NOP vs UTA,Brandon Ingram,ingrabr01,40,NOP,1,UTA,18,5,6,0,0,1,30.63333333,1,4,8,18,0,2,2,2,1,0,11,24,23,29,32
2023-24,202401230IND,1/23/2024,IND vs DEN,Michael Porter Jr.,portemi01,45,DEN,0,IND,5,4,1,0,1,0,30.65,0,4,2,9,1,5,0,0,1,1,5,6,9,10,14.3
2023-24,202401230OKC,1/23/2024,OKC vs POR,Jalen Williams,willija06,40,OKC,1,POR,19,4,2,2,2,0,32.13333333,0,4,9,20,1,3,0,0,1,4,6,21,23,25,38.8
2023-24,202401230IND,1/23/2024,IND vs DEN,Aaron Gordon,gordoaa01,39,DEN,0,IND,9,1,1,0,2,0,32.26666667,0,1,3,5,0,1,3,3,3,2,2,10,10,11,17.7
2023-24,202401230OKC,1/23/2024,OKC vs POR,Chet Holmgren,holmgch01,43,OKC,1,POR,8,10,3,0,6,1,32.43333333,1,9,3,6,0,2,2,4,1,6,13,11,18,21,41.5
2023-24,202401230IND,1/23/2024,IND vs DEN,Pascal Siakam,siakapa01,42,IND,1,DEN,16,10,4,0,0,1,32.56666667,2,8,7,16,0,0,2,2,1,0,14,20,26,30,33
2023-24,202401230LAC,1/23/2024,LAC vs LAL,Taurean Prince,princta02,43,LAL,0,LAC,11,3,2,2,1,1,32.58333333,0,3,4,10,2,6,1,1,2,3,5,13,14,16,25.6
2023-24,202401230OKC,1/23/2024,OKC vs POR,Anfernee Simons,simonan01,21,POR,0,OKC,17,3,5,0,1,4,33.13333333,0,3,5,12,4,9,3,4,3,1,8,22,20,25,27.1
2023-24,202401230BRK,1/23/2024,BRK vs NYK,OG Anunoby,anunoog01,39,NYK,0,BRK,10,5,1,4,2,3,33.45,1,4,3,8,0,1,4,4,2,6,6,11,15,16,32.5
2023-24,202401230OKC,1/23/2024,OKC vs POR,Jabari Walker,walkeja01,39,POR,0,OKC,14,13,0,0,1,1,33.78333333,6,7,6,14,2,7,0,0,0,1,13,14,27,27,31.6
2023-24,202401230IND,1/23/2024,IND vs DEN,Aaron Nesmith,nesmiaa01,40,IND,1,DEN,13,9,0,0,0,1,33.8,4,5,5,13,1,7,2,2,3,0,9,13,22,22,22.8
2023-24,202401230LAC,1/23/2024,LAC vs LAL,Austin Reaves,reaveau01,46,LAL,0,LAC,12,2,5,2,1,3,33.93333333,0,2,5,14,2,8,0,0,3,3,7,17,14,19,27.9
2023-24,202401230IND,1/23/2024,IND vs DEN,Kentavious Caldwell-Pope,caldwke01,43,DEN,0,IND,14,5,0,1,0,1,34.76666667,2,3,5,12,2,6,2,2,3,1,5,14,19,19,22
2023-24,202401230OKC,1/23/2024,OKC vs POR,Shai Gilgeous-Alexander,gilgesh01,42,OKC,1,POR,33,6,10,5,0,3,35.08333333,2,4,10,24,0,3,13,17,3,5,16,43,39,49,67.2
2023-24,202401230OKC,1/23/2024,OKC vs POR,Malcolm Brogdon,brogdma01,34,POR,0,OKC,18,2,7,0,1,7,35.23333333,0,2,5,12,2,4,6,6,2,1,9,25,20,27,26.9
2023-24,202401230BRK,1/23/2024,BRK vs NYK,Jalen Brunson,brunsja01,42,NYK,0,BRK,30,3,4,0,0,2,35.78333333,0,3,11,22,2,7,6,7,2,0,7,34,33,37,37.6
2023-24,202401230LAC,1/23/2024,LAC vs LAL,Anthony Davis,davisan02,44,LAL,0,LAC,26,12,2,0,0,1,35.78333333,4,8,12,20,0,1,2,2,2,0,14,28,38,40,42.4
2023-24,202401230BRK,1/23/2024,BRK vs NYK,Mikal Bridges,bridgmi01,43,BRK,1,NYK,36,5,5,1,0,0,36.68333333,0,5,14,26,7,13,1,2,2,1,10,41,41,46,52.5
2023-24,202401230IND,1/23/2024,IND vs DEN,Jamal Murray,murraja01,31,DEN,0,IND,31,8,7,0,0,3,36.78333333,2,6,11,24,3,9,6,6,1,0,15,38,39,46,48.1
2023-24,202401230BRK,1/23/2024,BRK vs NYK,Dorian Finney-Smith,finnedo01,40,BRK,1,NYK,5,2,7,1,1,2,36.81666667,2,0,2,10,1,7,0,0,3,2,9,12,7,14,21.9
2023-24,202401230BRK,1/23/2024,BRK vs NYK,Julius Randle,randlju01,44,NYK,0,BRK,30,9,7,0,0,4,36.95,2,7,10,19,2,2,8,8,3,0,16,37,39,46,47.3
2023-24,202401230IND,1/23/2024,IND vs DEN,Nikola Jokic,jokicni01,44,DEN,0,IND,31,13,10,0,1,1,37.01666667,2,11,13,19,3,4,2,2,3,1,23,41,44,54,63.6
2023-24,202401230IND,1/23/2024,IND vs DEN,Myles Turner,turnemy01,44,IND,1,DEN,22,6,1,1,0,2,37.03333333,0,6,8,18,0,5,6,7,3,1,7,23,28,29,31.7
2023-24,202401230LAC,1/23/2024,LAC vs LAL,Kawhi Leonard,leonaka01,38,LAC,1,LAL,25,11,10,2,1,2,38.08333333,2,9,11,16,0,1,3,3,0,3,21,35,36,46,60.2
2023-24,202401230BRK,1/23/2024,BRK vs NYK,Nic Claxton,claxtni01,33,BRK,1,NYK,8,17,1,2,1,3,38.7,6,11,4,9,0,0,0,0,1,3,18,9,25,26,35.9
2023-24,202401230LAC,1/23/2024,LAC vs LAL,James Harden,hardeja01,37,LAC,1,LAL,23,2,10,1,1,1,39.45,1,1,8,17,4,8,3,5,3,2,12,33,25,35,45.4
2023-24,202401230LAC,1/23/2024,LAC vs LAL,D'Angelo Russell,russeda01,42,LAL,0,LAC,27,5,10,0,1,5,39.95,2,3,9,21,4,10,5,6,3,1,15,37,32,42,46
2023-24,202401220MIN,1/22/2024,MIN vs CHO,Jordan McLaughlin,mclaujo01,22,MIN,1,CHO,0,2,3,0,1,1,10,0,2,0,2,0,2,0,0,0,1,5,3,2,5,8.9
2023-24,202401220MIN,1/22/2024,MIN vs CHO,Ish Smith,smithis01,34,CHO,0,MIN,6,1,1,2,0,0,10.66666667,0,1,3,3,0,0,0,0,2,2,2,7,7,8,14.7
2023-24,202401220PHO,1/22/2024,PHO vs CHI,Andre Drummond,drumman01,45,CHI,0,PHO,6,5,0,0,0,1,11.31666667,3,2,2,4,0,0,2,4,0,0,5,6,11,11,11
2023-24,202401220PHI,1/22/2024,PHI vs SAS,Cedi Osman,osmande01,43,SAS,0,PHI,2,3,1,0,0,0,11.35,0,3,1,1,0,0,0,0,2,0,4,3,5,6,7.1
2023-24,202401220DET,1/22/2024,DET vs MIL,Jae Crowder,crowdja01,12,MIL,0,DET,3,2,1,0,0,1,11.95,0,2,1,6,1,4,0,0,1,0,3,4,5,6,5.9
2023-24,202401220TOR,1/22/2024,TOR vs MEM,Chris Boucher,bouchch01,41,TOR,1,MEM,5,5,1,0,0,0,12,2,3,1,3,1,2,2,2,1,0,6,6,10,11,12.5
2023-24,202401220ORL,1/22/2024,ORL vs CLE,Cole Anthony,anthoco01,43,ORL,1,CLE,5,2,2,0,0,2,12.8,0,2,2,4,1,1,0,0,1,0,4,7,7,9,8.4
2023-24,202401220TOR,1/22/2024,TOR vs MEM,Jacob Gilyard,gilyaja01,26,MEM,0,TOR,5,1,2,0,0,0,12.96666667,0,1,2,3,1,2,0,0,0,0,3,7,6,8,9.2
2023-24,202401220PHI,1/22/2024,PHI vs SAS,Furkan Korkmaz,korkmfu01,27,PHI,1,SAS,0,1,1,0,1,0,13.46666667,0,1,0,3,0,1,0,0,1,1,2,1,1,2,5.7
2023-24,202401220ORL,1/22/2024,ORL vs CLE,Trevelin Queen,queentr01,10,ORL,1,CLE,8,1,5,1,0,1,13.63333333,0,1,2,4,0,1,4,6,0,1,6,13,9,14,18.7
2023-24,202401220TOR,1/22/2024,TOR vs MEM,Ziaire Williams,willizi02,41,MEM,0,TOR,6,2,2,0,0,2,13.63333333,1,1,1,3,1,1,3,3,3,0,4,8,8,10,9.4
2023-24,202401220PHI,1/22/2024,PHI vs SAS,Paul Reed,reedpa01,42,PHI,1,SAS,6,8,0,1,1,0,13.81666667,5,3,3,6,0,0,0,0,4,2,8,6,14,14,21.6
2023-24,202401220PHO,1/22/2024,PHO vs CHI,Josh Okogie,okogijo01,37,PHO,1,CHI,4,3,0,1,0,0,13.9,1,2,1,3,0,2,2,4,1,1,3,4,7,7,10.6
2023-24,202401220TOR,1/22/2024,TOR vs MEM,Gradey Dick,dickgr01,23,TOR,1,MEM,0,3,0,0,0,1,14.58333333,1,2,0,1,0,1,0,0,0,0,3,0,3,3,2.6
2023-24,202401220ORL,1/22/2024,ORL vs CLE,Joe Ingles,inglejo01,30,ORL,1,CLE,2,4,2,1,0,2,14.61666667,2,2,1,1,0,0,0,0,2,1,6,4,6,8,10.8
2023-24,202401220MIN,1/22/2024,MIN vs CHO,Naz Reid,reidna01,43,MIN,1,CHO,5,0,0,1,0,1,14.61666667,0,0,2,5,1,4,0,0,3,1,0,5,5,5,7
2023-24,202401220MIN,1/22/2024,MIN vs CHO,Shake Milton,miltosh01,34,MIN,1,CHO,4,1,3,1,0,0,14.76666667,0,1,2,5,0,2,0,0,1,1,4,7,5,8,12.7
2023-24,202401220MIN,1/22/2024,MIN vs CHO,Nick Smith Jr.,smithni01,26,CHO,0,MIN,8,2,2,0,0,2,14.81666667,0,2,3,4,2,3,0,0,1,0,4,10,10,12,11.4
2023-24,202401220PHI,1/22/2024,PHI vs SAS,Julian Champagnie,champju02,36,SAS,0,PHI,12,2,1,0,0,0,14.91666667,0,2,3,4,3,3,3,3,2,0,3,13,14,15,15.9
2023-24,202401220MIN,1/22/2024,MIN vs CHO,Nathan Mensah,mensana01,17,CHO,0,MIN,2,3,1,0,0,0,14.96666667,3,0,1,1,0,0,0,0,3,0,4,3,5,6,7.1
2023-24,202401220DAL,1/22/2024,DAL vs BOS,Sam Hauser,hausesa01,43,BOS,0,DAL,5,1,0,0,0,0,15.4,1,0,2,3,1,2,0,0,1,0,1,5,6,6,6.2
2023-24,202401220TOR,1/22/2024,TOR vs MEM,Xavier Tillman Sr.,tillmxa01,30,MEM,0,TOR,2,4,2,1,0,1,15.61666667,1,3,1,6,0,1,0,0,2,1,6,4,6,8,11.8
2023-24,202401220SAC,1/22/2024,SAC vs ATL,Patty Mills,millspa02,12,ATL,0,SAC,2,0,2,1,0,1,15.86666667,0,0,1,5,0,2,0,0,0,1,2,4,2,4,7
2023-24,202401220SAC,1/22/2024,SAC vs ATL,Trey Lyles,lylestr01,28,SAC,1,ATL,10,7,0,0,0,1,16.16666667,2,5,4,8,2,5,0,0,0,0,7,10,17,17,17.4
2023-24,202401220MIN,1/22/2024,MIN vs CHO,JT Thor,thorjt01,35,CHO,0,MIN,7,3,0,0,2,2,16.2,0,3,2,3,2,3,1,2,2,2,3,7,10,10,14.6
2023-24,202401220DET,1/22/2024,DET vs MIL,Killian Hayes,hayeski01,38,DET,1,MIL,2,1,5,1,1,1,16.25,0,1,1,2,0,0,0,0,2,2,6,7,3,8,15.7
2023-24,202401220DET,1/22/2024,DET vs MIL,Mike Muscala,muscami01,27,DET,1,MIL,3,4,1,0,1,0,16.46666667,2,2,1,1,1,1,0,0,2,1,5,4,7,8,12.3
2023-24,202401220PHI,1/22/2024,PHI vs SAS,KJ Martin,martike04,28,PHI,1,SAS,4,2,1,0,0,0,17.33333333,0,2,2,5,0,0,0,0,2,0,3,5,6,7,7.9
2023-24,202401220DAL,1/22/2024,DAL vs BOS,Grant Williams,willigr01,39,DAL,1,BOS,2,3,2,0,0,0,17.76666667,0,3,1,5,0,4,0,0,1,0,5,4,5,7,8.6
2023-24,202401220PHO,1/22/2024,PHO vs CHI,Keita Bates-Diop,bateske01,32,PHO,1,CHI,5,1,2,1,1,0,17.8,0,1,2,3,1,2,0,0,1,2,3,7,6,8,15.2
2023-24,202401220ORL,1/22/2024,ORL vs CLE,Anthony Black,blackan01,41,ORL,1,CLE,7,1,2,1,0,0,18.46666667,1,0,3,6,0,1,1,2,0,1,3,9,8,10,14.2
2023-24,202401220ORL,1/22/2024,ORL vs CLE,Moritz Wagner,wagnemo01,42,ORL,1,CLE,15,4,1,0,0,0,18.46666667,1,3,4,8,1,1,6,8,2,0,5,16,19,20,21.3
2023-24,202401220DAL,1/22/2024,DAL vs BOS,Luke Kornet,kornelu01,31,BOS,0,DAL,2,5,1,0,1,2,18.63333333,1,4,1,3,0,0,0,0,2,1,6,3,7,8,10.5
2023-24,202401220PHI,1/22/2024,PHI vs SAS,Blake Wesley,weslebl01,22,SAS,0,PHI,6,2,2,1,0,0,18.85,1,1,3,6,0,2,0,0,1,1,4,8,8,10,14.4
2023-24,202401220DET,1/22/2024,DET vs MIL,Ausar Thompson,thompau01,43,DET,1,MIL,0,5,1,0,0,0,18.95,1,4,0,1,0,0,0,2,2,0,6,1,5,6,7.5
2023-24,202401220PHI,1/22/2024,PHI vs SAS,Zach Collins,colliza01,34,SAS,0,PHI,1,6,4,0,0,1,19.65,2,4,0,7,0,5,1,2,2,0,10,5,7,11,13.2
2023-24,202401220DET,1/22/2024,DET vs MIL,Andre Jackson Jr.,jacksan01,37,MIL,0,DET,8,1,0,1,1,0,19.76666667,0,1,3,4,0,1,2,2,5,2,1,8,9,9,15.2
2023-24,202401220ORL,1/22/2024,ORL vs CLE,Isaac Okoro,okorois01,32,CLE,0,ORL,8,1,0,0,0,0,20.35,0,1,3,4,1,1,1,2,4,0,1,8,9,9,9.2
2023-24,202401220ORL,1/22/2024,ORL vs CLE,Tristan Thompson,thomptr01,36,CLE,0,ORL,4,5,1,1,1,1,20.71666667,1,4,2,6,0,0,0,2,1,2,6,5,9,10,16.5
2023-24,202401220PHI,1/22/2024,PHI vs SAS,Keldon Johnson,johnske04,41,SAS,0,PHI,8,2,0,0,0,1,20.81666667,0,2,4,12,0,4,0,0,3,0,2,8,10,10,9.4
2023-24,202401220TOR,1/22/2024,TOR vs MEM,Bruce Brown,brownbr01,37,TOR,1,MEM,7,3,2,0,0,2,21.05,0,3,3,5,1,2,0,0,3,0,5,9,10,12,11.6
2023-24,202401220TOR,1/22/2024,TOR vs MEM,GG Jackson II,jacksgg01,11,MEM,0,TOR,7,5,1,1,1,0,21.16666667,0,5,3,5,1,3,0,0,0,2,6,8,12,13,20.5
2023-24,202401220ORL,1/22/2024,ORL vs CLE,Chuma Okeke,okekech01,27,ORL,1,CLE,3,1,0,0,0,0,21.16666667,0,1,1,6,1,6,0,0,1,0,1,3,4,4,4.2
2023-24,202401220MIN,1/22/2024,MIN vs CHO,Kyle Anderson,anderky01,43,MIN,1,CHO,5,4,8,0,0,1,21.5,1,3,1,2,0,0,3,3,1,0,12,13,9,17,20.8
2023-24,202401220PHI,1/22/2024,PHI vs SAS,Doug McDermott,mcderdo01,38,SAS,0,PHI,13,5,0,0,0,2,21.58333333,3,2,5,12,3,9,0,0,1,0,5,13,18,18,17
2023-24,202401220ORL,1/22/2024,ORL vs CLE,Craig Porter Jr.,portecr01,28,CLE,0,ORL,12,3,5,0,0,1,21.96666667,0,3,5,7,0,0,2,2,2,0,8,17,15,20,22.1
2023-24,202401220TOR,1/22/2024,TOR vs MEM,Dennis Schroder,schrode01,44,TOR,1,MEM,11,2,3,1,0,2,21.98333333,1,1,3,9,1,3,4,4,1,1,5,14,13,16,18.9
2023-24,202401220SAC,1/22/2024,SAC vs ATL,Clint Capela,capelca01,41,ATL,0,SAC,11,12,1,0,2,1,22,6,6,4,10,0,0,3,4,0,2,13,12,23,24,31.9
2023-24,202401220SAC,1/22/2024,SAC vs ATL,Davion Mitchell,mitchda01,32,SAC,1,ATL,5,2,2,0,0,0,22.06666667,1,1,2,7,0,2,1,1,1,0,4,7,7,9,10.4
2023-24,202401220PHO,1/22/2024,PHO vs CHI,Drew Eubanks,eubandr01,37,PHO,1,CHI,10,8,4,0,0,0,22.31666667,2,6,4,4,0,0,2,2,3,0,12,14,18,22,25.6
2023-24,202401220DET,1/22/2024,DET vs MIL,Bojan Bogdanovic,bogdabo02,22,DET,1,MIL,15,1,1,0,1,0,22.58333333,0,1,6,12,2,4,1,2,3,1,2,16,16,17,20.7
2023-24,202401220TOR,1/22/2024,TOR vs MEM,Santi Aldama,aldamsa01,33,MEM,0,TOR,10,4,4,1,0,1,22.95,1,3,4,9,1,4,1,1,0,1,8,14,14,18,22.8
2023-24,202401220SAC,1/22/2024,SAC vs ATL,Garrison Mathews,mathega01,29,ATL,0,SAC,9,1,0,0,0,2,23.05,0,1,3,5,3,5,0,0,5,0,1,9,10,10,8.2
2023-24,202401220PHI,1/22/2024,PHI vs SAS,Danuel House Jr.,houseda01,27,PHI,1,SAS,8,2,1,0,0,0,23.13333333,0,2,2,4,1,3,3,6,0,0,3,9,10,11,11.9
2023-24,202401220TOR,1/22/2024,TOR vs MEM,David Roddy,roddyda01,40,MEM,0,TOR,8,9,2,0,0,1,23.23333333,6,3,4,12,0,0,0,0,1,0,11,10,17,19,20.8
2023-24,202401220ORL,1/22/2024,ORL vs CLE,Caleb Houstan,houstca01,35,ORL,1,CLE,6,2,0,0,0,1,23.55,0,2,2,3,2,3,0,0,2,0,2,6,8,8,7.4
2023-24,202401220TOR,1/22/2024,TOR vs MEM,Gary Trent Jr.,trentga02,39,TOR,1,MEM,6,0,2,1,0,1,23.6,0,0,2,6,2,4,0,0,1,1,2,8,6,8,11
2023-24,202401220ORL,1/22/2024,ORL vs CLE,Dean Wade,wadede01,34,CLE,0,ORL,9,3,0,2,0,0,24.05,0,3,3,4,3,3,0,0,2,2,3,9,12,12,18.6
2023-24,202401220ORL,1/22/2024,ORL vs CLE,Franz Wagner,wagnefr01,36,ORL,1,CLE,17,3,2,0,0,3,24.35,1,2,6,11,2,5,3,3,2,0,5,19,20,22,20.6
2023-24,202401220DAL,1/22/2024,DAL vs BOS,Payton Pritchard,pritcpa01,44,BOS,0,DAL,5,7,6,1,1,1,24.5,1,6,2,7,1,4,0,0,1,2,13,11,12,18,27.4
2023-24,202401220DAL,1/22/2024,DAL vs BOS,Dereck Lively II,livelde01,32,DAL,1,BOS,6,8,1,0,2,1,24.55,4,4,3,3,0,0,0,0,2,2,9,7,14,15,22.1
2023-24,202401220PHI,1/22/2024,PHI vs SAS,Kelly Oubre Jr.,oubreke01,30,PHI,1,SAS,8,3,0,0,0,0,24.58333333,0,3,3,6,0,1,2,5,4,0,3,8,11,11,11.6
2023-24,202401220SAC,1/22/2024,SAC vs ATL,Malik Monk,monkma01,41,SAC,1,ATL,13,1,8,1,0,1,24.98333333,0,1,4,6,0,1,5,5,3,1,9,21,14,22,28.2
2023-24,202401220DET,1/22/2024,DET vs MIL,Bobby Portis,portibo01,43,MIL,0,DET,7,4,0,0,1,0,25.25,1,3,2,5,0,3,3,4,3,1,4,7,11,11,14.8
2023-24,202401220DAL,1/22/2024,DAL vs BOS,Derrick Jones Jr.,jonesde02,41,DAL,1,BOS,5,2,3,0,0,1,25.3,0,2,2,7,1,3,0,0,1,0,5,8,7,10,10.9
2023-24,202401220ORL,1/22/2024,ORL vs CLE,Jalen Suggs,suggsja01,40,ORL,1,CLE,6,2,3,2,0,3,25.5,0,2,2,5,2,4,0,0,2,2,5,9,8,11,15.9
2023-24,202401220DAL,1/22/2024,DAL vs BOS,Maxi Kleber,klebima01,9,DAL,1,BOS,7,2,0,0,2,1,25.51666667,0,2,3,7,0,3,1,1,2,2,2,7,9,9,14.4
2023-24,202401220PHO,1/22/2024,PHO vs CHI,Jusuf Nurkic,nurkiju01,41,PHO,1,CHI,8,7,4,0,2,1,25.56666667,1,6,4,7,0,0,0,0,3,2,11,12,15,19,27.4
2023-24,202401220SAC,1/22/2024,SAC vs ATL,Kevin Huerter,huertke01,40,SAC,1,ATL,8,2,3,0,1,1,25.75,0,2,3,6,2,5,0,0,4,1,5,11,10,13,16.9
2023-24,202401220TOR,1/22/2024,TOR vs MEM,Thaddeus Young,youngth01,16,TOR,1,MEM,12,6,4,3,0,0,26.25,2,4,5,8,0,0,2,2,1,3,10,16,18,22,34.2
2023-24,202401220DET,1/22/2024,DET vs MIL,Marcus Sasser,sassema01,39,DET,1,MIL,23,1,3,1,0,2,26.26666667,0,1,9,17,0,4,5,5,1,1,4,26,24,27,29.7
2023-24,202401220ORL,1/22/2024,ORL vs CLE,Wendell Carter Jr.,cartewe01,18,ORL,1,CLE,10,9,1,2,0,1,26.88333333,2,7,4,9,1,2,1,2,2,2,10,11,19,20,27.3
2023-24,202401220ORL,1/22/2024,ORL vs CLE,Jarrett Allen,allenja01,36,CLE,0,ORL,14,11,4,0,2,2,27.3,5,6,6,8,0,0,2,4,2,2,15,18,25,29,37.2
2023-24,202401220ORL,1/22/2024,ORL vs CLE,Max Strus,strusma01,41,CLE,0,ORL,10,4,4,1,0,1,27.4,1,3,4,7,2,4,0,0,0,1,8,14,14,18,22.8
2023-24,202401220DET,1/22/2024,DET vs MIL,Alec Burks,burksal01,36,DET,1,MIL,9,2,3,0,0,1,27.5,0,2,3,12,3,9,0,0,4,0,5,12,11,14,14.9
2023-24,202401220TOR,1/22/2024,TOR vs MEM,John Konchar,konchjo01,34,MEM,0,TOR,6,5,4,0,5,1,28.16666667,4,1,3,6,0,1,0,1,2,5,9,10,11,15,32
2023-24,202401220DET,1/22/2024,DET vs MIL,Isaiah Stewart,stewais01,32,DET,1,MIL,19,8,2,2,5,1,28.31666667,1,7,5,9,2,6,7,8,2,7,10,21,27,29,51.6
2023-24,202401220PHI,1/22/2024,PHI vs SAS,Victor Wembanyama,wembavi01,37,SAS,0,PHI,33,7,2,0,2,1,28.35,3,4,10,19,2,5,11,12,5,2,9,35,40,42,49.4
2023-24,202401220ORL,1/22/2024,ORL vs CLE,Georges Niang,niangge01,41,CLE,0,ORL,11,5,1,0,1,0,28.48333333,0,5,3,9,2,7,3,4,3,1,6,12,16,17,21.5
2023-24,202401220SAC,1/22/2024,SAC vs ATL,Onyeka Okongwu,okongon01,42,ATL,0,SAC,8,9,3,0,2,2,29.05,3,6,4,6,0,1,0,1,6,2,12,11,17,20,27.3
2023-24,202401220ORL,1/22/2024,ORL vs CLE,Paolo Banchero,banchpa01,44,ORL,1,CLE,18,3,6,0,0,2,29.3,0,3,6,14,1,4,5,9,2,0,9,24,21,27,28.6
2023-24,202401220MIN,1/22/2024,MIN vs CHO,Brandon Miller,millebr02,35,CHO,0,MIN,27,3,2,1,0,0,29.43333333,0,3,11,13,3,4,2,2,4,1,5,29,30,32,36.6
2023-24,202401220SAC,1/22/2024,SAC vs ATL,Harrison Barnes,barneha02,42,SAC,1,ATL,32,4,0,1,0,0,29.83333333,2,2,10,20,4,8,8,8,2,1,4,32,36,36,39.8
2023-24,202401220ORL,1/22/2024,ORL vs CLE,Donovan Mitchell,mitchdo01,32,CLE,0,ORL,25,3,13,4,0,3,30.01666667,0,3,9,19,3,8,4,4,3,4,16,38,28,41,57.1
2023-24,202401220PHO,1/22/2024,PHO vs CHI,Ayo Dosunmu,dosunay01,43,CHI,0,PHO,13,1,0,2,1,1,30.15,1,0,6,11,0,2,1,2,2,3,1,13,14,14,22.2
2023-24,202401220MIN,1/22/2024,MIN vs CHO,Nickeil Alexander-Walker,alexani01,43,MIN,1,CHO,18,0,2,1,0,1,30.2,0,0,6,9,4,6,2,2,2,1,2,20,18,20,23
2023-24,202401220SAC,1/22/2024,SAC vs ATL,Saddiq Bey,beysa01,43,ATL,0,SAC,13,7,2,0,0,0,30.3,2,5,4,11,2,7,3,4,1,0,9,15,20,22,24.4
2023-24,202401220ORL,1/22/2024,ORL vs CLE,Sam Merrill,merrisa01,26,CLE,0,ORL,26,3,1,1,0,1,31.1,2,1,8,13,8,13,2,2,2,1,4,27,29,30,33.1
2023-24,202401220DAL,1/22/2024,DAL vs BOS,Al Horford,horfoal01,36,BOS,0,DAL,11,6,3,1,0,1,31.23333333,1,5,4,7,3,6,0,0,2,1,9,14,17,20,24.7
2023-24,202401220DET,1/22/2024,DET vs MIL,Khris Middleton,middlkh01,37,MIL,0,DET,26,2,2,2,0,1,31.43333333,0,2,9,14,2,5,6,6,2,2,4,28,28,30,36.4
2023-24,202401220PHO,1/22/2024,PHO vs CHI,Patrick Williams,willipa01,42,CHI,0,PHO,13,4,2,1,0,2,31.5,1,3,5,12,3,8,0,0,2,1,6,15,17,19,21.8
2023-24,202401220DAL,1/22/2024,DAL vs BOS,Tim Hardaway Jr.,hardati02,40,DAL,1,BOS,20,2,1,0,0,0,31.95,0,2,8,13,4,7,0,0,2,0,3,21,22,23,23.9
2023-24,202401220SAC,1/22/2024,SAC vs ATL,Keegan Murray,murrake02,38,SAC,1,ATL,13,6,2,2,0,0,32.23333333,2,4,5,12,2,7,1,2,3,2,8,15,19,21,29.2
2023-24,202401220TOR,1/22/2024,TOR vs MEM,Jaren Jackson Jr.,jacksja02,41,MEM,0,TOR,27,4,5,6,1,4,32.38333333,3,1,12,22,2,5,1,3,4,7,9,32,31,36,56.3
2023-24,202401220DET,1/22/2024,DET vs MIL,Jaden Ivey,iveyja01,39,DET,1,MIL,17,3,6,0,0,3,32.45,1,2,5,14,1,4,6,7,0,0,9,23,20,26,26.6
2023-24,202401220PHI,1/22/2024,PHI vs SAS,Nicolas Batum,batumni01,31,PHI,1,SAS,5,8,6,3,0,1,32.65,4,4,2,4,1,3,0,0,3,3,14,11,13,19,31.6
2023-24,202401220DET,1/22/2024,DET vs MIL,Jalen Duren,durenja01,28,DET,1,MIL,12,12,1,0,1,2,32.78333333,1,11,5,14,0,0,2,2,4,1,13,13,24,25,28.9
2023-24,202401220PHO,1/22/2024,PHO vs CHI,Alex Caruso,carusal01,38,CHI,0,PHO,15,4,3,0,3,2,32.81666667,1,3,5,12,5,11,0,0,5,3,7,18,19,22,31.3
2023-24,202401220MIN,1/22/2024,MIN vs CHO,P.J. Washington,washipj01,35,CHO,0,MIN,12,7,3,1,1,0,33.03333333,0,7,5,7,2,4,0,1,4,2,10,15,19,22,30.9
2023-24,202401220PHI,1/22/2024,PHI vs SAS,Jeremy Sochan,sochaje01,43,SAS,0,PHI,14,8,4,0,1,2,33.26666667,3,5,5,12,3,6,1,2,2,1,12,18,22,26,30.6
2023-24,202401220PHI,1/22/2024,PHI vs SAS,Tre Jones,jonestr01,39,SAS,0,PHI,12,4,6,2,0,0,33.28333333,1,3,5,7,0,1,2,2,1,2,10,18,16,22,31.8
2023-24,202401220SAC,1/22/2024,SAC vs ATL,Bogdan Bogdanovic,bogdabo01,41,ATL,0,SAC,18,2,4,0,0,2,33.6,0,2,5,12,2,8,6,6,4,0,6,22,20,24,24.4
2023-24,202401220DAL,1/22/2024,DAL vs BOS,Derrick White,whitede01,40,BOS,0,DAL,6,4,1,2,1,1,34.48333333,0,4,2,12,1,7,1,2,3,3,5,7,10,11,20.3
2023-24,202401220PHI,1/22/2024,PHI vs SAS,Tobias Harris,harrito02,41,PHI,1,SAS,14,2,6,0,0,0,34.66666667,0,2,5,11,0,5,4,4,3,0,8,20,16,22,25.4
2023-24,202401220DET,1/22/2024,DET vs MIL,Malik Beasley,beaslma01,41,MIL,0,DET,13,6,2,0,0,0,34.76666667,1,5,5,14,3,8,0,0,2,0,8,15,19,21,23.2
2023-24,202401220SAC,1/22/2024,SAC vs ATL,De'Aaron Fox,foxde01,36,SAC,1,ATL,12,3,1,1,0,1,34.76666667,0,3,5,16,0,5,2,3,1,1,4,13,15,16,19.1
2023-24,202401220TOR,1/22/2024,TOR vs MEM,Luke Kennard,kennalu01,20,MEM,0,TOR,19,3,7,0,0,3,34.86666667,0,3,7,18,5,13,0,1,1,0,10,26,22,29,30.1
2023-24,202401220MIN,1/22/2024,MIN vs CHO,Terry Rozier,roziete01,30,CHO,0,MIN,11,2,4,0,0,4,34.95,0,2,5,12,0,6,1,2,1,0,6,15,13,17,15.4
2023-24,202401220TOR,1/22/2024,TOR vs MEM,Vince Williams Jr.,willivi01,33,MEM,0,TOR,18,10,1,2,1,2,35.01666667,3,7,7,11,2,4,2,3,2,3,11,19,28,29,38.5
2023-24,202401220DET,1/22/2024,DET vs MIL,Brook Lopez,lopezbr01,43,MIL,0,DET,15,11,3,0,4,3,35.2,5,6,6,9,1,2,2,2,4,4,14,18,26,29,41.7
2023-24,202401220MIN,1/22/2024,MIN vs CHO,Jaden McDaniels,mcdanja02,33,MIN,1,CHO,9,5,4,1,0,1,35.33333333,0,5,3,9,2,7,1,2,2,1,9,13,14,18,23
2023-24,202401220MIN,1/22/2024,MIN vs CHO,LaMelo Ball,ballla01,20,CHO,0,MIN,18,6,13,3,0,1,35.36666667,2,4,7,18,1,6,3,4,1,3,19,31,24,37,52.7
2023-24,202401220DET,1/22/2024,DET vs MIL,Giannis Antetokounmpo,antetgi01,41,MIL,0,DET,31,17,10,3,2,2,35.55,3,14,11,25,1,5,8,12,3,5,27,41,48,58,79.4
2023-24,202401220PHO,1/22/2024,PHO vs CHI,Grayson Allen,allengr01,38,PHO,1,CHI,9,4,3,1,0,1,35.58333333,0,4,3,6,3,4,0,0,1,1,7,12,13,16,20.3
2023-24,202401220DAL,1/22/2024,DAL vs BOS,Kyrie Irving,irvinky01,27,DAL,1,BOS,23,6,3,2,0,1,35.83333333,0,6,9,20,3,7,2,2,3,2,9,26,29,32,39.7
2023-24,202401220DAL,1/22/2024,DAL vs BOS,Jaylen Brown,brownja02,41,BOS,0,DAL,34,3,4,0,2,0,36.55,1,2,13,22,2,7,6,9,5,2,7,38,37,41,49.6
2023-24,202401220MIN,1/22/2024,MIN vs CHO,Anthony Edwards,edwaran01,40,MIN,1,CHO,9,5,11,0,0,1,36.63333333,0,5,3,11,1,5,2,2,1,0,16,20,14,25,30.5
2023-24,202401220PHI,1/22/2024,PHI vs SAS,Joel Embiid,embiijo01,32,PHI,1,SAS,70,18,5,1,1,1,36.63333333,9,9,24,41,1,2,21,23,2,2,23,75,88,93,104.1
2023-24,202401220PHO,1/22/2024,PHO vs CHI,Nikola Vucevic,vucevni01,40,CHI,0,PHO,19,17,7,0,0,1,36.68333333,5,12,9,17,1,5,0,0,2,0,24,26,36,43,48.9
2023-24,202401220TOR,1/22/2024,TOR vs MEM,RJ Barrett,barrerj01,38,TOR,1,MEM,29,9,1,0,1,2,37.01666667,1,8,12,18,0,2,5,6,3,1,10,30,38,39,42.3
2023-24,202401220TOR,1/22/2024,TOR vs MEM,Immanuel Quickley,quickim01,42,TOR,1,MEM,8,5,10,2,0,4,37.01666667,0,5,3,13,2,6,0,0,1,2,15,18,13,23,31
2023-24,202401220DET,1/22/2024,DET vs MIL,Damian Lillard,lillada01,40,MIL,0,DET,17,5,8,1,0,2,37.26666667,0,5,4,15,2,10,7,8,0,1,13,25,22,30,36
2023-24,202401220PHO,1/22/2024,PHO vs CHI,Bradley Beal,bealbr01,19,PHO,1,CHI,18,4,5,0,0,1,37.55,0,4,7,17,2,4,2,2,0,0,9,23,22,27,29.3
2023-24,202401220DAL,1/22/2024,DAL vs BOS,Josh Green,greenjo02,30,DAL,1,BOS,14,7,1,0,0,3,37.75,1,6,5,11,4,7,0,0,4,0,8,15,21,22,20.9
2023-24,202401220SAC,1/22/2024,SAC vs ATL,Jalen Johnson,johnsja05,29,ATL,0,SAC,11,7,0,1,2,0,37.78333333,2,5,4,18,1,7,2,4,1,3,7,11,18,18,28.4
2023-24,202401220MIN,1/22/2024,MIN vs CHO,Karl-Anthony Towns,townska01,42,MIN,1,CHO,62,8,2,0,0,7,37.9,3,5,21,35,10,15,10,14,2,0,10,64,70,72,67.6
2023-24,202401220PHI,1/22/2024,PHI vs SAS,Devin Vassell,vassede01,38,SAS,0,PHI,22,4,9,0,0,1,37.93333333,0,4,7,13,2,6,6,6,3,0,13,31,26,35,39.3
2023-24,202401220SAC,1/22/2024,SAC vs ATL,Domantas Sabonis,sabondo01,42,SAC,1,ATL,14,21,6,2,0,4,38.05,2,19,4,10,0,1,6,6,4,2,27,20,35,41,50.2
2023-24,202401220DAL,1/22/2024,DAL vs BOS,Jrue Holiday,holidjr01,40,BOS,0,DAL,17,7,6,0,1,1,38.28333333,0,7,6,13,5,12,0,0,2,1,13,23,24,30,36.4
2023-24,202401220MIN,1/22/2024,MIN vs CHO,Rudy Gobert,goberru01,42,MIN,1,CHO,13,11,1,0,0,0,39.05,2,9,6,6,0,0,1,2,3,0,12,14,24,25,27.7
2023-24,202401220DAL,1/22/2024,DAL vs BOS,Luka Doncic,doncilu01,36,DAL,1,BOS,33,18,13,2,0,3,39.63333333,5,13,12,30,2,8,7,11,5,2,31,46,51,64,77.1
2023-24,202401220MIN,1/22/2024,MIN vs CHO,Miles Bridges,bridgmi02,30,CHO,0,MIN,28,5,2,1,0,1,39.75,1,4,10,23,3,10,5,5,2,1,7,30,33,35,39
2023-24,202401220PHO,1/22/2024,PHO vs CHI,DeMar DeRozan,derozde01,43,CHI,0,PHO,21,5,3,1,0,2,39.83333333,1,4,8,17,1,3,4,6,3,1,8,24,26,29,32.5
2023-24,202401220SAC,1/22/2024,SAC vs ATL,Dejounte Murray,murrade01,43,ATL,0,SAC,35,10,6,0,1,4,40.1,0,10,11,23,6,10,7,8,1,1,16,41,45,51,55
2023-24,202401220PHO,1/22/2024,PHO vs CHI,Devin Booker,bookede01,34,PHO,1,CHI,16,4,5,1,0,2,40.61666667,0,4,6,11,2,6,2,3,2,1,9,21,20,25,29.3
2023-24,202401220TOR,1/22/2024,TOR vs MEM,Scottie Barnes,barnesc01,44,TOR,1,MEM,22,12,8,0,6,5,40.7,5,7,6,14,1,3,9,9,2,6,20,30,34,42,61.4
2023-24,202401220PHO,1/22/2024,PHO vs CHI,Coby White,whiteco01,45,CHI,0,PHO,26,10,9,2,0,1,40.81666667,2,8,10,14,4,5,2,2,4,2,19,35,36,45,56.5
2023-24,202401220PHO,1/22/2024,PHO vs CHI,Kevin Durant,duranke01,36,PHO,1,CHI,43,6,8,1,2,1,40.9,1,5,16,32,6,15,5,6,2,3,14,51,49,57,70.2
2023-24,202401220DAL,1/22/2024,DAL vs BOS,Jayson Tatum,tatumja01,41,BOS,0,DAL,39,11,5,3,2,0,40.91666667,0,11,11,21,2,8,15,19,4,5,16,44,50,55,74.7
2023-24,202401220PHI,1/22/2024,PHI vs SAS,Tyrese Maxey,maxeyty01,41,PHI,1,SAS,18,4,8,0,0,2,41.58333333,1,3,7,15,2,5,2,2,1,0,12,26,22,30,32.8
2023-24,202401210LAC,1/21/2024,LAC vs BRK,Lonnie Walker IV,walkelo01,24,BRK,0,LAC,8,2,0,2,0,0,10.08333333,0,2,3,4,2,2,0,0,3,2,2,8,10,10,16.4
2023-24,202401210PHO,1/21/2024,PHO vs IND,Drew Eubanks,eubandr01,36,PHO,1,IND,3,2,0,0,0,1,10.56666667,0,2,1,1,0,0,1,2,2,0,2,3,5,5,4.4
2023-24,202401210HOU,1/21/2024,HOU vs BOS,Jock Landale,landajo01,24,HOU,1,BOS,3,3,0,0,0,1,10.86666667,2,1,1,2,0,0,1,2,0,0,3,3,6,6,5.6
2023-24,202401210ORL,1/21/2024,ORL vs MIA,Moritz Wagner,wagnemo01,41,ORL,1,MIA,8,4,0,0,0,0,10.86666667,3,1,1,3,0,0,6,8,1,0,4,8,12,12,12.8
2023-24,202401210LAC,1/21/2024,LAC vs BRK,Trendon Watford,watfotr01,31,BRK,0,LAC,2,1,1,1,0,1,11.68333333,1,0,1,3,0,1,0,0,1,1,2,3,3,4,6.7
2023-24,202401210PHO,1/21/2024,PHO vs IND,T.J. McConnell,mccontj01,36,IND,0,PHO,4,1,3,2,0,1,11.83333333,0,1,2,8,0,0,0,0,0,2,4,7,5,8,14.7
2023-24,202401210LAL,1/21/2024,LAL vs POR,Matisse Thybulle,thybuma01,40,POR,0,LAL,0,0,2,3,0,0,12.3,0,0,0,1,0,1,0,0,0,3,2,2,0,2,12
2023-24,202401210PHO,1/21/2024,PHO vs IND,Keita Bates-Diop,bateske01,31,PHO,1,IND,0,2,1,1,0,1,12.31666667,1,1,0,0,0,0,0,0,1,1,3,1,2,3,5.9
2023-24,202401210WAS,1/21/2024,WAS vs DEN,Peyton Watson,watsope01,42,DEN,0,WAS,2,3,2,0,3,2,12.71666667,0,3,1,2,0,0,0,1,0,3,5,4,5,7,15.6
2023-24,202401210ORL,1/21/2024,ORL vs MIA,Anthony Black,blackan01,40,ORL,1,MIA,6,0,1,0,0,1,13.8,0,0,2,5,1,2,1,2,3,0,1,7,6,7,6.5
2023-24,202401210ORL,1/21/2024,ORL vs MIA,Jonathan Isaac,isaacjo01,26,ORL,1,MIA,6,1,0,0,1,0,13.8,0,1,2,3,0,1,2,2,0,1,1,6,7,7,10.2
2023-24,202401210PHO,1/21/2024,PHO vs IND,Bennedict Mathurin,mathube01,44,IND,0,PHO,4,3,0,0,0,0,14.03333333,0,3,1,8,1,4,1,2,0,0,3,4,7,7,7.6
2023-24,202401210ORL,1/21/2024,ORL vs MIA,Kevin Love,loveke01,33,MIA,0,ORL,9,6,0,0,0,1,14.06666667,3,3,3,6,2,5,1,2,4,0,6,9,15,15,15.2
2023-24,202401210PHO,1/21/2024,PHO vs IND,Josh Okogie,okogijo01,36,PHO,1,IND,0,2,2,1,0,0,14.93333333,1,1,0,1,0,1,0,0,0,1,4,2,2,4,8.4
2023-24,202401210HOU,1/21/2024,HOU vs BOS,Jae'Sean Tate,tateja01,40,HOU,1,BOS,2,0,0,0,2,0,14.95,0,0,1,2,0,0,0,0,1,2,0,2,2,2,8
2023-24,202401210LAC,1/21/2024,LAC vs BRK,Amir Coffey,coffeam01,29,LAC,1,BRK,5,1,1,1,0,0,14.98333333,0,1,2,2,1,1,0,0,2,1,2,6,6,7,10.7
2023-24,202401210ORL,1/21/2024,ORL vs MIA,Nikola Jovic,jovicni01,17,MIA,0,ORL,2,3,0,0,0,1,15.03333333,0,3,1,4,0,1,0,1,2,0,3,2,5,5,4.6
2023-24,202401210LAC,1/21/2024,LAC vs BRK,Mason Plumlee,plumlma01,11,LAC,1,BRK,7,8,1,0,0,0,15.08333333,1,7,1,3,0,0,5,6,2,0,9,8,15,16,18.1
2023-24,202401210LAC,1/21/2024,LAC vs BRK,Royce O'Neale,onealro01,41,BRK,0,LAC,4,1,0,0,0,0,15.35,0,1,1,6,0,5,2,2,2,0,1,4,5,5,5.2
2023-24,202401210WAS,1/21/2024,WAS vs DEN,Landry Shamet,shamela01,26,WAS,1,DEN,14,1,3,1,0,0,16.05,1,0,4,10,1,5,5,5,2,1,4,17,15,18,22.7
2023-24,202401210ORL,1/21/2024,ORL vs MIA,Cole Anthony,anthoco01,42,ORL,1,MIA,5,6,2,1,1,3,16.48333333,0,6,2,6,1,2,0,0,0,2,8,7,11,13,18.2
2023-24,202401210WAS,1/21/2024,WAS vs DEN,Delon Wright,wrighde01,21,WAS,1,DEN,6,2,0,1,1,0,16.75,1,1,3,5,0,0,0,0,1,2,2,6,8,8,14.4
2023-24,202401210ORL,1/21/2024,ORL vs MIA,Joe Ingles,inglejo01,29,ORL,1,MIA,0,3,3,0,0,3,17.15,1,2,0,2,0,2,0,0,0,0,6,3,3,6,5.1
2023-24,202401210LAC,1/21/2024,LAC vs BRK,Daniel Theis,theisda01,31,LAC,1,BRK,8,3,1,0,2,1,17.23333333,2,1,4,6,0,1,0,0,1,2,4,9,11,12,18.1
2023-24,202401210LAL,1/21/2024,LAL vs POR,Christian Wood,woodch01,38,LAL,1,POR,4,6,2,2,3,0,17.53333333,1,5,2,3,0,1,0,0,2,5,8,6,10,12,29.2
2023-24,202401210WAS,1/21/2024,WAS vs DEN,Marvin Bagley III,baglema01,29,WAS,1,DEN,14,7,1,0,0,0,17.58333333,5,2,5,9,0,0,4,4,3,0,8,15,21,22,23.9
2023-24,202401210WAS,1/21/2024,WAS vs DEN,Corey Kispert,kispeco01,41,WAS,1,DEN,6,3,1,0,0,1,17.76666667,0,3,1,9,0,6,4,4,0,0,4,7,9,10,10.1
2023-24,202401210LAC,1/21/2024,LAC vs BRK,Dennis Smith Jr.,smithde03,27,BRK,0,LAC,13,3,1,0,0,2,18,1,2,6,8,1,2,0,0,2,0,4,14,16,17,16.1
2023-24,202401210WAS,1/21/2024,WAS vs DEN,Deni Avdija,avdijde01,42,WAS,1,DEN,4,8,3,0,1,2,18.4,0,8,1,5,0,1,2,4,1,1,11,7,12,15,19.1
2023-24,202401210PHO,1/21/2024,PHO vs IND,Jarace Walker,walkeja02,16,IND,0,PHO,10,9,1,1,0,1,18.4,3,6,4,6,2,3,0,0,0,1,10,11,19,20,24.3
2023-24,202401210HOU,1/21/2024,HOU vs BOS,Oshae Brissett,brissos01,26,BOS,0,HOU,6,2,3,0,1,3,18.41666667,1,1,3,5,0,2,0,0,4,1,5,9,8,11,12.9
2023-24,202401210PHO,1/21/2024,PHO vs IND,Myles Turner,turnemy01,43,IND,0,PHO,12,2,1,0,2,1,18.56666667,1,1,5,11,1,2,1,2,1,2,3,13,14,15,20.9
2023-24,202401210HOU,1/21/2024,HOU vs BOS,Jeenathan Williams,willije02,7,HOU,1,BOS,5,3,0,0,0,0,18.68333333,2,1,2,7,1,1,0,0,1,0,3,5,8,8,8.6
2023-24,202401210PHO,1/21/2024,PHO vs IND,Jalen Smith,smithja04,30,IND,0,PHO,15,4,1,1,2,1,18.78333333,2,2,5,5,3,3,2,4,0,3,5,16,19,20,29.3
2023-24,202401210PHO,1/21/2024,PHO vs IND,Jusuf Nurkic,nurkiju01,40,PHO,1,IND,4,13,4,0,1,6,18.9,0,13,2,2,0,0,0,0,6,1,17,8,17,21,22.6
2023-24,202401210PHO,1/21/2024,PHO vs IND,Ben Sheppard,sheppbe01,22,IND,0,PHO,4,4,4,2,0,0,19.71666667,2,2,1,4,0,1,2,2,3,2,8,8,8,12,20.8
2023-24,202401210WAS,1/21/2024,WAS vs DEN,Reggie Jackson,jacksre01,44,DEN,0,WAS,3,1,3,0,0,0,20.83333333,0,1,1,4,1,2,0,0,1,0,4,6,4,7,8.7
2023-24,202401210WAS,1/21/2024,WAS vs DEN,Christian Braun,braunch01,44,DEN,0,WAS,2,6,2,0,1,1,21.05,2,4,1,3,0,0,0,0,3,1,8,4,8,10,14.2
2023-24,202401210LAL,1/21/2024,LAL vs POR,Cam Reddish,reddica01,35,LAL,1,POR,10,4,1,2,0,0,21.06666667,0,4,5,8,0,2,0,0,2,2,5,11,14,15,22.3
2023-24,202401210LAL,1/21/2024,LAL vs POR,Jarred Vanderbilt,vandeja01,24,LAL,1,POR,4,4,2,2,0,3,21.1,2,2,2,3,0,0,0,0,1,2,6,6,8,10,14.8
2023-24,202401210ORL,1/21/2024,ORL vs MIA,Duncan Robinson,robindu01,41,MIA,0,ORL,6,1,1,2,0,2,21.23333333,0,1,1,6,0,3,4,4,2,2,2,7,7,8,12.7
2023-24,202401210LAL,1/21/2024,LAL vs POR,Max Christie,chrisma02,35,LAL,1,POR,4,1,2,0,1,2,22.2,0,1,1,7,0,3,2,2,3,1,3,6,5,7,9.2
2023-24,202401210LAL,1/21/2024,LAL vs POR,Deandre Ayton,aytonde01,26,POR,0,LAL,6,4,0,0,0,1,22.31666667,1,3,3,7,0,0,0,0,3,0,4,6,10,10,9.8
2023-24,202401210LAL,1/21/2024,LAL vs POR,Jabari Walker,walkeja01,38,POR,0,LAL,12,7,0,0,0,0,22.35,3,4,5,8,1,2,1,2,0,0,7,12,19,19,20.4
2023-24,202401210LAL,1/21/2024,LAL vs POR,Duop Reath,reathdu01,30,POR,0,LAL,16,3,4,0,1,1,22.36666667,2,1,6,9,2,4,2,2,3,1,7,20,19,23,27.6
2023-24,202401210LAL,1/21/2024,LAL vs POR,Toumani Camara,camarto01,41,POR,0,LAL,5,5,1,2,0,1,22.66666667,1,4,2,5,0,2,1,2,3,2,6,6,10,11,17.5
2023-24,202401210HOU,1/21/2024,HOU vs BOS,Luke Kornet,kornelu01,30,BOS,0,HOU,8,9,1,1,3,1,22.76666667,5,4,4,4,0,0,0,0,3,4,10,9,17,18,31.3
2023-24,202401210LAL,1/21/2024,LAL vs POR,Rui Hachimura,hachiru01,31,LAL,1,POR,9,2,2,1,0,1,22.8,1,1,2,7,1,3,4,5,2,1,4,11,11,13,16.4
2023-24,202401210LAL,1/21/2024,LAL vs POR,Scoot Henderson,hendesc01,33,POR,0,LAL,4,1,2,0,0,3,23.13333333,0,1,1,6,0,3,2,2,1,0,3,6,5,7,5.2
2023-24,202401210LAC,1/21/2024,LAC vs BRK,Norman Powell,powelno01,41,LAC,1,BRK,12,5,0,0,0,0,24.31666667,0,5,4,7,2,3,2,3,2,0,5,12,17,17,18
2023-24,202401210ORL,1/21/2024,ORL vs MIA,Haywood Highsmith,highsha01,29,MIA,0,ORL,5,2,1,2,0,0,25,0,2,1,3,1,1,2,3,4,2,3,6,7,8,14.9
2023-24,202401210ORL,1/21/2024,ORL vs MIA,Kyle Lowry,lowryky01,37,MIA,0,ORL,2,2,3,2,1,0,25.21666667,1,1,1,9,0,6,0,0,2,3,5,5,4,7,17.9
2023-24,202401210PHO,1/21/2024,PHO vs IND,Andrew Nembhard,nembhan01,29,IND,0,PHO,9,0,6,1,0,4,25.43333333,0,0,3,9,0,0,3,4,3,1,6,15,9,15,17
2023-24,202401210LAL,1/21/2024,LAL vs POR,Austin Reaves,reaveau01,45,LAL,1,POR,15,4,2,1,0,1,25.6,1,3,5,10,3,4,2,2,1,1,6,17,19,21,24.8
2023-24,202401210PHO,1/21/2024,PHO vs IND,Aaron Nesmith,nesmiaa01,39,IND,0,PHO,6,3,1,1,0,0,25.81666667,1,2,2,7,1,5,1,3,4,1,4,7,9,10,14.1
2023-24,202401210PHO,1/21/2024,PHO vs IND,Obi Toppin,toppiob01,44,IND,0,PHO,13,6,1,0,0,0,25.91666667,2,4,6,12,0,2,1,2,1,0,7,14,19,20,21.7
2023-24,202401210LAC,1/21/2024,LAC vs BRK,Terance Mann,mannte01,35,LAC,1,BRK,13,3,2,1,0,0,26.3,0,3,4,6,2,3,3,3,1,1,5,15,16,18,22.6
2023-24,202401210LAL,1/21/2024,LAL vs POR,Anthony Davis,davisan02,43,LAL,1,POR,14,14,3,0,0,0,26.36666667,3,11,4,7,0,1,6,6,0,0,17,17,28,31,35.3
2023-24,202401210LAC,1/21/2024,LAC vs BRK,Dorian Finney-Smith,finnedo01,39,BRK,0,LAC,0,9,0,0,1,1,26.95,0,9,0,5,0,3,0,0,2,1,9,0,9,9,12.8
2023-24,202401210HOU,1/21/2024,HOU vs BOS,Aaron Holiday,holidaa01,40,HOU,1,BOS,12,4,5,1,0,2,27.25,0,4,5,8,2,5,0,0,4,1,9,17,16,21,25.3
2023-24,202401210LAC,1/21/2024,LAC vs BRK,Cam Thomas,thomaca02,33,BRK,0,LAC,20,2,6,0,0,4,27.26666667,0,2,8,17,1,5,3,4,2,0,8,26,22,28,27.4
2023-24,202401210HOU,1/21/2024,HOU vs BOS,Cam Whitmore,whitmca01,19,HOU,1,BOS,5,4,0,1,1,1,27.45,0,4,2,7,1,4,0,2,1,2,4,5,9,9,14.8
2023-24,202401210ORL,1/21/2024,ORL vs MIA,Franz Wagner,wagnefr01,35,ORL,1,MIA,19,2,5,0,0,0,27.83333333,1,1,6,13,2,5,5,5,2,0,7,24,21,26,28.9
2023-24,202401210WAS,1/21/2024,WAS vs DEN,Jordan Poole,poolejo01,41,WAS,1,DEN,4,1,0,0,0,2,27.91666667,0,1,1,7,1,4,1,1,4,0,1,4,5,5,3.2
2023-24,202401210ORL,1/21/2024,ORL vs MIA,Jalen Suggs,suggsja01,39,ORL,1,MIA,11,4,1,1,0,2,28.5,4,0,4,11,1,6,2,2,4,1,5,12,15,16,18.3
2023-24,202401210ORL,1/21/2024,ORL vs MIA,Markelle Fultz,fultzma01,12,ORL,1,MIA,12,1,4,2,2,2,29,1,0,6,8,0,0,0,0,3,4,5,16,13,17,29.2
2023-24,202401210LAC,1/21/2024,LAC vs BRK,Cameron Johnson,johnsca02,34,BRK,0,LAC,9,4,6,1,0,0,29.01666667,0,4,3,11,2,7,1,2,1,1,10,15,13,19,25.8
2023-24,202401210ORL,1/21/2024,ORL vs MIA,Jimmy Butler,butleji01,28,MIA,0,ORL,15,4,2,0,0,0,29.08333333,0,4,5,10,3,5,2,2,1,0,6,17,19,21,22.8
2023-24,202401210PHO,1/21/2024,PHO vs IND,Eric Gordon,gordoer01,36,PHO,1,IND,4,3,2,0,1,2,29.75,0,3,1,6,0,5,2,2,2,1,5,6,7,9,11.6
2023-24,202401210LAL,1/21/2024,LAL vs POR,Anfernee Simons,simonan01,20,POR,0,LAL,19,2,3,0,0,4,30.08333333,0,2,8,15,3,7,0,0,4,0,5,22,21,24,21.9
2023-24,202401210PHO,1/21/2024,PHO vs IND,Pascal Siakam,siakapa01,41,IND,0,PHO,15,4,7,0,0,3,30.1,2,2,6,14,1,3,2,2,6,0,11,22,19,26,27.3
2023-24,202401210WAS,1/21/2024,WAS vs DEN,Daniel Gafford,gaffoda01,37,WAS,1,DEN,15,7,2,2,1,2,30.21666667,3,4,7,10,0,0,1,2,5,3,9,17,22,24,33.4
2023-24,202401210HOU,1/21/2024,HOU vs BOS,Payton Pritchard,pritcpa01,43,BOS,0,HOU,9,2,4,2,0,0,30.33333333,1,1,3,6,3,5,0,0,1,2,6,13,11,15,23.4
2023-24,202401210HOU,1/21/2024,HOU vs BOS,Sam Hauser,hausesa01,42,BOS,0,HOU,9,7,6,1,1,1,30.61666667,2,5,3,12,3,12,0,0,0,2,13,15,16,22,31.4
2023-24,202401210HOU,1/21/2024,HOU vs BOS,Jaylen Brown,brownja02,40,BOS,0,HOU,13,11,10,3,0,3,30.83333333,0,11,6,14,1,3,0,2,0,3,21,23,24,34,47.2
2023-24,202401210WAS,1/21/2024,WAS vs DEN,Bilal Coulibaly,coulibi01,41,WAS,1,DEN,9,3,1,1,4,2,31,1,2,4,9,1,3,0,0,2,5,4,10,12,13,27.1
2023-24,202401210LAL,1/21/2024,LAL vs POR,LeBron James,jamesle01,41,LAL,1,POR,28,5,5,0,0,3,31,0,5,8,16,3,8,9,10,2,0,10,33,33,38,38.5
2023-24,202401210WAS,1/21/2024,WAS vs DEN,Aaron Gordon,gordoaa01,38,DEN,0,WAS,11,10,2,1,3,1,31.05,3,7,4,10,0,0,3,7,0,4,12,13,21,23,37
2023-24,202401210LAC,1/21/2024,LAC vs BRK,Nic Claxton,claxtni01,32,BRK,0,LAC,16,6,3,1,2,0,31.08333333,2,4,7,10,0,1,2,4,5,3,9,19,22,25,36.7
2023-24,202401210ORL,1/21/2024,ORL vs MIA,Paolo Banchero,banchpa01,43,ORL,1,MIA,20,10,2,0,0,2,31.18333333,0,10,7,14,3,5,3,5,2,0,12,22,30,32,33
2023-24,202401210LAC,1/21/2024,LAC vs BRK,Russell Westbrook,westbru01,41,LAC,1,BRK,23,9,6,1,1,2,31.18333333,3,6,10,16,1,2,2,4,3,2,15,29,32,38,46.8
2023-24,202401210ORL,1/21/2024,ORL vs MIA,Caleb Martin,martica02,26,MIA,0,ORL,11,4,4,0,0,2,31.2,1,3,5,7,1,1,0,0,2,0,8,15,15,19,19.8
2023-24,202401210WAS,1/21/2024,WAS vs DEN,Tyus Jones,jonesty01,42,WAS,1,DEN,15,2,13,1,0,1,31.25,1,1,6,14,3,4,0,0,0,1,15,28,17,30,38.9
2023-24,202401210PHO,1/21/2024,PHO vs IND,Buddy Hield,hieldbu01,44,IND,0,PHO,18,4,3,1,0,0,31.4,1,3,6,10,5,8,1,2,2,1,7,21,22,25,30.3
2023-24,202401210HOU,1/21/2024,HOU vs BOS,Amen Thompson,thompam01,23,HOU,1,BOS,15,14,5,1,0,2,31.96666667,3,11,5,10,0,2,5,6,3,1,19,20,29,34,40.3
2023-24,202401210HOU,1/21/2024,HOU vs BOS,Jalen Green,greenja05,42,HOU,1,BOS,16,4,5,1,0,3,32.03333333,1,3,7,18,1,6,1,3,0,1,9,21,20,25,28.3
2023-24,202401210PHO,1/21/2024,PHO vs IND,Grayson Allen,allengr01,37,PHO,1,IND,13,2,2,1,0,0,32.25,1,1,5,7,3,4,0,0,1,1,4,15,15,17,21.4
2023-24,202401210WAS,1/21/2024,WAS vs DEN,Michael Porter Jr.,portemi01,44,DEN,0,WAS,19,5,0,2,2,3,32.41666667,0,5,8,14,3,7,0,0,2,4,5,19,24,24,34
2023-24,202401210LAL,1/21/2024,LAL vs POR,Malcolm Brogdon,brogdma01,33,POR,0,LAL,23,7,9,0,1,1,32.55,1,6,8,17,3,4,4,5,3,1,16,32,30,39,46.9
2023-24,202401210LAL,1/21/2024,LAL vs POR,Jerami Grant,grantje01,37,POR,0,LAL,17,3,3,1,1,1,32.55,1,2,6,15,0,3,5,5,3,2,6,20,20,23,30.1
2023-24,202401210LAC,1/21/2024,LAC vs BRK,Spencer Dinwiddie,dinwisp01,40,BRK,0,LAC,16,2,7,0,1,1,32.65,1,1,6,9,4,6,0,0,2,1,9,23,18,25,30.9
2023-24,202401210HOU,1/21/2024,HOU vs BOS,Kristaps Porzingis,porzikr01,32,BOS,0,HOU,32,6,1,1,5,3,32.81666667,4,2,11,21,6,11,4,4,5,6,7,33,38,39,55.7
2023-24,202401210ORL,1/21/2024,ORL vs MIA,Tyler Herro,herroty01,24,MIA,0,ORL,12,1,2,1,0,2,32.88333333,1,0,4,14,4,11,0,0,1,1,3,14,13,15,17.2
2023-24,202401210WAS,1/21/2024,WAS vs DEN,Kyle Kuzma,kuzmaky01,42,WAS,1,DEN,17,6,7,0,2,3,33.06666667,0,6,7,13,2,4,1,2,5,2,13,24,23,30,37.7
2023-24,202401210LAL,1/21/2024,LAL vs POR,D'Angelo Russell,russeda01,41,LAL,1,POR,34,1,8,0,2,0,33.93333333,1,0,14,21,6,11,0,0,2,2,9,42,35,43,53.2
2023-24,202401210ORL,1/21/2024,ORL vs MIA,Wendell Carter Jr.,cartewe01,17,ORL,1,MIA,17,9,2,1,0,1,34.11666667,2,7,7,11,1,3,2,2,1,1,11,19,26,28,32.8
2023-24,202401210ORL,1/21/2024,ORL vs MIA,Bam Adebayo,adebaba01,33,MIA,0,ORL,22,11,7,2,0,5,34.41666667,6,5,8,17,0,1,6,6,3,2,18,29,33,40,46.7
2023-24,202401210HOU,1/21/2024,HOU vs BOS,Jayson Tatum,tatumja01,40,BOS,0,HOU,18,7,3,1,0,2,35.11666667,1,6,4,17,1,6,9,12,0,1,10,21,25,28,31.9
2023-24,202401210WAS,1/21/2024,WAS vs DEN,Kentavious Caldwell-Pope,caldwke01,42,DEN,0,WAS,10,3,3,3,0,2,35.35,0,3,4,9,1,5,1,2,2,3,6,13,13,16,25.1
2023-24,202401210LAC,1/21/2024,LAC vs BRK,Paul George,georgpa01,39,LAC,1,BRK,12,7,1,1,0,1,35.7,1,6,5,17,2,7,0,0,3,1,8,13,19,20,23.9
2023-24,202401210HOU,1/21/2024,HOU vs BOS,Derrick White,whitede01,39,BOS,0,HOU,21,11,3,0,2,3,35.71666667,2,9,9,19,3,8,0,0,2,2,14,24,32,35,41.7
2023-24,202401210PHO,1/21/2024,PHO vs IND,Devin Booker,bookede01,33,PHO,1,IND,26,6,8,2,0,2,35.8,1,5,9,24,1,7,7,9,2,2,14,34,32,40,49.2
2023-24,202401210WAS,1/21/2024,WAS vs DEN,Nikola Jokic,jokicni01,43,DEN,0,WAS,42,12,8,2,2,0,36.08333333,4,8,15,20,0,0,12,14,2,4,20,50,54,62,80.4
2023-24,202401210HOU,1/21/2024,HOU vs BOS,Alperen Sengun,sengual01,42,HOU,1,BOS,24,12,10,1,0,6,36.46666667,2,10,10,18,0,2,4,4,2,1,22,34,36,46,50.4
2023-24,202401210LAC,1/21/2024,LAC vs BRK,Kawhi Leonard,leonaka01,37,LAC,1,BRK,21,4,4,0,1,2,36.78333333,1,3,6,15,2,3,7,8,2,1,8,25,25,29,32.8
2023-24,202401210LAC,1/21/2024,LAC vs BRK,Mikal Bridges,bridgmi01,42,BRK,0,LAC,26,6,5,1,1,3,37.91666667,1,5,9,17,4,7,4,4,1,2,11,31,32,37,43.7
2023-24,202401210PHO,1/21/2024,PHO vs IND,Bradley Beal,bealbr01,18,PHO,1,IND,25,4,3,1,0,2,38.11666667,1,3,11,16,0,1,3,3,4,1,7,28,29,32,35.3
2023-24,202401210LAC,1/21/2024,LAC vs BRK,James Harden,hardeja01,36,LAC,1,BRK,24,5,10,2,1,4,38.41666667,0,5,6,11,3,6,9,9,2,3,15,34,29,39,50
2023-24,202401210WAS,1/21/2024,WAS vs DEN,Jamal Murray,murraja01,30,DEN,0,WAS,19,5,7,0,0,1,38.8,1,4,7,23,3,8,2,2,2,0,12,26,24,31,34.5
2023-24,202401210PHO,1/21/2024,PHO vs IND,Kevin Durant,duranke01,35,PHO,1,IND,40,9,2,0,3,2,40.3,1,8,18,25,4,7,0,0,4,3,11,42,49,51,60.8
2023-24,202401210HOU,1/21/2024,HOU vs BOS,Dillon Brooks,brookdi01,33,HOU,1,BOS,25,5,1,4,0,0,40.33333333,1,4,8,22,5,15,4,5,5,4,6,26,30,31,44.5
2023-24,202401200ATL,1/20/2024,ATL vs CLE,Patty Mills,millspa02,11,ATL,1,CLE,6,0,0,1,0,0,10.2,0,0,2,3,2,3,0,0,1,1,0,6,6,6,9
2023-24,202401200CHO,1/20/2024,CHO vs PHI,Paul Reed,reedpa01,41,PHI,0,CHO,2,8,0,0,0,0,11.23333333,1,7,1,2,0,0,0,0,0,0,8,2,10,10,11.6
2023-24,202401200NYK,1/20/2024,NYK vs TOR,Chris Boucher,bouchch01,40,TOR,0,NYK,5,2,1,0,0,0,11.5,2,0,2,5,0,1,1,2,2,0,3,6,7,8,8.9
2023-24,202401200MIN,1/20/2024,MIN vs OKC,Jaylin Williams,willija07,34,OKC,0,MIN,5,1,0,0,2,1,11.63333333,0,1,2,3,1,2,0,0,1,2,1,5,6,6,11.2
2023-24,202401200WAS,1/20/2024,WAS vs SAS,Patrick Baldwin Jr.,baldwpa01,13,WAS,1,SAS,7,2,0,0,1,1,12.36666667,0,2,2,3,2,3,1,2,4,1,2,7,9,9,11.4
2023-24,202401200MIN,1/20/2024,MIN vs OKC,Aaron Wiggins,wiggiaa01,39,OKC,0,MIN,5,0,0,0,0,1,12.43333333,0,0,2,2,1,1,0,0,0,0,0,5,5,5,4
2023-24,202401200MIN,1/20/2024,MIN vs OKC,Cason Wallace,wallaca01,42,OKC,0,MIN,0,3,0,1,0,1,12.55,1,2,0,1,0,0,0,0,2,1,3,0,3,3,5.6
2023-24,202401200MIN,1/20/2024,MIN vs OKC,Jordan McLaughlin,mclaujo01,21,MIN,1,OKC,8,2,3,2,0,0,12.65,2,0,3,7,2,3,0,0,1,2,5,11,10,13,20.9
2023-24,202401200NYK,1/20/2024,NYK vs TOR,Miles McBride,mcbrimi01,30,NYK,1,TOR,3,0,1,0,0,2,12.88333333,0,0,1,4,1,3,0,0,1,0,1,4,3,4,2.5
2023-24,202401200HOU,1/20/2024,HOU vs UTA,Ochai Agbaji,agbajoc01,44,UTA,0,HOU,0,0,0,0,3,1,13.18333333,0,0,0,1,0,1,0,0,0,3,0,0,0,0,8
2023-24,202401200DET,1/20/2024,DET vs MIL,Mike Muscala,muscami01,26,DET,1,MIL,13,1,1,1,0,1,13.63333333,0,1,4,4,4,4,1,2,2,1,2,14,14,15,17.7
2023-24,202401200DET,1/20/2024,DET vs MIL,Jae Crowder,crowdja01,11,MIL,0,DET,2,2,0,1,0,0,13.8,0,2,1,3,0,2,0,0,2,1,2,2,4,4,7.4
2023-24,202401200DET,1/20/2024,DET vs MIL,Pat Connaughton,connapa01,36,MIL,0,DET,10,4,1,0,0,1,14.21666667,0,4,4,5,2,3,0,0,1,0,5,11,14,15,15.3
2023-24,202401200ATL,1/20/2024,ATL vs CLE,Tristan Thompson,thomptr01,35,CLE,0,ATL,6,5,2,0,1,0,14.21666667,0,5,3,4,0,1,0,0,0,1,7,8,11,13,18
2023-24,202401200ATL,1/20/2024,ATL vs CLE,Garrison Mathews,mathega01,28,ATL,1,CLE,4,2,2,0,0,0,14.36666667,0,2,1,3,1,3,1,1,0,0,4,6,6,8,9.4
2023-24,202401200HOU,1/20/2024,HOU vs UTA,Jae'Sean Tate,tateja01,39,HOU,1,UTA,2,3,3,1,1,0,14.4,3,0,1,4,0,1,0,0,2,2,6,5,5,8,16.1
2023-24,202401200CHO,1/20/2024,CHO vs PHI,Marcus Morris,morrima03,33,PHI,0,CHO,0,0,0,0,0,0,14.46666667,0,0,0,4,0,3,0,0,0,0,0,0,0,0,0
2023-24,202401200CHO,1/20/2024,CHO vs PHI,Nick Smith Jr.,smithni01,25,CHO,1,PHI,0,0,1,0,0,1,15.03333333,0,0,0,4,0,2,0,0,0,0,1,1,0,1,0.5
2023-24,202401200WAS,1/20/2024,WAS vs SAS,Blake Wesley,weslebl01,21,SAS,0,WAS,6,1,3,1,0,1,15.13333333,1,0,3,4,0,0,0,0,1,1,4,9,7,10,13.7
2023-24,202401200NYK,1/20/2024,NYK vs TOR,Thaddeus Young,youngth01,15,TOR,0,NYK,4,2,1,2,0,0,15.25,1,1,2,4,0,0,0,0,2,2,3,5,6,7,13.9
2023-24,202401200DET,1/20/2024,DET vs MIL,Andre Jackson Jr.,jacksan01,36,MIL,0,DET,2,7,0,0,0,0,15.43333333,3,4,1,1,0,0,0,0,2,0,7,2,9,9,10.4
2023-24,202401200CHO,1/20/2024,CHO vs PHI,Furkan Korkmaz,korkmfu01,26,PHI,0,CHO,2,4,1,0,0,1,15.51666667,0,4,1,2,0,0,0,0,1,0,5,3,6,7,7.3
2023-24,202401200CHI,1/20/2024,CHI vs MEM,Jacob Gilyard,gilyaja01,25,MEM,0,CHI,3,1,1,1,0,1,15.63333333,0,1,1,3,1,3,0,0,0,1,2,4,4,5,7.7
2023-24,202401200DET,1/20/2024,DET vs MIL,Kevin Knox,knoxke01,24,DET,1,MIL,3,3,0,1,0,0,15.68333333,0,3,1,5,1,2,0,0,3,1,3,3,6,6,9.6
2023-24,202401200HOU,1/20/2024,HOU vs UTA,Jeff Green,greenje02,40,HOU,1,UTA,3,3,2,0,0,1,15.71666667,1,2,1,6,1,3,0,0,0,0,5,5,6,8,8.6
2023-24,202401200DET,1/20/2024,DET vs MIL,Marcus Sasser,sassema01,38,DET,1,MIL,9,1,5,1,0,0,15.73333333,0,1,3,6,1,2,2,2,1,1,6,14,10,15,20.7
2023-24,202401200HOU,1/20/2024,HOU vs UTA,Kelly Olynyk,olynyke01,42,UTA,0,HOU,6,3,1,1,0,1,15.78333333,0,3,3,5,0,1,0,0,4,1,4,7,9,10,13.1
2023-24,202401200DET,1/20/2024,DET vs MIL,Danilo Gallinari,gallida01,27,DET,1,MIL,8,1,3,0,0,0,16.08333333,0,1,1,1,1,1,5,5,0,0,4,11,9,12,13.7
2023-24,202401200NYK,1/20/2024,NYK vs TOR,Gradey Dick,dickgr01,22,TOR,0,NYK,11,2,1,1,0,0,16.23333333,0,2,4,7,3,6,0,0,1,1,3,12,13,14,17.9
2023-24,202401200DET,1/20/2024,DET vs MIL,Bobby Portis,portibo01,42,MIL,0,DET,4,3,0,0,0,0,16.7,0,3,2,4,0,0,0,0,0,0,3,4,7,7,7.6
2023-24,202401200CHI,1/20/2024,CHI vs MEM,Jevon Carter,carteje01,42,CHI,1,MEM,12,1,5,0,0,0,16.85,0,1,5,7,2,3,0,0,0,0,6,17,13,18,20.7
2023-24,202401200WAS,1/20/2024,WAS vs SAS,Cedi Osman,osmande01,42,SAS,0,WAS,3,3,4,0,0,0,17.35,0,3,1,3,1,3,0,0,1,0,7,7,6,10,12.6
2023-24,202401200DET,1/20/2024,DET vs MIL,Killian Hayes,hayeski01,37,DET,1,MIL,2,1,5,1,0,1,17.63333333,0,1,1,3,0,0,0,0,3,1,6,7,3,8,12.7
2023-24,202401200CHO,1/20/2024,CHO vs PHI,Nathan Mensah,mensana01,16,CHO,1,PHI,0,3,2,0,0,3,17.76666667,2,1,0,0,0,0,0,0,6,0,5,2,3,5,3.6
2023-24,202401200CHI,1/20/2024,CHI vs MEM,Dalen Terry,terryda01,28,CHI,1,MEM,7,5,3,1,1,1,18.1,1,4,1,3,1,3,4,6,2,2,8,10,12,15,22.5
2023-24,202401200HOU,1/20/2024,HOU vs UTA,Amen Thompson,thompam01,22,HOU,1,UTA,6,8,2,2,2,0,18.46666667,4,4,2,6,0,1,2,2,3,4,10,8,14,16,30.6
2023-24,202401200CHI,1/20/2024,CHI vs MEM,GG Jackson II,jacksgg01,10,MEM,0,CHI,10,1,0,0,0,0,18.5,0,1,2,3,2,2,4,6,2,0,1,10,11,11,11.2
2023-24,202401200CHO,1/20/2024,CHO vs PHI,Ish Smith,smithis01,33,CHO,1,PHI,2,2,5,0,0,2,18.76666667,0,2,1,4,0,0,0,0,0,0,7,7,4,9,9.9
2023-24,202401200CHI,1/20/2024,CHI vs MEM,Andre Drummond,drumman01,44,CHI,1,MEM,15,10,1,4,0,0,18.86666667,5,5,7,11,0,0,1,2,2,4,11,16,25,26,40.5
2023-24,202401200MIN,1/20/2024,MIN vs OKC,Nickeil Alexander-Walker,alexani01,42,MIN,1,OKC,3,5,2,1,1,2,19.16666667,0,5,1,3,1,2,0,0,1,2,7,5,8,10,16
2023-24,202401200MIN,1/20/2024,MIN vs OKC,Kyle Anderson,anderky01,42,MIN,1,OKC,5,1,4,1,0,0,19.25,1,0,2,4,1,3,0,0,2,1,5,9,6,10,15.2
2023-24,202401200NYK,1/20/2024,NYK vs TOR,Quentin Grimes,grimequ01,40,NYK,1,TOR,4,4,1,1,1,1,19.73333333,1,3,2,8,0,4,0,0,3,2,5,5,8,9,15.3
2023-24,202401200WAS,1/20/2024,WAS vs SAS,Delon Wright,wrighde01,20,WAS,1,SAS,6,4,4,3,1,0,20.2,1,3,2,5,0,1,2,2,0,4,8,10,10,14,28.8
2023-24,202401200WAS,1/20/2024,WAS vs SAS,Zach Collins,colliza01,33,SAS,0,WAS,8,3,3,0,0,1,20.25,1,2,4,9,0,1,0,0,2,0,6,11,11,14,15.1
2023-24,202401200HOU,1/20/2024,HOU vs UTA,John Collins,collijo01,40,UTA,0,HOU,7,6,2,0,0,0,20.35,1,5,3,9,0,4,1,1,2,0,8,9,13,15,17.2
2023-24,202401200ATL,1/20/2024,ATL vs CLE,Max Strus,strusma01,40,CLE,0,ATL,13,3,7,1,0,2,20.35,2,1,5,10,1,4,2,2,1,1,10,20,16,23,28.1
2023-24,202401200NYK,1/20/2024,NYK vs TOR,Donte DiVincenzo,divindo01,43,NYK,1,TOR,17,3,1,1,0,0,20.48333333,1,2,7,12,2,7,1,3,1,1,4,18,20,21,25.1
2023-24,202401200ATL,1/20/2024,ATL vs CLE,Craig Porter Jr.,portecr01,27,CLE,0,ATL,4,5,3,0,0,3,20.6,0,5,1,3,0,1,2,2,2,0,8,7,9,12,11.5
2023-24,202401200NYK,1/20/2024,NYK vs TOR,Jontay Porter,portejo01,10,TOR,0,NYK,6,2,1,3,1,2,21.01666667,1,1,2,8,0,2,2,2,1,4,3,7,8,9,19.9
2023-24,202401200ATL,1/20/2024,ATL vs CLE,Georges Niang,niangge01,40,CLE,0,ATL,14,5,2,0,1,0,21.31666667,0,5,5,9,4,8,0,0,2,1,7,16,19,21,26
2023-24,202401200CHO,1/20/2024,CHO vs PHI,JT Thor,thorjt01,34,CHO,1,PHI,7,6,0,0,1,0,21.58333333,3,3,3,5,1,3,0,0,1,1,6,7,13,13,17.2
2023-24,202401200NYK,1/20/2024,NYK vs TOR,Bruce Brown,brownbr01,36,TOR,0,NYK,8,3,0,1,1,2,22.06666667,1,2,3,8,0,2,2,2,2,2,3,8,11,11,15.6
2023-24,202401200ATL,1/20/2024,ATL vs CLE,Clint Capela,capelca01,40,ATL,1,CLE,6,9,0,1,2,2,22.1,5,4,3,8,0,0,0,0,2,3,9,6,15,15,23.8
2023-24,202401200CHI,1/20/2024,CHI vs MEM,Ziaire Williams,willizi02,40,MEM,0,CHI,8,1,1,2,0,1,22.11666667,1,0,2,9,0,5,4,4,3,2,2,9,9,10,15.7
2023-24,202401200MIN,1/20/2024,MIN vs OKC,Isaiah Joe,joeis01,42,OKC,0,MIN,5,5,5,1,0,0,22.16666667,0,5,1,3,1,2,2,2,4,1,10,10,10,15,21.5
2023-24,202401200ATL,1/20/2024,ATL vs CLE,Onyeka Okongwu,okongon01,41,ATL,1,CLE,1,6,2,0,0,0,22.65,2,4,0,3,0,0,1,2,3,0,8,3,7,9,11.2
2023-24,202401200NYK,1/20/2024,NYK vs TOR,Dennis Schroder,schrode01,43,TOR,0,NYK,2,1,3,0,0,0,22.66666667,0,1,1,5,0,1,0,0,1,0,4,5,3,6,7.7
2023-24,202401200WAS,1/20/2024,WAS vs SAS,Julian Champagnie,champju02,35,SAS,0,WAS,11,7,0,0,2,2,22.88333333,2,5,4,7,3,6,0,0,2,2,7,11,18,18,23.4
2023-24,202401200WAS,1/20/2024,WAS vs SAS,Bilal Coulibaly,coulibi01,40,WAS,1,SAS,14,4,1,0,1,1,23,2,2,6,9,2,2,0,2,1,1,5,15,18,19,22.3
2023-24,202401200NYK,1/20/2024,NYK vs TOR,Isaiah Hartenstein,harteis01,43,NYK,1,TOR,1,4,1,0,0,0,23.06666667,0,4,0,1,0,0,1,2,2,0,5,2,5,6,7.3
2023-24,202401200WAS,1/20/2024,WAS vs SAS,Corey Kispert,kispeco01,40,WAS,1,SAS,16,2,2,1,0,2,24.63333333,0,2,4,10,1,6,7,7,1,1,4,18,18,20,22.4
2023-24,202401200MIN,1/20/2024,MIN vs OKC,Josh Giddey,giddejo01,41,OKC,0,MIN,5,8,4,1,0,1,24.85,1,7,2,8,0,4,1,2,0,1,12,9,13,17,22.6
2023-24,202401200NYK,1/20/2024,NYK vs TOR,Precious Achiuwa,achiupr01,36,NYK,1,TOR,18,11,0,0,1,3,24.93333333,4,7,9,10,0,0,0,0,4,1,11,18,29,29,31.2
2023-24,202401200CHI,1/20/2024,CHI vs MEM,Alex Caruso,carusal01,37,CHI,1,MEM,8,3,1,2,1,0,25.3,0,3,3,6,2,5,0,0,3,3,4,9,11,12,22.1
2023-24,202401200CHI,1/20/2024,CHI vs MEM,Nikola Vucevic,vucevni01,39,CHI,1,MEM,11,11,3,0,0,2,25.4,2,9,5,8,1,3,0,0,3,0,14,14,22,25,26.7
2023-24,202401200NYK,1/20/2024,NYK vs TOR,Gary Trent Jr.,trentga02,38,TOR,0,NYK,16,1,0,1,1,1,25.53333333,0,1,6,10,4,8,0,0,4,2,1,16,17,17,22.2
2023-24,202401200ATL,1/20/2024,ATL vs CLE,Dean Wade,wadede01,33,CLE,0,ATL,17,5,0,1,0,0,25.55,1,4,6,7,5,6,0,0,1,1,5,17,22,22,26
2023-24,202401200MIN,1/20/2024,MIN vs OKC,Naz Reid,reidna01,42,MIN,1,OKC,18,3,0,0,4,4,25.83333333,0,3,7,13,4,8,0,0,3,4,3,18,21,21,29.6
2023-24,202401200CHO,1/20/2024,CHO vs PHI,P.J. Washington,washipj01,34,CHO,1,PHI,9,3,0,0,0,2,25.85,0,3,3,8,1,4,2,2,6,0,3,9,12,12,10.6
2023-24,202401200NYK,1/20/2024,NYK vs TOR,Josh Hart,hartjo01,42,NYK,1,TOR,10,9,1,0,1,3,26.46666667,1,8,3,5,2,3,2,2,1,1,10,11,19,20,22.3
2023-24,202401200CHI,1/20/2024,CHI vs MEM,John Konchar,konchjo01,33,MEM,0,CHI,2,5,6,0,2,2,26.58333333,0,5,1,4,0,2,0,0,0,2,11,8,7,13,21
2023-24,202401200CHI,1/20/2024,CHI vs MEM,Patrick Williams,willipa01,41,CHI,1,MEM,15,5,0,2,1,2,26.8,2,3,4,11,3,7,4,4,4,3,5,15,20,20,28
2023-24,202401200HOU,1/20/2024,HOU vs UTA,Kris Dunn,dunnkr01,36,UTA,0,HOU,10,8,7,1,0,0,26.86666667,2,6,4,6,1,2,1,2,2,1,15,17,18,25,33.1
2023-24,202401200HOU,1/20/2024,HOU vs UTA,Cam Whitmore,whitmca01,18,HOU,1,UTA,17,5,1,0,2,2,26.88333333,1,4,6,13,4,6,1,3,1,2,6,18,22,23,28.5
2023-24,202401200CHO,1/20/2024,CHO vs PHI,Kelly Oubre Jr.,oubreke01,29,PHI,0,CHO,5,8,0,2,0,2,26.98333333,0,8,2,7,1,5,0,0,3,2,8,5,13,13,18.6
2023-24,202401200CHO,1/20/2024,CHO vs PHI,Danuel House Jr.,houseda01,26,PHI,0,CHO,9,3,0,1,1,2,27.33333333,0,3,3,4,1,1,2,3,3,2,3,9,12,12,16.6
2023-24,202401200MIN,1/20/2024,MIN vs OKC,Jaden McDaniels,mcdanja02,32,MIN,1,OKC,15,2,0,0,0,2,27.4,1,1,6,11,3,5,0,1,4,0,2,15,17,17,15.4
2023-24,202401200WAS,1/20/2024,WAS vs SAS,Tyus Jones,jonesty01,41,WAS,1,SAS,13,2,6,1,0,1,27.58333333,0,2,5,12,1,2,2,2,2,1,8,19,15,21,26.4
2023-24,202401200CHI,1/20/2024,CHI vs MEM,Santi Aldama,aldamsa01,32,MEM,0,CHI,5,8,3,1,2,2,27.73333333,0,8,2,7,1,5,0,0,0,3,11,8,13,16,26.1
2023-24,202401200WAS,1/20/2024,WAS vs SAS,Victor Wembanyama,wembavi01,36,SAS,0,WAS,24,8,4,0,6,6,27.75,1,7,10,21,2,5,2,4,3,6,12,28,32,36,51.6
2023-24,202401200CHI,1/20/2024,CHI vs MEM,Ayo Dosunmu,dosunay01,42,CHI,1,MEM,20,6,4,1,1,3,27.91666667,0,6,7,10,3,5,3,3,1,2,10,24,26,30,36.2
2023-24,202401200WAS,1/20/2024,WAS vs SAS,Jeremy Sochan,sochaje01,42,SAS,0,WAS,23,4,3,1,2,0,28.21666667,2,2,8,11,1,2,6,6,4,3,7,26,27,30,41.3
2023-24,202401200WAS,1/20/2024,WAS vs SAS,Keldon Johnson,johnske04,40,SAS,0,WAS,19,9,2,0,0,1,28.23333333,4,5,7,15,0,3,5,7,2,0,11,21,28,30,31.8
2023-24,202401200ATL,1/20/2024,ATL vs CLE,Trae Young,youngtr01,39,ATL,1,CLE,15,1,5,0,0,4,28.3,0,1,6,12,3,4,0,0,2,0,6,20,16,21,19.7
2023-24,202401200ATL,1/20/2024,ATL vs CLE,Bogdan Bogdanovic,bogdabo01,40,ATL,1,CLE,14,2,4,1,0,1,28.33333333,0,2,5,11,1,6,3,4,0,1,6,18,16,20,24.4
2023-24,202401200HOU,1/20/2024,HOU vs UTA,Jalen Green,greenja05,41,HOU,1,UTA,7,3,4,1,0,1,28.33333333,0,3,3,12,0,6,1,1,0,1,7,11,10,14,18.6
2023-24,202401200MIN,1/20/2024,MIN vs OKC,Mike Conley,conlemi01,41,MIN,1,OKC,3,3,4,0,1,3,28.55,0,3,1,11,1,9,0,0,3,1,7,7,6,10,12.6
2023-24,202401200WAS,1/20/2024,WAS vs SAS,Jordan Poole,poolejo01,40,WAS,1,SAS,16,0,2,2,1,1,28.73333333,0,0,7,15,0,3,2,2,4,3,2,18,16,18,27
2023-24,202401200NYK,1/20/2024,NYK vs TOR,RJ Barrett,barrerj01,37,TOR,0,NYK,20,8,4,1,0,0,28.93333333,2,6,8,15,1,3,3,9,2,1,12,24,28,32,38.6
2023-24,202401200CHO,1/20/2024,CHO vs PHI,Cody Martin,martico01,11,CHO,1,PHI,4,6,3,1,4,2,28.95,0,6,2,7,0,3,0,0,2,5,9,7,10,13,28.7
2023-24,202401200WAS,1/20/2024,WAS vs SAS,Kyle Kuzma,kuzmaky01,41,WAS,1,SAS,11,12,6,1,0,2,29.06666667,3,9,5,14,0,4,1,1,0,1,18,17,23,29,35.4
2023-24,202401200CHO,1/20/2024,CHO vs PHI,Nicolas Batum,batumni01,30,PHI,0,CHO,9,5,1,2,2,0,29.18333333,3,2,4,6,1,3,0,0,1,4,6,10,14,15,28.5
2023-24,202401200HOU,1/20/2024,HOU vs UTA,Simone Fontecchio,fontesi01,42,UTA,0,HOU,10,7,3,0,0,1,29.35,2,5,4,7,2,5,0,0,2,0,10,13,17,20,21.9
2023-24,202401200CHI,1/20/2024,CHI vs MEM,Luke Kennard,kennalu01,19,MEM,0,CHI,14,2,6,0,0,3,29.73333333,0,2,5,9,4,7,0,1,0,0,8,20,16,22,22.4
2023-24,202401200DET,1/20/2024,DET vs MIL,Alec Burks,burksal01,35,DET,1,MIL,33,7,6,1,0,0,29.88333333,0,7,9,20,7,14,8,8,2,1,13,39,40,46,53.4
2023-24,202401200CHI,1/20/2024,CHI vs MEM,Vince Williams Jr.,willivi01,32,MEM,0,CHI,14,5,2,1,0,2,29.88333333,0,5,5,9,3,6,1,2,2,1,7,16,19,21,24
2023-24,202401200ATL,1/20/2024,ATL vs CLE,Saddiq Bey,beysa01,42,ATL,1,CLE,0,7,2,0,0,1,30.06666667,3,4,0,12,0,6,0,0,3,0,9,2,7,9,10.4
2023-24,202401200ATL,1/20/2024,ATL vs CLE,Sam Merrill,merrisa01,25,CLE,0,ATL,18,4,6,0,0,1,30.1,0,4,6,16,5,14,1,1,2,0,10,24,22,28,30.8
2023-24,202401200DET,1/20/2024,DET vs MIL,Jalen Duren,durenja01,27,DET,1,MIL,8,9,1,1,0,1,30.2,2,7,4,8,0,0,0,0,5,1,10,9,17,18,22.3
2023-24,202401200NYK,1/20/2024,NYK vs TOR,Immanuel Quickley,quickim01,41,TOR,0,NYK,12,2,11,1,0,2,31.31666667,0,2,4,8,2,4,2,3,1,1,13,23,14,25,31.9
2023-24,202401200CHI,1/20/2024,CHI vs MEM,David Roddy,roddyda01,39,MEM,0,CHI,11,2,3,0,0,1,31.61666667,0,2,5,11,1,5,0,0,3,0,5,14,13,16,16.9
2023-24,202401200DET,1/20/2024,DET vs MIL,Bojan Bogdanovic,bogdabo02,21,DET,1,MIL,19,1,2,0,0,1,32.03333333,0,1,5,15,3,7,6,8,5,0,3,21,20,22,22.2
2023-24,202401200DET,1/20/2024,DET vs MIL,Ausar Thompson,thompau01,42,DET,1,MIL,22,9,1,0,1,1,32.06666667,5,4,10,15,2,2,0,0,4,1,10,23,31,32,36.3
2023-24,202401200WAS,1/20/2024,WAS vs SAS,Tre Jones,jonestr01,38,SAS,0,WAS,11,8,12,3,0,1,32.21666667,3,5,4,9,0,3,3,3,0,3,20,23,19,31,46.6
2023-24,202401200HOU,1/20/2024,HOU vs UTA,Walker Kessler,kesslwa01,36,UTA,0,HOU,7,10,3,0,5,3,32.25,3,7,2,4,0,0,3,6,6,5,13,10,17,20,35.5
2023-24,202401200NYK,1/20/2024,NYK vs TOR,Julius Randle,randlju01,43,NYK,1,TOR,18,16,10,0,0,7,32.4,7,9,7,13,3,7,1,2,3,0,26,28,34,44,45.2
2023-24,202401200WAS,1/20/2024,WAS vs SAS,Deni Avdija,avdijde01,41,WAS,1,SAS,16,7,4,1,0,1,32.48333333,0,7,7,11,1,3,1,1,2,1,11,20,23,27,32.4
2023-24,202401200DET,1/20/2024,DET vs MIL,Jaden Ivey,iveyja01,38,DET,1,MIL,18,6,6,0,1,3,32.5,2,4,6,16,2,5,4,7,5,1,12,24,24,30,34.2
2023-24,202401200NYK,1/20/2024,NYK vs TOR,Scottie Barnes,barnesc01,43,TOR,0,NYK,9,6,7,0,2,3,32.73333333,2,4,4,14,0,3,1,3,2,2,13,16,15,22,29.7
2023-24,202401200MIN,1/20/2024,MIN vs OKC,Chet Holmgren,holmgch01,42,OKC,0,MIN,15,5,2,1,2,0,33.08333333,1,4,4,8,1,2,6,6,4,3,7,17,20,22,33
2023-24,202401200CHI,1/20/2024,CHI vs MEM,Jaren Jackson Jr.,jacksja02,40,MEM,0,CHI,26,6,5,1,0,2,33.1,1,5,8,18,1,7,9,9,3,1,11,31,32,37,41.7
2023-24,202401200ATL,1/20/2024,ATL vs CLE,Isaac Okoro,okorois01,31,CLE,0,ATL,12,5,2,2,0,2,33.18333333,0,5,5,9,1,3,1,3,3,2,7,14,17,19,25
2023-24,202401200DET,1/20/2024,DET vs MIL,Khris Middleton,middlkh01,36,MIL,0,DET,17,5,4,1,2,1,33.23333333,0,5,5,12,3,7,4,6,4,3,9,21,22,26,37
2023-24,202401200MIN,1/20/2024,MIN vs OKC,Luguentz Dort,dortlu01,40,OKC,0,MIN,14,5,1,2,0,1,33.28333333,2,3,5,12,3,7,1,2,4,2,6,15,19,20,26.5
2023-24,202401200MIN,1/20/2024,MIN vs OKC,Rudy Gobert,goberru01,41,MIN,1,OKC,7,18,2,0,0,2,33.36666667,4,14,1,6,0,0,5,8,4,0,20,9,25,27,29.6
2023-24,202401200ATL,1/20/2024,ATL vs CLE,Jarrett Allen,allenja01,35,CLE,0,ATL,14,11,2,3,3,4,33.43333333,1,10,6,8,0,0,2,2,2,6,13,16,25,27,44.2
2023-24,202401200WAS,1/20/2024,WAS vs SAS,Devin Vassell,vassede01,37,SAS,0,WAS,21,5,5,1,0,4,33.61666667,0,5,8,14,4,6,1,3,1,1,10,26,26,31,33.5
2023-24,202401200ATL,1/20/2024,ATL vs CLE,Jalen Johnson,johnsja05,28,ATL,1,CLE,20,7,4,1,2,1,33.76666667,1,6,8,16,1,5,3,6,2,3,11,24,27,31,42.4
2023-24,202401200HOU,1/20/2024,HOU vs UTA,Fred VanVleet,vanvlfr01,40,HOU,1,UTA,18,5,7,1,3,2,33.98333333,2,3,8,19,2,10,0,0,6,4,12,25,23,30,44.5
2023-24,202401200DET,1/20/2024,DET vs MIL,Malik Beasley,beaslma01,40,MIL,0,DET,11,2,1,0,0,2,34.3,0,2,5,9,1,4,0,0,4,0,3,12,13,14,12.9
2023-24,202401200ATL,1/20/2024,ATL vs CLE,Dejounte Murray,murrade01,42,ATL,1,CLE,24,9,5,1,0,2,34.71666667,0,9,10,19,2,7,2,2,2,1,14,29,33,38,43.3
2023-24,202401200CHO,1/20/2024,CHO vs PHI,Brandon Miller,millebr02,34,CHO,1,PHI,23,7,3,0,1,1,34.76666667,2,5,8,17,2,10,5,5,1,1,10,26,30,33,37.9
2023-24,202401200NYK,1/20/2024,NYK vs TOR,Jalen Brunson,brunsja01,41,NYK,1,TOR,38,5,9,1,0,3,35.11666667,1,4,13,23,5,11,7,7,3,1,14,47,43,52,57.5
2023-24,202401200HOU,1/20/2024,HOU vs UTA,Dillon Brooks,brookdi01,32,HOU,1,UTA,7,5,1,0,0,0,35.13333333,0,5,3,10,1,3,0,0,2,0,6,8,12,13,14.5
2023-24,202401200MIN,1/20/2024,MIN vs OKC,Jalen Williams,willija06,39,OKC,0,MIN,20,5,3,3,0,0,35.56666667,3,2,6,18,0,2,8,10,4,3,8,23,25,28,39.5
2023-24,202401200CHO,1/20/2024,CHO vs PHI,Terry Rozier,roziete01,29,CHO,1,PHI,19,9,6,1,0,3,35.58333333,0,9,9,18,0,5,1,5,2,1,15,25,28,34,38.8
2023-24,202401200WAS,1/20/2024,WAS vs SAS,Marvin Bagley III,baglema01,28,WAS,1,SAS,21,12,2,1,0,2,35.63333333,7,5,8,19,1,3,4,4,5,1,14,23,33,35,39.4
2023-24,202401200CHO,1/20/2024,CHO vs PHI,Tobias Harris,harrito02,40,PHI,0,CHO,21,5,6,0,0,2,35.66666667,1,4,7,15,1,3,6,7,0,0,11,27,26,32,34
2023-24,202401200ATL,1/20/2024,ATL vs CLE,Donovan Mitchell,mitchdo01,31,CLE,0,ATL,18,6,8,0,1,1,35.71666667,0,6,6,17,0,6,6,6,3,1,14,26,24,32,39.2
2023-24,202401200MIN,1/20/2024,MIN vs OKC,Karl-Anthony Towns,townska01,41,MIN,1,OKC,19,11,2,0,1,3,35.78333333,1,10,4,10,1,4,10,10,6,1,13,21,30,32,35.2
2023-24,202401200CHI,1/20/2024,CHI vs MEM,Coby White,whiteco01,44,CHI,1,MEM,17,5,5,0,0,1,36.11666667,1,4,7,14,1,3,2,2,1,0,10,22,22,27,29.5
2023-24,202401200CHI,1/20/2024,CHI vs MEM,DeMar DeRozan,derozde01,42,CHI,1,MEM,18,4,8,1,1,1,36.6,1,3,7,20,1,4,3,4,0,2,12,26,22,30,39.8
2023-24,202401200CHO,1/20/2024,CHO vs PHI,Joel Embiid,embiijo01,31,PHI,0,CHO,33,10,5,0,3,3,36.76666667,1,9,11,23,0,1,11,12,2,3,15,38,43,48,58.5
2023-24,202401200NYK,1/20/2024,NYK vs TOR,OG Anunoby,anunoog01,38,NYK,1,TOR,14,7,1,1,3,1,36.81666667,0,7,5,11,0,3,4,4,2,4,8,15,21,22,34.9
2023-24,202401200DET,1/20/2024,DET vs MIL,Brook Lopez,lopezbr01,42,MIL,0,DET,19,10,4,1,3,0,36.91666667,2,8,7,13,1,4,4,5,1,4,14,23,29,33,49
2023-24,202401200MIN,1/20/2024,MIN vs OKC,Shai Gilgeous-Alexander,gilgesh01,41,OKC,0,MIN,33,2,6,2,0,2,37.16666667,1,1,10,22,1,2,12,13,0,2,8,39,35,41,48.4
2023-24,202401200DET,1/20/2024,DET vs MIL,Damian Lillard,lillada01,39,MIL,0,DET,45,6,11,1,0,1,37.26666667,0,6,12,22,5,11,16,16,3,1,17,56,51,62,70.7
2023-24,202401200MIN,1/20/2024,MIN vs OKC,Anthony Edwards,edwaran01,39,MIN,1,OKC,19,5,5,0,0,5,38,0,5,6,10,1,3,6,10,2,0,10,24,24,29,27.5
2023-24,202401200DET,1/20/2024,DET vs MIL,Giannis Antetokounmpo,antetgi01,40,MIL,0,DET,31,10,9,2,1,5,38.13333333,3,7,10,16,0,1,11,22,1,3,19,40,41,50,60.5
2023-24,202401200HOU,1/20/2024,HOU vs UTA,Jordan Clarkson,clarkjo01,34,UTA,0,HOU,33,12,4,0,0,3,38.5,2,10,12,25,4,10,5,5,1,0,16,37,45,49,50.4
2023-24,202401200HOU,1/20/2024,HOU vs UTA,Lauri Markkanen,markkla01,34,UTA,0,HOU,22,9,1,0,0,3,38.76666667,3,6,8,18,3,11,3,4,2,0,10,23,31,32,31.3
2023-24,202401200CHO,1/20/2024,CHO vs PHI,Miles Bridges,bridgmi02,29,CHO,1,PHI,25,11,3,0,1,2,40,0,11,9,22,5,10,2,2,2,1,14,28,36,39,43.7
2023-24,202401200HOU,1/20/2024,HOU vs UTA,Collin Sexton,sextoco01,44,UTA,0,HOU,28,3,5,2,0,2,40.2,3,0,11,27,2,7,4,4,4,2,8,33,31,36,43.1
2023-24,202401200HOU,1/20/2024,HOU vs UTA,Jabari Smith Jr.,smithja05,40,HOU,1,UTA,24,10,1,2,1,0,41.3,4,6,9,19,4,8,2,4,2,3,11,25,34,35,46.5
2023-24,202401200HOU,1/20/2024,HOU vs UTA,Alperen Sengun,sengual01,41,HOU,1,UTA,37,14,6,1,1,1,41.71666667,8,6,15,26,1,1,6,10,4,2,20,43,51,57,67.8
2023-24,202401200CHO,1/20/2024,CHO vs PHI,Tyrese Maxey,maxeyty01,40,PHI,0,CHO,16,3,8,2,0,0,42.25,0,3,7,22,1,9,1,2,2,2,11,24,19,27,37.6
2023-24,202401190MIA,1/19/2024,MIA vs ATL,Haywood Highsmith,highsha01,28,MIA,1,ATL,0,0,0,1,0,0,10.08333333,0,0,0,2,0,1,0,0,0,1,0,0,0,0,3
2023-24,202401190POR,1/19/2024,POR vs IND,Ben Sheppard,sheppbe01,21,IND,0,POR,3,1,0,1,0,0,10.48333333,0,1,1,4,1,3,0,0,1,1,1,3,4,4,7.2
2023-24,202401190NOP,1/19/2024,NOP vs PHO,Dyson Daniels,daniedy01,43,NOP,1,PHO,2,3,1,2,0,1,10.95,1,2,1,4,0,1,0,0,2,2,4,3,5,6,12.1
2023-24,202401190LAL,1/19/2024,LAL vs BRK,Christian Wood,woodch01,37,LAL,1,BRK,5,4,3,1,1,1,11.08333333,0,4,1,6,1,3,2,2,0,2,7,8,9,12,19.3
2023-24,202401190POR,1/19/2024,POR vs IND,Obi Toppin,toppiob01,43,IND,0,POR,0,0,2,0,0,2,11.33333333,0,0,0,3,0,3,0,0,2,0,2,2,0,2,1
2023-24,202401190ORL,1/19/2024,ORL vs PHI,Danuel House Jr.,houseda01,25,PHI,0,ORL,0,0,1,0,0,0,11.36666667,0,0,0,1,0,1,0,0,1,0,1,1,0,1,1.5
2023-24,202401190MIA,1/19/2024,MIA vs ATL,Kevin Love,loveke01,32,MIA,1,ATL,0,5,1,1,0,3,11.86666667,1,4,0,5,0,3,0,0,1,1,6,1,5,6,7.5
2023-24,202401190NOP,1/19/2024,NOP vs PHO,Udoka Azubuike,azubuud01,11,PHO,0,NOP,3,1,1,0,0,1,12.26666667,0,1,1,1,0,0,1,2,3,0,2,4,4,5,4.7
2023-24,202401190BOS,1/19/2024,BOS vs DEN,Payton Pritchard,pritcpa01,42,BOS,1,DEN,3,2,1,0,0,0,12.35,1,1,1,2,1,1,0,0,1,0,3,4,5,6,6.9
2023-24,202401190ORL,1/19/2024,ORL vs PHI,Jonathan Isaac,isaacjo01,25,ORL,1,PHI,7,3,1,0,1,0,12.66666667,1,2,3,7,1,3,0,0,0,1,4,8,10,11,15.1
2023-24,202401190ORL,1/19/2024,ORL vs PHI,Anthony Black,blackan01,39,ORL,1,PHI,7,3,3,0,1,0,12.68333333,0,3,1,2,1,2,4,4,2,1,6,10,10,13,18.1
2023-24,202401190CHO,1/19/2024,CHO vs SAS,Cedi Osman,osmande01,41,SAS,0,CHO,5,3,1,0,0,0,12.71666667,0,3,2,4,1,1,0,0,1,0,4,6,8,9,10.1
2023-24,202401190NOP,1/19/2024,NOP vs PHO,Naji Marshall,marshna01,34,NOP,1,PHO,5,0,1,0,0,1,12.85,0,0,1,4,1,2,2,2,0,0,1,6,5,6,5.5
2023-24,202401190POR,1/19/2024,POR vs IND,T.J. McConnell,mccontj01,35,IND,0,POR,2,0,2,0,0,2,13.13333333,0,0,1,4,0,0,0,0,1,0,2,4,2,4,3
2023-24,202401190LAL,1/19/2024,LAL vs BRK,Lonnie Walker IV,walkelo01,23,BRK,0,LAL,15,1,3,0,0,1,13.35,0,1,6,7,3,4,0,0,2,0,4,18,16,19,19.7
2023-24,202401190NOP,1/19/2024,NOP vs PHO,Chimezie Metu,metuch01,31,PHO,0,NOP,2,4,1,0,1,1,13.8,1,3,0,4,0,1,2,2,2,1,5,3,6,7,10.3
2023-24,202401190POR,1/19/2024,POR vs IND,Jalen Smith,smithja04,29,IND,0,POR,7,3,0,0,0,1,13.9,2,1,2,5,1,1,2,2,2,0,3,7,10,10,9.6
2023-24,202401190POR,1/19/2024,POR vs IND,Kris Murray,murrakr01,25,POR,1,IND,5,3,0,0,0,3,14.48333333,0,3,2,2,1,1,0,0,1,0,3,5,8,8,5.6
2023-24,202401190CHO,1/19/2024,CHO vs SAS,Blake Wesley,weslebl01,20,SAS,0,CHO,9,1,2,0,0,0,14.78333333,0,1,4,6,0,1,1,1,3,0,3,11,10,12,13.2
2023-24,202401190MIA,1/19/2024,MIA vs ATL,Nikola Jovic,jovicni01,16,MIA,1,ATL,2,3,0,0,0,0,14.96666667,2,1,1,5,0,1,0,0,2,0,3,2,5,5,5.6
2023-24,202401190ORL,1/19/2024,ORL vs PHI,Caleb Houstan,houstca01,33,ORL,1,PHI,0,2,0,0,0,1,15.28333333,2,0,0,3,0,2,0,0,0,0,2,0,2,2,1.4
2023-24,202401190ORL,1/19/2024,ORL vs PHI,Paul Reed,reedpa01,40,PHI,0,ORL,2,5,0,0,0,1,15.35,3,2,1,3,0,1,0,0,4,0,5,2,7,7,7
2023-24,202401190LAL,1/19/2024,LAL vs BRK,Rui Hachimura,hachiru01,30,LAL,1,BRK,0,2,1,0,0,1,15.46666667,1,1,0,6,0,3,0,0,0,0,3,1,2,3,2.9
2023-24,202401190ORL,1/19/2024,ORL vs PHI,Goga Bitadze,bitadgo01,38,ORL,1,PHI,2,2,1,1,1,1,15.58333333,0,2,1,2,0,1,0,0,4,2,3,3,4,5,10.9
2023-24,202401190BOS,1/19/2024,BOS vs DEN,Sam Hauser,hausesa01,41,BOS,1,DEN,0,1,1,0,0,0,15.96666667,0,1,0,1,0,1,0,0,2,0,2,1,1,2,2.7
2023-24,202401190NOP,1/19/2024,NOP vs PHO,Jordan Hawkins,hawkijo01,38,NOP,1,PHO,13,2,1,0,0,1,16.78333333,0,2,5,11,3,8,0,0,0,0,3,14,15,16,15.9
2023-24,202401190LAL,1/19/2024,LAL vs BRK,Dennis Smith Jr.,smithde03,26,BRK,0,LAL,11,2,5,3,0,2,17.1,1,1,4,7,2,4,1,1,2,3,7,16,13,18,27.9
2023-24,202401190LAL,1/19/2024,LAL vs BRK,Royce O'Neale,onealro01,40,BRK,0,LAL,0,7,3,0,0,0,17.16666667,0,7,0,5,0,5,0,0,1,0,10,3,7,10,12.9
2023-24,202401190POR,1/19/2024,POR vs IND,Duop Reath,reathdu01,29,POR,1,IND,3,5,2,0,2,0,17.63333333,2,3,1,1,0,0,1,2,4,2,7,5,8,10,18
2023-24,202401190CHO,1/19/2024,CHO vs SAS,Nick Smith Jr.,smithni01,24,CHO,1,SAS,5,4,0,0,0,1,17.78333333,1,3,2,6,1,2,0,0,1,0,4,5,9,9,8.8
2023-24,202401190MIA,1/19/2024,MIA vs ATL,Patty Mills,millspa02,10,ATL,0,MIA,11,3,2,1,0,1,18.03333333,0,3,4,6,3,5,0,0,4,1,5,13,14,16,19.6
2023-24,202401190NOP,1/19/2024,NOP vs PHO,Larry Nance Jr.,nancela02,26,NOP,1,PHO,3,5,1,0,0,0,18.46666667,0,5,1,2,1,2,0,0,1,0,6,4,8,9,10.5
2023-24,202401190POR,1/19/2024,POR vs IND,Toumani Camara,camarto01,40,POR,1,IND,4,4,0,0,0,1,18.56666667,1,3,1,3,0,0,2,2,2,0,4,4,8,8,7.8
2023-24,202401190CHO,1/19/2024,CHO vs SAS,Julian Champagnie,champju02,34,SAS,0,CHO,9,2,3,1,1,0,18.71666667,1,1,4,7,1,4,0,0,0,2,5,12,11,14,21.9
2023-24,202401190LAL,1/19/2024,LAL vs BRK,Max Christie,chrisma02,34,LAL,1,BRK,6,2,1,0,0,1,19.01666667,0,2,2,3,2,3,0,0,1,0,3,7,8,9,8.9
2023-24,202401190LAL,1/19/2024,LAL vs BRK,Jarred Vanderbilt,vandeja01,23,LAL,1,BRK,12,5,0,0,0,0,19.38333333,0,5,5,5,2,2,0,0,0,0,5,12,17,17,18
2023-24,202401190CHO,1/19/2024,CHO vs SAS,Dominick Barlow,barlodo01,19,SAS,0,CHO,12,4,2,0,1,1,19.48333333,2,2,5,6,1,1,1,1,0,1,6,14,16,18,21.8
2023-24,202401190MIA,1/19/2024,MIA vs ATL,Garrison Mathews,mathega01,27,ATL,0,MIA,9,3,3,0,0,1,19.93333333,0,3,3,5,3,4,0,0,2,0,6,12,12,15,16.1
2023-24,202401190CHO,1/19/2024,CHO vs SAS,Nathan Mensah,mensana01,15,CHO,1,SAS,0,3,1,0,2,0,20.06666667,2,1,0,1,0,0,0,0,1,2,4,1,3,4,11.1
2023-24,202401190ORL,1/19/2024,ORL vs PHI,Chuma Okeke,okekech01,25,ORL,1,PHI,8,1,0,1,0,1,20.06666667,0,1,3,4,1,1,1,2,3,1,1,8,9,9,11.2
2023-24,202401190ORL,1/19/2024,ORL vs PHI,Nicolas Batum,batumni01,29,PHI,0,ORL,3,2,5,0,0,0,20.13333333,2,0,1,2,1,2,0,0,4,0,7,8,5,10,12.9
2023-24,202401190ORL,1/19/2024,ORL vs PHI,Cole Anthony,anthoco01,41,ORL,1,PHI,3,1,3,0,0,4,20.58333333,0,1,0,5,0,1,3,3,3,0,4,6,4,7,4.7
2023-24,202401190BOS,1/19/2024,BOS vs DEN,Peyton Watson,watsope01,41,DEN,0,BOS,9,2,0,0,2,0,20.58333333,0,2,4,11,1,6,0,0,2,2,2,9,11,11,17.4
2023-24,202401190BOS,1/19/2024,BOS vs DEN,Reggie Jackson,jacksre01,43,DEN,0,BOS,4,2,2,0,0,2,20.66666667,1,1,2,4,0,2,0,0,0,0,4,6,6,8,7.4
2023-24,202401190MIA,1/19/2024,MIA vs ATL,Josh Richardson,richajo01,33,MIA,1,ATL,9,3,0,0,1,0,20.85,0,3,2,5,2,4,3,3,1,1,3,9,12,12,15.6
2023-24,202401190MIA,1/19/2024,MIA vs ATL,Duncan Robinson,robindu01,40,MIA,1,ATL,14,2,1,0,0,2,21.61666667,0,2,5,8,4,7,0,0,0,0,3,15,16,17,15.9
2023-24,202401190ORL,1/19/2024,ORL vs PHI,Markelle Fultz,fultzma01,11,ORL,1,PHI,7,1,3,0,0,1,22,1,0,3,6,0,0,1,1,3,0,4,10,8,11,11.7
2023-24,202401190MIA,1/19/2024,MIA vs ATL,Clint Capela,capelca01,39,ATL,0,MIA,9,11,0,0,1,0,22.21666667,5,6,2,4,0,0,5,7,2,1,11,9,20,20,25.2
2023-24,202401190ORL,1/19/2024,ORL vs PHI,Joe Ingles,inglejo01,28,ORL,1,PHI,9,1,3,0,0,0,22.23333333,0,1,3,6,3,3,0,0,2,0,4,12,10,13,14.7
2023-24,202401190LAL,1/19/2024,LAL vs BRK,Cameron Johnson,johnsca02,33,BRK,0,LAL,10,4,5,1,0,0,23.16666667,3,1,4,9,2,4,0,0,1,1,9,15,14,19,25.3
2023-24,202401190NOP,1/19/2024,NOP vs PHO,Herbert Jones,joneshe01,40,NOP,1,PHO,9,3,2,0,0,1,23.38333333,1,2,4,9,1,6,0,0,1,0,5,11,12,14,14.6
2023-24,202401190POR,1/19/2024,POR vs IND,Bennedict Mathurin,mathube01,43,IND,0,POR,2,3,0,0,0,3,23.46666667,0,3,0,8,0,5,2,3,1,0,3,2,5,5,2.6
2023-24,202401190NOP,1/19/2024,NOP vs PHO,Trey Murphy III,murphtr02,19,NOP,1,PHO,5,2,1,1,1,0,23.55,1,1,2,8,1,5,0,0,3,2,3,6,7,8,14.9
2023-24,202401190MIA,1/19/2024,MIA vs ATL,Kyle Lowry,lowryky01,36,MIA,1,ATL,2,3,4,1,0,1,24.33333333,1,2,1,4,0,3,0,0,2,1,7,6,5,9,13.6
2023-24,202401190ORL,1/19/2024,ORL vs PHI,Jalen Suggs,suggsja01,38,ORL,1,PHI,16,2,2,1,1,1,24.71666667,0,2,5,13,2,5,4,4,1,2,4,18,18,20,26.4
2023-24,202401190CHO,1/19/2024,CHO vs SAS,Cody Martin,martico01,10,CHO,1,SAS,5,3,3,2,1,2,25.18333333,1,2,2,5,1,1,0,0,3,3,6,8,8,11,20.1
2023-24,202401190NOP,1/19/2024,NOP vs PHO,Jonas Valanciunas,valanjo01,43,NOP,1,PHO,16,11,3,0,0,2,25.55,4,7,5,10,0,2,6,6,3,0,14,19,27,30,31.7
2023-24,202401190NOP,1/19/2024,NOP vs PHO,Eric Gordon,gordoer01,35,PHO,0,NOP,5,2,0,2,0,0,25.6,0,2,2,9,1,8,0,0,2,2,2,5,7,7,13.4
2023-24,202401190MIA,1/19/2024,MIA vs ATL,Onyeka Okongwu,okongon01,40,ATL,0,MIA,9,5,1,1,1,2,25.81666667,1,4,4,5,1,1,0,0,5,2,6,10,14,15,20.5
2023-24,202401190CHO,1/19/2024,CHO vs SAS,Zach Collins,colliza01,32,SAS,0,CHO,16,4,4,1,0,4,25.95,2,2,6,10,1,3,3,6,5,1,8,20,20,24,25.8
2023-24,202401190ORL,1/19/2024,ORL vs PHI,Wendell Carter Jr.,cartewe01,16,ORL,1,PHI,25,11,0,0,0,3,26.03333333,6,5,9,13,1,2,6,7,4,0,11,25,36,36,35.2
2023-24,202401190ORL,1/19/2024,ORL vs PHI,Marcus Morris,morrima03,32,PHI,0,ORL,10,9,0,0,0,2,26.11666667,4,5,5,10,0,2,0,0,1,0,9,10,19,19,18.8
2023-24,202401190MIA,1/19/2024,MIA vs ATL,Caleb Martin,martica02,25,MIA,1,ATL,10,8,1,0,1,1,26.81666667,3,5,4,9,2,3,0,0,1,1,9,11,18,19,23.1
2023-24,202401190BOS,1/19/2024,BOS vs DEN,Al Horford,horfoal01,35,BOS,1,DEN,6,10,2,0,0,0,27.25,3,7,2,5,2,5,0,0,3,0,12,8,16,18,21
2023-24,202401190POR,1/19/2024,POR vs IND,Matisse Thybulle,thybuma01,39,POR,1,IND,4,1,2,1,2,0,27.86666667,0,1,1,2,0,1,2,2,3,3,3,6,5,7,17.2
2023-24,202401190CHO,1/19/2024,CHO vs SAS,P.J. Washington,washipj01,33,CHO,1,SAS,20,6,0,1,0,2,27.93333333,1,5,7,11,3,4,3,3,4,1,6,20,26,26,28.2
2023-24,202401190LAL,1/19/2024,LAL vs BRK,Dorian Finney-Smith,finnedo01,38,BRK,0,LAL,3,4,1,1,2,0,28.01666667,1,3,1,8,0,5,1,2,4,3,5,4,7,8,18.3
2023-24,202401190POR,1/19/2024,POR vs IND,Aaron Nesmith,nesmiaa01,38,IND,0,POR,12,4,2,0,0,2,28.01666667,1,3,4,9,3,4,1,2,6,0,6,14,16,18,17.8
2023-24,202401190ORL,1/19/2024,ORL vs PHI,Patrick Beverley,beverpa01,39,PHI,0,ORL,5,6,4,1,2,1,28.43333333,1,5,2,7,1,3,0,0,1,3,10,9,11,15,26.2
2023-24,202401190LAL,1/19/2024,LAL vs BRK,Taurean Prince,princta02,42,LAL,1,BRK,10,3,2,1,0,3,28.98333333,0,3,3,7,2,4,2,2,1,1,5,12,13,15,16.6
2023-24,202401190CHO,1/19/2024,CHO vs SAS,Keldon Johnson,johnske04,39,SAS,0,CHO,25,4,3,0,0,1,29.26666667,0,4,9,15,4,8,3,4,3,0,7,28,29,32,33.3
2023-24,202401190BOS,1/19/2024,BOS vs DEN,Jrue Holiday,holidjr01,39,BOS,1,DEN,7,2,3,0,0,1,29.86666667,1,1,3,7,1,3,0,0,0,0,5,10,9,12,12.9
2023-24,202401190POR,1/19/2024,POR vs IND,Deandre Ayton,aytonde01,25,POR,1,IND,12,8,1,0,2,1,30.2,2,6,6,15,0,0,0,0,1,2,9,13,20,21,28.1
2023-24,202401190NOP,1/19/2024,NOP vs PHO,Bradley Beal,bealbr01,17,PHO,0,NOP,13,7,5,0,0,0,30.5,1,6,6,12,1,4,0,0,4,0,12,18,20,25,28.9
2023-24,202401190ORL,1/19/2024,ORL vs PHI,Joel Embiid,embiijo01,30,PHI,0,ORL,36,7,2,4,0,1,30.83333333,1,6,12,22,1,2,11,11,1,4,9,38,43,45,58.4
2023-24,202401190NOP,1/19/2024,NOP vs PHO,CJ McCollum,mccolcj01,29,NOP,1,PHO,13,4,4,0,2,1,31.45,0,4,5,13,1,7,2,3,1,2,8,17,17,21,28.8
2023-24,202401190CHO,1/19/2024,CHO vs SAS,LaMelo Ball,ballla01,19,CHO,1,SAS,28,1,8,3,0,4,31.53333333,1,0,10,13,4,6,4,5,4,3,9,36,29,37,46.2
2023-24,202401190CHO,1/19/2024,CHO vs SAS,Tre Jones,jonestr01,37,SAS,0,CHO,16,2,4,3,0,1,31.83333333,0,2,6,11,2,3,2,2,2,3,6,20,18,22,32.4
2023-24,202401190LAL,1/19/2024,LAL vs BRK,Cam Thomas,thomaca02,32,BRK,0,LAL,33,3,4,1,0,1,31.83333333,0,3,13,18,4,7,3,4,2,1,7,37,36,40,44.6
2023-24,202401190NOP,1/19/2024,NOP vs PHO,Grayson Allen,allengr01,36,PHO,0,NOP,12,4,6,2,0,0,31.86666667,0,4,4,8,3,6,1,2,1,2,10,18,16,22,31.8
2023-24,202401190ORL,1/19/2024,ORL vs PHI,Paolo Banchero,banchpa01,42,ORL,1,PHI,14,8,6,0,1,3,32.11666667,1,7,5,12,0,1,4,4,0,1,14,20,22,28,32.6
2023-24,202401190ORL,1/19/2024,ORL vs PHI,Kelly Oubre Jr.,oubreke01,28,PHI,0,ORL,15,4,2,0,1,0,32.25,1,3,5,8,3,4,2,2,5,1,6,17,19,21,25.8
2023-24,202401190LAL,1/19/2024,LAL vs BRK,Nic Claxton,claxtni01,31,BRK,0,LAL,22,14,1,1,2,0,32.71666667,2,12,11,16,0,0,0,0,3,3,15,23,36,37,49.3
2023-24,202401190NOP,1/19/2024,NOP vs PHO,Zion Williamson,willizi01,35,NOP,1,PHO,24,3,1,0,1,2,32.73333333,1,2,11,17,1,1,1,3,2,1,4,25,27,28,30.1
2023-24,202401190LAL,1/19/2024,LAL vs BRK,Spencer Dinwiddie,dinwisp01,39,BRK,0,LAL,19,3,4,1,0,1,33.05,0,3,5,11,4,8,5,5,1,1,7,23,22,26,30.6
2023-24,202401190NOP,1/19/2024,NOP vs PHO,Brandon Ingram,ingrabr01,39,NOP,1,PHO,17,7,11,0,0,2,33.2,0,7,5,11,1,5,6,9,2,0,18,28,24,35,39.9
2023-24,202401190LAL,1/19/2024,LAL vs BRK,Austin Reaves,reaveau01,44,LAL,1,BRK,9,3,5,1,0,0,33.41666667,0,3,4,12,0,6,1,1,2,1,8,14,12,17,23.1
2023-24,202401190ORL,1/19/2024,ORL vs PHI,Tyrese Maxey,maxeyty01,39,PHI,0,ORL,32,3,5,3,1,2,33.5,2,1,10,20,4,10,8,9,1,4,8,37,35,40,53.1
2023-24,202401190MIA,1/19/2024,MIA vs ATL,Jalen Johnson,johnsja05,27,ATL,0,MIA,15,7,2,2,0,2,33.61666667,2,5,7,14,1,4,0,0,1,2,9,17,22,24,30.4
2023-24,202401190LAL,1/19/2024,LAL vs BRK,LeBron James,jamesle01,40,LAL,1,BRK,24,11,5,0,0,4,33.73333333,5,6,9,22,2,5,4,5,1,0,16,29,35,40,40.7
2023-24,202401190POR,1/19/2024,POR vs IND,Myles Turner,turnemy01,42,IND,0,POR,29,12,1,0,5,1,34.1,2,10,10,17,6,10,3,3,3,5,13,30,41,42,58.9
2023-24,202401190POR,1/19/2024,POR vs IND,Pascal Siakam,siakapa01,40,IND,0,POR,21,6,3,1,0,1,34.26666667,0,6,9,14,1,3,2,6,5,1,9,24,27,30,34.7
2023-24,202401190CHO,1/19/2024,CHO vs SAS,Terry Rozier,roziete01,28,CHO,1,SAS,17,6,8,1,0,3,34.4,1,5,7,18,1,7,2,2,0,1,14,25,23,31,36.2
2023-24,202401190CHO,1/19/2024,CHO vs SAS,Jeremy Sochan,sochaje01,41,SAS,0,CHO,11,8,8,1,1,3,34.46666667,2,6,5,10,1,2,0,1,2,2,16,19,19,27,35.6
2023-24,202401190MIA,1/19/2024,MIA vs ATL,Tyler Herro,herroty01,23,MIA,1,ATL,25,6,2,1,0,2,34.53333333,0,6,10,19,4,9,1,1,4,1,8,27,31,33,36.2
2023-24,202401190LAL,1/19/2024,LAL vs BRK,Mikal Bridges,bridgmi01,41,BRK,0,LAL,17,1,5,2,0,2,34.65,0,1,6,11,4,8,1,2,1,2,6,22,18,23,29.7
2023-24,202401190ORL,1/19/2024,ORL vs PHI,Tobias Harris,harrito02,39,PHI,0,ORL,12,6,3,3,1,0,34.75,2,4,3,11,1,3,5,5,3,4,9,15,18,21,35.7
2023-24,202401190POR,1/19/2024,POR vs IND,Tyrese Haliburton,halibty01,35,IND,0,POR,21,2,17,0,0,0,34.86666667,0,2,6,14,2,7,7,9,1,0,19,38,23,40,48.9
2023-24,202401190LAL,1/19/2024,LAL vs BRK,D'Angelo Russell,russeda01,40,LAL,1,BRK,20,1,7,1,0,2,34.88333333,0,1,7,14,3,5,3,3,4,1,8,27,21,28,32.7
2023-24,202401190MIA,1/19/2024,MIA vs ATL,Bogdan Bogdanovic,bogdabo01,39,ATL,0,MIA,17,3,1,0,0,3,34.91666667,0,3,6,15,3,7,2,2,2,0,4,18,20,21,19.1
2023-24,202401190NOP,1/19/2024,NOP vs PHO,Jusuf Nurkic,nurkiju01,39,PHO,0,NOP,5,15,9,1,0,3,34.91666667,1,14,2,5,0,0,1,2,3,1,24,14,20,29,36.5
2023-24,202401190CHO,1/19/2024,CHO vs SAS,Brandon Miller,millebr02,33,CHO,1,SAS,24,9,2,2,0,3,35.1,3,6,8,14,4,7,4,5,0,2,11,26,33,35,40.8
2023-24,202401190LAL,1/19/2024,LAL vs BRK,Anthony Davis,davisan02,42,LAL,1,BRK,26,12,6,3,2,1,35.23333333,4,8,9,13,0,1,8,11,1,5,18,32,38,44,63.4
2023-24,202401190NOP,1/19/2024,NOP vs PHO,Kevin Durant,duranke01,34,PHO,0,NOP,26,5,2,2,2,1,35.46666667,1,4,11,19,3,8,1,1,1,4,7,28,31,33,46
2023-24,202401190BOS,1/19/2024,BOS vs DEN,Derrick White,whitede01,38,BOS,1,DEN,24,3,5,2,1,1,35.65,1,2,9,18,5,12,1,1,3,3,8,29,27,32,43.1
2023-24,202401190BOS,1/19/2024,BOS vs DEN,Jaylen Brown,brownja02,39,BOS,1,DEN,13,2,1,2,0,0,35.73333333,0,2,6,19,1,9,0,2,3,2,3,14,15,16,22.9
2023-24,202401190CHO,1/19/2024,CHO vs SAS,Devin Vassell,vassede01,36,SAS,0,CHO,17,5,7,2,0,2,35.85,0,5,6,13,4,8,1,2,1,2,12,24,22,29,37.5
2023-24,202401190MIA,1/19/2024,MIA vs ATL,Saddiq Bey,beysa01,41,ATL,0,MIA,14,2,0,0,0,1,36,1,1,4,12,0,5,6,7,2,0,2,14,16,16,15.4
2023-24,202401190MIA,1/19/2024,MIA vs ATL,Jimmy Butler,butleji01,27,MIA,1,ATL,25,5,6,2,0,4,36.05,4,1,8,10,0,0,9,10,2,2,11,31,30,36,42
2023-24,202401190BOS,1/19/2024,BOS vs DEN,Kristaps Porzingis,porzikr01,31,BOS,1,DEN,21,8,2,0,1,0,36.21666667,4,4,6,11,3,5,6,8,4,1,10,23,29,31,36.6
2023-24,202401190POR,1/19/2024,POR vs IND,Buddy Hield,hieldbu01,43,IND,0,POR,18,6,7,1,1,1,36.43333333,1,5,6,13,6,11,0,0,4,2,13,25,24,31,40.7
2023-24,202401190BOS,1/19/2024,BOS vs DEN,Kentavious Caldwell-Pope,caldwke01,41,DEN,0,BOS,5,5,1,0,0,0,36.78333333,1,4,2,6,1,3,0,0,1,0,6,6,10,11,12.5
2023-24,202401190BOS,1/19/2024,BOS vs DEN,Jamal Murray,murraja01,29,DEN,0,BOS,35,8,5,0,0,1,36.98333333,0,8,15,21,3,7,2,3,3,0,13,40,43,48,51.1
2023-24,202401190NOP,1/19/2024,NOP vs PHO,Devin Booker,bookede01,32,PHO,0,NOP,52,4,5,0,0,1,37.08333333,1,3,18,30,6,11,10,10,0,0,9,57,56,61,63.3
2023-24,202401190POR,1/19/2024,POR vs IND,Malcolm Brogdon,brogdma01,32,POR,1,IND,30,7,6,1,1,1,37.28333333,1,6,9,18,2,4,10,10,3,2,13,36,37,43,52.4
2023-24,202401190BOS,1/19/2024,BOS vs DEN,Michael Porter Jr.,portemi01,43,DEN,0,BOS,13,8,0,0,0,1,37.45,4,4,5,9,1,4,2,3,3,0,8,13,21,21,21.6
2023-24,202401190BOS,1/19/2024,BOS vs DEN,Nikola Jokic,jokicni01,42,DEN,0,BOS,34,12,9,0,0,4,38.26666667,2,10,14,22,2,4,4,4,1,0,21,43,46,55,57.9
2023-24,202401190CHO,1/19/2024,CHO vs SAS,Miles Bridges,bridgmi02,28,CHO,1,SAS,23,6,3,0,1,2,38.71666667,0,6,10,15,2,2,1,1,3,1,9,26,29,32,35.7
2023-24,202401190MIA,1/19/2024,MIA vs ATL,Bam Adebayo,adebaba01,32,MIA,1,ATL,21,9,6,1,0,3,38.88333333,2,7,7,15,0,0,7,8,4,1,15,27,30,36,40.8
2023-24,202401190BOS,1/19/2024,BOS vs DEN,Jayson Tatum,tatumja01,39,BOS,1,DEN,22,8,5,1,0,0,38.91666667,2,6,9,24,1,8,3,3,1,1,13,27,30,35,42.1
2023-24,202401190MIA,1/19/2024,MIA vs ATL,Dejounte Murray,murrade01,41,ATL,0,MIA,22,3,11,2,0,2,39.76666667,0,3,9,22,3,7,1,1,2,2,14,33,25,36,46.1
2023-24,202401190POR,1/19/2024,POR vs IND,Jabari Walker,walkeja01,37,POR,1,IND,13,12,3,0,1,0,41.11666667,2,10,4,11,0,2,5,6,3,1,15,16,25,28,34.9
2023-24,202401190BOS,1/19/2024,BOS vs DEN,Aaron Gordon,gordoaa01,37,DEN,0,BOS,2,10,3,0,1,1,41.56666667,2,8,0,6,0,3,2,3,3,1,13,5,12,15,20.5
2023-24,202401190POR,1/19/2024,POR vs IND,Jerami Grant,grantje01,36,POR,1,IND,37,4,3,1,2,1,42.61666667,1,3,14,28,1,4,8,11,2,3,7,40,41,44,54.3
2023-24,202401180MIN,1/18/2024,MIN vs MEM,GG Jackson II,jacksgg01,9,MEM,0,MIN,1,3,0,0,0,1,10.38333333,2,1,0,3,0,2,1,2,2,0,3,1,4,4,3.6
2023-24,202401180UTA,1/18/2024,UTA vs OKC,Jaylin Williams,willija07,33,OKC,0,UTA,0,2,0,2,1,1,10.7,1,1,0,1,0,1,0,0,2,3,2,0,2,2,10.4
2023-24,202401180SAC,1/18/2024,SAC vs IND,Sasha Vezenkov,vezenal01,32,SAC,1,IND,7,3,0,1,1,0,10.76666667,2,1,2,3,2,3,1,2,1,2,3,7,10,10,16.6
2023-24,202401180NYK,1/18/2024,NYK vs WAS,Delon Wright,wrighde01,19,WAS,0,NYK,5,2,1,1,0,0,11.16666667,0,2,1,5,1,1,2,2,1,1,3,6,7,8,11.9
2023-24,202401180UTA,1/18/2024,UTA vs OKC,Isaiah Joe,joeis01,41,OKC,0,UTA,6,2,1,0,0,0,11.75,1,1,2,4,2,4,0,0,1,0,3,7,8,9,9.9
2023-24,202401180TOR,1/18/2024,TOR vs CHI,Dalen Terry,terryda01,27,CHI,0,TOR,0,3,0,0,0,2,11.98333333,1,2,0,0,0,0,0,0,3,0,3,0,3,3,1.6
2023-24,202401180MIN,1/18/2024,MIN vs MEM,Ziaire Williams,willizi02,39,MEM,0,MIN,2,1,2,2,0,2,12.06666667,0,1,1,5,0,2,0,0,1,2,3,4,3,5,10.2
2023-24,202401180UTA,1/18/2024,UTA vs OKC,Kris Dunn,dunnkr01,35,UTA,1,OKC,0,1,6,0,0,1,13.05,0,1,0,2,0,0,0,0,4,0,7,6,1,7,9.2
2023-24,202401180MIN,1/18/2024,MIN vs MEM,Jacob Gilyard,gilyaja01,24,MEM,0,MIN,0,1,3,0,0,0,13.38333333,0,1,0,3,0,2,0,0,0,0,4,3,1,4,5.7
2023-24,202401180UTA,1/18/2024,UTA vs OKC,Keyonte George,georgke01,37,UTA,1,OKC,3,1,2,0,0,2,13.91666667,0,1,1,5,1,2,0,0,0,0,3,5,4,6,5.2
2023-24,202401180NYK,1/18/2024,NYK vs WAS,Landry Shamet,shamela01,24,WAS,0,NYK,13,1,1,0,0,2,14,1,0,5,6,3,4,0,0,5,0,2,14,14,15,13.7
2023-24,202401180UTA,1/18/2024,UTA vs OKC,Ochai Agbaji,agbajoc01,43,UTA,1,OKC,4,1,1,2,0,2,14.3,0,1,1,1,0,0,2,3,1,2,2,5,5,6,10.7
2023-24,202401180TOR,1/18/2024,TOR vs CHI,Thaddeus Young,youngth01,14,TOR,1,CHI,6,2,2,0,0,0,14.63333333,1,1,3,4,0,0,0,0,2,0,4,8,8,10,11.4
2023-24,202401180MIN,1/18/2024,MIN vs MEM,Kyle Anderson,anderky01,41,MIN,1,MEM,4,3,3,1,0,1,15.05,0,3,1,3,0,0,2,2,3,1,6,7,7,10,14.1
2023-24,202401180NYK,1/18/2024,NYK vs WAS,Bilal Coulibaly,coulibi01,39,WAS,0,NYK,5,3,2,0,0,0,16.98333333,0,3,1,4,1,3,2,2,3,0,5,7,8,10,11.6
2023-24,202401180UTA,1/18/2024,UTA vs OKC,Kenrich Williams,willike04,30,OKC,0,UTA,9,4,2,1,0,1,17,1,3,4,7,1,3,0,0,2,1,6,11,13,15,18.8
2023-24,202401180NYK,1/18/2024,NYK vs WAS,Corey Kispert,kispeco01,39,WAS,0,NYK,10,4,0,0,0,0,17.06666667,0,4,4,5,2,3,0,0,0,0,4,10,14,14,14.8
2023-24,202401180UTA,1/18/2024,UTA vs OKC,Kelly Olynyk,olynyke01,41,UTA,1,OKC,7,2,4,1,0,1,17.1,0,2,3,7,0,2,1,1,3,1,6,11,9,13,17.4
2023-24,202401180TOR,1/18/2024,TOR vs CHI,Chris Boucher,bouchch01,39,TOR,1,CHI,6,9,2,0,0,2,17.63333333,2,7,2,4,1,3,1,2,1,0,11,8,15,17,17.8
2023-24,202401180NYK,1/18/2024,NYK vs WAS,Quentin Grimes,grimequ01,39,NYK,1,WAS,0,1,2,0,0,0,19.23333333,0,1,0,5,0,5,0,0,1,0,3,2,1,3,4.2
2023-24,202401180SAC,1/18/2024,SAC vs IND,Trey Lyles,lylestr01,27,SAC,1,IND,0,3,2,1,0,0,19.28333333,1,2,0,2,0,2,0,0,0,1,5,2,3,5,9.6
2023-24,202401180SAC,1/18/2024,SAC vs IND,Jarace Walker,walkeja02,15,IND,0,SAC,15,2,2,0,0,2,19.55,1,1,6,13,3,8,0,0,1,0,4,17,17,19,18.4
2023-24,202401180TOR,1/18/2024,TOR vs CHI,Jontay Porter,portejo01,9,TOR,1,CHI,10,4,4,1,2,1,19.86666667,1,3,3,6,2,5,2,2,2,3,8,14,14,18,28.8
2023-24,202401180SAC,1/18/2024,SAC vs IND,Harrison Barnes,barneha02,41,SAC,1,IND,2,1,1,0,0,1,22.31666667,0,1,1,2,0,1,0,0,1,0,2,3,3,4,3.7
2023-24,202401180UTA,1/18/2024,UTA vs OKC,Aaron Wiggins,wiggiaa01,38,OKC,0,UTA,4,2,5,0,1,0,22.43333333,0,2,1,3,0,1,2,2,3,1,7,9,6,11,16.9
2023-24,202401180MIN,1/18/2024,MIN vs MEM,David Roddy,roddyda01,38,MEM,0,MIN,8,4,1,0,0,0,23.3,1,3,2,7,1,2,3,4,2,0,5,9,12,13,14.3
2023-24,202401180TOR,1/18/2024,TOR vs CHI,Patrick Williams,willipa01,40,CHI,0,TOR,12,0,1,0,0,0,23.43333333,0,0,5,9,2,3,0,0,3,0,1,13,12,13,13.5
2023-24,202401180UTA,1/18/2024,UTA vs OKC,John Collins,collijo01,39,UTA,1,OKC,21,4,1,0,1,2,23.61666667,0,4,7,11,1,5,6,6,5,1,5,22,25,26,28.3
2023-24,202401180MIN,1/18/2024,MIN vs MEM,Naz Reid,reidna01,41,MIN,1,MEM,20,3,1,2,1,0,23.78333333,0,3,8,13,4,5,0,0,2,3,4,21,23,24,34.1
2023-24,202401180UTA,1/18/2024,UTA vs OKC,Walker Kessler,kesslwa01,35,UTA,1,OKC,7,11,1,1,3,1,24.16666667,5,6,3,4,0,0,1,2,1,4,12,8,18,19,32.7
2023-24,202401180TOR,1/18/2024,TOR vs CHI,Zach LaVine,lavinza01,25,CHI,0,TOR,8,2,3,0,0,2,24.2,0,2,3,7,1,3,1,1,4,0,5,11,10,13,12.9
2023-24,202401180SAC,1/18/2024,SAC vs IND,Obi Toppin,toppiob01,42,IND,0,SAC,10,3,4,0,1,0,24.38333333,0,3,4,6,2,4,0,0,1,1,7,14,13,17,22.6
2023-24,202401180MIN,1/18/2024,MIN vs MEM,Nickeil Alexander-Walker,alexani01,41,MIN,1,MEM,7,2,5,0,0,2,24.5,0,2,3,5,1,3,0,0,0,0,7,12,9,14,14.9
2023-24,202401180SAC,1/18/2024,SAC vs IND,Jalen Smith,smithja04,28,IND,0,SAC,17,13,1,0,1,0,24.76666667,1,12,6,7,1,2,4,4,3,1,14,18,30,31,37.1
2023-24,202401180MIN,1/18/2024,MIN vs MEM,Santi Aldama,aldamsa01,31,MEM,0,MIN,13,5,0,1,1,2,24.86666667,0,5,5,14,2,5,1,3,4,2,5,13,18,18,23
2023-24,202401180TOR,1/18/2024,TOR vs CHI,Bruce Brown,brownbr01,35,TOR,1,CHI,15,7,1,1,0,0,24.91666667,2,5,7,10,1,3,0,0,4,1,8,16,22,23,27.9
2023-24,202401180TOR,1/18/2024,TOR vs CHI,Dennis Schroder,schrode01,42,TOR,1,CHI,7,0,5,0,0,0,26.06666667,0,0,3,7,1,4,0,0,1,0,5,12,7,12,14.5
2023-24,202401180SAC,1/18/2024,SAC vs IND,Malik Monk,monkma01,40,SAC,1,IND,9,3,4,1,2,1,26.18333333,1,2,3,9,2,6,1,6,3,3,7,13,12,16,26.6
2023-24,202401180NYK,1/18/2024,NYK vs WAS,Deni Avdija,avdijde01,40,WAS,0,NYK,15,8,1,0,0,2,26.21666667,2,6,5,13,0,3,5,5,6,0,9,16,23,24,24.1
2023-24,202401180MIN,1/18/2024,MIN vs MEM,John Konchar,konchjo01,32,MEM,0,MIN,5,3,2,1,0,1,26.85,0,3,2,2,1,1,0,0,4,1,5,7,8,10,13.6
2023-24,202401180MIN,1/18/2024,MIN vs MEM,Jaren Jackson Jr.,jacksja02,39,MEM,0,MIN,36,3,1,0,1,3,27.15,1,2,15,23,3,6,3,5,5,1,4,37,39,40,41.1
2023-24,202401180TOR,1/18/2024,TOR vs CHI,Alex Caruso,carusal01,36,CHI,0,TOR,10,3,4,2,2,1,27.56666667,0,3,4,6,2,4,0,0,4,4,7,14,13,17,30.6
2023-24,202401180SAC,1/18/2024,SAC vs IND,Ben Sheppard,sheppbe01,20,IND,0,SAC,7,4,2,2,0,0,28.28333333,0,4,2,5,2,3,1,2,4,2,6,9,11,13,20.8
2023-24,202401180UTA,1/18/2024,UTA vs OKC,Simone Fontecchio,fontesi01,41,UTA,1,OKC,12,5,2,1,0,1,28.98333333,2,3,4,9,2,7,2,2,2,1,7,14,17,19,23
2023-24,202401180MIN,1/18/2024,MIN vs MEM,Karl-Anthony Towns,townska01,40,MIN,1,MEM,14,7,2,0,1,1,29.36666667,0,7,5,12,2,5,2,3,2,1,9,16,21,23,27.4
2023-24,202401180TOR,1/18/2024,TOR vs CHI,Gary Trent Jr.,trentga02,37,TOR,1,CHI,6,2,2,0,0,2,29.65,0,2,3,8,0,4,0,0,3,0,4,8,8,10,9.4
2023-24,202401180MIN,1/18/2024,MIN vs MEM,Mike Conley,conlemi01,40,MIN,1,MEM,17,4,10,2,0,0,29.73333333,2,2,7,11,3,6,0,0,1,2,14,27,21,31,42.8
2023-24,202401180UTA,1/18/2024,UTA vs OKC,Josh Giddey,giddejo01,40,OKC,0,UTA,20,10,6,1,0,2,30.26666667,1,9,8,16,1,5,3,3,3,1,16,26,30,36,42
2023-24,202401180MIN,1/18/2024,MIN vs MEM,Luke Kennard,kennalu01,18,MEM,0,MIN,18,2,2,1,0,1,31.4,0,2,6,9,5,7,1,1,1,1,4,20,20,22,25.4
2023-24,202401180UTA,1/18/2024,UTA vs OKC,Chet Holmgren,holmgch01,41,OKC,0,UTA,15,5,5,0,4,3,31.91666667,0,5,6,16,2,6,1,2,3,4,10,20,20,25,37.5
2023-24,202401180SAC,1/18/2024,SAC vs IND,Myles Turner,turnemy01,41,IND,0,SAC,18,2,1,0,1,1,32,0,2,6,12,1,4,5,7,4,1,3,19,20,21,23.9
2023-24,202401180TOR,1/18/2024,TOR vs CHI,Ayo Dosunmu,dosunay01,41,CHI,0,TOR,10,1,5,0,1,0,32.03333333,0,1,4,9,0,1,2,2,2,1,6,15,11,16,21.7
2023-24,202401180UTA,1/18/2024,UTA vs OKC,Cason Wallace,wallaca01,41,OKC,0,UTA,16,4,1,1,1,1,32.48333333,2,2,6,7,4,5,0,0,3,2,5,17,20,21,27.3
2023-24,202401180SAC,1/18/2024,SAC vs IND,T.J. McConnell,mccontj01,34,IND,0,SAC,20,1,10,1,0,4,32.56666667,0,1,9,14,0,0,2,3,2,1,11,30,21,31,35.2
2023-24,202401180NYK,1/18/2024,NYK vs WAS,Jordan Poole,poolejo01,39,WAS,0,NYK,24,4,2,1,0,0,34.03333333,0,4,7,19,2,9,8,8,1,1,6,26,28,30,34.8
2023-24,202401180UTA,1/18/2024,UTA vs OKC,Collin Sexton,sextoco01,43,UTA,1,OKC,31,1,7,1,0,2,34.08333333,1,0,10,19,4,7,7,10,4,1,8,38,32,39,43.7
2023-24,202401180MIN,1/18/2024,MIN vs MEM,Anthony Edwards,edwaran01,38,MIN,1,MEM,28,5,5,1,0,3,34.45,0,5,11,19,1,6,5,6,2,1,10,33,33,38,41.5
2023-24,202401180MIN,1/18/2024,MIN vs MEM,Vince Williams Jr.,willivi01,31,MEM,0,MIN,10,7,5,3,1,2,34.61666667,2,5,3,8,2,5,2,2,3,4,12,15,17,22,35.9
2023-24,202401180UTA,1/18/2024,UTA vs OKC,Shai Gilgeous-Alexander,gilgesh01,40,OKC,0,UTA,31,6,6,1,1,4,34.68333333,1,5,8,15,0,1,15,17,4,2,12,37,37,43,49.2
2023-24,202401180TOR,1/18/2024,TOR vs CHI,RJ Barrett,barrerj01,36,TOR,1,CHI,17,4,6,1,0,1,34.81666667,0,4,6,16,1,6,4,5,2,1,10,23,21,27,32.8
2023-24,202401180TOR,1/18/2024,TOR vs CHI,Nikola Vucevic,vucevni01,38,CHI,0,TOR,24,14,7,2,1,0,34.86666667,5,9,12,20,0,3,0,0,1,3,21,31,38,45,60.3
2023-24,202401180TOR,1/18/2024,TOR vs CHI,Immanuel Quickley,quickim01,40,TOR,1,CHI,12,3,3,1,0,2,34.93333333,0,3,4,10,2,7,2,2,2,1,6,15,15,18,21.1
2023-24,202401180UTA,1/18/2024,UTA vs OKC,Jordan Clarkson,clarkjo01,33,UTA,1,OKC,18,2,5,0,0,1,34.95,2,0,7,18,3,5,1,1,1,0,7,23,20,25,26.9
2023-24,202401180TOR,1/18/2024,TOR vs CHI,Coby White,whiteco01,43,CHI,0,TOR,23,8,4,2,0,2,35.2,2,6,10,19,1,6,2,3,2,2,12,27,31,35,42.6
2023-24,202401180MIN,1/18/2024,MIN vs MEM,Jaden McDaniels,mcdanja02,31,MIN,1,MEM,11,3,0,1,1,2,35.6,1,2,5,9,1,2,0,0,0,2,3,11,14,14,18.6
2023-24,202401180UTA,1/18/2024,UTA vs OKC,Lauri Markkanen,markkla01,33,UTA,1,OKC,26,10,4,1,0,1,35.81666667,1,9,7,13,2,4,10,11,0,1,14,30,36,40,46
2023-24,202401180MIN,1/18/2024,MIN vs MEM,Xavier Tillman Sr.,tillmxa01,29,MEM,0,MIN,10,5,6,1,1,2,35.93333333,2,3,5,11,0,2,0,0,1,2,11,16,15,21,29
2023-24,202401180SAC,1/18/2024,SAC vs IND,Buddy Hield,hieldbu01,42,IND,0,SAC,12,5,8,1,1,1,36.25,0,5,4,9,2,6,2,2,2,2,13,20,17,25,35
2023-24,202401180UTA,1/18/2024,UTA vs OKC,Jalen Williams,willija06,38,OKC,0,UTA,27,3,8,2,2,2,36.6,0,3,11,14,4,5,1,2,6,4,11,35,30,38,52.6
2023-24,202401180NYK,1/18/2024,NYK vs WAS,Tyus Jones,jonesty01,40,WAS,0,NYK,2,4,15,3,0,1,36.81666667,0,4,1,6,0,3,0,0,2,3,19,17,6,21,37.3
2023-24,202401180SAC,1/18/2024,SAC vs IND,Bennedict Mathurin,mathube01,42,IND,0,SAC,25,3,4,1,2,3,37.16666667,1,2,11,21,2,6,1,1,2,3,7,29,28,32,40.6
2023-24,202401180TOR,1/18/2024,TOR vs CHI,Scottie Barnes,barnesc01,42,TOR,1,CHI,31,7,6,3,3,6,37.43333333,1,6,11,18,2,6,7,9,1,6,13,37,38,44,60.4
2023-24,202401180NYK,1/18/2024,NYK vs WAS,Donte DiVincenzo,divindo01,42,NYK,1,WAS,19,3,3,0,1,3,37.58333333,0,3,6,15,5,12,2,2,4,1,6,22,22,25,27.1
2023-24,202401180TOR,1/18/2024,TOR vs CHI,DeMar DeRozan,derozde01,41,CHI,0,TOR,24,7,6,1,0,2,38.05,1,6,9,20,0,4,6,7,2,1,13,30,31,37,42.4
2023-24,202401180SAC,1/18/2024,SAC vs IND,Domantas Sabonis,sabondo01,41,SAC,1,IND,21,11,10,0,1,3,38.05,0,11,8,13,0,1,5,8,5,1,21,31,32,42,49.2
2023-24,202401180SAC,1/18/2024,SAC vs IND,Keegan Murray,murrake02,37,SAC,1,IND,27,9,0,2,1,1,38.11666667,3,6,11,18,1,5,4,5,3,3,9,27,36,36,45.8
2023-24,202401180NYK,1/18/2024,NYK vs WAS,Kyle Kuzma,kuzmaky01,40,WAS,0,NYK,15,6,5,2,1,3,38.48333333,0,6,7,16,1,5,0,0,2,3,11,20,21,26,35.7
2023-24,202401180NYK,1/18/2024,NYK vs WAS,Isaiah Hartenstein,harteis01,42,NYK,1,WAS,6,17,3,2,1,2,38.51666667,5,12,3,5,0,0,0,0,2,3,20,9,23,26,37.9
2023-24,202401180SAC,1/18/2024,SAC vs IND,Kevin Huerter,huertke01,39,SAC,1,IND,31,2,4,1,1,2,38.68333333,0,2,11,17,7,12,2,2,4,2,6,35,33,37,43.4
2023-24,202401180MIN,1/18/2024,MIN vs MEM,Rudy Gobert,goberru01,40,MIN,1,MEM,17,10,4,0,6,3,38.88333333,3,7,5,10,0,1,7,10,3,6,14,21,27,31,50
2023-24,202401180NYK,1/18/2024,NYK vs WAS,Julius Randle,randlju01,42,NYK,1,WAS,21,8,5,0,0,5,38.95,1,7,8,17,3,8,2,4,2,0,13,26,29,34,33.1
2023-24,202401180NYK,1/18/2024,NYK vs WAS,Marvin Bagley III,baglema01,27,WAS,0,NYK,20,11,2,2,3,3,39.11666667,6,5,10,16,0,0,0,5,3,5,13,22,31,33,48.2
2023-24,202401180SAC,1/18/2024,SAC vs IND,De'Aaron Fox,foxde01,35,SAC,1,IND,24,6,6,1,0,1,39.56666667,1,5,8,20,3,7,5,9,2,1,12,30,30,36,42.2
2023-24,202401180NYK,1/18/2024,NYK vs WAS,Jalen Brunson,brunsja01,40,NYK,1,WAS,41,8,8,2,1,6,40.35,1,7,14,27,2,4,11,13,2,3,16,49,49,57,65.6
2023-24,202401180NYK,1/18/2024,NYK vs WAS,OG Anunoby,anunoog01,37,NYK,1,WAS,19,7,1,0,2,1,42.63333333,0,7,6,9,3,5,4,4,3,2,8,20,26,27,33.9
2023-24,202401170CLE,1/17/2024,CLE vs MIL,Damian Jones,jonesda03,16,CLE,1,MIL,0,1,0,0,0,0,10.08333333,0,1,0,3,0,1,0,0,1,0,1,0,1,1,1.2
2023-24,202401170NYK,1/17/2024,NYK vs HOU,Amen Thompson,thompam01,21,HOU,0,NYK,4,1,1,1,2,0,10.15,0,1,2,3,0,0,0,0,2,3,2,5,5,6,15.7
2023-24,202401170NOP,1/17/2024,NOP vs CHO,Ish Smith,smithis01,32,CHO,0,NOP,2,1,2,0,1,0,10.83333333,0,1,1,1,0,0,0,0,0,1,3,4,3,5,9.2
2023-24,202401170NYK,1/17/2024,NYK vs HOU,Miles McBride,mcbrimi01,28,NYK,1,HOU,0,1,1,0,0,1,11.11666667,0,1,0,4,0,3,0,0,1,0,2,1,1,2,1.7
2023-24,202401170TOR,1/17/2024,TOR vs MIA,Haywood Highsmith,highsha01,27,MIA,0,TOR,2,3,0,0,1,0,11.53333333,2,1,1,2,0,1,0,0,0,1,3,2,5,5,8.6
2023-24,202401170TOR,1/17/2024,TOR vs MIA,Gradey Dick,dickgr01,21,TOR,1,MIA,6,0,4,2,0,2,11.55,0,0,2,2,2,2,0,0,2,2,4,10,6,10,16
2023-24,202401170BOS,1/17/2024,BOS vs SAS,Doug McDermott,mcderdo01,35,SAS,0,BOS,2,0,1,0,0,0,11.76666667,0,0,1,4,0,2,0,0,1,0,1,3,2,3,3.5
2023-24,202401170BOS,1/17/2024,BOS vs SAS,Cedi Osman,osmande01,40,SAS,0,BOS,2,5,1,0,0,0,11.98333333,2,3,1,2,0,0,0,0,2,0,6,3,7,8,9.5
2023-24,202401170BOS,1/17/2024,BOS vs SAS,Neemias Queta,quetane01,15,BOS,1,SAS,6,8,0,0,2,0,12.08333333,4,4,2,4,0,0,2,2,5,2,8,6,14,14,21.6
2023-24,202401170DET,1/17/2024,DET vs MIN,Marcus Sasser,sassema01,37,DET,1,MIN,5,1,2,0,0,4,12.48333333,0,1,2,4,1,2,0,0,2,0,3,7,6,8,5.2
2023-24,202401170BOS,1/17/2024,BOS vs SAS,Oshae Brissett,brissos01,25,BOS,1,SAS,7,4,1,0,0,1,12.96666667,1,3,2,5,0,1,3,4,0,0,5,8,11,12,12.3
2023-24,202401170POR,1/17/2024,POR vs BRK,Ibou Badji,badjiib01,11,POR,1,BRK,2,2,0,0,2,0,13.11666667,1,1,1,1,0,0,0,0,0,2,2,2,4,4,10.4
2023-24,202401170CLE,1/17/2024,CLE vs MIL,A.J. Green,greenaj01,26,MIL,0,CLE,3,2,1,0,0,0,13.28333333,1,1,1,5,1,4,0,0,2,0,3,4,5,6,6.9
2023-24,202401170CLE,1/17/2024,CLE vs MIL,Cameron Payne,payneca01,39,MIL,0,CLE,13,0,1,1,0,0,13.33333333,0,0,5,9,2,5,1,1,0,1,1,14,13,14,17.5
2023-24,202401170NOP,1/17/2024,NOP vs CHO,Dyson Daniels,daniedy01,42,NOP,1,CHO,0,2,1,0,0,2,13.38333333,2,0,0,2,0,1,0,0,1,0,3,1,2,3,1.9
2023-24,202401170NOP,1/17/2024,NOP vs CHO,Nathan Mensah,mensana01,14,CHO,0,NOP,4,2,0,0,1,1,13.45,1,1,1,2,0,0,2,2,4,1,2,4,6,6,8.4
2023-24,202401170ATL,1/17/2024,ATL vs ORL,Garrison Mathews,mathega01,26,ATL,1,ORL,6,4,0,1,0,2,13.46666667,2,2,2,3,2,3,0,0,1,1,4,6,10,10,11.8
2023-24,202401170NYK,1/17/2024,NYK vs HOU,Jae'Sean Tate,tateja01,38,HOU,0,NYK,2,2,2,0,0,0,13.85,0,2,1,2,0,1,0,0,0,0,4,4,4,6,7.4
2023-24,202401170ATL,1/17/2024,ATL vs ORL,Caleb Houstan,houstca01,32,ORL,0,ATL,3,1,0,1,0,0,13.9,1,0,1,7,1,7,0,1,3,1,1,3,4,4,7.2
2023-24,202401170LAL,1/17/2024,LAL vs DAL,Max Christie,chrisma02,33,LAL,1,DAL,5,2,0,0,0,0,13.96666667,0,2,2,2,1,1,0,0,0,0,2,5,7,7,7.4
2023-24,202401170CLE,1/17/2024,CLE vs MIL,Pat Connaughton,connapa01,35,MIL,0,CLE,8,1,1,0,1,0,13.96666667,0,1,3,4,2,3,0,0,0,1,2,9,9,10,13.7
2023-24,202401170POR,1/17/2024,POR vs BRK,Dennis Smith Jr.,smithde03,25,BRK,0,POR,2,3,2,2,0,1,14,2,1,1,4,0,1,0,0,1,2,5,4,5,7,13.6
2023-24,202401170DET,1/17/2024,DET vs MIN,Mike Muscala,muscami01,25,DET,1,MIN,0,3,2,0,2,0,14.56666667,1,2,0,4,0,3,0,0,0,2,5,2,3,5,12.6
2023-24,202401170BOS,1/17/2024,BOS vs SAS,Malaki Branham,branhma01,39,SAS,0,BOS,8,1,1,0,0,0,16.45,0,1,4,9,0,3,0,0,0,0,2,9,9,10,10.7
2023-24,202401170LAL,1/17/2024,LAL vs DAL,Christian Wood,woodch01,36,LAL,1,DAL,2,2,1,1,0,1,16.56666667,0,2,1,5,0,3,0,0,0,1,3,3,4,5,7.9
2023-24,202401170NYK,1/17/2024,NYK vs HOU,Quentin Grimes,grimequ01,38,NYK,1,HOU,11,3,1,0,0,0,16.71666667,2,1,2,8,2,6,5,5,1,0,4,12,14,15,16.1
2023-24,202401170NOP,1/17/2024,NOP vs CHO,Naji Marshall,marshna01,33,NOP,1,CHO,8,2,1,1,0,0,17,1,1,3,5,0,1,2,2,0,1,3,9,10,11,14.9
2023-24,202401170NOP,1/17/2024,NOP vs CHO,Nick Smith Jr.,smithni01,23,CHO,0,NOP,3,3,3,0,0,1,17.36666667,2,1,1,5,1,2,0,0,1,0,6,6,6,9,10.1
2023-24,202401170BOS,1/17/2024,BOS vs SAS,Julian Champagnie,champju02,33,SAS,0,BOS,9,5,0,0,0,1,17.51666667,1,4,4,8,1,2,0,0,1,0,5,9,14,14,14
2023-24,202401170TOR,1/17/2024,TOR vs MIA,Chris Boucher,bouchch01,38,TOR,1,MIA,2,7,0,0,1,0,17.58333333,2,5,1,3,0,1,0,0,0,1,7,2,9,9,13.4
2023-24,202401170TOR,1/17/2024,TOR vs MIA,Jontay Porter,portejo01,8,TOR,1,MIA,6,4,2,0,2,0,18.16666667,2,2,2,7,2,4,0,0,3,2,6,8,10,12,19.8
2023-24,202401170NOP,1/17/2024,NOP vs CHO,Larry Nance Jr.,nancela02,25,NOP,1,CHO,7,6,2,0,1,0,18.5,2,4,3,3,1,1,0,0,1,1,8,9,13,15,20.2
2023-24,202401170POR,1/17/2024,POR vs BRK,Lonnie Walker IV,walkelo01,22,BRK,0,POR,13,1,0,1,0,1,18.81666667,0,1,5,10,3,7,0,0,0,1,1,13,14,14,16.2
2023-24,202401170CLE,1/17/2024,CLE vs MIL,Jae Crowder,crowdja01,10,MIL,0,CLE,15,1,0,1,0,0,19,0,1,5,13,4,10,1,2,1,1,1,15,16,16,19.2
2023-24,202401170NYK,1/17/2024,NYK vs HOU,Donte DiVincenzo,divindo01,41,NYK,1,HOU,5,2,5,0,0,2,19.03333333,0,2,2,7,1,4,0,0,1,0,7,10,7,12,12.9
2023-24,202401170CLE,1/17/2024,CLE vs MIL,Tristan Thompson,thomptr01,34,CLE,1,MIL,6,9,3,0,0,2,19.51666667,2,7,3,4,0,0,0,0,0,0,12,9,15,18,19.3
2023-24,202401170CLE,1/17/2024,CLE vs MIL,Khris Middleton,middlkh01,35,MIL,0,CLE,2,2,2,0,1,3,19.86666667,0,2,1,10,0,3,0,0,3,1,4,4,4,6,7.4
2023-24,202401170CLE,1/17/2024,CLE vs MIL,Craig Porter Jr.,portecr01,26,CLE,1,MIL,9,2,2,0,0,1,19.96666667,0,2,4,7,0,0,1,2,0,0,4,11,11,13,13.4
2023-24,202401170BOS,1/17/2024,BOS vs SAS,Sam Hauser,hausesa01,40,BOS,1,SAS,7,4,2,0,0,2,20.03333333,0,4,3,6,1,4,0,0,0,0,6,9,11,13,12.8
2023-24,202401170LAL,1/17/2024,LAL vs DAL,Jaden Hardy,hardyja02,37,DAL,0,LAL,7,0,0,0,0,1,20.15,0,0,3,7,1,5,0,0,0,0,0,7,7,7,6
2023-24,202401170ATL,1/17/2024,ATL vs ORL,Joe Ingles,inglejo01,27,ORL,0,ATL,3,4,3,1,0,3,20.23333333,0,4,1,5,1,5,0,0,4,1,7,6,7,10,12.3
2023-24,202401170POR,1/17/2024,POR vs BRK,Royce O'Neale,onealro01,39,BRK,0,POR,2,3,3,0,0,2,20.43333333,0,3,1,4,0,3,0,0,1,0,6,5,5,8,8.1
2023-24,202401170POR,1/17/2024,POR vs BRK,Toumani Camara,camarto01,39,POR,1,BRK,6,6,1,0,0,0,20.45,2,4,3,4,0,0,0,0,2,0,7,7,12,13,14.7
2023-24,202401170DET,1/17/2024,DET vs MIN,Alec Burks,burksal01,34,DET,1,MIN,12,1,1,2,0,0,20.46666667,1,0,3,10,1,4,5,5,1,2,2,13,13,14,20.7
2023-24,202401170LAL,1/17/2024,LAL vs DAL,Taurean Prince,princta02,41,LAL,1,DAL,9,1,1,0,0,0,20.5,0,1,3,8,0,3,3,5,4,0,2,10,10,11,11.7
2023-24,202401170POR,1/17/2024,POR vs BRK,Matisse Thybulle,thybuma01,38,POR,1,BRK,3,0,3,0,0,0,20.61666667,0,0,1,4,1,3,0,0,3,0,3,6,3,6,7.5
2023-24,202401170CLE,1/17/2024,CLE vs MIL,Dean Wade,wadede01,32,CLE,1,MIL,5,3,0,1,0,2,20.76666667,0,3,2,5,1,4,0,1,0,1,3,5,8,8,9.6
2023-24,202401170DET,1/17/2024,DET vs MIN,Kevin Knox,knoxke01,23,DET,1,MIN,5,1,2,0,0,1,20.81666667,0,1,2,3,1,2,0,0,2,0,3,7,6,8,8.2
2023-24,202401170TOR,1/17/2024,TOR vs MIA,Nikola Jovic,jovicni01,15,MIA,0,TOR,10,7,2,0,1,2,21.01666667,3,4,4,9,1,2,1,2,1,1,9,12,17,19,22.4
2023-24,202401170LAL,1/17/2024,LAL vs DAL,Maxi Kleber,klebima01,8,DAL,0,LAL,6,1,3,0,2,1,21.18333333,1,0,2,3,2,3,0,0,5,2,4,9,7,10,16.7
2023-24,202401170CLE,1/17/2024,CLE vs MIL,Bobby Portis,portibo01,41,MIL,0,CLE,16,6,3,1,0,1,21.18333333,2,4,6,11,1,4,3,4,0,1,9,19,22,25,29.7
2023-24,202401170TOR,1/17/2024,TOR vs MIA,Duncan Robinson,robindu01,39,MIA,0,TOR,14,3,1,0,0,2,21.31666667,1,2,6,11,2,5,0,0,0,0,4,15,17,18,17.1
2023-24,202401170BOS,1/17/2024,BOS vs SAS,Dominick Barlow,barlodo01,18,SAS,0,BOS,5,4,0,0,0,0,21.4,2,2,2,6,1,2,0,0,1,0,4,5,9,9,9.8
2023-24,202401170NYK,1/17/2024,NYK vs HOU,Jeff Green,greenje02,39,HOU,0,NYK,9,5,0,0,2,0,21.48333333,1,4,2,4,1,2,4,4,2,2,5,9,14,14,21
2023-24,202401170CLE,1/17/2024,CLE vs MIL,Caris LeVert,leverca01,31,CLE,1,MIL,4,3,4,0,0,2,21.58333333,1,2,1,7,0,2,2,3,1,0,7,8,7,11,11.6
2023-24,202401170POR,1/17/2024,POR vs BRK,Cam Thomas,thomaca02,31,BRK,0,POR,8,0,4,0,0,1,21.66666667,0,0,2,7,2,4,2,2,0,0,4,12,8,12,13
2023-24,202401170CLE,1/17/2024,CLE vs MIL,Max Strus,strusma01,39,CLE,1,MIL,6,6,3,0,1,0,21.7,0,6,2,4,0,1,2,2,1,1,9,9,12,15,20.7
2023-24,202401170DET,1/17/2024,DET vs MIN,Kyle Anderson,anderky01,40,MIN,0,DET,4,3,9,1,2,1,21.71666667,0,3,2,6,0,0,0,0,2,3,12,13,7,16,29.1
2023-24,202401170ATL,1/17/2024,ATL vs ORL,Cole Anthony,anthoco01,40,ORL,0,ATL,10,1,1,1,3,1,21.95,0,1,3,10,1,6,3,4,1,4,2,11,11,12,23.7
2023-24,202401170DET,1/17/2024,DET vs MIN,Ausar Thompson,thompau01,41,DET,1,MIN,7,9,1,0,1,0,21.95,3,6,3,6,0,2,1,5,0,1,10,8,16,17,22.3
2023-24,202401170CLE,1/17/2024,CLE vs MIL,Sam Merrill,merrisa01,24,CLE,1,MIL,10,5,5,0,0,0,22.01666667,3,2,4,8,2,6,0,0,1,0,10,15,15,20,23.5
2023-24,202401170LAL,1/17/2024,LAL vs DAL,Rui Hachimura,hachiru01,29,LAL,1,DAL,6,4,1,2,0,0,22.08333333,1,3,2,6,1,4,1,2,1,2,5,7,10,11,18.3
2023-24,202401170CLE,1/17/2024,CLE vs MIL,Malik Beasley,beaslma01,39,MIL,0,CLE,2,5,1,0,0,0,22.2,1,4,1,6,0,3,0,0,3,0,6,3,7,8,9.5
2023-24,202401170DET,1/17/2024,DET vs MIN,Nickeil Alexander-Walker,alexani01,40,MIN,0,DET,7,0,1,1,1,0,22.86666667,0,0,3,6,1,3,0,0,2,2,1,8,7,8,14.5
2023-24,202401170CLE,1/17/2024,CLE vs MIL,MarJon Beauchamp,beaucma01,34,MIL,0,CLE,0,3,2,0,0,1,22.86666667,1,2,0,3,0,0,0,0,1,0,5,2,3,5,5.6
2023-24,202401170DET,1/17/2024,DET vs MIN,Naz Reid,reidna01,40,MIN,0,DET,9,4,1,3,0,1,23.18333333,0,4,3,9,1,4,2,4,0,3,5,10,13,14,23.3
2023-24,202401170BOS,1/17/2024,BOS vs SAS,Keldon Johnson,johnske04,38,SAS,0,BOS,5,2,1,1,0,0,23.21666667,0,2,2,4,1,2,0,0,1,1,3,6,7,8,11.9
2023-24,202401170CLE,1/17/2024,CLE vs MIL,Andre Jackson Jr.,jacksan01,35,MIL,0,CLE,6,8,0,0,0,1,23.3,2,6,3,4,0,1,0,0,2,0,8,6,14,14,14.6
2023-24,202401170TOR,1/17/2024,TOR vs MIA,Josh Richardson,richajo01,32,MIA,0,TOR,5,1,0,1,2,1,23.38333333,0,1,2,7,1,4,0,0,3,3,1,5,6,6,14.2
2023-24,202401170POR,1/17/2024,POR vs BRK,Scoot Henderson,hendesc01,31,POR,1,BRK,7,3,3,0,0,5,23.4,1,2,1,6,0,2,5,5,0,0,6,10,10,13,10.1
2023-24,202401170NOP,1/17/2024,NOP vs CHO,Trey Murphy III,murphtr02,18,NOP,1,CHO,18,5,1,1,0,2,23.55,0,5,6,13,5,12,1,2,2,1,6,19,23,24,26.5
2023-24,202401170NOP,1/17/2024,NOP vs CHO,Herbert Jones,joneshe01,39,NOP,1,CHO,9,1,1,2,0,0,23.73333333,0,1,3,5,2,3,1,2,0,2,2,10,10,11,17.7
2023-24,202401170NOP,1/17/2024,NOP vs CHO,P.J. Washington,washipj01,32,CHO,0,NOP,7,5,2,1,2,1,23.76666667,4,1,3,9,1,4,0,0,3,3,7,9,12,14,24
2023-24,202401170ATL,1/17/2024,ATL vs ORL,Bogdan Bogdanovic,bogdabo01,38,ATL,1,ORL,12,4,1,1,1,1,23.91666667,1,3,4,7,2,4,2,2,1,2,5,13,16,17,23.3
2023-24,202401170ATL,1/17/2024,ATL vs ORL,Goga Bitadze,bitadgo01,37,ORL,0,ATL,10,10,3,1,2,1,24,7,3,5,8,0,1,0,0,3,3,13,13,20,23,34.5
2023-24,202401170ATL,1/17/2024,ATL vs ORL,Wendell Carter Jr.,cartewe01,15,ORL,0,ATL,18,5,2,2,1,0,24,2,3,6,7,3,4,3,4,1,3,7,20,23,25,36
2023-24,202401170NOP,1/17/2024,NOP vs CHO,Jordan Hawkins,hawkijo01,37,NOP,1,CHO,21,6,1,1,0,2,24.26666667,2,4,7,12,6,9,1,2,1,1,7,22,27,28,30.7
2023-24,202401170BOS,1/17/2024,BOS vs SAS,Al Horford,horfoal01,34,BOS,1,SAS,9,3,0,1,0,0,24.55,0,3,3,4,3,4,0,0,2,1,3,9,12,12,15.6
2023-24,202401170CLE,1/17/2024,CLE vs MIL,Brook Lopez,lopezbr01,41,MIL,0,CLE,11,4,1,1,3,2,24.55,0,4,5,7,1,3,0,0,2,4,5,12,15,16,27.3
2023-24,202401170NOP,1/17/2024,NOP vs CHO,Jonas Valanciunas,valanjo01,42,NOP,1,CHO,4,7,0,0,0,1,24.6,3,4,1,3,0,0,2,2,1,0,7,4,11,11,11.4
2023-24,202401170DET,1/17/2024,DET vs MIN,Isaiah Stewart,stewais01,31,DET,1,MIN,12,4,2,1,3,2,24.66666667,1,3,4,9,2,5,2,2,0,4,6,14,16,18,29.8
2023-24,202401170POR,1/17/2024,POR vs BRK,Duop Reath,reathdu01,28,POR,1,BRK,17,7,3,0,0,1,25.33333333,2,5,7,9,2,4,1,1,4,0,10,20,24,27,28.9
2023-24,202401170CLE,1/17/2024,CLE vs MIL,Damian Lillard,lillada01,38,MIL,0,CLE,17,2,5,2,0,1,25.43333333,1,1,7,20,1,5,2,3,1,2,7,22,19,24,31.9
2023-24,202401170CLE,1/17/2024,CLE vs MIL,Jarrett Allen,allenja01,34,CLE,1,MIL,21,13,3,0,1,1,25.61666667,3,10,9,15,0,0,3,3,0,1,16,24,34,37,43.1
2023-24,202401170TOR,1/17/2024,TOR vs MIA,Caleb Martin,martica02,24,MIA,0,TOR,10,3,5,0,0,1,25.61666667,1,2,4,5,0,0,2,2,1,0,8,15,13,18,20.1
2023-24,202401170CLE,1/17/2024,CLE vs MIL,Isaac Okoro,okorois01,30,CLE,1,MIL,10,3,7,1,1,0,25.61666667,1,2,5,7,0,0,0,1,2,2,10,17,13,20,30.1
2023-24,202401170LAL,1/17/2024,LAL vs DAL,Grant Williams,willigr01,38,DAL,0,LAL,8,3,2,0,0,0,25.7,0,3,2,6,2,6,2,2,3,0,5,10,11,13,14.6
2023-24,202401170LAL,1/17/2024,LAL vs DAL,Jarred Vanderbilt,vandeja01,22,LAL,1,DAL,7,9,1,1,0,1,25.85,1,8,1,3,0,1,5,8,3,1,10,8,16,17,21.3
2023-24,202401170CLE,1/17/2024,CLE vs MIL,Donovan Mitchell,mitchdo01,30,CLE,1,MIL,31,5,7,3,0,1,25.88333333,1,4,12,19,4,8,3,4,1,3,12,38,36,43,55.5
2023-24,202401170DET,1/17/2024,DET vs MIN,Killian Hayes,hayeski01,36,DET,1,MIN,8,1,8,0,0,0,26.33333333,0,1,4,4,0,0,0,0,3,0,9,16,9,17,21.2
2023-24,202401170BOS,1/17/2024,BOS vs SAS,Victor Wembanyama,wembavi01,35,SAS,0,BOS,27,5,1,0,1,5,26.6,2,3,10,19,2,6,5,6,2,1,6,28,32,33,32.5
2023-24,202401170POR,1/17/2024,POR vs BRK,Cameron Johnson,johnsca02,32,BRK,0,POR,13,3,5,0,1,0,26.63333333,1,2,6,9,1,3,0,0,1,1,8,18,16,21,27.1
2023-24,202401170LAL,1/17/2024,LAL vs DAL,Derrick Jones Jr.,jonesde02,40,DAL,0,LAL,8,1,0,0,1,0,26.63333333,1,0,3,3,2,2,0,0,2,1,1,8,9,9,12.2
2023-24,202401170TOR,1/17/2024,TOR vs MIA,Dennis Schroder,schrode01,41,TOR,1,MIA,9,1,6,1,0,1,26.71666667,0,1,3,6,3,5,0,0,1,1,7,15,10,16,21.2
2023-24,202401170BOS,1/17/2024,BOS vs SAS,Tre Jones,jonestr01,36,SAS,0,BOS,9,4,11,0,0,2,26.73333333,0,4,4,9,1,5,0,0,2,0,15,20,13,24,28.3
2023-24,202401170BOS,1/17/2024,BOS vs SAS,Payton Pritchard,pritcpa01,41,BOS,1,SAS,12,3,4,1,0,0,27.11666667,1,2,4,10,2,4,2,2,2,1,7,16,15,19,24.6
2023-24,202401170CLE,1/17/2024,CLE vs MIL,Georges Niang,niangge01,39,CLE,1,MIL,33,5,2,0,0,1,27.23333333,0,5,13,14,5,6,2,3,2,0,7,35,38,40,41
2023-24,202401170ATL,1/17/2024,ATL vs ORL,Onyeka Okongwu,okongon01,39,ATL,1,ORL,15,9,0,0,1,2,27.25,3,6,7,12,0,1,1,1,3,1,9,15,24,24,26.8
2023-24,202401170ATL,1/17/2024,ATL vs ORL,Clint Capela,capelca01,38,ATL,1,ORL,12,3,0,1,0,1,27.3,0,3,6,6,0,0,0,0,3,1,3,12,15,15,17.6
2023-24,202401170NOP,1/17/2024,NOP vs CHO,Zion Williamson,willizi01,34,NOP,1,CHO,13,5,9,3,0,2,27.38333333,2,3,5,11,0,0,3,4,1,3,14,22,18,27,39.5
2023-24,202401170ATL,1/17/2024,ATL vs ORL,Jalen Suggs,suggsja01,37,ORL,0,ATL,16,4,1,0,0,2,27.7,2,2,6,7,3,3,1,2,3,0,5,17,20,21,20.3
2023-24,202401170NOP,1/17/2024,NOP vs CHO,Cody Martin,martico01,9,CHO,0,NOP,7,4,4,2,0,0,27.96666667,1,3,2,9,1,5,2,2,2,2,8,11,11,15,23.8
2023-24,202401170LAL,1/17/2024,LAL vs DAL,Dereck Lively II,livelde01,31,DAL,0,LAL,16,11,2,1,0,2,28.01666667,5,6,8,9,0,0,0,0,2,1,13,18,27,29,33.2
2023-24,202401170TOR,1/17/2024,TOR vs MIA,Thaddeus Young,youngth01,13,TOR,1,MIA,5,8,2,1,0,0,28.03333333,2,6,2,6,0,0,1,2,3,1,10,7,13,15,20.6
2023-24,202401170LAL,1/17/2024,LAL vs DAL,Tim Hardaway Jr.,hardati02,39,DAL,0,LAL,12,4,1,1,0,4,28.28333333,2,2,5,17,0,7,2,2,2,1,5,13,16,17,17.3
2023-24,202401170NOP,1/17/2024,NOP vs CHO,CJ McCollum,mccolcj01,28,NOP,1,CHO,22,5,6,0,2,1,28.88333333,2,3,8,15,4,9,2,2,2,2,11,28,27,33,42
2023-24,202401170TOR,1/17/2024,TOR vs MIA,Kyle Lowry,lowryky01,35,MIA,0,TOR,4,2,3,0,1,1,29,1,1,2,9,0,6,0,0,2,1,5,7,6,9,12.9
2023-24,202401170NYK,1/17/2024,NYK vs HOU,Jalen Green,greenja05,40,HOU,0,NYK,15,7,1,1,0,5,29.2,0,7,6,15,0,5,3,3,2,1,8,16,22,23,22.9
2023-24,202401170DET,1/17/2024,DET vs MIN,Mike Conley,conlemi01,39,MIN,0,DET,8,3,7,1,1,1,29.3,0,3,3,8,2,6,0,1,0,2,10,15,11,18,27.1
2023-24,202401170LAL,1/17/2024,LAL vs DAL,Austin Reaves,reaveau01,43,LAL,1,DAL,14,3,7,1,0,3,29.5,0,3,6,8,2,2,0,0,2,1,10,21,17,24,28.1
2023-24,202401170NYK,1/17/2024,NYK vs HOU,Josh Hart,hartjo01,41,NYK,1,HOU,10,14,1,0,0,0,29.66666667,5,9,5,11,0,2,0,0,2,0,15,11,24,25,28.3
2023-24,202401170ATL,1/17/2024,ATL vs ORL,Chuma Okeke,okekech01,24,ORL,0,ATL,6,7,1,3,1,1,29.83333333,3,4,3,9,0,4,0,0,1,4,8,7,13,14,26.9
2023-24,202401170POR,1/17/2024,POR vs BRK,Jabari Walker,walkeja01,36,POR,1,BRK,4,6,0,1,0,0,29.86666667,0,6,1,4,1,1,1,2,2,1,6,4,10,10,14.2
2023-24,202401170ATL,1/17/2024,ATL vs ORL,Markelle Fultz,fultzma01,10,ORL,0,ATL,10,4,1,3,0,4,30.25,1,3,5,8,0,0,0,0,5,3,5,11,14,15,21.3
2023-24,202401170POR,1/17/2024,POR vs BRK,Malcolm Brogdon,brogdma01,31,POR,1,BRK,16,5,6,1,0,0,30.28333333,0,5,6,12,2,6,2,2,2,1,11,22,21,27,34
2023-24,202401170TOR,1/17/2024,TOR vs MIA,Immanuel Quickley,quickim01,39,TOR,1,MIA,17,8,9,0,0,2,30.3,1,7,6,16,3,6,2,2,1,0,17,26,25,34,38.1
2023-24,202401170DET,1/17/2024,DET vs MIN,Jaden McDaniels,mcdanja02,30,MIN,0,DET,23,3,0,1,0,1,30.31666667,2,1,8,11,3,4,4,4,0,1,3,23,26,26,28.6
2023-24,202401170BOS,1/17/2024,BOS vs SAS,Luke Kornet,kornelu01,28,BOS,1,SAS,6,9,4,1,3,2,30.41666667,3,6,3,5,0,0,0,0,2,4,13,10,15,19,32.8
2023-24,202401170BOS,1/17/2024,BOS vs SAS,Jeremy Sochan,sochaje01,40,SAS,0,BOS,5,7,4,3,1,0,30.51666667,3,4,2,9,1,4,0,0,2,4,11,9,12,16,31.4
2023-24,202401170TOR,1/17/2024,TOR vs MIA,Jimmy Butler,butleji01,26,MIA,0,TOR,16,5,5,2,0,1,30.8,2,3,6,11,0,0,4,5,0,2,10,21,21,26,34.5
2023-24,202401170TOR,1/17/2024,TOR vs MIA,Gary Trent Jr.,trentga02,36,TOR,1,MIA,28,2,0,1,0,0,30.86666667,0,2,10,13,8,9,0,0,1,1,2,28,30,30,33.4
2023-24,202401170DET,1/17/2024,DET vs MIN,Karl-Anthony Towns,townska01,39,MIN,0,DET,27,6,4,0,0,1,30.93333333,2,4,10,17,5,5,2,2,2,0,10,31,33,37,39.2
2023-24,202401170DET,1/17/2024,DET vs MIN,Jalen Duren,durenja01,26,DET,1,MIN,16,11,3,0,0,2,30.95,2,9,8,14,0,0,0,1,4,0,14,19,27,30,31.7
2023-24,202401170NOP,1/17/2024,NOP vs CHO,Nick Richards,richani01,32,CHO,0,NOP,10,12,2,0,2,0,30.98333333,5,7,4,5,0,0,2,2,2,2,14,12,22,24,33.4
2023-24,202401170NOP,1/17/2024,NOP vs CHO,LaMelo Ball,ballla01,18,CHO,0,NOP,29,5,7,2,0,4,31.28333333,0,5,8,19,4,12,9,10,5,2,12,36,34,41,47.5
2023-24,202401170BOS,1/17/2024,BOS vs SAS,Jaylen Brown,brownja02,38,BOS,1,SAS,21,7,5,1,1,3,31.28333333,1,6,8,16,3,6,2,2,2,2,12,26,28,33,39.9
2023-24,202401170BOS,1/17/2024,BOS vs SAS,Jrue Holiday,holidjr01,38,BOS,1,SAS,22,4,4,0,0,1,31.28333333,0,4,8,14,6,7,0,0,0,0,8,26,26,30,31.8
2023-24,202401170NYK,1/17/2024,NYK vs HOU,Jabari Smith Jr.,smithja05,39,HOU,0,NYK,11,6,1,1,0,0,31.28333333,2,4,5,9,1,2,0,0,2,1,7,12,17,18,22.7
2023-24,202401170BOS,1/17/2024,BOS vs SAS,Jayson Tatum,tatumja01,38,BOS,1,SAS,24,5,2,0,0,2,31.55,0,5,9,21,3,8,3,5,2,0,7,26,29,31,31
2023-24,202401170POR,1/17/2024,POR vs BRK,Nic Claxton,claxtni01,30,BRK,0,POR,12,12,0,3,1,1,31.81666667,2,10,4,5,0,0,4,10,3,4,12,12,24,24,37.4
2023-24,202401170BOS,1/17/2024,BOS vs SAS,Devin Vassell,vassede01,35,SAS,0,BOS,21,2,3,1,0,1,32,0,2,7,15,0,5,7,8,1,1,5,24,23,26,29.9
2023-24,202401170POR,1/17/2024,POR vs BRK,Dorian Finney-Smith,finnedo01,37,BRK,0,POR,7,5,1,2,0,1,32.01666667,1,4,2,5,1,4,2,2,1,2,6,8,12,13,19.5
2023-24,202401170NOP,1/17/2024,NOP vs CHO,Terry Rozier,roziete01,27,CHO,0,NOP,25,2,4,1,1,1,32.08333333,1,1,9,15,7,11,0,0,1,2,6,29,27,31,38.4
2023-24,202401170DET,1/17/2024,DET vs MIN,Bojan Bogdanovic,bogdabo02,20,DET,1,MIN,20,5,3,0,1,1,32.16666667,0,5,7,13,3,7,3,4,2,1,8,23,25,28,32.5
2023-24,202401170LAL,1/17/2024,LAL vs DAL,Kyrie Irving,irvinky01,26,DAL,0,LAL,12,5,6,0,0,2,32.23333333,0,5,4,16,1,5,3,3,2,0,11,18,17,23,25
2023-24,202401170TOR,1/17/2024,TOR vs MIA,Tyler Herro,herroty01,22,MIA,0,TOR,16,7,3,0,0,3,32.38333333,1,6,7,20,2,9,0,0,2,0,10,19,23,26,25.9
2023-24,202401170POR,1/17/2024,POR vs BRK,Spencer Dinwiddie,dinwisp01,38,BRK,0,POR,19,2,7,1,0,1,32.43333333,0,2,5,8,3,4,6,7,2,1,9,26,21,28,33.9
2023-24,202401170LAL,1/17/2024,LAL vs DAL,LeBron James,jamesle01,39,LAL,1,DAL,25,8,8,1,0,3,33.03333333,1,7,10,19,3,7,2,2,1,1,16,33,33,41,46.6
2023-24,202401170LAL,1/17/2024,LAL vs DAL,Anthony Davis,davisan02,41,LAL,1,DAL,28,12,9,1,1,1,33.05,5,7,12,17,0,0,4,5,2,2,21,37,40,49,60.9
2023-24,202401170DET,1/17/2024,DET vs MIN,Anthony Edwards,edwaran01,37,MIN,0,DET,27,5,8,0,0,3,33.48333333,0,5,10,24,3,8,4,4,3,0,13,35,32,40,42
2023-24,202401170NOP,1/17/2024,NOP vs CHO,Brandon Ingram,ingrabr01,38,NOP,1,CHO,28,10,10,3,0,2,33.61666667,1,9,8,19,7,11,5,5,3,3,20,38,38,48,62
2023-24,202401170POR,1/17/2024,POR vs BRK,Mikal Bridges,bridgmi01,40,BRK,0,POR,21,4,4,0,1,1,33.8,0,4,7,18,3,9,4,6,4,1,8,25,25,29,33.8
2023-24,202401170TOR,1/17/2024,TOR vs MIA,Scottie Barnes,barnesc01,41,TOR,1,MIA,20,5,8,2,1,5,33.95,2,3,9,16,1,6,1,1,2,3,13,28,25,33,42
2023-24,202401170NYK,1/17/2024,NYK vs HOU,Julius Randle,randlju01,41,NYK,1,HOU,31,8,4,0,1,4,34.18333333,2,6,11,19,4,8,5,6,4,1,12,35,39,43,45.6
2023-24,202401170NOP,1/17/2024,NOP vs CHO,Miles Bridges,bridgmi02,27,CHO,0,NOP,19,4,3,0,0,2,34.7,0,4,8,20,3,7,0,0,1,0,7,22,23,26,26.3
2023-24,202401170ATL,1/17/2024,ATL vs ORL,Saddiq Bey,beysa01,40,ATL,1,ORL,7,4,0,0,0,0,35.16666667,2,2,1,7,1,5,4,4,2,0,4,7,11,11,11.8
2023-24,202401170DET,1/17/2024,DET vs MIN,Jaden Ivey,iveyja01,37,DET,1,MIN,32,4,6,1,0,2,35.56666667,0,4,13,22,4,6,2,2,4,1,10,38,36,42,46.8
2023-24,202401170POR,1/17/2024,POR vs BRK,Jerami Grant,grantje01,35,POR,1,BRK,30,8,1,0,0,2,35.58333333,4,4,14,26,2,4,0,0,1,0,9,31,38,39,39.1
2023-24,202401170TOR,1/17/2024,TOR vs MIA,Bam Adebayo,adebaba01,31,MIA,0,TOR,16,5,4,1,0,2,35.81666667,1,4,7,13,0,0,2,3,3,1,9,20,21,25,29
2023-24,202401170LAL,1/17/2024,LAL vs DAL,D'Angelo Russell,russeda01,39,LAL,1,DAL,29,4,3,0,0,1,35.96666667,1,3,11,20,5,7,2,2,0,0,7,32,33,36,37.3
2023-24,202401170ATL,1/17/2024,ATL vs ORL,Dejounte Murray,murrade01,40,ATL,1,ORL,26,5,5,2,0,5,36.03333333,1,4,11,18,1,4,3,3,1,2,10,31,31,36,40.5
2023-24,202401170LAL,1/17/2024,LAL vs DAL,Luka Doncic,doncilu01,35,DAL,0,LAL,33,13,10,2,2,4,36.2,0,13,12,24,2,9,7,9,2,4,23,43,46,56,71.6
2023-24,202401170TOR,1/17/2024,TOR vs MIA,RJ Barrett,barrerj01,35,TOR,1,MIA,26,8,3,0,0,0,36.33333333,3,5,9,14,1,3,7,13,1,0,11,29,34,37,40.1
2023-24,202401170NYK,1/17/2024,NYK vs HOU,Jalen Brunson,brunsja01,39,NYK,1,HOU,30,3,7,0,0,2,36.88333333,0,3,11,21,4,9,4,7,2,0,10,37,33,40,42.1
2023-24,202401170DET,1/17/2024,DET vs MIN,Rudy Gobert,goberru01,39,MIN,0,DET,19,16,2,0,1,1,37.65,5,11,8,11,0,0,3,4,4,1,18,21,35,37,43.2
2023-24,202401170ATL,1/17/2024,ATL vs ORL,Paolo Banchero,banchpa01,41,ORL,0,ATL,26,4,4,2,1,1,38.13333333,0,4,8,25,1,5,9,11,1,3,8,30,30,34,44.8
2023-24,202401170ATL,1/17/2024,ATL vs ORL,Jalen Johnson,johnsja05,26,ATL,1,ORL,10,9,3,2,0,4,38.16666667,0,9,3,9,1,2,3,5,3,2,12,13,19,22,27.3
2023-24,202401170ATL,1/17/2024,ATL vs ORL,Trae Young,youngtr01,38,ATL,1,ORL,18,3,12,1,0,8,38.7,1,2,5,14,1,6,7,7,3,1,15,30,21,33,34.6
2023-24,202401170POR,1/17/2024,POR vs BRK,Anfernee Simons,simonan01,19,POR,1,BRK,20,4,4,0,0,0,38.76666667,0,4,8,20,1,7,3,4,2,0,8,24,24,28,30.8
2023-24,202401170NYK,1/17/2024,NYK vs HOU,Alperen Sengun,sengual01,40,HOU,0,NYK,18,10,5,1,4,3,39.78333333,3,7,7,16,0,1,4,7,3,5,15,23,28,33,49.5
2023-24,202401170NYK,1/17/2024,NYK vs HOU,Dillon Brooks,brookdi01,31,HOU,0,NYK,11,1,0,1,1,1,39.81666667,0,1,4,13,1,6,2,2,3,2,1,11,12,12,17.2
2023-24,202401170NYK,1/17/2024,NYK vs HOU,Isaiah Hartenstein,harteis01,41,NYK,1,HOU,7,11,5,2,2,2,40.96666667,2,9,3,5,0,0,1,1,4,4,16,12,18,23,37.7
2023-24,202401170NYK,1/17/2024,NYK vs HOU,Fred VanVleet,vanvlfr01,39,HOU,0,NYK,24,3,12,1,0,1,41.28333333,0,3,8,19,5,12,3,3,3,1,15,36,27,39,47.6
2023-24,202401170NYK,1/17/2024,NYK vs HOU,OG Anunoby,anunoog01,36,NYK,1,HOU,15,5,0,4,1,1,43.13333333,0,5,5,10,2,5,3,3,2,5,5,15,20,20,35
2023-24,202401160PHO,1/16/2024,PHO vs SAC,Drew Eubanks,eubandr01,35,PHO,1,SAC,3,4,0,1,0,0,10.33333333,3,1,1,1,0,0,1,1,0,1,4,3,7,7,10.8
2023-24,202401160PHO,1/16/2024,PHO vs SAC,Chimezie Metu,metuch01,30,PHO,1,SAC,6,5,1,0,0,1,10.35,0,5,3,5,0,1,0,0,1,0,6,7,11,12,12.5
2023-24,202401160LAC,1/16/2024,LAC vs OKC,Vasilije Micic,micicva01,20,OKC,0,LAC,7,1,2,0,0,0,11.3,0,1,3,4,0,1,1,1,0,0,3,9,8,10,11.2
2023-24,202401160PHI,1/16/2024,PHI vs DEN,Peyton Watson,watsope01,40,DEN,0,PHI,5,1,2,0,0,0,11.3,1,0,1,4,1,2,2,2,0,0,3,7,6,8,9.2
2023-24,202401160PHO,1/16/2024,PHO vs SAC,Trey Lyles,lylestr01,26,SAC,0,PHO,0,2,0,1,0,0,13.91666667,0,2,0,2,0,2,0,0,1,1,2,0,2,2,5.4
2023-24,202401160LAC,1/16/2024,LAC vs OKC,Cason Wallace,wallaca01,40,OKC,0,LAC,5,2,1,1,1,0,14.91666667,2,0,2,4,1,2,0,0,1,2,3,6,7,8,14.9
2023-24,202401160LAC,1/16/2024,LAC vs OKC,Amir Coffey,coffeam01,28,LAC,1,OKC,9,3,0,0,0,0,15.51666667,1,2,3,4,3,3,0,0,2,0,3,9,12,12,12.6
2023-24,202401160PHO,1/16/2024,PHO vs SAC,Josh Okogie,okogijo01,34,PHO,1,SAC,2,2,0,0,1,0,15.9,0,2,1,3,0,0,0,0,1,1,2,2,4,4,7.4
2023-24,202401160LAC,1/16/2024,LAC vs OKC,Kenrich Williams,willike04,29,OKC,0,LAC,3,6,1,1,1,1,16.23333333,2,4,1,4,1,4,0,0,1,2,7,4,9,10,16.7
2023-24,202401160LAC,1/16/2024,LAC vs OKC,Aaron Wiggins,wiggiaa01,37,OKC,0,LAC,7,4,2,1,0,0,16.85,0,4,3,4,1,1,0,0,0,1,6,9,11,13,17.8
2023-24,202401160PHO,1/16/2024,PHO vs SAC,Sasha Vezenkov,vezenal01,31,SAC,0,PHO,14,2,1,1,0,1,17.68333333,1,1,6,9,2,3,0,0,1,1,3,15,16,17,19.9
2023-24,202401160PHI,1/16/2024,PHI vs DEN,Christian Braun,braunch01,42,DEN,0,PHI,11,4,0,0,1,0,17.8,0,4,3,5,2,3,3,3,3,1,4,11,15,15,18.8
2023-24,202401160PHI,1/16/2024,PHI vs DEN,Marcus Morris,morrima03,31,PHI,1,DEN,7,2,0,0,0,0,18.6,1,1,1,3,1,2,4,5,3,0,2,7,9,9,9.4
2023-24,202401160LAC,1/16/2024,LAC vs OKC,Norman Powell,powelno01,40,LAC,1,OKC,8,0,1,1,0,0,18.76666667,0,0,2,10,2,7,2,4,3,1,1,9,8,9,12.5
2023-24,202401160LAC,1/16/2024,LAC vs OKC,Josh Giddey,giddejo01,39,OKC,0,LAC,9,4,4,0,0,0,19.23333333,1,3,4,9,1,3,0,0,0,0,8,13,13,17,19.8
2023-24,202401160PHI,1/16/2024,PHI vs DEN,Reggie Jackson,jacksre01,42,DEN,0,PHI,10,2,2,1,0,1,19.66666667,0,2,3,6,2,3,2,2,0,1,4,12,12,14,17.4
2023-24,202401160LAC,1/16/2024,LAC vs OKC,Daniel Theis,theisda01,30,LAC,1,OKC,9,8,0,0,3,2,19.83333333,5,3,4,6,1,2,0,0,3,3,8,9,17,17,25.6
2023-24,202401160LAC,1/16/2024,LAC vs OKC,Russell Westbrook,westbru01,40,LAC,1,OKC,11,2,4,1,0,2,22.45,1,1,4,8,0,3,3,4,0,1,6,15,13,17,20.4
2023-24,202401160LAC,1/16/2024,LAC vs OKC,Isaiah Joe,joeis01,40,OKC,0,LAC,15,6,3,2,0,0,23.41666667,3,3,5,7,5,6,0,0,2,2,9,18,21,24,32.7
2023-24,202401160LAC,1/16/2024,LAC vs OKC,Terance Mann,mannte01,34,LAC,1,OKC,7,3,4,0,2,1,23.53333333,2,1,3,6,1,2,0,0,4,2,7,11,10,14,21.6
2023-24,202401160PHO,1/16/2024,PHO vs SAC,Eric Gordon,gordoer01,34,PHO,1,SAC,13,3,2,2,0,2,23.9,0,3,5,10,3,7,0,0,0,2,5,15,16,18,23.6
2023-24,202401160PHO,1/16/2024,PHO vs SAC,Kevin Huerter,huertke01,38,SAC,0,PHO,10,3,2,2,1,0,25.95,0,3,4,9,2,6,0,0,4,3,5,12,13,15,25.6
2023-24,202401160PHI,1/16/2024,PHI vs DEN,Kelly Oubre Jr.,oubreke01,27,PHI,1,DEN,11,5,0,1,0,2,26.51666667,0,5,5,9,1,4,0,1,4,1,5,11,16,16,18
2023-24,202401160PHI,1/16/2024,PHI vs DEN,Patrick Beverley,beverpa01,38,PHI,1,DEN,8,2,2,2,0,0,26.58333333,0,2,3,7,2,3,0,0,2,2,4,10,10,12,19.4
2023-24,202401160PHO,1/16/2024,PHO vs SAC,Jusuf Nurkic,nurkiju01,38,PHO,1,SAC,10,15,3,0,1,1,27.38333333,3,12,4,5,0,0,2,2,3,1,18,13,25,28,34.5
2023-24,202401160LAC,1/16/2024,LAC vs OKC,Mason Plumlee,plumlma01,10,LAC,1,OKC,14,5,2,0,3,0,28.16666667,2,3,5,5,0,0,4,7,2,3,7,16,19,21,32
2023-24,202401160PHO,1/16/2024,PHO vs SAC,Malik Monk,monkma01,39,SAC,0,PHO,13,3,8,0,1,5,29.08333333,0,3,5,16,2,7,1,1,2,1,11,21,16,24,26.6
2023-24,202401160LAC,1/16/2024,LAC vs OKC,Jalen Williams,willija06,37,OKC,0,LAC,25,3,7,0,0,4,32.73333333,0,3,10,14,2,3,3,3,5,0,10,32,28,35,35.1
2023-24,202401160PHI,1/16/2024,PHI vs DEN,Kentavious Caldwell-Pope,caldwke01,40,DEN,0,PHI,13,5,2,1,0,0,32.78333333,0,5,5,13,2,7,1,1,2,1,7,15,18,20,25
2023-24,202401160LAC,1/16/2024,LAC vs OKC,Luguentz Dort,dortlu01,39,OKC,0,LAC,19,1,1,0,0,3,33.1,0,1,6,10,5,8,2,2,2,0,2,20,20,21,18.7
2023-24,202401160LAC,1/16/2024,LAC vs OKC,Chet Holmgren,holmgch01,40,OKC,0,LAC,8,5,5,0,1,1,33.11666667,0,5,2,10,0,2,4,6,4,1,10,13,13,18,23.5
2023-24,202401160LAC,1/16/2024,LAC vs OKC,Shai Gilgeous-Alexander,gilgesh01,39,OKC,0,LAC,19,2,4,0,2,2,33.73333333,1,1,6,16,0,3,7,8,4,2,6,23,21,25,31.4
2023-24,202401160PHI,1/16/2024,PHI vs DEN,Michael Porter Jr.,portemi01,42,DEN,0,PHI,20,5,0,1,0,1,33.78333333,0,5,6,12,4,8,4,5,3,1,5,20,25,25,28
2023-24,202401160PHO,1/16/2024,PHO vs SAC,Harrison Barnes,barneha02,40,SAC,0,PHO,8,3,3,0,0,2,34.08333333,0,3,3,9,2,6,0,0,2,0,6,11,11,14,14.1
2023-24,202401160LAC,1/16/2024,LAC vs OKC,Paul George,georgpa01,38,LAC,1,OKC,38,7,5,3,0,0,34.46666667,0,7,15,24,6,12,2,4,2,3,12,43,45,50,62.9
2023-24,202401160PHI,1/16/2024,PHI vs DEN,Nicolas Batum,batumni01,28,PHI,1,DEN,8,4,2,0,2,2,34.98333333,1,3,3,4,2,3,0,0,3,2,6,10,12,14,19.8
2023-24,202401160PHO,1/16/2024,PHO vs SAC,Keegan Murray,murrake02,36,SAC,0,PHO,18,4,3,1,1,1,35.3,1,3,7,12,3,5,1,2,3,2,7,21,22,25,32.3
2023-24,202401160LAC,1/16/2024,LAC vs OKC,Kawhi Leonard,leonaka01,36,LAC,1,OKC,16,6,6,0,1,3,36.7,1,5,6,10,3,4,1,2,0,1,12,22,22,28,32.2
2023-24,202401160PHO,1/16/2024,PHO vs SAC,De'Aaron Fox,foxde01,34,SAC,0,PHO,33,2,6,2,0,1,36.76666667,1,1,12,24,6,10,3,5,2,2,8,39,35,41,49.4
2023-24,202401160PHO,1/16/2024,PHO vs SAC,Grayson Allen,allengr01,35,PHO,1,SAC,29,5,6,2,2,2,37.16666667,0,5,10,17,9,14,0,0,1,4,11,35,34,40,54
2023-24,202401160PHI,1/16/2024,PHI vs DEN,Tobias Harris,harrito02,38,PHI,1,DEN,24,5,4,1,2,0,37.98333333,0,5,8,10,2,4,6,6,2,3,9,28,29,33,45
2023-24,202401160PHI,1/16/2024,PHI vs DEN,Nikola Jokic,jokicni01,41,DEN,0,PHI,25,19,3,1,1,4,38,11,8,11,20,0,2,3,4,3,2,22,28,44,47,54.3
2023-24,202401160PHI,1/16/2024,PHI vs DEN,Jamal Murray,murraja01,28,DEN,0,PHI,17,3,10,0,1,2,38.13333333,1,2,7,16,1,3,2,2,0,1,13,27,20,30,36.6
2023-24,202401160PHO,1/16/2024,PHO vs SAC,Bradley Beal,bealbr01,16,PHO,1,SAC,13,3,5,2,0,1,38.2,1,2,6,14,0,4,1,2,2,2,8,18,16,21,29.1
2023-24,202401160PHO,1/16/2024,PHO vs SAC,Devin Booker,bookede01,31,PHO,1,SAC,16,4,11,0,0,2,38.23333333,0,4,5,14,1,3,5,6,4,0,15,27,20,31,35.3
2023-24,202401160PHI,1/16/2024,PHI vs DEN,Aaron Gordon,gordoaa01,36,DEN,0,PHI,16,6,4,0,0,2,38.5,3,3,7,11,0,1,2,6,5,0,10,20,22,26,27.2
2023-24,202401160PHO,1/16/2024,PHO vs SAC,Kevin Durant,duranke01,33,PHO,1,SAC,27,5,4,0,2,7,38.51666667,1,4,7,16,4,8,9,9,3,2,9,31,32,36,38
2023-24,202401160PHI,1/16/2024,PHI vs DEN,Joel Embiid,embiijo01,29,PHI,1,DEN,41,7,10,0,1,3,38.55,1,6,13,22,3,6,12,15,4,1,17,51,48,58,64.4
2023-24,202401160PHO,1/16/2024,PHO vs SAC,Domantas Sabonis,sabondo01,40,SAC,0,PHO,21,12,11,0,1,2,39.31666667,2,10,9,11,1,1,2,4,2,1,23,32,33,44,52.9
2023-24,202401160LAC,1/16/2024,LAC vs OKC,James Harden,hardeja01,35,LAC,1,OKC,16,5,8,0,1,1,40.53333333,0,5,5,14,4,10,2,2,2,1,13,24,21,29,36
2023-24,202401160PHI,1/16/2024,PHI vs DEN,Tyrese Maxey,maxeyty01,38,PHI,1,DEN,25,5,9,2,0,1,42.9,1,4,9,20,4,9,3,7,2,2,14,34,30,39,49.5
2023-24,202401150LAL,1/15/2024,LAL vs OKC,Max Christie,chrisma02,32,LAL,1,OKC,0,1,0,0,0,1,10.63333333,1,0,0,2,0,1,0,0,1,0,1,0,1,1,0.2
2023-24,202401150CLE,1/15/2024,CLE vs CHI,Jevon Carter,carteje01,40,CHI,0,CLE,5,2,0,0,0,0,11.03333333,1,1,2,4,1,3,0,0,1,0,2,5,7,7,7.4
2023-24,202401150WAS,1/15/2024,WAS vs DET,Marcus Sasser,sassema01,36,DET,0,WAS,6,2,4,0,2,1,11.13333333,0,2,3,7,0,0,0,0,0,2,6,10,8,12,19.4
2023-24,202401150NYK,1/15/2024,NYK vs ORL,Malachi Flynn,flynnma01,36,NYK,1,ORL,2,0,0,0,0,0,11.91666667,0,0,0,4,0,4,2,4,0,0,0,2,2,2,2
2023-24,202401150BRK,1/15/2024,BRK vs MIA,Haywood Highsmith,highsha01,26,MIA,0,BRK,0,1,0,0,0,0,11.95,0,1,0,2,0,1,0,0,2,0,1,0,1,1,1.2
2023-24,202401150ATL,1/15/2024,ATL vs SAS,Cedi Osman,osmande01,39,SAS,0,ATL,3,1,0,0,0,1,11.98333333,0,1,1,5,1,5,0,0,3,0,1,3,4,4,3.2
2023-24,202401150UTA,1/15/2024,UTA vs IND,Kendall Brown,brownke03,4,IND,0,UTA,8,2,1,0,0,0,12,2,0,2,5,0,1,4,6,3,0,3,9,10,11,11.9
2023-24,202401150UTA,1/15/2024,UTA vs IND,Oscar Tshiebwe,tshieos01,7,IND,0,UTA,4,6,0,2,0,0,12,4,2,1,5,0,0,2,2,0,2,6,4,10,10,17.2
2023-24,202401150TOR,1/15/2024,TOR vs BOS,Jalen McDaniels,mcdanja01,25,TOR,1,BOS,5,2,0,0,0,0,12.25,1,1,2,5,1,3,0,2,0,0,2,5,7,7,7.4
2023-24,202401150LAL,1/15/2024,LAL vs OKC,Ousmane Dieng,diengou01,21,OKC,0,LAL,5,3,0,0,0,1,12.36666667,1,2,2,5,1,4,0,0,2,0,3,5,8,8,7.6
2023-24,202401150ATL,1/15/2024,ATL vs SAS,Trent Forrest,forretr01,14,ATL,1,SAS,3,3,0,0,0,0,12.36666667,1,2,1,3,1,1,0,0,2,0,3,3,6,6,6.6
2023-24,202401150PHI,1/15/2024,PHI vs HOU,Jeff Green,greenje02,38,HOU,0,PHI,1,2,0,0,2,1,12.55,1,1,0,5,0,1,1,2,1,2,2,1,3,3,8.4
2023-24,202401150ATL,1/15/2024,ATL vs SAS,Blake Wesley,weslebl01,18,SAS,0,ATL,3,2,3,0,0,1,12.63333333,1,1,1,4,0,2,1,2,0,0,5,6,5,8,8.9
2023-24,202401150PHI,1/15/2024,PHI vs HOU,Jae'Sean Tate,tateja01,37,HOU,0,PHI,2,4,2,0,0,0,12.8,1,3,1,4,0,3,0,0,4,0,6,4,6,8,9.8
2023-24,202401150UTA,1/15/2024,UTA vs IND,Obi Toppin,toppiob01,41,IND,0,UTA,2,3,2,1,0,0,13.03333333,1,2,1,3,0,0,0,0,1,1,5,4,5,7,11.6
2023-24,202401150ATL,1/15/2024,ATL vs SAS,Garrison Mathews,mathega01,25,ATL,1,SAS,6,0,0,0,0,0,13.2,0,0,2,4,2,4,0,0,0,0,0,6,6,6,6
2023-24,202401150WAS,1/15/2024,WAS vs DET,Patrick Baldwin Jr.,baldwpa01,11,WAS,1,DET,9,3,1,1,0,0,13.41666667,0,3,3,3,3,3,0,0,2,1,4,10,12,13,17.1
2023-24,202401150DAL,1/15/2024,DAL vs NOP,A.J. Lawson,lawsoaj01,18,DAL,1,NOP,3,1,0,0,1,0,13.61666667,1,0,1,3,1,2,0,0,1,1,1,3,4,4,7.2
2023-24,202401150CLE,1/15/2024,CLE vs CHI,Tristan Thompson,thomptr01,33,CLE,1,CHI,4,2,1,0,0,0,13.81666667,1,1,2,4,0,0,0,0,0,0,3,5,6,7,7.9
2023-24,202401150NYK,1/15/2024,NYK vs ORL,Quentin Grimes,grimequ01,37,NYK,1,ORL,8,2,1,1,0,2,13.9,0,2,3,4,2,3,0,0,2,1,3,9,10,11,12.9
2023-24,202401150WAS,1/15/2024,WAS vs DET,Landry Shamet,shamela01,23,WAS,1,DET,11,0,0,1,1,0,13.95,0,0,4,7,2,3,1,1,1,2,0,11,11,11,17
2023-24,202401150LAL,1/15/2024,LAL vs OKC,Christian Wood,woodch01,35,LAL,1,OKC,11,7,1,0,3,1,13.95,2,5,4,7,1,2,2,2,2,3,8,12,18,19,28.9
2023-24,202401150PHI,1/15/2024,PHI vs HOU,Marcus Morris,morrima03,30,PHI,1,HOU,8,5,1,0,0,0,14.01666667,0,5,3,3,2,2,0,0,1,0,6,9,13,14,15.5
2023-24,202401150TOR,1/15/2024,TOR vs BOS,Chris Boucher,bouchch01,37,TOR,1,BOS,4,2,0,0,0,0,14.1,1,1,1,6,0,4,2,2,1,0,2,4,6,6,6.4
2023-24,202401150TOR,1/15/2024,TOR vs BOS,Jontay Porter,portejo01,7,TOR,1,BOS,2,4,3,0,1,1,14.71666667,1,3,1,5,0,2,0,0,4,1,7,5,6,9,13.3
2023-24,202401150WAS,1/15/2024,WAS vs DET,James Wiseman,wisemja01,28,DET,0,WAS,6,5,0,0,2,0,14.73333333,2,3,3,4,0,0,0,0,1,2,5,6,11,11,18
2023-24,202401150LAL,1/15/2024,LAL vs OKC,Vasilije Micic,micicva01,19,OKC,0,LAL,6,1,1,0,0,0,15.06666667,0,1,2,4,2,2,0,0,2,0,2,7,7,8,8.7
2023-24,202401150WAS,1/15/2024,WAS vs DET,Corey Kispert,kispeco01,38,WAS,1,DET,8,2,3,0,0,1,15.08333333,0,2,3,5,2,3,0,0,3,0,5,11,10,13,13.9
2023-24,202401150ATL,1/15/2024,ATL vs SAS,Doug McDermott,mcderdo01,34,SAS,0,ATL,6,1,0,0,0,0,15.26666667,0,1,2,5,2,5,0,0,1,0,1,6,7,7,7.2
2023-24,202401150DAL,1/15/2024,DAL vs NOP,Jaden Hardy,hardyja02,36,DAL,1,NOP,5,4,1,0,0,0,15.31666667,1,3,2,7,1,5,0,0,2,0,5,6,9,10,11.3
2023-24,202401150WAS,1/15/2024,WAS vs DET,Delon Wright,wrighde01,18,WAS,1,DET,5,1,4,1,0,0,15.73333333,1,0,2,6,1,2,0,0,2,1,5,9,6,10,15.2
2023-24,202401150NYK,1/15/2024,NYK vs ORL,Jonathan Isaac,isaacjo01,23,ORL,0,NYK,5,7,0,0,1,0,15.9,1,6,2,4,1,2,0,0,1,1,7,5,12,12,16.4
2023-24,202401150DAL,1/15/2024,DAL vs NOP,Dwight Powell,poweldw01,38,DAL,1,NOP,4,4,2,0,2,0,16.03333333,3,1,2,2,0,0,0,0,5,2,6,6,8,10,17.8
2023-24,202401150TOR,1/15/2024,TOR vs BOS,Thaddeus Young,youngth01,12,TOR,1,BOS,0,4,7,2,0,0,16.08333333,2,2,0,4,0,1,0,0,2,2,11,7,4,11,21.3
2023-24,202401150TOR,1/15/2024,TOR vs BOS,Sam Hauser,hausesa01,39,BOS,0,TOR,3,5,0,0,1,0,16.18333333,0,5,1,2,1,1,0,0,0,1,5,3,8,8,12
2023-24,202401150PHI,1/15/2024,PHI vs HOU,Paul Reed,reedpa01,38,PHI,1,HOU,7,4,2,0,1,1,16.51666667,2,2,3,4,0,0,1,2,0,1,6,9,11,13,16.8
2023-24,202401150LAL,1/15/2024,LAL vs OKC,Kenrich Williams,willike04,28,OKC,0,LAL,5,2,0,1,0,0,16.51666667,0,2,2,5,1,3,0,0,1,1,2,5,7,7,10.4
2023-24,202401150UTA,1/15/2024,UTA vs IND,Jordan Nwora,nworajo01,18,IND,0,UTA,7,3,2,0,0,1,16.71666667,1,2,3,10,0,4,1,2,2,0,5,9,10,12,12.6
2023-24,202401150UTA,1/15/2024,UTA vs IND,Kelly Olynyk,olynyke01,40,UTA,1,IND,4,6,4,0,1,3,16.71666667,1,5,1,3,0,0,2,2,4,1,10,8,10,14,17.2
2023-24,202401150ATL,1/15/2024,ATL vs SAS,Dominick Barlow,barlodo01,17,SAS,0,ATL,4,7,1,1,0,0,16.8,0,7,1,4,0,0,2,4,2,1,8,5,11,12,16.9
2023-24,202401150MEM,1/15/2024,MEM vs GSW,Santi Aldama,aldamsa01,30,MEM,1,GSW,11,6,1,0,3,1,17.1,0,6,3,6,1,4,4,5,2,3,7,12,17,18,27.7
2023-24,202401150UTA,1/15/2024,UTA vs IND,Myles Turner,turnemy01,40,IND,0,UTA,12,4,0,0,0,2,17.15,1,3,4,8,1,2,3,4,5,0,4,12,16,16,14.8
2023-24,202401150MEM,1/15/2024,MEM vs GSW,Kevon Looney,looneke01,40,GSW,0,MEM,8,5,2,1,0,1,17.75,1,4,4,4,0,0,0,0,1,1,7,10,13,15,19
2023-24,202401150PHI,1/15/2024,PHI vs HOU,Danuel House Jr.,houseda01,24,PHI,1,HOU,6,5,1,0,0,0,17.85,2,3,2,4,1,1,1,1,4,0,6,7,11,12,13.5
2023-24,202401150TOR,1/15/2024,TOR vs BOS,Luke Kornet,kornelu01,27,BOS,0,TOR,4,3,0,0,1,0,17.86666667,0,3,2,2,0,0,0,0,1,1,3,4,7,7,10.6
2023-24,202401150LAL,1/15/2024,LAL vs OKC,Jarred Vanderbilt,vandeja01,21,LAL,1,OKC,5,4,2,3,0,0,18.1,0,4,2,2,0,0,1,1,0,3,6,7,9,11,21.8
2023-24,202401150CLE,1/15/2024,CLE vs CHI,Georges Niang,niangge01,38,CLE,1,CHI,9,2,0,0,1,1,18.53333333,0,2,3,11,3,9,0,0,2,1,2,9,11,11,13.4
2023-24,202401150UTA,1/15/2024,UTA vs IND,T.J. McConnell,mccontj01,33,IND,0,UTA,8,5,5,1,0,3,18.65,1,4,3,6,0,0,2,2,1,1,10,13,13,18,21.5
2023-24,202401150BRK,1/15/2024,BRK vs MIA,Nikola Jovic,jovicni01,14,MIA,0,BRK,5,3,2,0,0,0,18.73333333,0,3,2,4,1,3,0,0,0,0,5,7,8,10,11.6
2023-24,202401150NYK,1/15/2024,NYK vs ORL,Wendell Carter Jr.,cartewe01,14,ORL,0,NYK,17,3,0,0,1,0,18.88333333,1,2,7,11,1,3,2,2,1,1,3,17,20,20,23.6
2023-24,202401150DAL,1/15/2024,DAL vs NOP,Dyson Daniels,daniedy01,41,NOP,0,DAL,2,3,2,0,0,0,18.98333333,2,1,1,2,0,1,0,0,3,0,5,4,5,7,8.6
2023-24,202401150MEM,1/15/2024,MEM vs GSW,Jacob Gilyard,gilyaja01,23,MEM,1,GSW,11,2,3,2,1,0,19.11666667,0,2,4,7,3,4,0,0,0,3,5,14,13,16,26.9
2023-24,202401150CLE,1/15/2024,CLE vs CHI,Ayo Dosunmu,dosunay01,40,CHI,0,CLE,10,3,3,0,0,0,19.21666667,1,2,3,7,1,2,3,3,3,0,6,13,13,16,18.1
2023-24,202401150DAL,1/15/2024,DAL vs NOP,Maxi Kleber,klebima01,7,DAL,1,NOP,4,5,1,0,2,1,19.26666667,0,5,1,3,0,2,2,2,5,2,6,5,9,10,16.5
2023-24,202401150PHI,1/15/2024,PHI vs HOU,Amen Thompson,thompam01,20,HOU,0,PHI,14,3,0,1,0,1,19.26666667,2,1,7,8,0,1,0,1,2,1,3,14,17,17,19.6
2023-24,202401150UTA,1/15/2024,UTA vs IND,Jalen Smith,smithja04,27,IND,0,UTA,12,6,3,0,1,2,19.4,1,5,5,10,2,5,0,0,5,1,9,15,18,21,24.7
2023-24,202401150DAL,1/15/2024,DAL vs NOP,Jonas Valanciunas,valanjo01,41,NOP,0,DAL,6,6,2,0,2,3,19.46666667,4,2,2,5,0,0,2,2,4,2,8,8,12,14,19.2
2023-24,202401150NYK,1/15/2024,NYK vs ORL,Precious Achiuwa,achiupr01,33,NYK,1,ORL,6,5,1,0,1,1,19.5,3,2,2,4,0,0,2,2,0,1,6,7,11,12,15.5
2023-24,202401150LAL,1/15/2024,LAL vs OKC,Cason Wallace,wallaca01,39,OKC,0,LAL,5,0,1,2,1,1,19.65,0,0,2,6,1,4,0,0,0,3,1,6,5,6,14.5
2023-24,202401150MEM,1/15/2024,MEM vs GSW,Ziaire Williams,willizi02,38,MEM,1,GSW,4,3,0,1,0,1,19.8,2,1,1,6,1,5,1,4,2,1,3,4,7,7,9.6
2023-24,202401150LAL,1/15/2024,LAL vs OKC,Isaiah Joe,joeis01,39,OKC,0,LAL,4,7,1,2,0,1,20.03333333,2,5,2,10,0,6,0,0,1,2,8,5,11,12,18.9
2023-24,202401150ATL,1/15/2024,ATL vs SAS,Julian Champagnie,champju02,32,SAS,0,ATL,15,1,1,1,0,0,20.08333333,0,1,5,8,5,8,0,0,1,1,2,16,16,17,20.7
2023-24,202401150LAL,1/15/2024,LAL vs OKC,Rui Hachimura,hachiru01,28,LAL,1,OKC,12,3,0,0,2,1,20.15,1,2,5,8,2,3,0,0,1,2,3,12,15,15,20.6
2023-24,202401150UTA,1/15/2024,UTA vs IND,John Collins,collijo01,38,UTA,1,IND,10,6,1,0,0,1,20.23333333,4,2,3,8,0,2,4,4,0,0,7,11,16,17,17.7
2023-24,202401150NYK,1/15/2024,NYK vs ORL,Joe Ingles,inglejo01,26,ORL,0,NYK,6,1,4,0,0,1,20.26666667,0,1,3,6,0,1,0,0,2,0,5,10,7,11,12.2
2023-24,202401150CLE,1/15/2024,CLE vs CHI,Sam Merrill,merrisa01,23,CLE,1,CHI,15,3,2,2,0,0,20.26666667,1,2,5,7,4,6,1,1,4,2,5,17,18,20,27.6
2023-24,202401150BRK,1/15/2024,BRK vs MIA,Spencer Dinwiddie,dinwisp01,37,BRK,1,MIA,3,0,1,3,0,1,20.4,0,0,1,6,1,6,0,0,2,3,1,4,3,4,12.5
2023-24,202401150DAL,1/15/2024,DAL vs NOP,Jordan Hawkins,hawkijo01,36,NOP,0,DAL,9,1,0,1,0,0,20.76666667,0,1,3,4,1,2,2,2,3,1,1,9,10,10,13.2
2023-24,202401150NYK,1/15/2024,NYK vs ORL,Caleb Houstan,houstca01,31,ORL,0,NYK,7,1,0,0,0,0,21.38333333,1,0,1,7,1,7,4,5,4,0,1,7,8,8,8.2
2023-24,202401150MEM,1/15/2024,MEM vs GSW,David Roddy,roddyda01,37,MEM,1,GSW,12,7,2,0,0,2,21.4,3,4,5,12,2,4,0,0,1,0,9,14,19,21,21.4
2023-24,202401150UTA,1/15/2024,UTA vs IND,Kris Dunn,dunnkr01,34,UTA,1,IND,4,2,6,2,1,1,21.45,1,1,2,3,0,0,0,0,3,3,8,10,6,12,23.4
2023-24,202401150LAL,1/15/2024,LAL vs OKC,Josh Giddey,giddejo01,38,OKC,0,LAL,8,5,3,0,1,0,21.53333333,2,3,2,8,2,5,2,2,1,1,8,11,13,16,21.5
2023-24,202401150BRK,1/15/2024,BRK vs MIA,Duncan Robinson,robindu01,38,MIA,0,BRK,0,2,2,1,1,2,21.8,0,2,0,4,0,3,0,0,1,2,4,2,2,4,9.4
2023-24,202401150CLE,1/15/2024,CLE vs CHI,Andre Drummond,drumman01,42,CHI,0,CLE,8,10,1,2,2,2,22.21666667,3,7,3,3,0,0,2,4,2,4,11,9,18,19,31.5
2023-24,202401150DAL,1/15/2024,DAL vs NOP,Trey Murphy III,murphtr02,17,NOP,0,DAL,14,3,0,1,0,0,22.46666667,0,3,2,5,1,4,9,12,0,1,3,14,17,17,20.6
2023-24,202401150BRK,1/15/2024,BRK vs MIA,Cameron Johnson,johnsca02,31,BRK,1,MIA,6,2,0,0,0,0,22.55,0,2,3,13,0,8,0,0,3,0,2,6,8,8,8.4
2023-24,202401150UTA,1/15/2024,UTA vs IND,Buddy Hield,hieldbu01,41,IND,0,UTA,14,2,1,0,0,1,22.71666667,1,1,5,8,3,5,1,1,1,0,3,15,16,17,16.9
2023-24,202401150UTA,1/15/2024,UTA vs IND,Andrew Nembhard,nembhan01,28,IND,0,UTA,14,0,4,1,0,2,23.08333333,0,0,5,10,1,3,3,3,2,1,4,18,14,18,21
2023-24,202401150ATL,1/15/2024,ATL vs SAS,Onyeka Okongwu,okongon01,38,ATL,1,SAS,7,6,1,0,0,2,23.15,2,4,3,8,0,1,1,1,4,0,7,8,13,14,13.7
2023-24,202401150PHI,1/15/2024,PHI vs HOU,Cam Whitmore,whitmca01,16,HOU,0,PHI,14,6,1,1,0,0,23.41666667,2,4,6,12,2,5,0,1,3,1,7,15,20,21,25.7
2023-24,202401150NYK,1/15/2024,NYK vs ORL,Markelle Fultz,fultzma01,9,ORL,0,NYK,6,5,7,0,0,0,23.46666667,1,4,3,8,0,0,0,0,2,0,12,13,11,18,22.5
2023-24,202401150MEM,1/15/2024,MEM vs GSW,Dario Saric,saricda01,40,GSW,0,MEM,13,7,3,0,1,4,23.48333333,0,7,3,6,3,5,4,4,5,1,10,16,20,23,24.9
2023-24,202401150MEM,1/15/2024,MEM vs GSW,Draymond Green,greendr01,16,GSW,0,MEM,7,7,4,1,0,3,23.5,0,7,2,4,1,1,2,2,4,1,11,11,14,18,21.4
2023-24,202401150UTA,1/15/2024,UTA vs IND,Ochai Agbaji,agbajoc01,42,UTA,1,IND,4,4,0,0,1,1,23.71666667,0,4,1,4,0,1,2,2,2,1,4,4,8,8,10.8
2023-24,202401150NYK,1/15/2024,NYK vs ORL,Josh Hart,hartjo01,40,NYK,1,ORL,4,6,1,0,0,1,23.71666667,1,5,2,7,0,2,0,0,2,0,7,5,10,11,11.7
2023-24,202401150UTA,1/15/2024,UTA vs IND,Keyonte George,georgke01,36,UTA,1,IND,19,0,5,1,0,2,23.73333333,0,0,6,11,3,7,4,5,1,1,5,24,19,24,27.5
2023-24,202401150TOR,1/15/2024,TOR vs BOS,Payton Pritchard,pritcpa01,40,BOS,0,TOR,3,3,2,0,0,0,23.73333333,0,3,1,7,1,6,0,0,2,0,5,5,6,8,9.6
2023-24,202401150BRK,1/15/2024,BRK vs MIA,Kyle Lowry,lowryky01,34,MIA,0,BRK,2,4,5,1,0,1,23.9,0,4,1,5,0,2,0,0,3,1,9,7,6,11,16.3
2023-24,202401150UTA,1/15/2024,UTA vs IND,Collin Sexton,sextoco01,42,UTA,1,IND,30,3,5,0,0,1,24.26666667,1,2,11,17,4,5,4,4,2,0,8,35,33,38,40.1
2023-24,202401150NYK,1/15/2024,NYK vs ORL,Donte DiVincenzo,divindo01,40,NYK,1,ORL,15,6,4,0,1,0,24.28333333,2,4,5,12,2,8,3,6,2,1,10,19,21,25,31.2
2023-24,202401150UTA,1/15/2024,UTA vs IND,Simone Fontecchio,fontesi01,40,UTA,1,IND,8,4,2,0,0,1,24.28333333,0,4,3,5,2,3,0,0,2,0,6,10,12,14,14.8
2023-24,202401150WAS,1/15/2024,WAS vs DET,Killian Hayes,hayeski01,35,DET,0,WAS,4,1,6,0,0,1,24.48333333,0,1,2,4,0,1,0,0,1,0,7,10,5,11,13.2
2023-24,202401150ATL,1/15/2024,ATL vs SAS,Clint Capela,capelca01,37,ATL,1,SAS,13,12,0,0,4,1,24.85,6,6,5,7,0,0,3,6,2,4,12,13,25,25,38.4
2023-24,202401150UTA,1/15/2024,UTA vs IND,Walker Kessler,kesslwa01,34,UTA,1,IND,4,5,1,0,5,1,24.96666667,1,4,2,2,0,0,0,2,0,5,6,5,9,10,25.5
2023-24,202401150CLE,1/15/2024,CLE vs CHI,Isaac Okoro,okorois01,29,CLE,1,CHI,7,5,1,0,0,1,25.28333333,1,4,3,12,1,6,0,0,1,0,6,8,12,13,13.5
2023-24,202401150UTA,1/15/2024,UTA vs IND,Ben Sheppard,sheppbe01,19,IND,0,UTA,4,3,2,0,0,0,25.36666667,2,1,1,7,0,5,2,2,4,0,5,6,7,9,10.6
2023-24,202401150UTA,1/15/2024,UTA vs IND,Bennedict Mathurin,mathube01,41,IND,0,UTA,11,1,2,0,0,0,25.45,1,0,5,10,0,1,1,1,1,0,3,13,12,14,15.2
2023-24,202401150NYK,1/15/2024,NYK vs ORL,Chuma Okeke,okekech01,23,ORL,0,NYK,15,3,0,0,1,0,25.51666667,2,1,5,7,4,5,1,1,1,1,3,15,18,18,21.6
2023-24,202401150ATL,1/15/2024,ATL vs SAS,Bogdan Bogdanovic,bogdabo01,37,ATL,1,SAS,5,2,1,1,0,3,25.56666667,0,2,2,10,1,6,0,0,2,1,3,6,7,8,8.9
2023-24,202401150PHI,1/15/2024,PHI vs HOU,Kelly Oubre Jr.,oubreke01,26,PHI,1,HOU,7,2,0,4,0,1,25.8,0,2,3,8,1,3,0,0,3,4,2,7,9,9,20.4
2023-24,202401150WAS,1/15/2024,WAS vs DET,Jalen Duren,durenja01,25,DET,0,WAS,20,19,4,0,1,2,26,2,17,8,8,0,0,4,5,3,1,23,24,39,43,49.8
2023-24,202401150CLE,1/15/2024,CLE vs CHI,Dean Wade,wadede01,31,CLE,1,CHI,12,7,3,3,0,0,26,1,6,4,10,4,10,0,0,2,3,10,15,19,22,33.9
2023-24,202401150NYK,1/15/2024,NYK vs ORL,Cole Anthony,anthoco01,39,ORL,0,NYK,15,4,5,2,0,2,26.1,2,2,6,12,0,3,3,4,2,2,9,20,19,24,31.3
2023-24,202401150ATL,1/15/2024,ATL vs SAS,Keldon Johnson,johnske04,37,SAS,0,ATL,5,6,0,1,0,5,26.16666667,2,4,1,11,0,5,3,5,4,1,6,5,11,11,10.2
2023-24,202401150WAS,1/15/2024,WAS vs DET,Daniel Gafford,gaffoda01,36,WAS,1,DET,8,6,3,1,2,2,26.18333333,3,3,4,6,0,0,0,0,3,3,9,11,14,17,26.7
2023-24,202401150UTA,1/15/2024,UTA vs IND,Jarace Walker,walkeja02,14,IND,0,UTA,8,4,4,4,2,1,26.18333333,2,2,3,11,2,5,0,0,2,6,8,12,12,16,35.8
2023-24,202401150DAL,1/15/2024,DAL vs NOP,Dereck Lively II,livelde01,30,DAL,1,NOP,6,12,1,0,0,2,26.23333333,7,5,2,2,0,0,2,2,4,0,13,7,18,19,19.9
2023-24,202401150DAL,1/15/2024,DAL vs NOP,Larry Nance Jr.,nancela02,24,NOP,0,DAL,14,8,2,3,0,1,26.43333333,1,7,5,11,1,4,3,3,1,3,10,16,22,24,34.6
2023-24,202401150UTA,1/15/2024,UTA vs IND,Jordan Clarkson,clarkjo01,32,UTA,1,IND,17,3,2,2,0,2,26.55,0,3,6,13,0,3,5,6,1,2,5,19,20,22,27.6
2023-24,202401150NYK,1/15/2024,NYK vs ORL,Jalen Suggs,suggsja01,36,ORL,0,NYK,4,5,4,0,0,2,26.85,0,5,1,8,1,6,1,2,3,0,9,8,9,13,14
2023-24,202401150MEM,1/15/2024,MEM vs GSW,Brandin Podziemski,podzibr01,34,GSW,0,MEM,8,4,4,0,0,2,26.88333333,2,2,4,12,0,3,0,0,4,0,8,12,12,16,16.8
2023-24,202401150ATL,1/15/2024,ATL vs SAS,Victor Wembanyama,wembavi01,34,SAS,0,ATL,26,13,2,2,5,3,27.08333333,2,11,12,18,1,5,1,1,2,7,15,28,39,41,62.6
2023-24,202401150WAS,1/15/2024,WAS vs DET,Bilal Coulibaly,coulibi01,38,WAS,1,DET,2,4,2,0,0,0,27.13333333,1,3,1,4,0,1,0,0,2,0,6,4,6,8,9.8
2023-24,202401150WAS,1/15/2024,WAS vs DET,Ausar Thompson,thompau01,40,DET,0,WAS,14,8,2,3,0,0,27.18333333,1,7,6,8,0,1,2,3,2,3,10,16,22,24,35.6
2023-24,202401150PHI,1/15/2024,PHI vs HOU,Jalen Green,greenja05,39,HOU,0,PHI,20,5,3,0,0,2,27.28333333,0,5,7,16,1,7,5,7,2,0,8,23,25,28,28.5
2023-24,202401150WAS,1/15/2024,WAS vs DET,Deni Avdija,avdijde01,39,WAS,1,DET,12,2,4,0,2,3,27.55,0,2,4,8,1,2,3,4,1,2,6,16,14,18,23.4
2023-24,202401150PHI,1/15/2024,PHI vs HOU,Nicolas Batum,batumni01,27,PHI,1,HOU,5,5,3,2,1,0,27.55,2,3,2,7,1,3,0,0,2,3,8,8,10,13,24.5
2023-24,202401150BRK,1/15/2024,BRK vs MIA,Josh Richardson,richajo01,31,MIA,0,BRK,9,5,1,0,1,1,27.96666667,1,4,3,13,2,6,1,1,2,1,6,10,14,15,18.5
2023-24,202401150BRK,1/15/2024,BRK vs MIA,Dorian Finney-Smith,finnedo01,36,BRK,1,MIA,5,7,2,0,2,0,28.33333333,2,5,1,6,1,5,2,2,0,2,9,7,12,14,22.4
2023-24,202401150NYK,1/15/2024,NYK vs ORL,Isaiah Hartenstein,harteis01,40,NYK,1,ORL,7,12,3,0,0,2,28.48333333,5,7,3,6,0,0,1,1,5,0,15,10,19,22,23.9
2023-24,202401150UTA,1/15/2024,UTA vs IND,Lauri Markkanen,markkla01,32,UTA,1,IND,32,10,3,0,0,1,28.48333333,2,8,10,15,2,4,10,10,1,0,13,35,42,45,47.5
2023-24,202401150PHI,1/15/2024,PHI vs HOU,Patrick Beverley,beverpa01,37,PHI,1,HOU,11,5,6,1,1,3,28.58333333,0,5,3,8,1,4,4,6,2,2,11,17,16,22,29
2023-24,202401150WAS,1/15/2024,WAS vs DET,Alec Burks,burksal01,33,DET,0,WAS,34,2,2,0,0,1,28.61666667,0,2,11,17,8,12,4,4,2,0,4,36,36,38,38.4
2023-24,202401150NYK,1/15/2024,NYK vs ORL,Goga Bitadze,bitadgo01,36,ORL,0,NYK,3,11,3,0,0,0,29,4,7,1,3,0,0,1,2,3,0,14,6,14,17,20.7
2023-24,202401150DAL,1/15/2024,DAL vs NOP,CJ McCollum,mccolcj01,27,NOP,0,DAL,23,6,4,1,0,0,29,0,6,9,17,3,7,2,2,5,1,10,27,29,33,39.2
2023-24,202401150MEM,1/15/2024,MEM vs GSW,Jonathan Kuminga,kuminjo01,39,GSW,0,MEM,20,11,0,0,0,3,29.11666667,2,9,9,18,1,5,1,1,3,0,11,20,31,31,30.2
2023-24,202401150MEM,1/15/2024,MEM vs GSW,GG Jackson II,jacksgg01,8,MEM,1,GSW,23,6,1,2,2,2,29.16666667,1,5,6,9,5,8,6,8,3,4,7,24,29,30,41.7
2023-24,202401150DAL,1/15/2024,DAL vs NOP,Herbert Jones,joneshe01,38,NOP,0,DAL,10,3,3,0,0,0,29.26666667,1,2,4,5,1,1,1,1,2,0,6,13,13,16,18.1
2023-24,202401150LAL,1/15/2024,LAL vs OKC,Luguentz Dort,dortlu01,38,OKC,0,LAL,11,7,1,1,0,1,29.41666667,4,3,4,9,3,8,0,0,2,1,8,12,18,19,22.9
2023-24,202401150DAL,1/15/2024,DAL vs NOP,Josh Green,greenjo02,29,DAL,1,NOP,13,4,3,0,0,1,29.83333333,1,3,4,8,3,5,2,6,5,0,7,16,17,20,21.3
2023-24,202401150PHI,1/15/2024,PHI vs HOU,Alperen Sengun,sengual01,39,HOU,0,PHI,19,9,6,1,2,5,30.15,5,4,7,15,1,1,4,6,1,3,15,25,28,34,42.8
2023-24,202401150BRK,1/15/2024,BRK vs MIA,Royce O'Neale,onealro01,38,BRK,1,MIA,15,9,5,0,1,0,30.16666667,1,8,5,10,5,10,0,0,4,1,14,20,24,29,36.3
2023-24,202401150ATL,1/15/2024,ATL vs SAS,Tre Jones,jonestr01,35,SAS,0,ATL,6,1,12,3,0,3,30.18333333,0,1,3,8,0,1,0,0,0,3,13,18,7,19,31.2
2023-24,202401150MEM,1/15/2024,MEM vs GSW,Xavier Tillman Sr.,tillmxa01,28,MEM,1,GSW,2,4,3,1,2,0,30.28333333,1,3,1,6,0,2,0,0,0,3,7,5,6,9,20.3
2023-24,202401150ATL,1/15/2024,ATL vs SAS,Devin Vassell,vassede01,34,SAS,0,ATL,4,4,4,0,1,0,30.45,1,3,2,11,0,5,0,0,0,1,8,8,8,12,17.8
2023-24,202401150LAL,1/15/2024,LAL vs OKC,Chet Holmgren,holmgch01,39,OKC,0,LAL,9,8,4,1,3,3,30.48333333,1,7,4,9,1,4,0,0,5,4,12,13,17,21,33.6
2023-24,202401150CLE,1/15/2024,CLE vs CHI,Caris LeVert,leverca01,30,CLE,1,CHI,16,7,7,0,0,3,30.48333333,1,6,6,17,4,10,0,0,2,0,14,23,23,30,31.9
2023-24,202401150PHI,1/15/2024,PHI vs HOU,Tobias Harris,harrito02,37,PHI,1,HOU,10,3,2,0,0,1,30.83333333,0,3,3,7,2,3,2,2,2,0,5,12,13,15,15.6
2023-24,202401150MEM,1/15/2024,MEM vs GSW,Andrew Wiggins,wiggian01,36,GSW,0,MEM,16,5,1,0,2,1,30.83333333,1,4,7,13,1,3,1,2,1,2,6,17,21,22,28.5
2023-24,202401150LAL,1/15/2024,LAL vs OKC,Taurean Prince,princta02,40,LAL,1,OKC,3,2,3,0,1,0,30.85,0,2,1,6,1,5,0,0,2,1,5,6,5,8,12.9
2023-24,202401150CLE,1/15/2024,CLE vs CHI,Alex Caruso,carusal01,35,CHI,0,CLE,10,3,3,3,1,2,30.86666667,0,3,4,9,2,5,0,0,1,4,6,13,13,16,28.1
2023-24,202401150PHI,1/15/2024,PHI vs HOU,Jabari Smith Jr.,smithja05,38,HOU,0,PHI,13,7,2,0,0,2,31,1,6,5,9,0,1,3,5,3,0,9,15,20,22,22.4
2023-24,202401150DAL,1/15/2024,DAL vs NOP,Grant Williams,willigr01,37,DAL,1,NOP,7,3,7,3,0,0,31.05,0,3,3,7,1,4,0,0,5,3,10,14,10,17,30.1
2023-24,202401150WAS,1/15/2024,WAS vs DET,Tyus Jones,jonesty01,39,WAS,1,DET,22,6,7,1,0,0,31.18333333,2,4,9,19,4,10,0,0,0,1,13,29,28,35,42.7
2023-24,202401150PHI,1/15/2024,PHI vs HOU,Joel Embiid,embiijo01,28,PHI,1,HOU,41,10,3,1,1,2,31.26666667,2,8,12,21,1,5,16,17,5,2,13,44,51,54,61.5
2023-24,202401150PHI,1/15/2024,PHI vs HOU,Dillon Brooks,brookdi01,30,HOU,0,PHI,18,6,0,2,0,0,31.35,2,4,7,9,2,3,2,4,2,2,6,18,24,24,31.2
2023-24,202401150BRK,1/15/2024,BRK vs MIA,Cam Thomas,thomaca02,30,BRK,1,MIA,23,2,3,0,0,2,31.78333333,0,2,7,20,2,10,7,7,2,0,5,26,25,28,27.9
2023-24,202401150WAS,1/15/2024,WAS vs DET,Jordan Poole,poolejo01,38,WAS,1,DET,16,0,2,0,0,1,31.83333333,0,0,6,14,2,7,2,2,3,0,2,18,16,18,18
2023-24,202401150TOR,1/15/2024,TOR vs BOS,Kristaps Porzingis,porzikr01,30,BOS,0,TOR,15,6,2,0,2,6,31.88333333,0,6,2,6,1,4,10,12,4,2,8,17,21,23,25.2
2023-24,202401150MEM,1/15/2024,MEM vs GSW,Luke Kennard,kennalu01,17,MEM,1,GSW,11,2,5,1,0,1,31.93333333,1,1,2,9,2,7,5,5,1,1,7,16,13,18,22.9
2023-24,202401150DAL,1/15/2024,DAL vs NOP,Brandon Ingram,ingrabr01,37,NOP,0,DAL,12,5,5,1,0,1,32.08333333,0,5,3,14,0,4,6,8,3,1,10,17,17,22,27.5
2023-24,202401150DAL,1/15/2024,DAL vs NOP,Zion Williamson,willizi01,33,NOP,0,DAL,30,1,3,1,0,3,32.36666667,0,1,12,17,0,0,6,11,2,1,4,33,31,34,35.7
2023-24,202401150BRK,1/15/2024,BRK vs MIA,Dennis Smith Jr.,smithde03,24,BRK,1,MIA,8,5,5,4,1,2,32.38333333,1,4,3,8,1,4,1,2,2,5,10,13,13,18,34.5
2023-24,202401150WAS,1/15/2024,WAS vs DET,Jaden Ivey,iveyja01,36,DET,0,WAS,24,7,6,0,3,5,32.46666667,1,6,9,18,2,7,4,7,0,3,13,30,31,37,45.4
2023-24,202401150PHI,1/15/2024,PHI vs HOU,Fred VanVleet,vanvlfr01,38,HOU,0,PHI,8,1,5,0,2,1,32.53333333,0,1,2,5,2,4,2,4,4,2,6,13,9,14,21.7
2023-24,202401150NYK,1/15/2024,NYK vs ORL,Paolo Banchero,banchpa01,40,ORL,0,NYK,20,6,3,0,0,2,32.6,1,5,9,19,0,2,2,5,1,0,9,23,26,29,29.7
2023-24,202401150TOR,1/15/2024,TOR vs BOS,Dennis Schroder,schrode01,40,TOR,1,BOS,13,7,2,0,0,2,32.6,0,7,5,9,1,3,2,2,4,0,9,15,20,22,22.4
2023-24,202401150MEM,1/15/2024,MEM vs GSW,Stephen Curry,curryst01,37,GSW,0,MEM,26,4,8,2,1,5,32.73333333,1,3,11,20,3,9,1,1,4,3,12,34,30,38,46.8
2023-24,202401150ATL,1/15/2024,ATL vs SAS,Saddiq Bey,beysa01,39,ATL,1,SAS,10,5,2,0,0,0,32.83333333,4,1,3,9,1,7,3,4,3,0,7,12,15,17,19
2023-24,202401150ATL,1/15/2024,ATL vs SAS,Dejounte Murray,murrade01,39,ATL,1,SAS,13,13,0,0,1,2,32.83333333,0,13,6,15,1,6,0,0,3,1,13,13,26,26,29.6
2023-24,202401150WAS,1/15/2024,WAS vs DET,Kevin Knox,knoxke01,22,DET,0,WAS,5,2,1,0,0,1,32.86666667,2,0,1,7,1,4,2,2,0,0,3,6,7,8,7.9
2023-24,202401150WAS,1/15/2024,WAS vs DET,Kyle Kuzma,kuzmaky01,39,WAS,1,DET,21,8,4,3,2,0,33.15,0,8,7,21,3,9,4,4,2,5,12,25,29,33,51.6
2023-24,202401150LAL,1/15/2024,LAL vs OKC,Austin Reaves,reaveau01,42,LAL,1,OKC,15,3,7,0,1,2,33.16666667,0,3,6,10,1,3,2,2,0,1,10,22,18,25,30.1
2023-24,202401150MEM,1/15/2024,MEM vs GSW,Jaren Jackson Jr.,jacksja02,38,MEM,1,GSW,18,5,5,4,1,1,33.3,0,5,4,20,3,14,7,8,1,5,10,23,23,28,45.5
2023-24,202401150TOR,1/15/2024,TOR vs BOS,Jrue Holiday,holidjr01,37,BOS,0,TOR,22,6,7,1,2,1,33.93333333,1,5,7,14,4,6,4,4,2,3,13,29,28,35,47.7
2023-24,202401150BRK,1/15/2024,BRK vs MIA,Caleb Martin,martica02,23,MIA,0,BRK,9,3,1,1,1,1,33.98333333,0,3,3,8,1,4,2,2,1,2,4,10,12,13,19.1
2023-24,202401150CLE,1/15/2024,CLE vs CHI,Jarrett Allen,allenja01,33,CLE,1,CHI,10,14,3,2,1,2,34.08333333,5,9,4,5,0,0,2,2,1,3,17,13,24,27,38.3
2023-24,202401150MEM,1/15/2024,MEM vs GSW,Klay Thompson,thompkl01,39,GSW,0,MEM,9,0,3,0,0,0,34.11666667,0,0,4,10,1,4,0,0,1,0,3,12,9,12,13.5
2023-24,202401150LAL,1/15/2024,LAL vs OKC,Shai Gilgeous-Alexander,gilgesh01,38,OKC,0,LAL,24,3,6,1,1,3,34.3,0,3,9,19,1,6,5,5,3,2,9,30,27,33,39.6
2023-24,202401150CLE,1/15/2024,CLE vs CHI,Zach LaVine,lavinza01,24,CHI,0,CLE,17,4,4,0,0,3,34.66666667,0,4,7,14,3,6,0,0,3,0,8,21,21,25,24.8
2023-24,202401150LAL,1/15/2024,LAL vs OKC,Jalen Williams,willija06,36,OKC,0,LAL,25,3,6,3,0,1,34.8,2,1,10,18,2,4,3,4,1,3,9,31,28,34,45.6
2023-24,202401150CLE,1/15/2024,CLE vs CHI,Max Strus,strusma01,38,CLE,1,CHI,2,5,4,0,1,2,35.01666667,1,4,1,8,0,6,0,0,2,1,9,6,7,11,15
2023-24,202401150TOR,1/15/2024,TOR vs BOS,Al Horford,horfoal01,33,BOS,0,TOR,10,11,2,1,0,1,35.16666667,2,9,4,10,2,4,0,0,3,1,13,12,21,23,28.2
2023-24,202401150PHI,1/15/2024,PHI vs HOU,Tyrese Maxey,maxeyty01,37,PHI,1,HOU,27,1,7,0,0,2,35.36666667,0,1,8,18,6,10,5,5,4,0,8,34,28,35,36.7
2023-24,202401150LAL,1/15/2024,LAL vs OKC,D'Angelo Russell,russeda01,38,LAL,1,OKC,14,2,6,2,1,5,35.8,1,1,5,12,2,7,2,2,2,3,8,20,16,22,29.4
2023-24,202401150NYK,1/15/2024,NYK vs ORL,Miles McBride,mcbrimi01,27,NYK,1,ORL,20,2,1,2,1,1,36.08333333,0,2,8,17,4,10,0,0,4,3,3,21,22,23,31.9
2023-24,202401150TOR,1/15/2024,TOR vs BOS,RJ Barrett,barrerj01,34,TOR,1,BOS,24,9,4,0,0,0,36.28333333,0,9,11,19,0,4,2,3,4,0,13,28,33,37,40.8
2023-24,202401150CLE,1/15/2024,CLE vs CHI,Donovan Mitchell,mitchdo01,29,CLE,1,CHI,34,3,7,2,0,2,36.5,2,1,11,21,4,10,8,8,0,2,10,41,37,44,52.1
2023-24,202401150TOR,1/15/2024,TOR vs BOS,Pascal Siakam,siakapa01,39,TOR,1,BOS,17,5,4,1,0,0,36.56666667,2,3,5,15,0,6,7,8,1,1,9,21,22,26,32
2023-24,202401150TOR,1/15/2024,TOR vs BOS,Immanuel Quickley,quickim01,38,TOR,1,BOS,21,6,3,1,1,0,36.73333333,0,6,8,20,2,7,3,4,3,2,9,24,27,30,38.7
2023-24,202401150TOR,1/15/2024,TOR vs BOS,Derrick White,whitede01,37,BOS,0,TOR,22,2,1,0,0,3,37,0,2,7,18,5,11,3,3,1,0,3,23,24,25,22.9
2023-24,202401150CLE,1/15/2024,CLE vs CHI,Nikola Vucevic,vucevni01,37,CHI,0,CLE,17,10,4,0,0,2,37.06666667,0,10,8,19,1,7,0,0,3,0,14,21,27,31,33
2023-24,202401150TOR,1/15/2024,TOR vs BOS,Jayson Tatum,tatumja01,37,BOS,0,TOR,19,14,6,1,1,1,37.46666667,0,14,7,19,1,6,4,4,2,2,20,25,33,39,49.8
2023-24,202401150ATL,1/15/2024,ATL vs SAS,Jalen Johnson,johnsja05,25,ATL,1,SAS,16,10,7,6,0,5,37.6,0,10,7,13,1,2,1,1,3,6,17,23,26,33,51.5
2023-24,202401150ATL,1/15/2024,ATL vs SAS,Trae Young,youngtr01,37,ATL,1,SAS,36,6,13,1,1,3,37.6,0,6,11,24,6,11,8,9,0,2,19,49,42,55,65.7
2023-24,202401150BRK,1/15/2024,BRK vs MIA,Tyler Herro,herroty01,21,MIA,0,BRK,29,11,2,0,0,4,37.61666667,1,10,11,22,4,11,3,4,3,0,13,31,40,42,41.2
2023-24,202401150WAS,1/15/2024,WAS vs DET,Isaiah Stewart,stewais01,30,DET,0,WAS,16,6,4,1,2,3,37.68333333,4,2,7,17,1,6,1,2,4,3,10,20,22,26,35.2
2023-24,202401150MEM,1/15/2024,MEM vs GSW,Vince Williams Jr.,willivi01,30,MEM,1,GSW,24,7,4,2,1,3,37.86666667,3,4,6,11,3,6,9,10,2,3,11,28,31,35,44.4
2023-24,202401150ATL,1/15/2024,ATL vs SAS,Jeremy Sochan,sochaje01,39,SAS,0,ATL,23,8,4,2,2,4,38.08333333,3,5,8,16,2,4,5,5,4,4,12,27,31,35,46.6
2023-24,202401150CLE,1/15/2024,CLE vs CHI,DeMar DeRozan,derozde01,40,CHI,0,CLE,6,6,3,2,1,2,38.11666667,0,6,3,8,0,1,0,0,3,3,9,9,12,15,24.7
2023-24,202401150CLE,1/15/2024,CLE vs CHI,Coby White,whiteco01,42,CHI,0,CLE,18,4,3,1,2,7,38.13333333,1,3,5,15,1,5,7,9,0,3,7,21,22,25,29.3
2023-24,202401150NYK,1/15/2024,NYK vs ORL,Julius Randle,randlju01,40,NYK,1,ORL,15,6,5,0,0,0,38.35,1,5,5,18,2,9,3,5,3,0,11,20,21,26,29.7
2023-24,202401150LAL,1/15/2024,LAL vs OKC,Anthony Davis,davisan02,40,LAL,1,OKC,27,15,5,2,1,2,38.4,3,12,9,17,0,1,9,10,3,3,20,32,42,47,59.5
2023-24,202401150LAL,1/15/2024,LAL vs OKC,LeBron James,jamesle01,38,LAL,1,OKC,25,7,6,0,0,5,38.91666667,0,7,12,20,1,2,0,1,1,0,13,31,32,38,37.4
2023-24,202401150BRK,1/15/2024,BRK vs MIA,Jimmy Butler,butleji01,25,MIA,0,BRK,31,5,4,2,0,1,40.3,2,3,8,12,0,0,15,16,2,2,9,35,36,40,48
2023-24,202401150DAL,1/15/2024,DAL vs NOP,Tim Hardaway Jr.,hardati02,38,DAL,1,NOP,41,2,2,1,0,4,40.63333333,0,2,11,23,9,15,10,10,0,1,4,43,43,45,45.4
2023-24,202401150TOR,1/15/2024,TOR vs BOS,Scottie Barnes,barnesc01,40,TOR,1,BOS,10,13,2,2,0,4,40.66666667,2,11,5,12,0,2,0,0,2,2,15,12,23,25,30.6
2023-24,202401150DAL,1/15/2024,DAL vs NOP,Kyrie Irving,irvinky01,25,DAL,1,NOP,42,7,7,0,1,3,41.4,0,7,13,28,3,9,13,15,1,1,14,49,49,56,60.9
2023-24,202401150BRK,1/15/2024,BRK vs MIA,Nic Claxton,claxtni01,29,BRK,1,MIA,9,13,2,0,2,1,42.58333333,2,11,4,9,0,0,1,1,1,2,15,11,22,24,32.6
2023-24,202401150NYK,1/15/2024,NYK vs ORL,OG Anunoby,anunoog01,35,NYK,1,ORL,17,2,4,0,0,2,43.73333333,1,1,5,11,3,4,4,4,2,0,6,21,19,23,23.4
2023-24,202401150BRK,1/15/2024,BRK vs MIA,Bam Adebayo,adebaba01,30,MIA,0,BRK,11,20,4,1,1,2,43.81666667,2,18,5,17,0,1,1,2,2,2,24,15,31,35,45
2023-24,202401150BRK,1/15/2024,BRK vs MIA,Mikal Bridges,bridgmi01,39,BRK,1,MIA,26,9,6,2,2,1,43.85,2,7,10,23,2,10,4,4,1,4,15,32,35,41,56.8
2023-24,202401140MIL,1/14/2024,MIL vs SAC,Andre Jackson Jr.,jacksan01,34,MIL,1,SAC,0,0,1,0,0,2,10,0,0,0,0,0,0,0,0,5,0,1,1,0,1,-0.5
2023-24,202401140MIA,1/14/2024,MIA vs CHO,Nathan Mensah,mensana01,13,CHO,0,MIA,2,2,0,0,0,0,11.16666667,2,0,1,1,0,0,0,0,3,0,2,2,4,4,4.4
2023-24,202401140MIL,1/14/2024,MIL vs SAC,Alex Len,lenal01,15,SAC,0,MIL,4,5,1,0,0,0,11.36666667,3,2,2,4,0,1,0,0,3,0,6,5,9,10,11.5
2023-24,202401140MIL,1/14/2024,MIL vs SAC,Cameron Payne,payneca01,38,MIL,1,SAC,15,0,1,1,0,0,11.58333333,0,0,5,7,3,4,2,2,0,1,1,16,15,16,19.5
2023-24,202401140MIA,1/14/2024,MIA vs CHO,Ish Smith,smithis01,31,CHO,0,MIA,1,2,0,0,0,0,12.46666667,1,1,0,1,0,0,1,2,0,0,2,1,3,3,3.4
2023-24,202401140DEN,1/14/2024,DEN vs IND,Jordan Nwora,nworajo01,17,IND,0,DEN,3,1,1,1,0,0,12.91666667,0,1,1,5,1,4,0,0,1,1,2,4,4,5,8.7
2023-24,202401140POR,1/14/2024,POR vs PHO,Keita Bates-Diop,bateske01,29,PHO,0,POR,4,2,3,0,0,0,13.16666667,1,1,2,3,0,1,0,0,1,0,5,7,6,9,10.9
2023-24,202401140DEN,1/14/2024,DEN vs IND,Peyton Watson,watsope01,39,DEN,1,IND,0,3,0,1,0,0,13.65,0,3,0,3,0,0,0,0,3,1,3,0,3,3,6.6
2023-24,202401140MIN,1/14/2024,MIN vs LAC,Naz Reid,reidna01,39,MIN,1,LAC,8,1,1,2,0,1,14.38333333,0,1,3,5,2,3,0,0,2,2,2,9,9,10,15.7
2023-24,202401140POR,1/14/2024,POR vs PHO,Rayan Rupert,ruperra01,13,POR,1,PHO,11,5,2,0,0,1,14.41666667,2,3,4,5,3,3,0,0,2,0,7,13,16,18,19
2023-24,202401140MIA,1/14/2024,MIA vs CHO,Jaime Jaquez Jr.,jaqueja01,39,MIA,1,CHO,15,5,2,1,0,0,14.61666667,1,4,7,11,0,0,1,1,1,1,7,17,20,22,27
2023-24,202401140DEN,1/14/2024,DEN vs IND,Christian Braun,braunch01,41,DEN,1,IND,2,2,0,0,0,0,14.75,0,2,1,5,0,1,0,2,1,0,2,2,4,4,4.4
2023-24,202401140MIN,1/14/2024,MIN vs LAC,Mason Plumlee,plumlma01,9,LAC,0,MIN,8,3,0,1,0,0,15.66666667,0,3,4,5,0,0,0,0,4,1,3,8,11,11,14.6
2023-24,202401140MIA,1/14/2024,MIA vs CHO,Nick Smith Jr.,smithni01,22,CHO,0,MIA,4,2,0,0,0,2,16.28333333,0,2,2,5,0,2,0,0,0,0,2,4,6,6,4.4
2023-24,202401140POR,1/14/2024,POR vs PHO,Chimezie Metu,metuch01,29,PHO,0,POR,8,3,0,1,2,0,17.1,0,3,3,3,1,1,1,2,3,3,3,8,11,11,20.6
2023-24,202401140POR,1/14/2024,POR vs PHO,Justin Minaya,minayju01,10,POR,1,PHO,1,2,0,0,0,0,17.18333333,0,2,0,1,0,1,1,2,5,0,2,1,3,3,3.4
2023-24,202401140MIL,1/14/2024,MIL vs SAC,A.J. Green,greenaj01,25,MIL,1,SAC,5,0,0,0,0,0,17.5,0,0,1,5,1,4,2,2,2,0,0,5,5,5,5
2023-24,202401140MIN,1/14/2024,MIN vs LAC,Terance Mann,mannte01,33,LAC,0,MIN,2,3,0,0,0,0,18.9,2,1,1,2,0,1,0,0,3,0,3,2,5,5,5.6
2023-24,202401140DEN,1/14/2024,DEN vs IND,T.J. McConnell,mccontj01,32,IND,0,DEN,5,2,5,0,0,1,19.25,1,1,2,9,0,2,1,2,0,0,7,10,7,12,13.9
2023-24,202401140MIL,1/14/2024,MIL vs SAC,Keegan Murray,murrake02,35,SAC,0,MIL,4,1,0,0,1,0,19.46666667,0,1,2,9,0,2,0,0,1,1,1,4,5,5,8.2
2023-24,202401140MIA,1/14/2024,MIA vs CHO,Josh Richardson,richajo01,30,MIA,1,CHO,11,2,0,0,0,1,19.53333333,1,1,4,8,2,3,1,1,1,0,2,11,13,13,12.4
2023-24,202401140DEN,1/14/2024,DEN vs IND,Isaiah Jackson,jacksis01,32,IND,0,DEN,12,7,1,2,0,2,19.58333333,3,4,6,9,0,0,0,0,3,2,8,13,19,20,25.9
2023-24,202401140MIN,1/14/2024,MIN vs LAC,Nickeil Alexander-Walker,alexani01,39,MIN,1,LAC,6,0,1,0,1,0,19.98333333,0,0,2,6,2,5,0,0,4,1,1,7,6,7,10.5
2023-24,202401140DEN,1/14/2024,DEN vs IND,Bennedict Mathurin,mathube01,40,IND,0,DEN,12,3,2,0,0,2,21.6,1,2,3,9,1,3,5,5,3,0,5,14,15,17,16.6
2023-24,202401140MIN,1/14/2024,MIN vs LAC,Daniel Theis,theisda01,29,LAC,0,MIN,3,4,0,1,0,0,21.61666667,1,3,1,3,1,2,0,0,3,1,4,3,7,7,10.8
2023-24,202401140POR,1/14/2024,POR vs PHO,Toumani Camara,camarto01,38,POR,1,PHO,2,2,2,0,0,0,22.71666667,2,0,1,4,0,2,0,0,1,0,4,4,4,6,7.4
2023-24,202401140MIA,1/14/2024,MIA vs CHO,Cody Martin,martico01,8,CHO,0,MIA,3,2,2,0,2,3,22.8,2,0,1,3,1,2,0,0,1,2,4,5,5,7,11.4
2023-24,202401140DEN,1/14/2024,DEN vs IND,Reggie Jackson,jacksre01,41,DEN,1,IND,9,0,4,1,0,3,23.4,0,0,3,3,0,0,3,4,1,1,4,13,9,13,15
2023-24,202401140POR,1/14/2024,POR vs PHO,Eric Gordon,gordoer01,33,PHO,0,POR,3,2,4,1,0,0,24.38333333,0,2,1,4,1,3,0,0,0,1,6,7,5,9,14.4
2023-24,202401140MIA,1/14/2024,MIA vs CHO,Caleb Martin,martica02,22,MIA,1,CHO,2,3,2,1,0,1,24.93333333,0,3,1,5,0,2,0,0,2,1,5,4,5,7,10.6
2023-24,202401140DEN,1/14/2024,DEN vs IND,Jalen Smith,smithja04,26,IND,0,DEN,8,3,3,0,0,0,25.33333333,2,1,4,7,0,1,0,1,2,0,6,11,11,14,16.1
2023-24,202401140DEN,1/14/2024,DEN vs IND,Obi Toppin,toppiob01,40,IND,0,DEN,11,3,1,1,0,0,25.46666667,0,3,4,5,3,3,0,0,2,1,4,12,14,15,19.1
2023-24,202401140MIL,1/14/2024,MIL vs SAC,Bobby Portis,portibo01,40,MIL,1,SAC,22,10,1,0,0,2,25.55,2,8,9,11,2,2,2,2,1,0,11,23,32,33,33.5
2023-24,202401140DEN,1/14/2024,DEN vs IND,Myles Turner,turnemy01,39,IND,0,DEN,12,4,1,2,1,3,25.58333333,1,3,5,11,0,4,2,3,5,3,5,13,16,17,24.3
2023-24,202401140MIA,1/14/2024,MIA vs CHO,Kyle Lowry,lowryky01,33,MIA,1,CHO,0,4,3,0,1,2,25.86666667,0,4,0,3,0,1,0,0,1,1,7,3,4,7,10.3
2023-24,202401140MIN,1/14/2024,MIN vs LAC,Kyle Anderson,anderky01,39,MIN,1,LAC,10,1,3,1,0,0,26.7,0,1,4,6,1,1,1,3,4,1,4,13,11,14,18.7
2023-24,202401140MIA,1/14/2024,MIA vs CHO,Nick Richards,richani01,31,CHO,0,MIA,2,8,0,0,0,1,26.73333333,0,8,1,5,0,0,0,0,4,0,8,2,10,10,10.6
2023-24,202401140POR,1/14/2024,POR vs PHO,Jusuf Nurkic,nurkiju01,37,PHO,0,POR,14,13,1,3,1,1,27.25,4,9,5,8,0,0,4,6,3,4,14,15,27,28,42.1
2023-24,202401140MIA,1/14/2024,MIA vs CHO,Nikola Jovic,jovicni01,13,MIA,1,CHO,5,7,2,0,2,3,27.86666667,1,6,2,6,1,2,0,0,3,2,9,7,12,14,19.4
2023-24,202401140DEN,1/14/2024,DEN vs IND,Buddy Hield,hieldbu01,40,IND,0,DEN,16,2,1,2,0,1,28,0,2,6,13,2,9,2,2,2,2,3,17,18,19,24.9
2023-24,202401140MIA,1/14/2024,MIA vs CHO,P.J. Washington,washipj01,31,CHO,0,MIA,5,6,1,1,0,1,28.41666667,2,4,2,7,1,5,0,2,3,1,7,6,11,12,15.7
2023-24,202401140MIA,1/14/2024,MIA vs CHO,Tyler Herro,herroty01,20,MIA,1,CHO,21,7,4,1,0,3,28.46666667,1,6,7,15,4,9,3,4,1,1,11,25,28,32,35.4
2023-24,202401140DEN,1/14/2024,DEN vs IND,Andrew Nembhard,nembhan01,27,IND,0,DEN,12,2,7,0,0,2,28.75,1,1,4,8,0,1,4,6,0,0,9,19,14,21,22.9
2023-24,202401140POR,1/14/2024,POR vs PHO,Jabari Walker,walkeja01,35,POR,1,PHO,11,8,1,0,0,1,28.83333333,2,6,4,6,2,3,1,2,2,0,9,12,19,20,21.1
2023-24,202401140MIN,1/14/2024,MIN vs LAC,Russell Westbrook,westbru01,39,LAC,0,MIN,12,8,13,2,0,3,29.1,3,5,3,8,2,2,4,5,4,2,21,25,20,33,44.1
2023-24,202401140MIN,1/14/2024,MIN vs LAC,Norman Powell,powelno01,39,LAC,0,MIN,24,1,0,0,2,1,29.9,0,1,9,12,6,9,0,0,1,2,1,24,25,25,30.2
2023-24,202401140MIA,1/14/2024,MIA vs CHO,Duncan Robinson,robindu01,37,MIA,1,CHO,19,4,5,1,1,2,30.06666667,0,4,7,11,3,6,2,2,2,2,9,24,23,28,35.3
2023-24,202401140MIA,1/14/2024,MIA vs CHO,LaMelo Ball,ballla01,17,CHO,0,MIA,21,10,5,3,0,2,30.48333333,2,8,9,24,3,13,0,0,3,3,15,26,31,36,47.5
2023-24,202401140MIA,1/14/2024,MIA vs CHO,Haywood Highsmith,highsha01,25,MIA,1,CHO,7,2,2,2,1,0,31.1,0,2,3,5,1,1,0,0,0,3,4,9,9,11,21.4
2023-24,202401140MIN,1/14/2024,MIN vs LAC,Mike Conley,conlemi01,38,MIN,1,LAC,6,2,5,1,0,2,31.81666667,1,1,2,7,2,6,0,0,2,1,7,11,8,13,16.9
2023-24,202401140MIL,1/14/2024,MIL vs SAC,Harrison Barnes,barneha02,39,SAC,0,MIL,14,1,1,1,0,0,31.83333333,0,1,6,9,1,4,1,1,0,1,2,15,15,16,19.7
2023-24,202401140DEN,1/14/2024,DEN vs IND,Nikola Jokic,jokicni01,40,DEN,1,IND,25,12,9,2,1,7,33.08333333,3,9,12,13,0,0,1,2,3,3,21,34,37,46,54.9
2023-24,202401140MIL,1/14/2024,MIL vs SAC,Trey Lyles,lylestr01,25,SAC,0,MIL,9,7,2,0,0,0,33.1,1,6,3,8,3,7,0,0,3,0,9,11,16,18,20.4
2023-24,202401140POR,1/14/2024,POR vs PHO,Grayson Allen,allengr01,34,PHO,0,POR,20,4,1,0,2,4,33.15,1,3,4,6,4,6,8,8,2,2,5,21,24,25,28.3
2023-24,202401140MIL,1/14/2024,MIL vs SAC,Pat Connaughton,connapa01,34,MIL,1,SAC,5,3,2,0,0,0,33.23333333,0,3,1,3,1,3,2,2,3,0,5,7,8,10,11.6
2023-24,202401140DEN,1/14/2024,DEN vs IND,Bruce Brown,brownbr01,34,IND,0,DEN,18,10,6,3,0,2,33.45,5,5,8,16,1,2,1,3,3,3,16,24,28,34,46
2023-24,202401140MIA,1/14/2024,MIA vs CHO,Terry Rozier,roziete01,26,CHO,0,MIA,26,5,7,0,0,1,34.6,2,3,8,23,4,11,6,6,2,0,12,33,31,38,41.5
2023-24,202401140MIN,1/14/2024,MIN vs LAC,Jaden McDaniels,mcdanja02,29,MIN,1,LAC,14,4,4,2,0,4,35.35,1,3,6,10,2,3,0,0,2,2,8,18,18,22,26.8
2023-24,202401140MIA,1/14/2024,MIA vs CHO,Bam Adebayo,adebaba01,29,MIA,1,CHO,24,10,7,0,1,2,35.38333333,0,10,9,17,0,1,6,8,3,1,17,31,34,41,47.5
2023-24,202401140MIN,1/14/2024,MIN vs LAC,James Harden,hardeja01,34,LAC,0,MIN,14,1,8,2,2,4,36.08333333,0,1,4,14,2,9,4,5,3,4,9,22,15,23,35.2
2023-24,202401140DEN,1/14/2024,DEN vs IND,Jamal Murray,murraja01,27,DEN,1,IND,25,1,8,1,0,5,36.16666667,0,1,11,18,1,4,2,4,3,1,9,33,26,34,36.2
2023-24,202401140MIL,1/14/2024,MIL vs SAC,Malik Monk,monkma01,38,SAC,0,MIL,28,7,7,0,0,1,36.3,1,6,9,21,4,9,6,10,1,0,14,35,35,42,45.9
2023-24,202401140MIN,1/14/2024,MIN vs LAC,Karl-Anthony Towns,townska01,38,MIN,1,LAC,17,6,5,0,0,4,36.6,0,6,7,12,2,4,1,2,4,0,11,22,23,28,27.7
2023-24,202401140DEN,1/14/2024,DEN vs IND,Michael Porter Jr.,portemi01,41,DEN,1,IND,25,8,5,1,2,1,36.83333333,0,8,9,15,7,11,0,0,1,3,13,30,33,38,50.1
2023-24,202401140MIN,1/14/2024,MIN vs LAC,Rudy Gobert,goberru01,38,MIN,1,LAC,15,18,0,0,4,1,36.91666667,3,15,4,5,0,0,7,14,4,4,18,15,33,33,47.6
2023-24,202401140POR,1/14/2024,POR vs PHO,Kris Murray,murrakr01,23,POR,1,PHO,13,1,3,3,0,3,37.03333333,0,1,5,9,3,6,0,1,2,3,4,16,14,17,24.7
2023-24,202401140DEN,1/14/2024,DEN vs IND,Aaron Gordon,gordoaa01,35,DEN,1,IND,20,10,3,0,0,2,37.21666667,1,9,7,10,0,1,6,8,0,0,13,23,30,33,34.5
2023-24,202401140DEN,1/14/2024,DEN vs IND,Kentavious Caldwell-Pope,caldwke01,39,DEN,1,IND,11,2,1,2,0,1,37.23333333,0,2,3,4,2,3,3,3,2,2,3,12,13,14,19.9
2023-24,202401140POR,1/14/2024,POR vs PHO,Bradley Beal,bealbr01,15,PHO,0,POR,23,4,5,2,0,4,37.43333333,0,4,9,13,4,6,1,3,4,2,9,28,27,32,37.3
2023-24,202401140MIN,1/14/2024,MIN vs LAC,Kawhi Leonard,leonaka01,35,LAC,0,MIN,26,9,4,2,0,1,37.43333333,0,9,9,19,2,3,6,6,4,2,13,30,35,39,47.8
2023-24,202401140POR,1/14/2024,POR vs PHO,Kevin Durant,duranke01,32,PHO,0,POR,21,5,6,0,0,3,37.63333333,1,4,8,16,2,5,3,3,4,0,11,27,26,32,33
2023-24,202401140MIA,1/14/2024,MIA vs CHO,Miles Bridges,bridgmi02,26,CHO,0,MIA,20,7,1,1,0,3,37.76666667,1,6,8,17,1,7,3,3,0,1,8,21,27,28,29.9
2023-24,202401140MIN,1/14/2024,MIN vs LAC,Anthony Edwards,edwaran01,36,MIN,1,LAC,33,9,6,2,0,5,38.21666667,1,8,10,16,2,4,11,12,1,2,15,39,42,48,53.8
2023-24,202401140MIL,1/14/2024,MIL vs SAC,Kevin Huerter,huertke01,37,SAC,0,MIL,26,10,3,1,0,1,38.71666667,0,10,10,14,6,9,0,0,4,1,13,29,36,39,44.5
2023-24,202401140POR,1/14/2024,POR vs PHO,Duop Reath,reathdu01,27,POR,1,PHO,17,6,1,2,1,2,38.98333333,2,4,7,15,2,6,1,1,4,3,7,18,23,24,32.7
2023-24,202401140POR,1/14/2024,POR vs PHO,Devin Booker,bookede01,30,PHO,0,POR,34,6,7,0,0,0,39,0,6,14,22,1,6,5,5,2,0,13,41,40,47,51.7
2023-24,202401140POR,1/14/2024,POR vs PHO,Scoot Henderson,hendesc01,30,POR,1,PHO,33,7,9,3,0,3,39.9,4,3,11,31,4,9,7,9,3,3,16,42,40,49,60.9
2023-24,202401140MIL,1/14/2024,MIL vs SAC,Brook Lopez,lopezbr01,40,MIL,1,SAC,17,9,3,0,3,0,40.06666667,1,8,7,15,3,6,0,0,2,3,12,20,26,29,41.3
2023-24,202401140MIL,1/14/2024,MIL vs SAC,Giannis Antetokounmpo,antetgi01,39,MIL,1,SAC,27,10,10,3,0,4,40.38333333,1,9,9,16,0,2,9,14,4,3,20,37,37,47,59
2023-24,202401140POR,1/14/2024,POR vs PHO,Anfernee Simons,simonan01,18,POR,1,PHO,28,5,5,0,0,3,40.91666667,0,5,8,18,6,12,6,7,2,0,10,33,33,38,38.5
2023-24,202401140MIL,1/14/2024,MIL vs SAC,Damian Lillard,lillada01,37,MIL,1,SAC,29,4,8,0,0,4,41.41666667,0,4,9,23,5,13,6,6,0,0,12,37,33,41,41.8
2023-24,202401140MIN,1/14/2024,MIN vs LAC,Paul George,georgpa01,37,LAC,0,MIN,16,4,3,0,0,1,42.23333333,0,4,5,19,4,13,2,2,2,0,7,19,20,23,24.3
2023-24,202401140MIL,1/14/2024,MIL vs SAC,De'Aaron Fox,foxde01,33,SAC,0,MIL,32,2,5,3,0,4,42.88333333,1,1,12,26,2,6,6,7,4,3,7,37,34,39,46.9
2023-24,202401140MIL,1/14/2024,MIL vs SAC,Domantas Sabonis,sabondo01,39,SAC,0,MIL,21,13,15,1,1,3,44.93333333,3,10,9,10,1,1,2,2,3,2,28,36,34,49,62.1
2023-24,202401140MIL,1/14/2024,MIL vs SAC,Malik Beasley,beaslma01,38,MIL,1,SAC,23,4,5,1,0,1,45.26666667,0,4,7,12,5,9,4,4,5,1,9,28,27,32,37.3
2023-24,202401130DAL,1/13/2024,DAL vs NOP,Maxi Kleber,klebima01,6,DAL,1,NOP,2,2,1,1,0,1,11,1,1,1,3,0,2,0,0,0,1,3,3,4,5,7.9
2023-24,202401130SAS,1/13/2024,SAS vs CHI,Blake Wesley,weslebl01,17,SAS,1,CHI,2,1,3,0,0,0,11.15,0,1,1,3,0,2,0,0,2,0,4,5,3,6,7.7
2023-24,202401130OKC,1/13/2024,OKC vs ORL,Vasilije Micic,micicva01,18,OKC,1,ORL,7,2,1,1,0,1,11.26666667,0,2,3,5,1,2,0,0,1,1,3,8,9,10,12.9
2023-24,202401130UTA,1/13/2024,UTA vs LAL,Cam Reddish,reddica01,34,LAL,0,UTA,0,1,0,0,0,0,11.26666667,0,1,0,1,0,1,0,0,0,0,1,0,1,1,1.2
2023-24,202401130DAL,1/13/2024,DAL vs NOP,Seth Curry,curryse01,31,DAL,1,NOP,3,0,0,1,0,0,11.6,0,0,1,3,1,2,0,0,3,1,0,3,3,3,6
2023-24,202401130BOS,1/13/2024,BOS vs HOU,Jock Landale,landajo01,22,HOU,0,BOS,2,3,1,0,0,0,12,3,0,1,6,0,3,0,0,0,0,4,3,5,6,7.1
2023-24,202401130ATL,1/13/2024,ATL vs WAS,Trent Forrest,forretr01,13,ATL,1,WAS,4,2,1,1,0,2,13.33333333,0,2,1,4,0,0,2,4,1,1,3,5,6,7,8.9
2023-24,202401130UTA,1/13/2024,UTA vs LAL,Walker Kessler,kesslwa01,33,UTA,1,LAL,4,6,0,0,1,0,13.53333333,2,4,2,4,0,0,0,2,2,1,6,4,10,10,14.2
2023-24,202401130UTA,1/13/2024,UTA vs LAL,Max Christie,chrisma02,31,LAL,0,UTA,3,0,3,1,0,0,13.95,0,0,1,2,1,1,0,0,3,1,3,6,3,6,10.5
2023-24,202401130BOS,1/13/2024,BOS vs HOU,Jeff Green,greenje02,37,HOU,0,BOS,9,1,1,0,0,0,14.01666667,0,1,3,5,1,1,2,2,1,0,2,10,10,11,11.7
2023-24,202401130BOS,1/13/2024,BOS vs HOU,Luke Kornet,kornelu01,26,BOS,1,HOU,2,2,0,0,1,0,14.35,1,1,1,2,0,0,0,0,5,1,2,2,4,4,7.4
2023-24,202401130DAL,1/13/2024,DAL vs NOP,Grant Williams,willigr01,36,DAL,1,NOP,0,1,1,0,1,2,14.35,1,0,0,2,0,2,0,0,5,1,2,1,1,2,3.7
2023-24,202401130UTA,1/13/2024,UTA vs LAL,Kelly Olynyk,olynyke01,39,UTA,1,LAL,4,5,2,0,0,2,14.96666667,1,4,2,8,0,1,0,0,1,0,7,6,9,11,11
2023-24,202401130MEM,1/13/2024,MEM vs NYK,Quentin Grimes,grimequ01,36,NYK,0,MEM,3,2,1,0,0,0,15.06666667,0,2,1,5,1,4,0,0,1,0,3,4,5,6,6.9
2023-24,202401130OKC,1/13/2024,OKC vs ORL,Jonathan Isaac,isaacjo01,22,ORL,0,OKC,6,5,1,0,0,0,15.1,2,3,0,1,0,0,6,8,3,0,6,7,11,12,13.5
2023-24,202401130ATL,1/13/2024,ATL vs WAS,Garrison Mathews,mathega01,24,ATL,1,WAS,8,2,1,0,0,1,15.41666667,0,2,3,6,2,5,0,2,1,0,3,9,10,11,10.9
2023-24,202401130OKC,1/13/2024,OKC vs ORL,Isaiah Joe,joeis01,38,OKC,1,ORL,9,2,1,0,0,1,16.31666667,0,2,4,8,1,4,0,0,1,0,3,10,11,12,11.9
2023-24,202401130OKC,1/13/2024,OKC vs ORL,Kenrich Williams,willike04,27,OKC,1,ORL,3,5,2,0,0,0,16.45,0,5,1,2,1,2,0,0,1,0,7,5,8,10,12
2023-24,202401130SAS,1/13/2024,SAS vs CHI,Julian Champagnie,champju02,31,SAS,1,CHI,6,5,4,0,0,1,16.7,0,5,1,5,1,3,3,3,1,0,9,10,11,15,17
2023-24,202401130UTA,1/13/2024,UTA vs LAL,Kris Dunn,dunnkr01,33,UTA,1,LAL,7,0,3,1,0,2,16.73333333,0,0,3,4,1,2,0,0,2,1,3,10,7,10,12.5
2023-24,202401130SAS,1/13/2024,SAS vs CHI,Andre Drummond,drumman01,41,CHI,0,SAS,7,10,1,1,1,0,16.85,4,6,3,7,0,0,1,3,2,2,11,8,17,18,26.5
2023-24,202401130OKC,1/13/2024,OKC vs ORL,Trevelin Queen,queentr01,7,ORL,0,OKC,7,4,1,0,3,2,17.08333333,0,4,3,6,0,3,1,1,2,3,5,8,11,12,20.3
2023-24,202401130MIL,1/13/2024,MIL vs GSW,Lester Quinones,quinole01,7,GSW,0,MIL,6,4,2,0,0,1,17.55,2,2,2,5,1,1,1,2,2,0,6,8,10,12,12.8
2023-24,202401130ATL,1/13/2024,ATL vs WAS,Corey Kispert,kispeco01,37,WAS,0,ATL,11,4,2,0,0,1,17.56666667,1,3,4,8,3,5,0,0,3,0,6,13,15,17,17.8
2023-24,202401130UTA,1/13/2024,UTA vs LAL,Ochai Agbaji,agbajoc01,41,UTA,1,LAL,2,4,0,0,1,0,18.1,1,3,1,5,0,2,0,0,0,1,4,2,6,6,9.8
2023-24,202401130SAS,1/13/2024,SAS vs CHI,Sandro Mamukelashvili,mamuksa01,22,SAS,1,CHI,8,8,1,1,2,0,18.16666667,3,5,3,7,1,3,1,2,5,3,9,9,16,17,28.1
2023-24,202401130ATL,1/13/2024,ATL vs WAS,Patrick Baldwin Jr.,baldwpa01,10,WAS,0,ATL,8,9,0,0,1,2,18.18333333,3,6,3,8,0,3,2,4,5,1,9,8,17,17,19.8
2023-24,202401130MIL,1/13/2024,MIL vs GSW,Trayce Jackson-Davis,jackstr02,29,GSW,0,MIL,12,2,1,1,1,0,18.18333333,0,2,6,8,0,0,0,2,0,2,3,13,14,15,21.9
2023-24,202401130OKC,1/13/2024,OKC vs ORL,Moritz Wagner,wagnemo01,39,ORL,0,OKC,4,4,2,0,1,3,18.21666667,0,4,2,6,0,3,0,0,1,1,6,6,8,10,11.8
2023-24,202401130MIL,1/13/2024,MIL vs GSW,Cory Joseph,josepco01,20,GSW,0,MIL,3,3,2,0,1,1,18.41666667,0,3,1,2,1,2,0,0,1,1,5,5,6,8,11.6
2023-24,202401130MIL,1/13/2024,MIL vs GSW,Kevon Looney,looneke01,39,GSW,0,MIL,6,6,3,0,1,0,18.43333333,4,2,3,6,0,0,0,0,2,1,9,9,12,15,20.7
2023-24,202401130UTA,1/13/2024,UTA vs LAL,Rui Hachimura,hachiru01,27,LAL,0,UTA,17,3,1,1,0,0,18.7,1,2,6,12,0,2,5,6,0,1,4,18,20,21,25.1
2023-24,202401130OKC,1/13/2024,OKC vs ORL,Chuma Okeke,okekech01,22,ORL,0,OKC,5,4,2,0,0,0,19,1,3,2,6,1,5,0,0,1,0,6,7,9,11,12.8
2023-24,202401130ATL,1/13/2024,ATL vs WAS,Onyeka Okongwu,okongon01,37,ATL,1,WAS,9,10,1,0,3,2,19,6,4,3,5,0,0,3,5,4,3,11,10,19,20,29.5
2023-24,202401130MEM,1/13/2024,MEM vs NYK,Ziaire Williams,willizi02,37,MEM,1,NYK,10,4,2,1,0,2,19.51666667,1,3,2,8,1,4,5,5,0,1,6,12,14,16,18.8
2023-24,202401130OKC,1/13/2024,OKC vs ORL,Jalen Suggs,suggsja01,35,ORL,0,OKC,9,4,0,0,0,1,19.68333333,1,3,4,8,1,3,0,0,3,0,4,9,13,13,12.8
2023-24,202401130OKC,1/13/2024,OKC vs ORL,Cason Wallace,wallaca01,38,OKC,1,ORL,1,3,0,0,0,0,19.75,2,1,0,5,0,4,1,2,3,0,3,1,4,4,4.6
2023-24,202401130DAL,1/13/2024,DAL vs NOP,Larry Nance Jr.,nancela02,23,NOP,0,DAL,14,2,3,2,0,0,20.16666667,1,1,4,4,0,0,6,6,0,2,5,17,16,19,26.9
2023-24,202401130BOS,1/13/2024,BOS vs HOU,Sam Hauser,hausesa01,38,BOS,1,HOU,6,6,0,0,0,0,20.23333333,0,6,2,9,2,8,0,0,0,0,6,6,12,12,13.2
2023-24,202401130BOS,1/13/2024,BOS vs HOU,Jalen Green,greenja05,38,HOU,0,BOS,10,3,1,0,0,1,20.25,0,3,3,9,2,5,2,2,0,0,4,11,13,14,14.1
2023-24,202401130BOS,1/13/2024,BOS vs HOU,Al Horford,horfoal01,32,BOS,1,HOU,7,4,1,0,1,0,20.4,0,4,2,3,1,2,2,2,0,1,5,8,11,12,16.3
2023-24,202401130MEM,1/13/2024,MEM vs NYK,John Konchar,konchjo01,31,MEM,1,NYK,0,3,1,1,2,0,20.41666667,1,2,0,4,0,3,0,0,1,3,4,1,3,4,14.1
2023-24,202401130MIL,1/13/2024,MIL vs GSW,Bobby Portis,portibo01,39,MIL,1,GSW,10,8,0,0,0,1,21.05,0,8,4,11,2,4,0,0,5,0,8,10,18,18,18.6
2023-24,202401130MIL,1/13/2024,MIL vs GSW,Pat Connaughton,connapa01,33,MIL,1,GSW,3,2,2,1,1,0,21.55,0,2,1,4,1,3,0,0,1,2,4,5,5,7,14.4
2023-24,202401130SAS,1/13/2024,SAS vs CHI,Malaki Branham,branhma01,37,SAS,1,CHI,14,1,1,3,0,1,21.71666667,0,1,6,15,2,8,0,0,0,3,2,15,15,16,24.7
2023-24,202401130ATL,1/13/2024,ATL vs WAS,Delon Wright,wrighde01,17,WAS,0,ATL,8,2,4,2,1,0,21.9,1,1,3,7,2,3,0,0,1,3,6,12,10,14,25.4
2023-24,202401130DAL,1/13/2024,DAL vs NOP,Jeremiah Robinson-Earl,robinje02,17,NOP,0,DAL,2,4,0,2,0,1,22.13333333,0,4,1,4,0,1,0,0,1,2,4,2,6,6,11.8
2023-24,202401130OKC,1/13/2024,OKC vs ORL,Goga Bitadze,bitadgo01,35,ORL,0,OKC,8,9,2,2,0,1,22.18333333,2,7,4,6,0,1,0,0,2,2,11,10,17,19,26.8
2023-24,202401130SAS,1/13/2024,SAS vs CHI,Dominick Barlow,barlodo01,16,SAS,1,CHI,5,6,3,1,1,0,22.21666667,4,2,2,5,0,0,1,2,1,2,9,8,11,14,22.7
2023-24,202401130UTA,1/13/2024,UTA vs LAL,Christian Wood,woodch01,34,LAL,0,UTA,15,9,1,0,1,0,22.43333333,1,8,5,10,2,6,3,3,1,1,10,16,24,25,30.3
2023-24,202401130BOS,1/13/2024,BOS vs HOU,Payton Pritchard,pritcpa01,39,BOS,1,HOU,19,4,3,0,0,2,22.58333333,2,2,7,10,3,6,2,2,1,0,7,22,23,26,26.3
2023-24,202401130BOS,1/13/2024,BOS vs HOU,Fred VanVleet,vanvlfr01,37,HOU,0,BOS,5,1,7,0,1,0,22.63333333,1,0,2,6,1,3,0,0,2,1,8,12,6,13,19.7
2023-24,202401130SAS,1/13/2024,SAS vs CHI,Cedi Osman,osmande01,38,SAS,1,CHI,9,2,1,1,0,0,22.86666667,0,2,3,5,3,5,0,0,3,1,3,10,11,12,15.9
2023-24,202401130UTA,1/13/2024,UTA vs LAL,Jarred Vanderbilt,vandeja01,20,LAL,0,UTA,5,3,1,1,0,2,22.91666667,2,1,2,2,1,1,0,0,4,1,4,6,8,9,11.1
2023-24,202401130DAL,1/13/2024,DAL vs NOP,Jaden Hardy,hardyja02,35,DAL,1,NOP,8,2,1,0,0,2,23.35,0,2,3,8,2,4,0,0,1,0,3,9,10,11,9.9
2023-24,202401130UTA,1/13/2024,UTA vs LAL,Simone Fontecchio,fontesi01,39,UTA,1,LAL,0,4,4,0,0,1,23.56666667,2,2,0,5,0,3,0,0,3,0,8,4,4,8,9.8
2023-24,202401130ATL,1/13/2024,ATL vs WAS,Bogdan Bogdanovic,bogdabo01,36,ATL,1,WAS,14,3,2,3,0,0,23.75,1,2,5,13,3,8,1,1,2,3,5,16,17,19,29.6
2023-24,202401130SAS,1/13/2024,SAS vs CHI,Jevon Carter,carteje01,39,CHI,0,SAS,14,1,0,0,0,3,23.78333333,0,1,5,12,4,9,0,0,2,0,1,14,15,15,12.2
2023-24,202401130ATL,1/13/2024,ATL vs WAS,Clint Capela,capelca01,36,ATL,1,WAS,4,8,0,0,1,0,24.21666667,2,6,2,8,0,0,0,0,1,1,8,4,12,12,16.6
2023-24,202401130BOS,1/13/2024,BOS vs HOU,Alperen Sengun,sengual01,38,HOU,0,BOS,19,10,3,4,0,3,24.41666667,2,8,8,17,0,2,3,3,3,4,13,22,29,32,44.5
2023-24,202401130OKC,1/13/2024,OKC vs ORL,Cole Anthony,anthoco01,38,ORL,0,OKC,14,4,2,1,1,2,24.58333333,2,2,6,11,1,3,1,2,4,2,6,16,18,20,25.8
2023-24,202401130BOS,1/13/2024,BOS vs HOU,Amen Thompson,thompam01,19,HOU,0,BOS,10,10,3,3,0,4,24.91666667,3,7,3,10,0,0,4,4,0,3,13,13,20,23,31.5
2023-24,202401130BOS,1/13/2024,BOS vs HOU,Dillon Brooks,brookdi01,29,HOU,0,BOS,12,1,0,1,0,0,24.93333333,1,0,3,8,0,1,6,6,4,1,1,12,13,13,16.2
2023-24,202401130BOS,1/13/2024,BOS vs HOU,Derrick White,whitede01,36,BOS,1,HOU,13,3,5,2,0,0,25.25,1,2,5,9,3,5,0,0,1,2,8,18,16,21,30.1
2023-24,202401130ATL,1/13/2024,ATL vs WAS,Jordan Poole,poolejo01,37,WAS,0,ATL,20,2,2,1,1,1,25.83333333,0,2,8,16,2,6,2,2,1,2,4,22,22,24,30.4
2023-24,202401130BOS,1/13/2024,BOS vs HOU,Jrue Holiday,holidjr01,36,BOS,1,HOU,11,6,3,0,0,1,26.1,2,4,4,10,1,4,2,2,2,0,9,14,17,20,21.7
2023-24,202401130ATL,1/13/2024,ATL vs WAS,Tyus Jones,jonesty01,38,WAS,0,ATL,8,3,7,1,1,0,26.1,1,2,4,9,0,3,0,0,0,2,10,15,11,18,28.1
2023-24,202401130DAL,1/13/2024,DAL vs NOP,Jose Alvarado,alvarjo01,24,NOP,0,DAL,14,2,4,1,0,0,26.26666667,0,2,5,12,3,8,1,2,2,1,6,18,16,20,25.4
2023-24,202401130UTA,1/13/2024,UTA vs LAL,Keyonte George,georgke01,35,UTA,1,LAL,19,3,3,1,0,1,26.51666667,0,3,5,11,3,9,6,6,0,1,6,22,22,25,29.1
2023-24,202401130ATL,1/13/2024,ATL vs WAS,Saddiq Bey,beysa01,38,ATL,1,WAS,16,7,0,4,0,1,26.81666667,6,1,5,13,2,7,4,4,1,4,7,16,23,23,35.4
2023-24,202401130MEM,1/13/2024,MEM vs NYK,GG Jackson II,jacksgg01,7,MEM,1,NYK,20,6,1,0,2,2,27.05,2,4,9,14,2,4,0,0,0,2,7,21,26,27,32.7
2023-24,202401130BOS,1/13/2024,BOS vs HOU,Jabari Smith Jr.,smithja05,37,HOU,0,BOS,9,6,2,0,0,2,27.38333333,1,5,4,11,0,4,1,1,2,0,8,11,15,17,17.2
2023-24,202401130ATL,1/13/2024,ATL vs WAS,Kyle Kuzma,kuzmaky01,38,WAS,0,ATL,29,6,4,0,1,2,27.4,3,3,10,20,3,5,6,7,0,1,10,33,35,39,43.2
2023-24,202401130OKC,1/13/2024,OKC vs ORL,Josh Giddey,giddejo01,37,OKC,1,ORL,12,8,4,1,0,0,27.45,1,7,4,12,1,5,3,4,1,1,12,16,20,24,30.6
2023-24,202401130MIL,1/13/2024,MIL vs GSW,Andre Jackson Jr.,jacksan01,33,MIL,1,GSW,10,10,2,0,1,1,27.55,6,4,5,8,0,0,0,0,1,1,12,12,20,22,27
2023-24,202401130UTA,1/13/2024,UTA vs LAL,Collin Sexton,sextoco01,41,UTA,1,LAL,27,4,5,0,0,1,27.71666667,1,3,8,13,1,4,10,10,5,0,9,32,31,36,38.3
2023-24,202401130BOS,1/13/2024,BOS vs HOU,Cam Whitmore,whitmca01,15,HOU,0,BOS,22,7,0,1,1,1,27.75,1,6,7,13,2,7,6,8,2,2,7,22,29,29,35.4
2023-24,202401130ATL,1/13/2024,ATL vs WAS,Bilal Coulibaly,coulibi01,37,WAS,0,ATL,12,6,3,2,1,1,27.81666667,0,6,3,8,1,2,5,6,4,3,9,15,18,21,31.7
2023-24,202401130DAL,1/13/2024,DAL vs NOP,Jonas Valanciunas,valanjo01,40,NOP,0,DAL,14,12,7,0,2,0,27.83333333,5,7,4,6,0,0,6,9,4,2,19,21,26,33,44.9
2023-24,202401130DAL,1/13/2024,DAL vs NOP,Derrick Jones Jr.,jonesde02,39,DAL,1,NOP,24,4,1,0,0,1,27.93333333,0,4,8,10,3,5,5,5,4,0,5,25,28,29,29.3
2023-24,202401130BOS,1/13/2024,BOS vs HOU,Kristaps Porzingis,porzikr01,29,BOS,1,HOU,17,7,5,1,3,2,28.11666667,1,6,6,11,3,5,2,2,3,4,12,22,24,29,42.9
2023-24,202401130BOS,1/13/2024,BOS vs HOU,Jaylen Brown,brownja02,37,BOS,1,HOU,32,6,2,2,2,3,28.45,1,5,11,15,4,6,6,10,5,4,8,34,38,40,51.2
2023-24,202401130MIL,1/13/2024,MIL vs GSW,Malik Beasley,beaslma01,37,MIL,1,GSW,11,4,1,2,0,1,28.53333333,2,2,4,8,3,6,0,0,1,2,5,12,15,16,22.3
2023-24,202401130MEM,1/13/2024,MEM vs NYK,Josh Hart,hartjo01,39,NYK,0,MEM,8,7,3,2,0,2,28.71666667,0,7,3,7,2,4,0,0,2,2,10,11,15,18,24.9
2023-24,202401130SAS,1/13/2024,SAS vs CHI,Ayo Dosunmu,dosunay01,39,CHI,0,SAS,21,2,4,1,0,2,29.33333333,0,2,8,9,3,3,2,2,4,1,6,25,23,27,30.4
2023-24,202401130BOS,1/13/2024,BOS vs HOU,Jayson Tatum,tatumja01,36,BOS,1,HOU,27,8,5,1,1,2,29.5,1,7,9,17,4,7,5,7,2,2,13,32,35,40,48.1
2023-24,202401130MIL,1/13/2024,MIL vs GSW,Jonathan Kuminga,kuminjo01,38,GSW,0,MIL,28,3,2,1,1,0,29.6,0,3,10,18,2,3,6,6,2,2,5,30,31,33,40.6
2023-24,202401130SAS,1/13/2024,SAS vs CHI,Keldon Johnson,johnske04,36,SAS,1,CHI,26,4,5,0,1,2,29.73333333,0,4,8,14,4,5,6,6,2,1,9,31,30,35,39.3
2023-24,202401130ATL,1/13/2024,ATL vs WAS,Daniel Gafford,gaffoda01,35,WAS,0,ATL,10,6,0,1,2,1,29.81666667,0,6,4,4,0,0,2,2,0,3,6,10,16,16,25.2
2023-24,202401130UTA,1/13/2024,UTA vs LAL,Taurean Prince,princta02,39,LAL,0,UTA,12,1,1,0,1,0,30.16666667,0,1,5,8,2,4,0,0,3,1,2,13,13,14,17.7
2023-24,202401130DAL,1/13/2024,DAL vs NOP,Naji Marshall,marshna01,31,NOP,0,DAL,13,6,1,0,0,2,30.63333333,1,5,5,12,2,4,1,2,3,0,7,14,19,20,19.7
2023-24,202401130UTA,1/13/2024,UTA vs LAL,Austin Reaves,reaveau01,41,LAL,0,UTA,19,4,2,0,0,1,30.9,1,3,7,8,1,2,4,6,6,0,6,21,23,25,25.8
2023-24,202401130ATL,1/13/2024,ATL vs WAS,Dejounte Murray,murrade01,38,ATL,1,WAS,13,5,3,0,0,2,31.1,0,5,4,15,1,6,4,4,1,0,8,16,18,21,21.5
2023-24,202401130SAS,1/13/2024,SAS vs CHI,Nikola Vucevic,vucevni01,36,CHI,0,SAS,24,16,5,0,3,1,31.15,3,13,10,17,2,5,2,3,2,3,21,29,40,45,58.7
2023-24,202401130SAS,1/13/2024,SAS vs CHI,Jeremy Sochan,sochaje01,38,SAS,1,CHI,11,7,2,0,0,1,31.16666667,4,3,4,15,2,6,1,1,3,0,9,13,18,20,21.4
2023-24,202401130UTA,1/13/2024,UTA vs LAL,Jordan Clarkson,clarkjo01,31,UTA,1,LAL,21,4,4,0,1,2,31.45,2,2,6,18,1,6,8,8,2,1,8,25,25,29,32.8
2023-24,202401130OKC,1/13/2024,OKC vs ORL,Chet Holmgren,holmgch01,38,OKC,1,ORL,15,8,3,1,2,2,31.55,2,6,7,14,1,5,0,0,0,3,11,18,23,26,36.1
2023-24,202401130MEM,1/13/2024,MEM vs NYK,Jacob Gilyard,gilyaja01,22,MEM,1,NYK,5,2,7,2,0,0,31.63333333,1,1,2,8,1,6,0,0,4,2,9,12,7,14,23.9
2023-24,202401130MEM,1/13/2024,MEM vs NYK,OG Anunoby,anunoog01,34,NYK,0,MEM,18,5,2,1,4,4,31.66666667,2,3,7,15,1,4,3,4,1,5,7,20,23,25,38
2023-24,202401130DAL,1/13/2024,DAL vs NOP,Herbert Jones,joneshe01,37,NOP,0,DAL,15,5,3,0,2,1,31.66666667,2,3,5,13,1,3,4,6,5,2,8,18,20,23,30.5
2023-24,202401130SAS,1/13/2024,SAS vs CHI,Coby White,whiteco01,41,CHI,0,SAS,15,2,4,0,1,0,32.23333333,0,2,6,13,0,3,3,4,2,1,6,19,17,21,26.4
2023-24,202401130DAL,1/13/2024,DAL vs NOP,Josh Green,greenjo02,28,DAL,1,NOP,9,6,4,0,0,3,32.38333333,2,4,3,8,1,3,2,2,2,0,10,13,15,19,19.2
2023-24,202401130SAS,1/13/2024,SAS vs CHI,Tre Jones,jonestr01,34,SAS,1,CHI,30,9,4,0,0,1,32.43333333,1,8,10,13,4,6,6,6,2,0,13,34,39,43,45.8
2023-24,202401130OKC,1/13/2024,OKC vs ORL,Luguentz Dort,dortlu01,37,OKC,1,ORL,12,3,2,1,1,1,32.46666667,1,2,4,8,2,5,2,2,5,2,5,14,15,17,23.6
2023-24,202401130MIL,1/13/2024,MIL vs GSW,Andrew Wiggins,wiggian01,35,GSW,0,MIL,7,4,1,0,0,0,32.48333333,3,1,3,13,1,3,0,0,3,0,5,8,11,12,13.3
2023-24,202401130MIL,1/13/2024,MIL vs GSW,Khris Middleton,middlkh01,34,MIL,1,GSW,24,3,10,1,1,3,32.85,1,2,10,13,3,5,1,2,2,2,13,34,27,37,45.6
2023-24,202401130MEM,1/13/2024,MEM vs NYK,Donte DiVincenzo,divindo01,39,NYK,0,MEM,13,3,4,4,0,2,32.93333333,0,3,4,14,3,11,2,3,2,4,7,17,16,20,32.6
2023-24,202401130OKC,1/13/2024,OKC vs ORL,Jalen Williams,willija06,35,OKC,1,ORL,16,6,2,0,0,2,32.98333333,2,4,7,16,1,3,1,1,1,0,8,18,22,24,24.2
2023-24,202401130OKC,1/13/2024,OKC vs ORL,Anthony Black,blackan01,37,ORL,0,OKC,13,4,1,1,1,1,33.13333333,0,4,5,8,0,1,3,6,2,2,5,14,17,18,24.3
2023-24,202401130UTA,1/13/2024,UTA vs LAL,Lauri Markkanen,markkla01,31,UTA,1,LAL,29,9,5,2,1,0,33.25,2,7,8,16,3,6,10,11,0,3,14,34,38,43,56.3
2023-24,202401130MEM,1/13/2024,MEM vs NYK,Luke Kennard,kennalu01,16,MEM,1,NYK,14,3,2,0,0,0,33.3,0,3,6,13,2,8,0,0,2,0,5,16,17,19,20.6
2023-24,202401130SAS,1/13/2024,SAS vs CHI,Alex Caruso,carusal01,34,CHI,0,SAS,11,6,6,2,3,1,33.38333333,0,6,3,5,3,4,2,2,1,5,12,17,17,23,41.2
2023-24,202401130DAL,1/13/2024,DAL vs NOP,Dwight Powell,poweldw01,37,DAL,1,NOP,2,9,8,3,0,1,33.65,5,4,0,1,0,0,2,2,5,3,17,10,11,19,32.8
2023-24,202401130MIL,1/13/2024,MIL vs GSW,Brook Lopez,lopezbr01,39,MIL,1,GSW,11,8,6,0,2,1,33.68333333,2,6,5,9,1,5,0,0,1,2,14,17,19,25,34.6
2023-24,202401130SAS,1/13/2024,SAS vs CHI,Devin Vassell,vassede01,33,SAS,1,CHI,5,4,2,1,0,2,33.85,0,4,1,13,1,8,2,3,0,1,6,7,9,11,13.8
2023-24,202401130MIL,1/13/2024,MIL vs GSW,Dario Saric,saricda01,39,GSW,0,MIL,12,6,6,1,0,3,34.06666667,0,6,5,9,1,5,1,2,1,1,12,18,18,24,28.2
2023-24,202401130UTA,1/13/2024,UTA vs LAL,John Collins,collijo01,37,UTA,1,LAL,19,13,2,3,1,1,34.16666667,2,11,7,9,3,4,2,2,5,4,15,21,32,34,48.6
2023-24,202401130SAS,1/13/2024,SAS vs CHI,DeMar DeRozan,derozde01,39,CHI,0,SAS,20,4,4,0,0,0,34.41666667,0,4,8,19,2,5,2,2,1,0,8,24,24,28,30.8
2023-24,202401130OKC,1/13/2024,OKC vs ORL,Caleb Houstan,houstca01,30,ORL,0,OKC,14,3,2,1,0,3,34.65,1,2,5,13,4,12,0,0,0,1,5,16,17,19,20.6
2023-24,202401130MEM,1/13/2024,MEM vs NYK,David Roddy,roddyda01,36,MEM,1,NYK,14,4,1,2,0,2,34.88333333,1,3,6,12,2,4,0,0,4,2,5,15,18,19,24.3
2023-24,202401130MIL,1/13/2024,MIL vs GSW,Klay Thompson,thompkl01,38,GSW,0,MIL,21,3,3,0,0,2,35.53333333,2,1,7,23,6,17,1,1,2,0,6,24,24,27,27.1
2023-24,202401130MEM,1/13/2024,MEM vs NYK,Julius Randle,randlju01,39,NYK,0,MEM,24,11,5,0,1,6,35.61666667,5,6,9,21,1,6,5,6,2,1,16,29,35,40,41.7
2023-24,202401130MEM,1/13/2024,MEM vs NYK,Vince Williams Jr.,willivi01,29,MEM,1,NYK,17,8,8,2,1,4,35.7,3,5,5,13,1,7,6,8,1,3,16,25,25,33,43.6
2023-24,202401130SAS,1/13/2024,SAS vs CHI,Zach LaVine,lavinza01,23,CHI,0,SAS,10,6,7,1,0,2,35.73333333,0,6,3,8,1,5,3,4,3,1,13,17,16,23,28.7
2023-24,202401130MIL,1/13/2024,MIL vs GSW,Brandin Podziemski,podzibr01,33,GSW,0,MIL,23,10,3,2,0,0,35.73333333,1,9,10,14,3,5,0,1,3,2,13,26,33,36,45.5
2023-24,202401130ATL,1/13/2024,ATL vs WAS,Jalen Johnson,johnsja05,24,ATL,1,WAS,5,6,3,0,2,4,35.86666667,0,6,2,7,1,3,0,0,3,2,9,8,11,14,18.7
2023-24,202401130OKC,1/13/2024,OKC vs ORL,Shai Gilgeous-Alexander,gilgesh01,37,OKC,1,ORL,37,6,7,3,1,0,35.95,2,4,13,20,0,4,11,12,2,4,13,44,43,50,66.7
2023-24,202401130ATL,1/13/2024,ATL vs WAS,Trae Young,youngtr01,36,ATL,1,WAS,21,2,10,1,1,1,36.15,1,1,6,19,2,10,7,9,5,2,12,31,23,33,43.4
2023-24,202401130MEM,1/13/2024,MEM vs NYK,Xavier Tillman Sr.,tillmxa01,27,MEM,1,NYK,12,5,5,6,1,2,36.18333333,0,5,6,15,0,2,0,0,4,7,10,17,17,22,44.5
2023-24,202401130OKC,1/13/2024,OKC vs ORL,Paolo Banchero,banchpa01,39,ORL,0,OKC,20,9,8,0,2,2,36.36666667,2,7,8,19,0,4,4,7,4,2,17,28,29,37,46.8
2023-24,202401130DAL,1/13/2024,DAL vs NOP,Jordan Hawkins,hawkijo01,35,NOP,0,DAL,34,5,4,2,0,3,36.56666667,3,2,11,19,6,12,6,8,3,2,9,38,39,43,49
2023-24,202401130MIL,1/13/2024,MIL vs GSW,Giannis Antetokounmpo,antetgi01,38,MIL,1,GSW,33,9,5,0,0,4,36.65,3,6,13,22,1,3,6,8,3,0,14,38,42,47,47.3
2023-24,202401130ATL,1/13/2024,ATL vs WAS,Deni Avdija,avdijde01,38,WAS,0,ATL,19,14,9,1,1,3,37.11666667,1,13,7,12,1,2,4,5,5,2,23,28,33,42,52.3
2023-24,202401130DAL,1/13/2024,DAL vs NOP,Dyson Daniels,daniedy01,40,NOP,0,DAL,10,6,7,0,0,2,37.6,2,4,4,7,0,1,2,2,2,0,13,17,16,23,25.7
2023-24,202401130MIL,1/13/2024,MIL vs GSW,Damian Lillard,lillada01,36,MIL,1,GSW,27,6,7,2,0,1,37.61666667,0,6,9,19,2,5,7,7,1,2,13,34,33,40,49.7
2023-24,202401130MEM,1/13/2024,MEM vs NYK,Miles McBride,mcbrimi01,26,NYK,0,MEM,19,6,5,1,1,3,38.05,0,6,7,10,4,7,1,2,3,2,11,24,25,30,36.7
2023-24,202401130UTA,1/13/2024,UTA vs LAL,Anthony Davis,davisan02,39,LAL,0,UTA,15,15,11,1,4,6,39.26666667,2,13,5,21,0,1,5,6,1,5,26,26,30,41,58.5
2023-24,202401130DAL,1/13/2024,DAL vs NOP,Tim Hardaway Jr.,hardati02,37,DAL,1,NOP,24,4,0,0,0,0,39.33333333,0,4,8,17,3,8,5,6,3,0,4,24,28,28,28.8
2023-24,202401130DAL,1/13/2024,DAL vs NOP,Kyrie Irving,irvinky01,24,DAL,1,NOP,33,5,6,1,0,1,40.31666667,0,5,12,27,5,14,4,4,2,1,11,39,38,44,50
2023-24,202401130UTA,1/13/2024,UTA vs LAL,D'Angelo Russell,russeda01,37,LAL,0,UTA,39,3,8,1,2,3,40.78333333,0,3,15,26,6,11,3,3,3,3,11,47,42,50,60.6
2023-24,202401130MEM,1/13/2024,MEM vs NYK,Isaiah Hartenstein,harteis01,39,NYK,0,MEM,12,20,2,2,4,3,42.11666667,7,13,5,6,0,0,2,4,1,6,22,14,32,34,54
2023-24,202401120PHI,1/12/2024,PHI vs SAC,Keon Ellis,elliske01,27,SAC,0,PHI,3,2,0,0,0,2,10.03333333,0,2,1,3,1,2,0,0,1,0,2,3,5,5,3.4
2023-24,202401120DET,1/12/2024,DET vs HOU,Marcus Sasser,sassema01,35,DET,1,HOU,0,1,7,1,0,1,10.93333333,1,0,0,2,0,1,0,0,2,1,8,7,1,8,13.7
2023-24,202401120UTA,1/12/2024,UTA vs TOR,Chris Boucher,bouchch01,36,TOR,0,UTA,7,0,0,0,0,1,11.6,0,0,2,4,1,3,2,2,1,0,0,7,7,7,6
2023-24,202401120SAS,1/12/2024,SAS vs CHO,Doug McDermott,mcderdo01,33,SAS,1,CHO,14,2,0,0,0,0,11.61666667,0,2,4,6,4,6,2,3,0,0,2,14,16,16,16.4
2023-24,202401120DEN,1/12/2024,DEN vs NOP,Naji Marshall,marshna01,30,NOP,0,DEN,6,2,0,0,0,0,12.05,1,1,2,5,0,2,2,2,0,0,2,6,8,8,8.4
2023-24,202401120CHI,1/12/2024,CHI vs GSW,Andre Drummond,drumman01,40,CHI,1,GSW,5,4,1,0,1,0,12.1,0,4,2,2,0,0,1,2,0,1,5,6,9,10,14.3
2023-24,202401120UTA,1/12/2024,UTA vs TOR,Gradey Dick,dickgr01,20,TOR,0,UTA,0,1,2,0,0,0,12.16666667,0,1,0,3,0,2,0,0,1,0,3,2,1,3,4.2
2023-24,202401120DET,1/12/2024,DET vs HOU,Marvin Bagley III,baglema01,26,DET,1,HOU,11,4,1,1,0,0,12.21666667,1,3,4,6,0,0,3,4,2,1,5,12,15,16,20.3
2023-24,202401120UTA,1/12/2024,UTA vs TOR,Thaddeus Young,youngth01,11,TOR,0,UTA,0,2,2,0,0,0,12.26666667,0,2,0,1,0,0,0,0,5,0,4,2,2,4,5.4
2023-24,202401120CHI,1/12/2024,CHI vs GSW,Cory Joseph,josepco01,19,GSW,0,CHI,2,1,2,0,0,0,12.83333333,0,1,1,3,0,1,0,0,1,0,3,4,3,5,6.2
2023-24,202401120MIN,1/12/2024,MIN vs POR,Jordan McLaughlin,mclaujo01,18,MIN,1,POR,2,0,5,1,0,2,12.85,0,0,1,3,0,2,0,0,2,1,5,7,2,7,10.5
2023-24,202401120DET,1/12/2024,DET vs HOU,Jeff Green,greenje02,36,HOU,0,DET,6,2,0,0,0,1,13.1,0,2,2,2,0,0,2,2,2,0,2,6,8,8,7.4
2023-24,202401120SAS,1/12/2024,SAS vs CHO,Cedi Osman,osmande01,37,SAS,1,CHO,11,4,1,1,0,3,13.73333333,1,3,4,4,2,2,1,2,2,1,5,12,15,16,17.3
2023-24,202401120MIA,1/12/2024,MIA vs ORL,Jalen Suggs,suggsja01,34,ORL,0,MIA,2,0,0,0,3,0,13.83333333,0,0,1,5,0,4,0,0,3,3,0,2,2,2,11
2023-24,202401120DEN,1/12/2024,DEN vs NOP,DeAndre Jordan,jordade01,17,DEN,1,NOP,6,7,1,0,1,0,13.88333333,1,6,2,2,0,0,2,2,1,1,8,7,13,14,18.9
2023-24,202401120PHI,1/12/2024,PHI vs SAC,Danuel House Jr.,houseda01,23,PHI,1,SAC,4,2,1,0,0,0,14.36666667,0,2,1,2,0,1,2,2,3,0,3,5,6,7,7.9
2023-24,202401120MIN,1/12/2024,MIN vs POR,Matisse Thybulle,thybuma01,37,POR,0,MIN,3,1,0,2,0,0,14.36666667,0,1,1,3,1,2,0,0,1,2,1,3,4,4,10.2
2023-24,202401120UTA,1/12/2024,UTA vs TOR,John Collins,collijo01,36,UTA,1,TOR,4,7,1,0,0,1,14.46666667,1,6,2,3,0,1,0,0,4,0,8,5,11,12,12.9
2023-24,202401120ATL,1/12/2024,ATL vs IND,Patty Mills,millspa02,9,ATL,1,IND,2,1,0,1,0,0,14.53333333,1,0,1,3,0,1,0,0,1,1,1,2,3,3,6.2
2023-24,202401120DEN,1/12/2024,DEN vs NOP,Peyton Watson,watsope01,38,DEN,1,NOP,8,3,0,1,1,0,15.08333333,1,2,3,7,2,4,0,0,1,2,3,8,11,11,17.6
2023-24,202401120MIN,1/12/2024,MIN vs POR,Kyle Anderson,anderky01,38,MIN,1,POR,2,2,1,0,0,2,15.25,0,2,1,2,0,0,0,0,2,0,3,3,4,5,3.9
2023-24,202401120DEN,1/12/2024,DEN vs NOP,Dyson Daniels,daniedy01,39,NOP,0,DEN,2,4,3,3,0,0,15.4,2,2,1,4,0,2,0,2,0,3,7,5,6,9,20.3
2023-24,202401120DET,1/12/2024,DET vs HOU,Cam Whitmore,whitmca01,14,HOU,0,DET,3,1,0,0,0,0,15.45,0,1,1,7,1,5,0,0,2,0,1,3,4,4,4.2
2023-24,202401120MEM,1/12/2024,MEM vs LAC,Russell Westbrook,westbru01,38,LAC,0,MEM,12,2,2,0,0,1,16,1,1,5,11,1,3,1,3,1,0,4,14,14,16,16.4
2023-24,202401120MIA,1/12/2024,MIA vs ORL,Kevin Love,loveke01,31,MIA,1,ORL,5,3,1,1,0,1,16.16666667,1,2,2,6,1,4,0,1,3,1,4,6,8,9,12.1
2023-24,202401120DET,1/12/2024,DET vs HOU,Isaiah Livers,liveris01,23,DET,1,HOU,3,0,1,0,2,0,16.48333333,0,0,1,4,1,4,0,0,3,2,1,4,3,4,10.5
2023-24,202401120DEN,1/12/2024,DEN vs NOP,Jose Alvarado,alvarjo01,23,NOP,0,DEN,10,1,1,1,0,1,16.56666667,1,0,3,7,2,3,2,2,0,1,2,11,11,12,14.7
2023-24,202401120SAS,1/12/2024,SAS vs CHO,Blake Wesley,weslebl01,16,SAS,1,CHO,4,2,3,1,0,0,16.61666667,0,2,2,3,0,0,0,0,3,1,5,7,6,9,13.9
2023-24,202401120CHI,1/12/2024,CHI vs GSW,Ayo Dosunmu,dosunay01,38,CHI,1,GSW,6,0,0,0,0,3,16.65,0,0,2,4,2,3,0,0,4,0,0,6,6,6,3
2023-24,202401120DEN,1/12/2024,DEN vs NOP,Christian Braun,braunch01,40,DEN,1,NOP,4,6,0,0,0,3,16.71666667,1,5,1,4,1,4,1,2,2,0,6,4,10,10,8.2
2023-24,202401120PHI,1/12/2024,PHI vs SAC,Marcus Morris,morrima03,29,PHI,1,SAC,0,4,0,0,0,1,16.71666667,0,4,0,5,0,0,0,0,0,0,4,0,4,4,3.8
2023-24,202401120SAS,1/12/2024,SAS vs CHO,Dominick Barlow,barlodo01,15,SAS,1,CHO,5,6,1,0,3,0,16.91666667,2,4,1,4,0,0,3,6,2,3,7,6,11,12,22.7
2023-24,202401120MIA,1/12/2024,MIA vs ORL,Markelle Fultz,fultzma01,8,ORL,0,MIA,3,3,3,2,1,2,16.96666667,2,1,1,2,0,0,1,2,2,3,6,6,6,9,18.1
2023-24,202401120CHI,1/12/2024,CHI vs GSW,Trayce Jackson-Davis,jackstr02,28,GSW,0,CHI,13,7,2,1,1,1,17.06666667,3,4,4,5,0,0,5,7,2,2,9,15,20,22,29.4
2023-24,202401120UTA,1/12/2024,UTA vs TOR,Kris Dunn,dunnkr01,32,UTA,1,TOR,6,5,5,1,2,2,17.45,2,3,3,4,0,1,0,0,3,3,10,11,11,16,26.5
2023-24,202401120DET,1/12/2024,DET vs HOU,Ausar Thompson,thompau01,39,DET,1,HOU,4,8,0,0,0,1,18.28333333,2,6,2,3,0,1,0,0,2,0,8,4,12,12,12.6
2023-24,202401120ATL,1/12/2024,ATL vs IND,Isaiah Jackson,jacksis01,31,IND,0,ATL,12,5,2,4,3,2,18.36666667,1,4,6,7,0,0,0,0,3,7,7,14,17,19,40
2023-24,202401120SAS,1/12/2024,SAS vs CHO,Keldon Johnson,johnske04,35,SAS,1,CHO,10,2,1,1,0,2,18.65,0,2,3,11,2,7,2,2,2,1,3,11,12,13,14.9
2023-24,202401120MEM,1/12/2024,MEM vs LAC,Ziaire Williams,willizi02,36,MEM,1,LAC,13,3,2,0,0,1,18.71666667,2,1,5,12,3,5,0,0,2,0,5,15,16,18,18.6
2023-24,202401120SAS,1/12/2024,SAS vs CHO,Nathan Mensah,mensana01,12,CHO,0,SAS,0,7,2,0,0,2,18.78333333,4,3,0,4,0,0,0,0,6,0,9,2,7,9,9.4
2023-24,202401120MIN,1/12/2024,MIN vs POR,Nickeil Alexander-Walker,alexani01,38,MIN,1,POR,2,2,3,2,0,2,18.9,0,2,1,3,0,2,0,0,1,2,5,5,4,7,12.9
2023-24,202401120SAS,1/12/2024,SAS vs CHO,JT Thor,thorjt01,30,CHO,0,SAS,5,4,0,0,0,1,18.96666667,2,2,2,7,1,3,0,0,3,0,4,5,9,9,8.8
2023-24,202401120DEN,1/12/2024,DEN vs NOP,Herbert Jones,joneshe01,36,NOP,0,DEN,8,1,1,0,1,1,19.18333333,0,1,3,4,2,2,0,0,1,1,2,9,9,10,12.7
2023-24,202401120ATL,1/12/2024,ATL vs IND,Jalen Smith,smithja04,25,IND,0,ATL,6,7,0,0,0,0,19.25,3,4,3,7,0,0,0,0,1,0,7,6,13,13,14.4
2023-24,202401120MIA,1/12/2024,MIA vs ORL,Goga Bitadze,bitadgo01,34,ORL,0,MIA,2,9,1,1,1,0,19.4,0,9,1,1,0,0,0,2,1,2,10,3,11,12,20.3
2023-24,202401120DET,1/12/2024,DET vs HOU,Jae'Sean Tate,tateja01,35,HOU,0,DET,2,7,1,0,0,1,19.61666667,2,5,1,2,0,0,0,0,1,0,8,3,9,10,10.9
2023-24,202401120ATL,1/12/2024,ATL vs IND,Trent Forrest,forretr01,12,ATL,1,IND,4,0,6,1,0,1,19.63333333,0,0,2,5,0,0,0,0,0,1,6,10,4,10,15
2023-24,202401120SAS,1/12/2024,SAS vs CHO,Victor Wembanyama,wembavi01,33,SAS,1,CHO,26,11,1,0,2,3,19.68333333,3,8,9,14,2,3,6,6,2,2,12,27,37,38,43.7
2023-24,202401120MEM,1/12/2024,MEM vs LAC,Jake LaRavia,laravja01,10,MEM,1,LAC,12,4,1,0,1,0,19.88333333,2,2,5,10,2,4,0,0,4,1,5,13,16,17,21.3
2023-24,202401120MIA,1/12/2024,MIA vs ORL,Joe Ingles,inglejo01,25,ORL,0,MIA,14,0,6,3,0,2,20.05,0,0,5,10,4,8,0,1,2,3,6,20,14,20,30
2023-24,202401120MEM,1/12/2024,MEM vs LAC,Jacob Gilyard,gilyaja01,21,MEM,1,LAC,0,1,8,0,0,1,20.11666667,0,1,0,2,0,2,0,0,1,0,9,8,1,9,12.2
2023-24,202401120UTA,1/12/2024,UTA vs TOR,Collin Sexton,sextoco01,40,UTA,1,TOR,20,2,5,2,0,2,20.15,0,2,5,10,3,3,7,8,0,2,7,25,22,27,33.9
2023-24,202401120PHI,1/12/2024,PHI vs SAC,Mo Bamba,bambamo01,24,PHI,1,SAC,11,3,0,1,4,2,20.33333333,2,1,4,6,2,2,1,2,1,5,3,11,14,14,27.6
2023-24,202401120MIN,1/12/2024,MIN vs POR,Mike Conley,conlemi01,37,MIN,1,POR,9,4,10,0,0,0,20.4,0,4,3,7,3,5,0,0,1,0,14,19,13,23,28.8
2023-24,202401120DEN,1/12/2024,DEN vs NOP,Larry Nance Jr.,nancela02,22,NOP,0,DEN,13,2,1,2,1,1,20.41666667,0,2,5,6,3,4,0,0,1,3,3,14,15,16,24.9
2023-24,202401120SAS,1/12/2024,SAS vs CHO,Malaki Branham,branhma01,36,SAS,1,CHO,8,2,4,0,0,2,20.46666667,0,2,3,7,2,3,0,0,0,0,6,12,10,14,14.4
2023-24,202401120UTA,1/12/2024,UTA vs TOR,Walker Kessler,kesslwa01,32,UTA,1,TOR,12,6,1,1,3,0,20.48333333,2,4,5,5,0,0,2,4,4,4,7,13,18,19,32.7
2023-24,202401120SAS,1/12/2024,SAS vs CHO,Julian Champagnie,champju02,30,SAS,1,CHO,9,2,1,0,0,1,20.53333333,0,2,2,8,2,7,3,3,2,0,3,10,11,12,11.9
2023-24,202401120ATL,1/12/2024,ATL vs IND,Obi Toppin,toppiob01,39,IND,0,ATL,18,7,4,0,0,1,20.55,2,5,7,7,0,0,4,4,4,0,11,22,25,29,31.4
2023-24,202401120MIN,1/12/2024,MIN vs POR,Naz Reid,reidna01,38,MIN,1,POR,14,3,1,2,0,0,20.7,1,2,5,10,2,6,2,5,2,2,4,15,17,18,25.1
2023-24,202401120DET,1/12/2024,DET vs HOU,Reggie Bullock,bullore01,16,HOU,0,DET,3,4,1,1,0,1,20.81666667,0,4,1,3,1,3,0,0,0,1,5,4,7,8,11.3
2023-24,202401120PHI,1/12/2024,PHI vs SAC,Harrison Barnes,barneha02,38,SAC,0,PHI,4,2,0,1,0,1,21.1,2,0,1,5,0,4,2,2,1,1,2,4,6,6,8.4
2023-24,202401120ATL,1/12/2024,ATL vs IND,Bruce Brown,brownbr01,33,IND,0,ATL,12,1,4,0,0,2,21.15,0,1,5,9,2,3,0,0,0,0,5,16,13,17,17.2
2023-24,202401120UTA,1/12/2024,UTA vs TOR,Kelly Olynyk,olynyke01,38,UTA,1,TOR,11,10,5,1,0,1,21.3,2,8,4,7,1,2,2,4,3,1,15,16,21,26,32.5
2023-24,202401120ATL,1/12/2024,ATL vs IND,Aaron Nesmith,nesmiaa01,37,IND,0,ATL,13,4,0,1,0,1,21.41666667,1,3,5,6,3,3,0,0,3,1,4,13,17,17,19.8
2023-24,202401120SAS,1/12/2024,SAS vs CHO,Ish Smith,smithis01,30,CHO,0,SAS,0,2,6,1,0,2,21.55,0,2,0,4,0,0,0,0,0,1,8,6,2,8,12.4
2023-24,202401120SAS,1/12/2024,SAS vs CHO,Tre Jones,jonestr01,33,SAS,1,CHO,6,3,7,1,0,0,21.63333333,0,3,2,4,0,1,2,2,3,1,10,13,9,16,23.1
2023-24,202401120PHI,1/12/2024,PHI vs SAC,Trey Lyles,lylestr01,24,SAC,0,PHI,5,3,0,0,0,0,21.66666667,2,1,2,8,1,5,0,0,1,0,3,5,8,8,8.6
2023-24,202401120ATL,1/12/2024,ATL vs IND,Clint Capela,capelca01,35,ATL,1,IND,7,5,1,1,1,0,21.68333333,3,2,3,5,0,0,1,4,1,2,6,8,12,13,20.5
2023-24,202401120UTA,1/12/2024,UTA vs TOR,Gary Trent Jr.,trentga02,35,TOR,0,UTA,5,1,2,0,0,1,21.68333333,1,0,2,6,1,2,0,0,1,0,3,7,6,8,8.2
2023-24,202401120MEM,1/12/2024,MEM vs LAC,Daniel Theis,theisda01,28,LAC,0,MEM,7,5,4,2,3,0,21.83333333,2,3,2,4,1,1,2,4,2,5,9,11,12,16,34
2023-24,202401120UTA,1/12/2024,UTA vs TOR,Ochai Agbaji,agbajoc01,40,UTA,1,TOR,8,5,1,0,2,0,21.85,1,4,3,8,2,7,0,0,1,2,6,9,13,14,21.5
2023-24,202401120MEM,1/12/2024,MEM vs LAC,Ivica Zubac,zubaciv01,38,LAC,0,MEM,6,11,0,0,2,0,21.95,4,7,2,5,0,0,2,2,3,2,11,6,17,17,25.2
2023-24,202401120SAS,1/12/2024,SAS vs CHO,Nick Richards,richani01,30,CHO,0,SAS,12,8,1,0,1,0,22.18333333,5,3,5,8,0,0,2,2,3,1,9,13,20,21,26.1
2023-24,202401120UTA,1/12/2024,UTA vs TOR,Simone Fontecchio,fontesi01,38,UTA,1,TOR,13,2,0,0,1,0,22.5,1,1,5,9,3,5,0,0,0,1,2,13,15,15,18.4
2023-24,202401120ATL,1/12/2024,ATL vs IND,Onyeka Okongwu,okongon01,36,ATL,1,IND,6,1,1,0,0,0,22.61666667,1,0,3,4,0,0,0,0,2,0,2,7,7,8,8.7
2023-24,202401120ATL,1/12/2024,ATL vs IND,Andrew Nembhard,nembhan01,26,IND,0,ATL,10,4,6,2,0,4,22.66666667,0,4,4,6,2,2,0,0,2,2,10,16,14,20,25.8
2023-24,202401120UTA,1/12/2024,UTA vs TOR,Dennis Schroder,schrode01,39,TOR,0,UTA,12,0,4,1,0,1,22.71666667,0,0,4,9,4,7,0,0,2,1,4,16,12,16,20
2023-24,202401120MEM,1/12/2024,MEM vs LAC,Desmond Bane,banede01,37,MEM,1,LAC,15,1,3,1,0,0,22.8,0,1,3,11,3,6,6,7,3,1,4,18,16,19,23.7
2023-24,202401120ATL,1/12/2024,ATL vs IND,Buddy Hield,hieldbu01,39,IND,0,ATL,18,3,2,0,3,2,23.23333333,0,3,7,11,4,6,0,0,3,3,5,20,21,23,31.6
2023-24,202401120SAS,1/12/2024,SAS vs CHO,Bryce McGowens,mcgowbr01,31,CHO,0,SAS,12,0,0,1,0,4,23.5,0,0,5,7,1,2,1,1,1,1,0,12,12,12,11
2023-24,202401120MIN,1/12/2024,MIN vs POR,Duop Reath,reathdu01,26,POR,0,MIN,14,6,0,1,1,1,23.88333333,3,3,6,14,2,6,0,3,4,2,6,14,20,20,26.2
2023-24,202401120MIN,1/12/2024,MIN vs POR,Jaden McDaniels,mcdanja02,28,MIN,1,POR,9,2,3,2,0,4,23.9,0,2,4,8,1,3,0,0,1,2,5,12,11,14,17.9
2023-24,202401120MIA,1/12/2024,MIA vs ORL,Caleb Martin,martica02,21,MIA,1,ORL,11,4,2,1,0,0,23.95,0,4,3,6,1,2,4,4,1,1,6,13,15,17,21.8
2023-24,202401120UTA,1/12/2024,UTA vs TOR,Keyonte George,georgke01,34,UTA,1,TOR,9,3,6,0,0,3,24.2,0,3,3,10,0,5,3,3,0,0,9,15,12,18,18.6
2023-24,202401120CHI,1/12/2024,CHI vs GSW,Jonathan Kuminga,kuminjo01,37,GSW,0,CHI,24,5,1,1,0,0,24.26666667,0,5,9,12,4,4,2,3,2,1,6,25,29,30,34.5
2023-24,202401120MEM,1/12/2024,MEM vs LAC,Norman Powell,powelno01,38,LAC,0,MEM,11,5,0,0,0,1,24.26666667,0,5,5,8,0,2,1,1,2,0,5,11,16,16,16
2023-24,202401120DEN,1/12/2024,DEN vs NOP,Reggie Jackson,jacksre01,40,DEN,1,NOP,12,2,0,1,0,3,24.35,0,2,5,10,2,5,0,0,1,1,2,12,14,14,14.4
2023-24,202401120PHI,1/12/2024,PHI vs SAC,Paul Reed,reedpa01,37,PHI,1,SAC,8,8,2,2,3,0,24.45,5,3,3,9,0,1,2,2,4,5,10,10,16,18,35.6
2023-24,202401120SAS,1/12/2024,SAS vs CHO,Nick Smith Jr.,smithni01,21,CHO,0,SAS,9,6,5,0,0,1,24.5,2,4,4,9,1,3,0,0,2,0,11,14,15,20,22.7
2023-24,202401120MIN,1/12/2024,MIN vs POR,Toumani Camara,camarto01,37,POR,0,MIN,14,5,0,0,1,3,24.78333333,2,3,5,8,1,3,3,4,1,1,5,14,19,19,20
2023-24,202401120UTA,1/12/2024,UTA vs TOR,Immanuel Quickley,quickim01,37,TOR,0,UTA,15,3,0,0,0,1,24.9,1,2,4,8,3,3,4,4,1,0,3,15,18,18,17.6
2023-24,202401120ATL,1/12/2024,ATL vs IND,Bogdan Bogdanovic,bogdabo01,35,ATL,1,IND,10,5,2,3,0,2,24.93333333,3,2,3,12,2,5,2,2,2,3,7,12,15,17,26
2023-24,202401120MIA,1/12/2024,MIA vs ORL,Nikola Jovic,jovicni01,12,MIA,1,ORL,4,3,4,0,0,2,24.98333333,0,3,1,8,1,4,1,2,2,0,7,8,7,11,11.6
2023-24,202401120PHI,1/12/2024,PHI vs SAC,De'Anthony Melton,meltode01,33,PHI,1,SAC,6,4,3,1,0,1,25.11666667,1,3,2,9,2,8,0,0,3,1,7,9,10,13,17.3
2023-24,202401120MIA,1/12/2024,MIA vs ORL,Josh Richardson,richajo01,29,MIA,1,ORL,9,1,2,1,0,2,25.15,0,1,4,6,0,1,1,1,2,1,3,11,10,12,14.2
2023-24,202401120MIN,1/12/2024,MIN vs POR,Scoot Henderson,hendesc01,29,POR,0,MIN,8,2,4,0,0,6,25.18333333,0,2,3,4,0,0,2,7,2,0,6,12,10,14,10.4
2023-24,202401120ATL,1/12/2024,ATL vs IND,T.J. McConnell,mccontj01,31,IND,0,ATL,6,4,14,3,1,5,25.33333333,0,4,3,5,0,0,0,0,0,4,18,20,10,24,38.8
2023-24,202401120PHI,1/12/2024,PHI vs SAC,Nicolas Batum,batumni01,26,PHI,1,SAC,14,5,3,0,0,0,25.45,3,2,5,5,4,4,0,0,2,0,8,17,19,22,24.5
2023-24,202401120SAS,1/12/2024,SAS vs CHO,Jeremy Sochan,sochaje01,37,SAS,1,CHO,13,6,4,2,1,1,25.61666667,0,6,5,7,1,2,2,3,0,3,10,17,19,23,34.2
2023-24,202401120SAS,1/12/2024,SAS vs CHO,Devin Vassell,vassede01,32,SAS,1,CHO,12,3,5,2,0,2,25.63333333,0,3,4,10,1,3,3,3,2,2,8,17,15,20,27.1
2023-24,202401120DEN,1/12/2024,DEN vs NOP,Jonas Valanciunas,valanjo01,39,NOP,0,DEN,17,6,1,0,0,0,25.65,2,4,5,11,1,3,6,6,3,0,7,18,23,24,25.7
2023-24,202401120MEM,1/12/2024,MEM vs LAC,Amir Coffey,coffeam01,26,LAC,0,MEM,13,2,1,2,0,1,25.76666667,0,2,6,6,1,1,0,1,0,2,3,14,15,16,21.9
2023-24,202401120MIN,1/12/2024,MIN vs POR,Malcolm Brogdon,brogdma01,30,POR,0,MIN,9,2,3,0,0,1,25.9,0,2,2,7,2,5,3,4,1,0,5,12,11,14,14.9
2023-24,202401120ATL,1/12/2024,ATL vs IND,Myles Turner,turnemy01,38,IND,0,ATL,12,7,4,2,2,3,25.93333333,2,5,5,9,0,3,2,3,2,4,11,16,19,23,35.4
2023-24,202401120MEM,1/12/2024,MEM vs LAC,Terance Mann,mannte01,32,LAC,0,MEM,7,5,0,0,0,1,26.45,2,3,3,8,1,4,0,0,0,0,5,7,12,12,12
2023-24,202401120CHI,1/12/2024,CHI vs GSW,Kevon Looney,looneke01,38,GSW,0,CHI,9,5,1,0,1,0,26.5,3,2,4,4,0,0,1,2,2,1,6,10,14,15,19.5
2023-24,202401120MEM,1/12/2024,MEM vs LAC,Vince Williams Jr.,willivi01,28,MEM,1,LAC,6,3,1,1,0,1,26.53333333,2,1,2,6,2,5,0,0,2,1,4,7,9,10,13.1
2023-24,202401120SAS,1/12/2024,SAS vs CHO,LaMelo Ball,ballla01,16,CHO,0,SAS,28,3,5,5,0,6,26.7,0,3,5,14,3,9,15,16,4,5,8,33,31,36,48.1
2023-24,202401120PHI,1/12/2024,PHI vs SAC,Malik Monk,monkma01,37,SAC,0,PHI,15,1,4,2,1,2,26.91666667,0,1,5,17,0,7,5,6,1,3,5,19,16,20,29.2
2023-24,202401120MEM,1/12/2024,MEM vs LAC,David Roddy,roddyda01,35,MEM,1,LAC,17,6,4,1,0,2,26.91666667,1,5,7,11,3,5,0,0,3,1,10,21,23,27,31.2
2023-24,202401120PHI,1/12/2024,PHI vs SAC,Patrick Beverley,beverpa01,36,PHI,1,SAC,4,9,7,0,0,3,27.15,0,9,2,8,0,4,0,0,2,0,16,11,13,20,22.3
2023-24,202401120CHI,1/12/2024,CHI vs GSW,Brandin Podziemski,podzibr01,32,GSW,0,CHI,5,3,4,0,0,0,27.21666667,1,2,2,8,0,4,1,1,3,0,7,9,8,12,14.6
2023-24,202401120ATL,1/12/2024,ATL vs IND,Bennedict Mathurin,mathube01,39,IND,0,ATL,15,1,3,0,0,5,27.28333333,1,0,6,9,0,1,3,5,2,0,4,18,16,19,15.7
2023-24,202401120MIN,1/12/2024,MIN vs POR,Anthony Edwards,edwaran01,35,MIN,1,POR,9,3,6,1,1,0,27.3,0,3,4,9,0,3,1,2,2,2,9,15,12,18,27.6
2023-24,202401120MIA,1/12/2024,MIA vs ORL,Cole Anthony,anthoco01,37,ORL,0,MIA,5,3,0,2,1,0,27.31666667,1,2,2,8,0,2,1,2,1,3,3,5,8,8,17.6
2023-24,202401120DEN,1/12/2024,DEN vs NOP,Trey Murphy III,murphtr02,16,NOP,0,DEN,6,3,4,2,0,0,27.55,0,3,2,9,2,8,0,0,0,2,7,10,9,13,21.6
2023-24,202401120MIN,1/12/2024,MIN vs POR,Karl-Anthony Towns,townska01,37,MIN,1,POR,23,8,1,2,0,0,27.75,1,7,7,8,3,3,6,7,2,2,9,24,31,32,40.1
2023-24,202401120MEM,1/12/2024,MEM vs LAC,James Harden,hardeja01,33,LAC,0,MEM,11,1,9,1,0,3,27.78333333,0,1,3,7,2,4,3,3,0,1,10,20,12,21,25.7
2023-24,202401120DET,1/12/2024,DET vs HOU,Jaden Ivey,iveyja01,35,DET,1,HOU,18,7,8,0,1,3,28.03333333,5,2,8,19,1,6,1,4,3,1,15,26,25,33,38.4
2023-24,202401120UTA,1/12/2024,UTA vs TOR,Scottie Barnes,barnesc01,39,TOR,0,UTA,19,3,3,0,3,3,28.1,1,2,6,13,2,4,5,11,3,3,6,22,22,25,33.1
2023-24,202401120CHI,1/12/2024,CHI vs GSW,Dario Saric,saricda01,38,GSW,0,CHI,12,7,6,2,0,0,28.16666667,1,6,4,6,2,3,2,4,2,2,13,18,19,25,35.4
2023-24,202401120SAS,1/12/2024,SAS vs CHO,Terry Rozier,roziete01,25,CHO,0,SAS,16,2,2,2,1,1,28.38333333,0,2,6,14,3,9,1,2,2,3,4,18,18,20,29.4
2023-24,202401120MIN,1/12/2024,MIN vs POR,Rudy Gobert,goberru01,37,MIN,1,POR,24,17,0,0,2,1,28.45,5,12,9,11,0,0,6,8,2,2,17,24,41,41,49.4
2023-24,202401120MIA,1/12/2024,MIA vs ORL,Moritz Wagner,wagnemo01,38,ORL,0,MIA,19,5,4,1,1,1,28.6,1,4,7,9,0,1,5,5,5,2,9,23,24,28,36
2023-24,202401120DET,1/12/2024,DET vs HOU,Isaiah Stewart,stewais01,29,DET,1,HOU,16,7,1,0,0,3,28.65,0,7,6,13,3,8,1,2,1,0,8,17,23,24,22.9
2023-24,202401120CHI,1/12/2024,CHI vs GSW,Patrick Williams,willipa01,39,CHI,1,GSW,9,3,7,1,0,2,28.65,1,2,4,8,1,3,0,0,3,1,10,16,12,19,24.1
2023-24,202401120MEM,1/12/2024,MEM vs LAC,Kawhi Leonard,leonaka01,34,LAC,0,MEM,22,7,4,2,2,1,28.68333333,0,7,10,16,2,5,0,0,3,4,11,26,29,33,47.4
2023-24,202401120DET,1/12/2024,DET vs HOU,Killian Hayes,hayeski01,34,DET,1,HOU,5,4,8,1,1,1,28.75,0,4,2,6,0,2,1,1,1,2,12,13,9,17,26.8
2023-24,202401120MIN,1/12/2024,MIN vs POR,Anfernee Simons,simonan01,17,POR,0,MIN,5,2,3,0,1,3,28.81666667,0,2,0,10,0,2,5,5,0,1,5,8,7,10,11.9
2023-24,202401120CHI,1/12/2024,CHI vs GSW,Alex Caruso,carusal01,33,CHI,1,GSW,6,2,2,0,1,0,29.06666667,1,1,2,6,2,6,0,0,0,1,4,8,8,10,14.4
2023-24,202401120UTA,1/12/2024,UTA vs TOR,Lauri Markkanen,markkla01,30,UTA,1,TOR,22,9,2,1,0,3,29.13333333,3,6,7,11,4,6,4,5,2,1,11,24,31,33,35.8
2023-24,202401120MIA,1/12/2024,MIA vs ORL,Chuma Okeke,okekech01,21,ORL,0,MIA,16,4,2,0,1,1,29.2,2,2,6,10,4,8,0,0,0,1,6,18,20,22,25.8
2023-24,202401120MEM,1/12/2024,MEM vs LAC,Luke Kennard,kennalu01,15,MEM,1,LAC,11,7,6,0,0,1,29.26666667,1,6,4,7,3,5,0,0,2,0,13,17,18,24,27.4
2023-24,202401120MEM,1/12/2024,MEM vs LAC,Jaren Jackson Jr.,jacksja02,37,MEM,1,LAC,21,6,1,1,1,1,29.61666667,2,4,6,20,1,8,8,10,1,2,7,22,27,28,34.7
2023-24,202401120DET,1/12/2024,DET vs HOU,Alec Burks,burksal01,32,DET,1,HOU,19,0,1,0,2,2,29.93333333,0,0,7,14,5,9,0,0,3,2,1,20,19,20,24.5
2023-24,202401120UTA,1/12/2024,UTA vs TOR,Pascal Siakam,siakapa01,38,TOR,0,UTA,27,4,2,0,0,2,29.95,0,4,8,14,5,6,6,8,1,0,6,29,31,33,32.8
2023-24,202401120ATL,1/12/2024,ATL vs IND,Trae Young,youngtr01,35,ATL,1,IND,13,3,6,2,0,5,30.05,3,0,4,17,2,6,3,3,1,2,9,19,16,22,26.6
2023-24,202401120UTA,1/12/2024,UTA vs TOR,RJ Barrett,barrerj01,33,TOR,0,UTA,4,7,2,1,3,2,30.15,0,7,2,9,0,2,0,0,4,4,9,6,11,13,25.4
2023-24,202401120DEN,1/12/2024,DEN vs NOP,CJ McCollum,mccolcj01,26,NOP,0,DEN,12,5,7,1,0,2,30.16666667,0,5,4,10,3,8,1,2,2,1,12,19,17,24,29.5
2023-24,202401120MIN,1/12/2024,MIN vs POR,Jerami Grant,grantje01,34,POR,0,MIN,13,0,1,2,0,0,30.53333333,0,0,4,15,2,7,3,3,3,2,1,14,13,14,20.5
2023-24,202401120UTA,1/12/2024,UTA vs TOR,Jordan Clarkson,clarkjo01,30,UTA,1,TOR,21,1,5,0,0,0,30.55,0,1,8,16,5,9,0,0,1,0,6,26,22,27,29.7
2023-24,202401120MEM,1/12/2024,MEM vs LAC,Xavier Tillman Sr.,tillmxa01,26,MEM,1,LAC,20,9,2,1,2,2,30.58333333,4,5,8,10,1,2,3,7,1,3,11,22,29,31,40.8
2023-24,202401120CHI,1/12/2024,CHI vs GSW,Andrew Wiggins,wiggian01,34,GSW,0,CHI,17,5,8,1,1,0,30.73333333,3,2,8,13,1,5,0,0,2,2,13,25,22,30,41
2023-24,202401120DEN,1/12/2024,DEN vs NOP,Aaron Gordon,gordoaa01,34,DEN,1,NOP,15,5,2,0,0,2,30.98333333,3,2,7,12,0,2,1,3,2,0,7,17,20,22,22
2023-24,202401120DEN,1/12/2024,DEN vs NOP,Kentavious Caldwell-Pope,caldwke01,38,DEN,1,NOP,11,2,3,2,0,0,31,0,2,4,9,3,6,0,0,0,2,5,14,13,16,23.9
2023-24,202401120ATL,1/12/2024,ATL vs IND,Saddiq Bey,beysa01,37,ATL,1,IND,17,4,2,1,0,0,31.2,1,3,3,10,3,7,8,9,1,1,6,19,21,23,27.8
2023-24,202401120UTA,1/12/2024,UTA vs TOR,Jontay Porter,portejo01,6,TOR,0,UTA,9,6,6,2,2,0,31.46666667,2,4,3,8,1,4,2,2,1,4,12,15,15,21,37.2
2023-24,202401120DET,1/12/2024,DET vs HOU,Jalen Duren,durenja01,24,DET,1,HOU,15,8,3,2,1,2,31.53333333,2,6,7,12,0,0,1,2,3,3,11,18,23,26,36.1
2023-24,202401120ATL,1/12/2024,ATL vs IND,Dejounte Murray,murrade01,37,ATL,1,IND,29,4,4,3,0,3,31.78333333,0,4,13,18,3,6,0,0,2,3,8,33,33,37,45.8
2023-24,202401120MIA,1/12/2024,MIA vs ORL,Haywood Highsmith,highsha01,24,MIA,1,ORL,7,8,1,1,0,1,31.93333333,2,6,2,5,1,3,2,2,2,1,9,8,15,16,20.1
2023-24,202401120MIA,1/12/2024,MIA vs ORL,Caleb Houstan,houstca01,29,ORL,0,MIA,9,2,3,0,0,0,31.95,1,1,3,9,3,9,0,0,4,0,5,12,11,14,15.9
2023-24,202401120DEN,1/12/2024,DEN vs NOP,Nikola Jokic,jokicni01,39,DEN,1,NOP,27,10,14,0,1,2,32.18333333,3,7,11,17,1,2,4,4,4,1,24,41,37,51,61
2023-24,202401120ATL,1/12/2024,ATL vs IND,Jalen Johnson,johnsja05,23,ATL,1,IND,16,4,3,2,0,3,32.46666667,0,4,7,11,1,2,1,3,3,2,7,19,20,23,28.3
2023-24,202401120MIN,1/12/2024,MIN vs POR,Jabari Walker,walkeja01,34,POR,0,MIN,17,13,3,1,0,4,32.46666667,2,11,6,11,1,2,4,4,4,1,16,20,30,33,36.1
2023-24,202401120CHI,1/12/2024,CHI vs GSW,Nikola Vucevic,vucevni01,35,CHI,1,GSW,14,7,2,0,0,3,32.71666667,2,5,6,12,2,5,0,0,1,0,9,16,21,23,22.4
2023-24,202401120PHI,1/12/2024,PHI vs SAC,Domantas Sabonis,sabondo01,38,SAC,0,PHI,14,12,5,0,0,4,32.75,5,7,6,10,0,0,2,2,3,0,17,19,26,31,31.9
2023-24,202401120SAS,1/12/2024,SAS vs CHO,Miles Bridges,bridgmi02,25,CHO,0,SAS,14,9,0,1,0,1,32.81666667,1,8,4,13,1,4,5,5,1,1,9,14,23,23,26.8
2023-24,202401120DEN,1/12/2024,DEN vs NOP,Michael Porter Jr.,portemi01,40,DEN,1,NOP,20,10,1,1,1,1,33.38333333,1,9,8,12,2,5,2,3,2,2,11,21,30,31,38.5
2023-24,202401120DEN,1/12/2024,DEN vs NOP,Brandon Ingram,ingrabr01,36,NOP,0,DEN,9,4,6,0,0,2,33.8,0,4,4,11,0,1,1,2,2,0,10,15,13,19,20.8
2023-24,202401120CHI,1/12/2024,CHI vs GSW,Klay Thompson,thompkl01,37,GSW,0,CHI,30,6,6,1,1,1,33.98333333,2,4,9,19,7,15,5,6,1,2,12,36,36,42,51.2
2023-24,202401120DEN,1/12/2024,DEN vs NOP,Jamal Murray,murraja01,26,DEN,1,NOP,20,2,9,0,0,2,34.11666667,0,2,8,15,3,5,1,1,3,0,11,29,22,31,33.9
2023-24,202401120MEM,1/12/2024,MEM vs LAC,Paul George,georgpa01,36,LAC,0,MEM,37,3,1,2,0,4,34.61666667,0,3,12,18,7,10,6,6,3,2,4,38,40,41,44.1
2023-24,202401120CHI,1/12/2024,CHI vs GSW,Zach LaVine,lavinza01,22,CHI,1,GSW,25,8,7,0,1,1,35.06666667,0,8,9,15,4,8,3,3,3,1,15,32,33,40,47.1
2023-24,202401120CHI,1/12/2024,CHI vs GSW,Stephen Curry,curryst01,36,GSW,0,CHI,27,5,9,1,0,1,35.16666667,0,5,8,24,6,15,5,5,1,1,14,36,32,41,48.5
2023-24,202401120DET,1/12/2024,DET vs HOU,Kevin Knox,knoxke01,21,DET,1,HOU,19,7,2,1,2,1,35.18333333,0,7,7,9,2,4,3,3,1,3,9,21,26,28,38.4
2023-24,202401120PHI,1/12/2024,PHI vs SAC,Keegan Murray,murrake02,34,SAC,0,PHI,15,8,3,1,2,2,35.21666667,2,6,6,14,3,7,0,1,2,3,11,18,23,26,36.1
2023-24,202401120DEN,1/12/2024,DEN vs NOP,Zion Williamson,willizi01,32,NOP,0,DEN,30,6,5,0,1,1,35.35,2,4,13,22,0,0,4,6,1,1,11,35,36,41,46.7
2023-24,202401120MIA,1/12/2024,MIA vs ORL,Paolo Banchero,banchpa01,38,ORL,0,MIA,25,8,6,0,0,4,36.25,3,5,10,26,1,7,4,6,2,0,14,31,33,39,39.6
2023-24,202401120PHI,1/12/2024,PHI vs SAC,Tobias Harris,harrito02,36,PHI,1,SAC,37,7,3,3,0,3,36.38333333,3,4,14,25,3,7,6,6,0,3,10,40,44,47,55.9
2023-24,202401120MIA,1/12/2024,MIA vs ORL,Jaime Jaquez Jr.,jaqueja01,38,MIA,1,ORL,19,7,3,1,0,3,36.96666667,4,3,8,16,0,2,3,3,3,1,10,22,26,29,31.9
2023-24,202401120CHI,1/12/2024,CHI vs GSW,Coby White,whiteco01,40,CHI,1,GSW,25,4,7,0,0,1,37.21666667,0,4,9,13,5,7,2,3,4,0,11,32,29,36,39.3
2023-24,202401120DET,1/12/2024,DET vs HOU,Alperen Sengun,sengual01,37,HOU,0,DET,29,6,1,1,0,4,37.31666667,0,6,12,19,0,1,5,7,3,1,7,30,35,36,36.7
2023-24,202401120PHI,1/12/2024,PHI vs SAC,De'Aaron Fox,foxde01,32,SAC,0,PHI,21,5,4,1,0,2,37.81666667,1,4,5,15,2,7,9,11,2,1,9,25,26,30,34
2023-24,202401120DET,1/12/2024,DET vs HOU,Jalen Green,greenja05,37,HOU,0,DET,28,4,3,2,1,1,39.03333333,2,2,9,25,2,9,8,9,3,3,7,31,32,35,45.3
2023-24,202401120MIA,1/12/2024,MIA vs ORL,Bam Adebayo,adebaba01,28,MIA,1,ORL,21,11,7,0,1,4,39.41666667,4,7,8,17,0,0,5,6,3,1,18,28,32,39,43.7
2023-24,202401120PHI,1/12/2024,PHI vs SAC,Tyrese Maxey,maxeyty01,36,PHI,1,SAC,21,3,4,3,2,3,40.36666667,0,3,6,17,3,6,6,6,3,5,7,25,24,28,42.6
2023-24,202401120CHI,1/12/2024,CHI vs GSW,DeMar DeRozan,derozde01,38,CHI,1,GSW,39,7,5,0,0,1,40.98333333,1,6,15,21,2,5,7,8,5,0,12,44,46,51,53.9
2023-24,202401120DET,1/12/2024,DET vs HOU,Jabari Smith Jr.,smithja05,36,HOU,0,DET,19,11,1,1,2,1,40.98333333,5,6,7,15,1,3,4,4,0,3,12,20,30,31,41.7
2023-24,202401120MIA,1/12/2024,MIA vs ORL,Duncan Robinson,robindu01,36,MIA,1,ORL,23,4,3,1,0,3,41.43333333,1,3,9,19,4,10,1,1,1,1,7,26,27,30,32.3
2023-24,202401120DET,1/12/2024,DET vs HOU,Fred VanVleet,vanvlfr01,36,HOU,0,DET,20,4,12,2,2,0,42.53333333,1,3,7,15,3,9,3,3,5,4,16,32,24,36,54.8
2023-24,202401110OKC,1/11/2024,OKC vs POR,Kenrich Williams,willike04,26,OKC,1,POR,2,0,0,0,0,0,10.1,0,0,1,4,0,2,0,0,0,0,0,2,2,2,2
2023-24,202401110LAL,1/11/2024,LAL vs PHO,Josh Okogie,okogijo01,32,PHO,0,LAL,5,0,0,1,0,0,11.56666667,0,0,2,4,0,2,1,2,1,1,0,5,5,5,8
2023-24,202401110MIL,1/11/2024,MIL vs BOS,MarJon Beauchamp,beaucma01,33,MIL,1,BOS,0,1,0,0,1,1,12,0,1,0,2,0,2,0,0,0,1,1,0,1,1,3.2
2023-24,202401110LAL,1/11/2024,LAL vs PHO,Skylar Mays,mayssk01,22,LAL,1,PHO,12,1,1,1,0,0,12,1,0,5,6,2,2,0,0,0,1,2,13,13,14,17.7
2023-24,202401110OKC,1/11/2024,OKC vs POR,Rayan Rupert,ruperra01,11,POR,0,OKC,3,3,2,0,0,0,12,0,3,1,5,1,2,0,0,0,0,5,5,6,8,9.6
2023-24,202401110OKC,1/11/2024,OKC vs POR,Lindy Waters III,waterli01,14,OKC,1,POR,6,2,2,0,1,1,12,0,2,2,5,2,4,0,0,1,1,4,8,8,10,13.4
2023-24,202401110MIL,1/11/2024,MIL vs BOS,Neemias Queta,quetane01,14,BOS,0,MIL,4,3,0,0,1,1,12.65,1,2,2,4,0,0,0,0,1,1,3,4,7,7,9.6
2023-24,202401110CLE,1/11/2024,CLE vs BRK,Trendon Watford,watfotr01,27,BRK,0,CLE,8,4,1,1,0,0,12.65,2,2,4,5,0,1,0,0,6,1,5,9,12,13,17.3
2023-24,202401110LAL,1/11/2024,LAL vs PHO,Jaxson Hayes,hayesja02,33,LAL,1,PHO,6,2,1,0,2,2,13.01666667,1,1,3,3,0,0,0,0,6,2,3,7,8,9,13.9
2023-24,202401110OKC,1/11/2024,OKC vs POR,Justin Minaya,minayju01,8,POR,0,OKC,4,2,1,2,1,0,13.55,0,2,2,5,0,2,0,0,0,3,3,5,6,7,16.9
2023-24,202401110CLE,1/11/2024,CLE vs BRK,Dorian Finney-Smith,finnedo01,35,BRK,0,CLE,0,0,0,0,1,1,14.23333333,0,0,0,1,0,1,0,0,3,1,0,0,0,0,2
2023-24,202401110MIL,1/11/2024,MIL vs BOS,Cameron Payne,payneca01,37,MIL,1,BOS,7,4,3,0,0,0,14.75,0,4,3,4,1,2,0,0,0,0,7,10,11,14,16.3
2023-24,202401110DAL,1/11/2024,DAL vs NYK,Quentin Grimes,grimequ01,35,NYK,0,DAL,9,0,3,0,0,0,14.96666667,0,0,3,6,3,6,0,2,1,0,3,12,9,12,13.5
2023-24,202401110CLE,1/11/2024,CLE vs BRK,Spencer Dinwiddie,dinwisp01,36,BRK,0,CLE,2,2,3,0,0,0,15.58333333,0,2,1,3,0,2,0,0,2,0,5,5,4,7,8.9
2023-24,202401110MIL,1/11/2024,MIL vs BOS,Jayson Tatum,tatumja01,35,BOS,0,MIL,7,1,3,0,0,1,15.75,0,1,2,6,0,1,3,4,2,0,4,10,8,11,11.7
2023-24,202401110DAL,1/11/2024,DAL vs NYK,Precious Achiuwa,achiupr01,31,NYK,0,DAL,7,6,0,1,0,2,15.78333333,1,5,3,3,0,0,1,2,4,1,6,7,13,13,15.2
2023-24,202401110MIL,1/11/2024,MIL vs BOS,Andre Jackson Jr.,jacksan01,32,MIL,1,BOS,0,4,4,0,0,0,15.8,2,2,0,2,0,2,0,0,5,0,8,4,4,8,10.8
2023-24,202401110CLE,1/11/2024,CLE vs BRK,Georges Niang,niangge01,37,CLE,1,BRK,10,4,2,0,0,0,16.35,1,3,3,6,2,4,2,2,3,0,6,12,14,16,17.8
2023-24,202401110CLE,1/11/2024,CLE vs BRK,Royce O'Neale,onealro01,37,BRK,0,CLE,0,2,1,0,0,1,17.26666667,0,2,0,2,0,2,0,0,2,0,3,1,2,3,2.9
2023-24,202401110LAL,1/11/2024,LAL vs PHO,Bol Bol,bolbo01,12,PHO,0,LAL,6,6,2,2,2,0,17.3,2,4,2,3,0,0,2,2,1,4,8,8,12,14,28.2
2023-24,202401110MIL,1/11/2024,MIL vs BOS,Svi Mykhailiuk,mykhasv01,17,BOS,0,MIL,9,1,1,1,0,0,17.35,0,1,3,5,2,3,1,2,0,1,2,10,10,11,14.7
2023-24,202401110OKC,1/11/2024,OKC vs POR,Cason Wallace,wallaca01,37,OKC,1,POR,4,6,2,0,0,0,17.41666667,1,5,1,5,0,3,2,2,0,0,8,6,10,12,14.2
2023-24,202401110MIL,1/11/2024,MIL vs BOS,Oshae Brissett,brissos01,22,BOS,0,MIL,13,2,1,0,0,0,17.45,0,2,4,8,0,3,5,6,0,0,3,14,15,16,16.9
2023-24,202401110MIL,1/11/2024,MIL vs BOS,Derrick White,whitede01,35,BOS,0,MIL,2,1,0,0,0,0,17.5,0,1,1,4,0,1,0,0,0,0,1,2,3,3,3.2
2023-24,202401110OKC,1/11/2024,OKC vs POR,Keyontae Johnson,johnske08,2,OKC,1,POR,4,3,2,0,0,2,17.76666667,1,2,2,5,0,1,0,0,1,0,5,6,7,9,8.6
2023-24,202401110OKC,1/11/2024,OKC vs POR,Tre Mann,manntr01,13,OKC,1,POR,11,7,4,0,0,1,17.76666667,1,6,4,5,3,4,0,0,0,0,11,15,18,22,24.4
2023-24,202401110OKC,1/11/2024,OKC vs POR,Jaylin Williams,willija07,31,OKC,1,POR,6,4,1,1,0,2,17.76666667,0,4,2,6,2,4,0,0,0,1,5,7,10,11,13.3
2023-24,202401110MIL,1/11/2024,MIL vs BOS,Dalano Banton,bantoda01,19,BOS,0,MIL,4,1,3,2,1,0,17.95,0,1,1,5,1,2,1,2,1,3,4,7,5,8,18.7
2023-24,202401110MIL,1/11/2024,MIL vs BOS,Jaylen Brown,brownja02,36,BOS,0,MIL,10,4,3,0,0,0,18.31666667,1,3,5,14,0,1,0,0,1,0,7,13,14,17,19.3
2023-24,202401110OKC,1/11/2024,OKC vs POR,Matisse Thybulle,thybuma01,36,POR,0,OKC,4,0,1,1,0,0,18.53333333,0,0,1,5,0,4,2,2,1,1,1,5,4,5,8.5
2023-24,202401110OKC,1/11/2024,OKC vs POR,Luguentz Dort,dortlu01,36,OKC,1,POR,11,3,1,1,1,1,18.58333333,0,3,3,7,3,5,2,2,2,2,4,12,14,15,21.1
2023-24,202401110MIL,1/11/2024,MIL vs BOS,Jrue Holiday,holidjr01,35,BOS,0,MIL,6,4,2,0,0,1,18.58333333,1,3,2,9,0,4,2,2,1,0,6,8,10,12,12.8
2023-24,202401110OKC,1/11/2024,OKC vs POR,Jalen Williams,willija06,34,OKC,1,POR,21,7,4,0,2,1,18.98333333,3,4,9,10,1,1,2,3,0,2,11,25,28,32,40.4
2023-24,202401110OKC,1/11/2024,OKC vs POR,Ibou Badji,badjiib01,9,POR,0,OKC,0,3,2,0,3,0,19.05,0,3,0,0,0,0,0,0,3,3,5,2,3,5,15.6
2023-24,202401110MIL,1/11/2024,MIL vs BOS,Lamar Stevens,stevela01,14,BOS,0,MIL,5,4,0,0,1,0,19.4,1,3,1,6,0,0,3,4,2,1,4,5,9,9,12.8
2023-24,202401110OKC,1/11/2024,OKC vs POR,Chet Holmgren,holmgch01,37,OKC,1,POR,19,4,3,1,0,0,20.13333333,1,3,9,13,1,3,0,2,2,1,7,22,23,26,31.3
2023-24,202401110OKC,1/11/2024,OKC vs POR,Anfernee Simons,simonan01,16,POR,0,OKC,14,3,2,0,0,3,20.15,1,2,4,13,4,8,2,4,2,0,5,16,17,19,17.6
2023-24,202401110MIL,1/11/2024,MIL vs BOS,Khris Middleton,middlkh01,33,MIL,1,BOS,5,2,7,1,0,0,20.25,0,2,2,9,1,5,0,0,2,1,9,12,7,14,20.9
2023-24,202401110MIL,1/11/2024,MIL vs BOS,Kristaps Porzingis,porzikr01,28,BOS,0,MIL,6,2,4,1,1,1,20.93333333,1,1,3,9,0,3,0,0,2,2,6,10,8,12,19.4
2023-24,202401110OKC,1/11/2024,OKC vs POR,Shai Gilgeous-Alexander,gilgesh01,36,OKC,1,POR,31,5,4,0,1,2,21.11666667,1,4,11,15,1,3,8,8,2,1,9,35,36,40,44
2023-24,202401110MIL,1/11/2024,MIL vs BOS,Pat Connaughton,connapa01,32,MIL,1,BOS,2,1,3,0,0,0,21.25,1,0,1,1,0,0,0,0,3,0,4,5,3,6,7.7
2023-24,202401110OKC,1/11/2024,OKC vs POR,Shaedon Sharpe,sharpsh01,32,POR,0,OKC,7,6,1,0,0,1,21.28333333,3,3,3,14,1,6,0,0,3,0,7,8,13,14,14.7
2023-24,202401110MIL,1/11/2024,MIL vs BOS,Bobby Portis,portibo01,38,MIL,1,BOS,28,12,0,1,0,0,21.78333333,1,11,11,18,5,6,1,2,1,1,12,28,40,40,45.4
2023-24,202401110OKC,1/11/2024,OKC vs POR,Josh Giddey,giddejo01,36,OKC,1,POR,13,10,12,0,3,1,22.5,0,10,5,5,0,0,3,3,0,3,22,25,23,35,51
2023-24,202401110DAL,1/11/2024,DAL vs NYK,Jaden Hardy,hardyja02,34,DAL,1,NYK,8,6,4,0,0,0,22.7,0,6,2,8,0,2,4,5,2,0,10,12,14,18,21.2
2023-24,202401110CLE,1/11/2024,CLE vs BRK,Dennis Smith Jr.,smithde03,23,BRK,0,CLE,2,4,5,0,1,1,22.71666667,1,3,1,2,0,0,0,0,1,1,9,7,6,11,16.3
2023-24,202401110OKC,1/11/2024,OKC vs POR,Ousmane Dieng,diengou01,19,OKC,1,POR,9,6,3,1,0,1,22.73333333,0,6,4,11,1,5,0,0,2,1,9,12,15,18,22.7
2023-24,202401110LAL,1/11/2024,LAL vs PHO,Eric Gordon,gordoer01,32,PHO,0,LAL,5,3,0,0,0,0,22.95,2,1,2,11,1,9,0,0,0,0,3,5,8,8,8.6
2023-24,202401110OKC,1/11/2024,OKC vs POR,Kris Murray,murrakr01,21,POR,0,OKC,9,5,0,1,0,0,23.25,3,2,4,10,1,5,0,0,0,1,5,9,14,14,18
2023-24,202401110CLE,1/11/2024,CLE vs BRK,Cameron Johnson,johnsca02,30,BRK,0,CLE,3,2,1,1,0,3,23.26666667,1,1,1,7,1,5,0,2,3,1,3,4,5,6,6.9
2023-24,202401110DAL,1/11/2024,DAL vs NYK,Josh Hart,hartjo01,38,NYK,0,DAL,4,4,2,0,0,1,23.4,3,1,1,4,0,3,2,3,3,0,6,6,8,10,10.8
2023-24,202401110MIL,1/11/2024,MIL vs BOS,Sam Hauser,hausesa01,37,BOS,0,MIL,15,4,0,1,0,1,23.6,1,3,4,8,4,8,3,3,1,1,4,15,19,19,21.8
2023-24,202401110LAL,1/11/2024,LAL vs PHO,LeBron James,jamesle01,37,LAL,1,PHO,10,5,9,1,0,4,24.26666667,0,5,3,11,0,4,4,7,1,1,14,19,15,24,28.5
2023-24,202401110OKC,1/11/2024,OKC vs POR,Duop Reath,reathdu01,25,POR,0,OKC,8,7,2,0,1,0,24.31666667,2,5,3,9,1,4,1,2,2,1,9,10,15,17,22.4
2023-24,202401110LAL,1/11/2024,LAL vs PHO,Max Christie,chrisma02,30,LAL,1,PHO,14,7,4,0,0,2,24.55,0,7,4,8,1,3,5,6,2,0,11,18,21,25,26.4
2023-24,202401110OKC,1/11/2024,OKC vs POR,Jerami Grant,grantje01,33,POR,0,OKC,9,2,2,1,1,0,24.75,0,2,4,10,1,3,0,0,2,2,4,11,11,13,20.4
2023-24,202401110CLE,1/11/2024,CLE vs BRK,Lonnie Walker IV,walkelo01,20,BRK,0,CLE,20,3,2,1,1,1,24.98333333,1,2,8,12,4,5,0,0,3,2,5,22,23,25,31.6
2023-24,202401110MIL,1/11/2024,MIL vs BOS,Giannis Antetokounmpo,antetgi01,37,MIL,1,BOS,24,12,6,1,1,4,25.66666667,5,7,10,13,0,0,4,5,2,2,18,30,36,42,49.4
2023-24,202401110DAL,1/11/2024,DAL vs NYK,Grant Williams,willigr01,35,DAL,1,NYK,11,6,3,0,1,1,26.86666667,3,3,3,7,2,6,3,3,3,1,9,14,17,20,24.7
2023-24,202401110CLE,1/11/2024,CLE vs BRK,Dean Wade,wadede01,30,CLE,1,BRK,4,1,2,2,0,0,27,0,1,0,1,0,1,4,4,5,2,3,6,5,7,14.2
2023-24,202401110MIL,1/11/2024,MIL vs BOS,Damian Lillard,lillada01,35,MIL,1,BOS,21,4,4,0,0,0,27.05,0,4,6,12,3,8,6,6,1,0,8,25,25,29,31.8
2023-24,202401110MIL,1/11/2024,MIL vs BOS,Malik Beasley,beaslma01,36,MIL,1,BOS,16,4,0,0,0,0,27.1,1,3,6,11,4,8,0,0,0,0,4,16,20,20,20.8
2023-24,202401110LAL,1/11/2024,LAL vs PHO,D'Angelo Russell,russeda01,36,LAL,1,PHO,19,1,6,2,0,3,27.4,0,1,7,14,3,7,2,4,2,2,7,25,20,26,32.2
2023-24,202401110MIL,1/11/2024,MIL vs BOS,Brook Lopez,lopezbr01,38,MIL,1,BOS,15,5,3,0,2,1,27.98333333,1,4,6,8,2,4,1,2,3,2,8,18,20,23,30.5
2023-24,202401110DAL,1/11/2024,DAL vs NYK,Dwight Powell,poweldw01,36,DAL,1,NYK,4,9,2,1,0,0,28.16666667,5,4,2,3,0,0,0,0,5,1,11,6,13,15,20.8
2023-24,202401110LAL,1/11/2024,LAL vs PHO,Taurean Prince,princta02,38,LAL,1,PHO,11,6,2,0,0,0,28.21666667,1,5,4,10,3,8,0,0,0,0,8,13,17,19,21.2
2023-24,202401110LAL,1/11/2024,LAL vs PHO,Jusuf Nurkic,nurkiju01,36,PHO,0,LAL,9,12,2,1,0,2,28.48333333,4,8,3,6,0,0,3,4,2,1,14,11,21,23,27.4
2023-24,202401110LAL,1/11/2024,LAL vs PHO,Jarred Vanderbilt,vandeja01,19,LAL,1,PHO,6,9,2,2,0,1,29.46666667,3,6,2,5,1,3,1,4,0,2,11,8,15,17,24.8
2023-24,202401110DAL,1/11/2024,DAL vs NYK,Donte DiVincenzo,divindo01,38,NYK,0,DAL,19,4,3,2,0,2,29.63333333,1,3,7,13,5,10,0,0,4,2,7,22,23,26,32.3
2023-24,202401110LAL,1/11/2024,LAL vs PHO,Grayson Allen,allengr01,33,PHO,0,LAL,5,5,3,0,0,0,30.06666667,1,4,2,8,1,6,0,0,3,0,8,8,10,13,15.5
2023-24,202401110LAL,1/11/2024,LAL vs PHO,Austin Reaves,reaveau01,40,LAL,1,PHO,13,1,6,1,0,3,30.36666667,1,0,4,7,2,3,3,3,2,1,7,19,14,20,23.2
2023-24,202401110MIL,1/11/2024,MIL vs BOS,Payton Pritchard,pritcpa01,38,BOS,0,MIL,21,4,4,0,1,1,30.58333333,0,4,6,13,2,9,7,7,1,1,8,25,25,29,33.8
2023-24,202401110OKC,1/11/2024,OKC vs POR,Scoot Henderson,hendesc01,28,POR,0,OKC,13,6,2,1,0,3,31.2,2,4,4,21,1,9,4,6,3,1,8,15,19,21,23.2
2023-24,202401110LAL,1/11/2024,LAL vs PHO,Anthony Davis,davisan02,38,LAL,1,PHO,13,5,1,1,2,3,31.66666667,0,5,6,11,0,2,1,1,4,3,6,14,18,19,26.5
2023-24,202401110CLE,1/11/2024,CLE vs BRK,Sam Merrill,merrisa01,22,CLE,1,BRK,6,9,1,1,0,0,31.86666667,2,7,2,12,2,11,0,0,1,1,10,7,15,16,21.3
2023-24,202401110OKC,1/11/2024,OKC vs POR,Toumani Camara,camarto01,36,POR,0,OKC,6,5,1,2,2,2,31.91666667,2,3,2,9,1,6,1,2,3,4,6,7,11,12,23.5
2023-24,202401110LAL,1/11/2024,LAL vs PHO,Bradley Beal,bealbr01,14,PHO,0,LAL,37,6,4,1,0,3,32.1,2,4,14,21,8,10,1,1,3,1,10,41,43,47,50.2
2023-24,202401110DAL,1/11/2024,DAL vs NYK,Isaiah Hartenstein,harteis01,38,NYK,0,DAL,8,15,3,1,0,0,32.21666667,5,10,2,3,0,0,4,4,4,1,18,11,23,26,33.5
2023-24,202401110LAL,1/11/2024,LAL vs PHO,Kevin Durant,duranke01,31,PHO,0,LAL,18,5,5,3,1,1,32.25,0,5,7,12,2,5,2,2,0,4,10,23,23,28,42.5
2023-24,202401110CLE,1/11/2024,CLE vs BRK,Nic Claxton,claxtni01,28,BRK,0,CLE,13,11,1,1,0,4,33.26666667,3,8,6,9,0,0,1,2,3,1,12,14,24,25,26.7
2023-24,202401110LAL,1/11/2024,LAL vs PHO,Devin Booker,bookede01,29,PHO,0,LAL,31,5,5,3,0,3,33.51666667,0,5,11,22,2,6,7,7,2,3,10,36,36,41,50.5
2023-24,202401110CLE,1/11/2024,CLE vs BRK,Cam Thomas,thomaca02,29,BRK,0,CLE,26,6,2,0,1,0,34.5,0,6,9,21,1,5,7,11,3,1,8,28,32,34,39.2
2023-24,202401110CLE,1/11/2024,CLE vs BRK,Isaac Okoro,okorois01,28,CLE,1,BRK,12,4,0,0,0,1,34.65,3,1,4,12,2,5,2,2,4,0,4,12,16,16,15.8
2023-24,202401110CLE,1/11/2024,CLE vs BRK,Caris LeVert,leverca01,29,CLE,1,BRK,21,3,1,1,2,1,34.76666667,0,3,5,14,3,9,8,12,2,3,4,22,24,25,34.1
2023-24,202401110DAL,1/11/2024,DAL vs NYK,Josh Green,greenjo02,27,DAL,1,NYK,18,2,3,1,0,0,34.93333333,0,2,8,12,2,4,0,2,2,1,5,21,20,23,27.9
2023-24,202401110DAL,1/11/2024,DAL vs NYK,Derrick Jones Jr.,jonesde02,38,DAL,1,NYK,9,4,1,0,1,1,35,1,3,4,10,1,5,0,2,2,1,5,10,13,14,17.3
2023-24,202401110DAL,1/11/2024,DAL vs NYK,Julius Randle,randlju01,38,NYK,0,DAL,32,6,5,2,0,4,37.3,1,5,12,23,2,7,6,7,3,2,11,37,38,43,48.7
2023-24,202401110CLE,1/11/2024,CLE vs BRK,Jarrett Allen,allenja01,32,CLE,1,BRK,12,12,4,2,4,1,38.06666667,3,9,3,5,0,0,6,6,5,6,16,16,24,28,49.4
2023-24,202401110CLE,1/11/2024,CLE vs BRK,Mikal Bridges,bridgmi01,38,BRK,0,CLE,26,6,1,1,0,4,38.53333333,0,6,6,18,2,6,12,13,3,1,7,27,32,33,33.7
2023-24,202401110DAL,1/11/2024,DAL vs NYK,Tim Hardaway Jr.,hardati02,36,DAL,1,NYK,32,6,4,2,0,2,38.66666667,2,4,10,20,6,13,6,7,2,2,10,36,38,42,49.2
2023-24,202401110DAL,1/11/2024,DAL vs NYK,OG Anunoby,anunoog01,33,NYK,0,DAL,10,6,2,0,2,1,38.7,1,5,4,10,1,6,1,1,1,2,8,12,16,18,25.2
2023-24,202401110DAL,1/11/2024,DAL vs NYK,Jalen Brunson,brunsja01,38,NYK,0,DAL,30,2,8,1,0,4,38.98333333,0,2,10,22,2,6,8,9,3,1,10,38,32,40,43.4
2023-24,202401110DAL,1/11/2024,DAL vs NYK,Kyrie Irving,irvinky01,23,DAL,1,NYK,44,4,10,2,0,5,39.51666667,0,4,15,26,6,10,8,9,3,2,14,54,48,58,64.8
2023-24,202401110CLE,1/11/2024,CLE vs BRK,Donovan Mitchell,mitchdo01,28,CLE,1,BRK,45,12,6,4,0,7,40.61666667,2,10,15,30,4,12,11,13,1,4,18,51,57,63,73.4
2023-24,202401100CHO,1/10/2024,CHO vs SAC,Bryce McGowens,mcgowbr01,30,CHO,1,SAC,4,2,1,0,0,1,10.4,0,2,1,2,1,2,1,2,0,0,3,5,6,7,6.9
2023-24,202401100IND,1/10/2024,IND vs WAS,Mike Muscala,muscami01,24,WAS,0,IND,4,4,0,0,0,1,10.53333333,3,1,2,4,0,2,0,0,4,0,4,4,8,8,7.8
2023-24,202401100CHI,1/10/2024,CHI vs HOU,Aaron Holiday,holidaa01,34,HOU,0,CHI,4,2,0,2,0,2,11.23333333,1,1,1,3,0,1,2,2,0,2,2,4,6,6,10.4
2023-24,202401100LAC,1/10/2024,LAC vs TOR,Chris Boucher,bouchch01,35,TOR,0,LAC,3,1,0,0,0,0,11.35,0,1,1,3,0,1,1,1,0,0,1,3,4,4,4.2
2023-24,202401100MIA,1/10/2024,MIA vs OKC,Jaylin Williams,willija07,30,OKC,0,MIA,3,2,4,0,0,0,12.05,0,2,1,2,1,2,0,0,2,0,6,7,5,9,11.4
2023-24,202401100UTA,1/10/2024,UTA vs DEN,Justin Holiday,holidju01,22,DEN,0,UTA,3,0,1,1,0,0,12.35,0,0,1,3,1,3,0,0,2,1,1,4,3,4,7.5
2023-24,202401100CHI,1/10/2024,CHI vs HOU,Andre Drummond,drumman01,39,CHI,1,HOU,4,0,1,2,0,3,12.5,0,0,2,2,0,0,0,0,1,2,1,5,4,5,8.5
2023-24,202401100ATL,1/10/2024,ATL vs PHI,Patrick Beverley,beverpa01,35,PHI,0,ATL,9,3,2,0,0,1,12.51666667,1,2,3,4,1,2,2,2,2,0,5,11,12,14,14.6
2023-24,202401100ATL,1/10/2024,ATL vs PHI,Jaden Springer,sprinja01,23,PHI,0,ATL,2,1,0,1,0,0,13.01666667,0,1,1,2,0,0,0,0,2,1,1,2,3,3,6.2
2023-24,202401100LAC,1/10/2024,LAC vs TOR,Jalen McDaniels,mcdanja01,23,TOR,0,LAC,2,3,1,1,0,0,13.21666667,0,3,1,2,0,0,0,0,2,1,4,3,5,6,10.1
2023-24,202401100UTA,1/10/2024,UTA vs DEN,Ochai Agbaji,agbajoc01,39,UTA,1,DEN,0,4,1,1,2,0,13.38333333,1,3,0,2,0,1,0,0,1,3,5,1,4,5,15.3
2023-24,202401100GSW,1/10/2024,GSW vs NOP,Naji Marshall,marshna01,29,NOP,0,GSW,12,3,2,1,0,1,13.38333333,0,3,5,6,0,0,2,2,1,1,5,14,15,17,20.6
2023-24,202401100GSW,1/10/2024,GSW vs NOP,Dario Saric,saricda01,37,GSW,1,NOP,4,3,3,1,0,2,13.5,1,2,1,3,0,2,2,2,2,1,6,7,7,10,13.1
2023-24,202401100CHI,1/10/2024,CHI vs HOU,Amen Thompson,thompam01,17,HOU,0,CHI,6,2,3,1,0,2,13.6,0,2,3,7,0,3,0,0,2,1,5,9,8,11,13.9
2023-24,202401100CHO,1/10/2024,CHO vs SAC,Chris Duarte,duartch01,33,SAC,0,CHO,0,2,2,0,0,0,13.75,1,1,0,2,0,0,0,0,2,0,4,2,2,4,5.4
2023-24,202401100CHO,1/10/2024,CHO vs SAC,Colby Jones,jonesco02,14,SAC,0,CHO,0,1,0,0,0,0,13.9,1,0,0,2,0,2,0,0,0,0,1,0,1,1,1.2
2023-24,202401100LAC,1/10/2024,LAC vs TOR,Russell Westbrook,westbru01,37,LAC,1,TOR,6,0,3,0,0,0,14.33333333,0,0,3,9,0,1,0,0,0,0,3,9,6,9,10.5
2023-24,202401100ATL,1/10/2024,ATL vs PHI,Mo Bamba,bambamo01,23,PHI,0,ATL,5,6,2,1,3,1,14.35,4,2,2,4,0,1,1,2,3,4,8,7,11,13,26.2
2023-24,202401100IND,1/10/2024,IND vs WAS,Delon Wright,wrighde01,16,WAS,0,IND,3,1,2,0,0,0,14.4,1,0,1,4,0,1,1,4,1,0,3,5,4,6,7.2
2023-24,202401100MIA,1/10/2024,MIA vs OKC,Vasilije Micic,micicva01,16,OKC,0,MIA,4,1,5,1,0,0,14.55,0,1,2,2,0,0,0,0,1,1,6,9,5,10,15.7
2023-24,202401100DET,1/10/2024,DET vs SAS,Doug McDermott,mcderdo01,32,SAS,0,DET,14,2,0,0,0,0,14.96666667,0,2,5,6,4,5,0,0,0,0,2,14,16,16,16.4
2023-24,202401100UTA,1/10/2024,UTA vs DEN,Walker Kessler,kesslwa01,31,UTA,1,DEN,8,4,1,2,1,1,14.98333333,2,2,4,4,0,0,0,0,4,3,5,9,12,13,22.3
2023-24,202401100DET,1/10/2024,DET vs SAS,Ausar Thompson,thompau01,38,DET,1,SAS,3,6,1,0,1,1,15.03333333,0,6,1,6,0,3,1,1,4,1,7,4,9,10,13.7
2023-24,202401100CHO,1/10/2024,CHO vs SAC,Alex Len,lenal01,13,SAC,0,CHO,8,10,1,1,1,1,15.51666667,4,6,4,6,0,0,0,0,2,2,11,9,18,19,26.5
2023-24,202401100LAC,1/10/2024,LAC vs TOR,Daniel Theis,theisda01,27,LAC,1,TOR,4,4,1,1,1,1,15.9,2,2,1,2,0,0,2,2,1,2,5,5,8,9,15.3
2023-24,202401100CHO,1/10/2024,CHO vs SAC,Ish Smith,smithis01,29,CHO,1,SAC,2,1,0,0,0,0,16.01666667,0,1,1,3,0,0,0,0,1,0,1,2,3,3,3.2
2023-24,202401100BOS,1/10/2024,BOS vs MIN,Payton Pritchard,pritcpa01,37,BOS,1,MIN,3,1,1,0,0,0,16.36666667,0,1,1,4,1,3,0,0,0,0,2,4,4,5,5.7
2023-24,202401100DET,1/10/2024,DET vs SAS,Marcus Sasser,sassema01,34,DET,1,SAS,6,2,5,0,0,1,16.48333333,1,1,3,7,0,1,0,0,2,0,7,11,8,13,14.9
2023-24,202401100CHO,1/10/2024,CHO vs SAC,Juan Toscano-Anderson,toscaju01,10,SAC,0,CHO,2,3,0,0,1,0,16.68333333,1,2,1,4,0,1,0,0,2,1,3,2,5,5,8.6
2023-24,202401100MIA,1/10/2024,MIA vs OKC,Kenrich Williams,willike04,25,OKC,0,MIA,7,6,2,0,0,2,16.7,1,5,3,4,1,2,0,0,0,0,8,9,13,15,15.2
2023-24,202401100UTA,1/10/2024,UTA vs DEN,Christian Braun,braunch01,39,DEN,0,UTA,5,3,1,1,0,1,16.71666667,0,3,2,4,1,2,0,0,1,1,4,6,8,9,12.1
2023-24,202401100BOS,1/10/2024,BOS vs MIN,Jordan McLaughlin,mclaujo01,17,MIN,0,BOS,6,2,0,0,0,0,16.73333333,0,2,2,5,2,3,0,0,1,0,2,6,8,8,8.4
2023-24,202401100DET,1/10/2024,DET vs SAS,Isaiah Livers,liveris01,22,DET,1,SAS,6,4,1,1,0,0,17.08333333,2,2,2,3,2,3,0,0,1,1,5,7,10,11,15.3
2023-24,202401100IND,1/10/2024,IND vs WAS,Isaiah Jackson,jacksis01,30,IND,1,WAS,12,3,1,1,3,2,17.25,2,1,4,4,0,0,4,6,3,4,4,13,15,16,27.1
2023-24,202401100UTA,1/10/2024,UTA vs DEN,Peyton Watson,watsope01,37,DEN,0,UTA,3,2,0,0,0,0,17.26666667,1,1,1,8,1,5,0,0,1,0,2,3,5,5,5.4
2023-24,202401100GSW,1/10/2024,GSW vs NOP,Cory Joseph,josepco01,18,GSW,1,NOP,2,3,2,0,0,2,17.31666667,2,1,1,3,0,2,0,0,2,0,5,4,5,7,6.6
2023-24,202401100IND,1/10/2024,IND vs WAS,Jordan Nwora,nworajo01,15,IND,1,WAS,9,5,0,0,0,0,17.46666667,0,5,4,7,1,2,0,0,3,0,5,9,14,14,15
2023-24,202401100ATL,1/10/2024,ATL vs PHI,Bruno Fernando,fernabr01,10,ATL,1,PHI,8,5,0,1,3,1,17.48333333,2,3,3,4,0,0,2,9,2,4,5,8,13,13,25
2023-24,202401100DET,1/10/2024,DET vs SAS,James Wiseman,wisemja01,27,DET,1,SAS,3,3,3,0,0,0,17.48333333,0,3,1,1,0,0,1,2,2,0,6,6,6,9,11.1
2023-24,202401100LAC,1/10/2024,LAC vs TOR,Amir Coffey,coffeam01,25,LAC,1,TOR,6,1,1,1,0,0,17.86666667,0,1,3,5,0,2,0,0,1,1,2,7,7,8,11.7
2023-24,202401100CHI,1/10/2024,CHI vs HOU,Jae'Sean Tate,tateja01,34,HOU,0,CHI,3,2,0,0,0,0,17.88333333,1,1,1,3,0,2,1,2,1,0,2,3,5,5,5.4
2023-24,202401100BOS,1/10/2024,BOS vs MIN,Sam Hauser,hausesa01,36,BOS,1,MIN,6,4,0,0,1,0,17.96666667,0,4,2,6,2,5,0,0,2,1,4,6,10,10,13.8
2023-24,202401100CHI,1/10/2024,CHI vs HOU,Ayo Dosunmu,dosunay01,37,CHI,1,HOU,8,4,3,0,0,0,18.01666667,2,2,3,8,2,4,0,0,0,0,7,11,12,15,17.3
2023-24,202401100MIA,1/10/2024,MIA vs OKC,Cason Wallace,wallaca01,36,OKC,0,MIA,8,2,1,0,0,1,18.21666667,1,1,3,5,2,4,0,0,2,0,3,9,10,11,10.9
2023-24,202401100BOS,1/10/2024,BOS vs MIN,Luke Kornet,kornelu01,24,BOS,1,MIN,8,5,0,0,1,0,18.3,2,3,3,4,0,0,2,2,1,1,5,8,13,13,17
2023-24,202401100LAC,1/10/2024,LAC vs TOR,Jontay Porter,portejo01,5,TOR,0,LAC,9,7,4,0,0,3,18.33333333,3,4,4,8,1,3,0,0,4,0,11,13,16,20,20.4
2023-24,202401100ATL,1/10/2024,ATL vs PHI,Trent Forrest,forretr01,11,ATL,1,PHI,4,5,3,0,0,0,18.5,0,5,2,3,0,1,0,0,3,0,8,7,9,12,14.5
2023-24,202401100GSW,1/10/2024,GSW vs NOP,Kevon Looney,looneke01,37,GSW,1,NOP,7,7,0,0,1,0,18.65,2,5,3,3,0,0,1,2,4,1,7,7,14,14,18.4
2023-24,202401100IND,1/10/2024,IND vs WAS,Buddy Hield,hieldbu01,38,IND,1,WAS,0,3,4,0,0,1,18.78333333,1,2,0,5,0,3,0,0,1,0,7,4,3,7,8.6
2023-24,202401100GSW,1/10/2024,GSW vs NOP,Larry Nance Jr.,nancela02,21,NOP,0,GSW,6,5,1,2,1,1,18.91666667,1,4,1,1,1,1,3,4,0,3,6,7,11,12,21.5
2023-24,202401100ATL,1/10/2024,ATL vs PHI,Paul Reed,reedpa01,36,PHI,0,ATL,9,9,2,1,2,0,18.95,1,8,4,8,0,1,1,1,2,3,11,11,18,20,31.8
2023-24,202401100CHI,1/10/2024,CHI vs HOU,Jeff Green,greenje02,35,HOU,0,CHI,9,3,1,0,0,1,19,1,2,4,5,0,1,1,1,1,0,4,10,12,13,13.1
2023-24,202401100UTA,1/10/2024,UTA vs DEN,Kelly Olynyk,olynyke01,37,UTA,1,DEN,9,3,5,2,1,1,19.25,0,3,4,5,1,1,0,0,2,3,8,14,12,17,28.1
2023-24,202401100DET,1/10/2024,DET vs SAS,Alec Burks,burksal01,31,DET,1,SAS,15,2,2,0,0,1,19.58333333,0,2,5,13,1,5,4,4,1,0,4,17,17,19,19.4
2023-24,202401100MIA,1/10/2024,MIA vs OKC,Kevin Love,loveke01,30,MIA,1,OKC,12,5,2,0,0,1,19.7,1,4,3,6,0,2,6,6,0,0,7,14,17,19,20
2023-24,202401100CHO,1/10/2024,CHO vs SAC,James Bouknight,bouknja01,7,CHO,1,SAC,8,0,1,0,0,0,19.78333333,0,0,3,8,2,6,0,0,0,0,1,9,8,9,9.5
2023-24,202401100UTA,1/10/2024,UTA vs DEN,Reggie Jackson,jacksre01,39,DEN,0,UTA,5,0,2,0,0,0,20.3,0,0,2,7,1,4,0,0,2,0,2,7,5,7,8
2023-24,202401100MIA,1/10/2024,MIA vs OKC,Josh Giddey,giddejo01,35,OKC,0,MIA,9,7,2,1,0,2,20.46666667,0,7,3,5,1,2,2,2,0,1,9,11,16,18,21.4
2023-24,202401100UTA,1/10/2024,UTA vs DEN,Simone Fontecchio,fontesi01,37,UTA,1,DEN,3,0,2,0,0,3,20.5,0,0,1,5,1,4,0,0,0,0,2,5,3,5,3
2023-24,202401100CHO,1/10/2024,CHO vs SAC,JT Thor,thorjt01,29,CHO,1,SAC,2,5,0,0,0,0,20.76666667,2,3,1,7,0,2,0,0,2,0,5,2,7,7,8
2023-24,202401100MIA,1/10/2024,MIA vs OKC,Josh Richardson,richajo01,28,MIA,1,OKC,8,1,2,1,0,2,20.78333333,0,1,3,7,2,5,0,0,2,1,3,10,9,11,13.2
2023-24,202401100DET,1/10/2024,DET vs SAS,Cedi Osman,osmande01,36,SAS,0,DET,11,6,3,2,0,0,20.85,1,5,4,6,1,3,2,3,0,2,9,14,17,20,28.7
2023-24,202401100DET,1/10/2024,DET vs SAS,Malaki Branham,branhma01,35,SAS,0,DET,7,2,3,0,0,1,20.91666667,1,1,2,7,1,3,2,2,2,0,5,10,9,12,12.9
2023-24,202401100DET,1/10/2024,DET vs SAS,Julian Champagnie,champju02,29,SAS,0,DET,2,4,1,2,0,0,20.91666667,1,3,1,3,0,2,0,0,2,2,5,3,6,7,14.3
2023-24,202401100DET,1/10/2024,DET vs SAS,Victor Wembanyama,wembavi01,32,SAS,0,DET,16,12,10,0,0,0,21.03333333,3,9,6,16,0,4,4,5,1,0,22,26,28,38,45.4
2023-24,202401100UTA,1/10/2024,UTA vs DEN,Collin Sexton,sextoco01,39,UTA,1,DEN,22,2,4,1,1,1,21.13333333,1,1,8,14,2,4,4,4,3,2,6,26,24,28,35.4
2023-24,202401100GSW,1/10/2024,GSW vs NOP,Jonas Valanciunas,valanjo01,38,NOP,0,GSW,21,9,2,2,1,0,21.16666667,4,5,9,13,2,3,1,2,4,3,11,23,30,32,43.8
2023-24,202401100GSW,1/10/2024,GSW vs NOP,Jordan Hawkins,hawkijo01,33,NOP,0,GSW,14,1,2,0,0,0,21.18333333,0,1,5,9,4,5,0,0,1,0,3,16,15,17,18.2
2023-24,202401100CHO,1/10/2024,CHO vs SAC,Trey Lyles,lylestr01,23,SAC,0,CHO,8,5,2,0,0,1,21.18333333,1,4,2,4,2,4,2,4,1,0,7,10,13,15,16
2023-24,202401100ATL,1/10/2024,ATL vs PHI,De'Anthony Melton,meltode01,32,PHI,0,ATL,10,3,2,0,0,1,21.3,1,2,3,7,2,4,2,2,0,0,5,12,13,15,15.6
2023-24,202401100CHO,1/10/2024,CHO vs SAC,Nathan Mensah,mensana01,11,CHO,1,SAC,2,4,1,0,1,1,21.65,1,3,1,2,0,0,0,0,4,1,5,3,6,7,10.3
2023-24,202401100IND,1/10/2024,IND vs WAS,T.J. McConnell,mccontj01,30,IND,1,WAS,14,2,8,2,0,0,21.81666667,0,2,7,10,0,0,0,0,2,2,10,22,16,24,34.4
2023-24,202401100GSW,1/10/2024,GSW vs NOP,Trayce Jackson-Davis,jackstr02,27,GSW,1,NOP,19,5,1,1,1,1,21.85,3,2,9,11,0,0,1,1,1,2,6,20,24,25,31.5
2023-24,202401100MIA,1/10/2024,MIA vs OKC,Isaiah Joe,joeis01,36,OKC,0,MIA,11,2,0,0,0,1,22.01666667,1,1,4,7,3,6,0,0,1,0,2,11,13,13,12.4
2023-24,202401100CHO,1/10/2024,CHO vs SAC,Harrison Barnes,barneha02,37,SAC,0,CHO,6,2,1,0,0,1,22.3,1,1,2,4,2,4,0,0,0,0,3,7,8,9,8.9
2023-24,202401100UTA,1/10/2024,UTA vs DEN,Keyonte George,georgke01,33,UTA,1,DEN,6,1,3,1,0,1,22.3,0,1,2,7,1,4,1,2,0,1,4,9,7,10,13.7
2023-24,202401100IND,1/10/2024,IND vs WAS,Bilal Coulibaly,coulibi01,36,WAS,0,IND,5,6,1,0,1,0,22.33333333,1,5,1,5,0,1,3,4,4,1,7,6,11,12,16.7
2023-24,202401100GSW,1/10/2024,GSW vs NOP,Dyson Daniels,daniedy01,38,NOP,0,GSW,8,3,3,1,0,1,22.48333333,0,3,3,4,1,2,1,2,2,1,6,11,11,14,18.1
2023-24,202401100GSW,1/10/2024,GSW vs NOP,Brandon Ingram,ingrabr01,35,NOP,0,GSW,13,5,1,1,0,2,22.65,1,4,5,12,1,3,2,2,4,1,6,14,18,19,21.5
2023-24,202401100GSW,1/10/2024,GSW vs NOP,Andrew Wiggins,wiggian01,33,GSW,1,NOP,5,2,2,0,0,1,22.95,0,2,2,8,1,3,0,0,2,0,4,7,7,9,9.4
2023-24,202401100GSW,1/10/2024,GSW vs NOP,Herbert Jones,joneshe01,35,NOP,0,GSW,12,5,4,1,2,1,23.35,1,4,4,7,4,7,0,0,1,3,9,16,17,21,32
2023-24,202401100LAC,1/10/2024,LAC vs TOR,Thaddeus Young,youngth01,10,TOR,0,LAC,8,4,3,2,0,2,23.41666667,2,2,4,5,0,1,0,0,1,2,7,11,12,15,21.3
2023-24,202401100DET,1/10/2024,DET vs SAS,Kevin Knox,knoxke01,20,DET,1,SAS,12,4,0,0,0,0,23.61666667,3,1,5,11,2,5,0,0,2,0,4,12,16,16,16.8
2023-24,202401100LAC,1/10/2024,LAC vs TOR,Terance Mann,mannte01,31,LAC,1,TOR,13,2,1,0,0,1,23.68333333,2,0,5,5,3,3,0,0,1,0,3,14,15,16,15.9
2023-24,202401100UTA,1/10/2024,UTA vs DEN,Michael Porter Jr.,portemi01,39,DEN,0,UTA,5,4,1,0,0,1,24.03333333,1,3,2,9,1,3,0,0,2,0,5,6,9,10,10.3
2023-24,202401100DET,1/10/2024,DET vs SAS,Dominick Barlow,barlodo01,14,SAS,0,DET,11,8,4,0,2,0,24.05,3,5,5,8,0,0,1,1,3,2,12,15,19,23,32.6
2023-24,202401100UTA,1/10/2024,UTA vs DEN,John Collins,collijo01,35,UTA,1,DEN,15,6,3,1,0,1,24.08333333,0,6,6,10,2,4,1,2,2,1,9,18,21,24,28.7
2023-24,202401100BOS,1/10/2024,BOS vs MIN,Jaden McDaniels,mcdanja02,27,MIN,0,BOS,5,1,1,0,0,1,24.13333333,0,1,2,8,1,4,0,0,6,0,2,6,6,7,6.7
2023-24,202401100GSW,1/10/2024,GSW vs NOP,Klay Thompson,thompkl01,36,GSW,1,NOP,13,4,2,0,1,3,24.15,1,3,5,10,3,7,0,0,1,1,6,15,17,19,20.8
2023-24,202401100LAC,1/10/2024,LAC vs TOR,Gary Trent Jr.,trentga02,34,TOR,0,LAC,12,3,2,0,0,0,24.16666667,1,2,5,9,2,4,0,0,1,0,5,14,15,17,18.6
2023-24,202401100IND,1/10/2024,IND vs WAS,Aaron Nesmith,nesmiaa01,36,IND,1,WAS,10,3,1,0,0,0,24.18333333,0,3,3,9,2,5,2,2,1,0,4,11,13,14,15.1
2023-24,202401100GSW,1/10/2024,GSW vs NOP,Trey Murphy III,murphtr02,15,NOP,0,GSW,16,4,6,0,1,0,24.23333333,3,1,6,13,4,11,0,0,2,1,10,22,20,26,32.8
2023-24,202401100IND,1/10/2024,IND vs WAS,Deni Avdija,avdijde01,37,WAS,0,IND,15,5,1,1,0,1,24.56666667,0,5,4,10,1,3,6,7,5,1,6,16,20,21,24.5
2023-24,202401100MIA,1/10/2024,MIA vs OKC,Duncan Robinson,robindu01,35,MIA,1,OKC,3,1,1,2,0,1,24.73333333,0,1,1,8,1,7,0,0,0,2,2,4,4,5,10.7
2023-24,202401100GSW,1/10/2024,GSW vs NOP,Moses Moody,moodymo01,34,GSW,1,NOP,21,2,0,1,0,0,24.78333333,1,1,8,18,4,8,1,1,3,1,2,21,23,23,26.4
2023-24,202401100DET,1/10/2024,DET vs SAS,Keldon Johnson,johnske04,34,SAS,0,DET,17,1,3,2,1,0,24.9,0,1,4,8,1,2,8,8,2,3,4,20,18,21,31.7
2023-24,202401100CHO,1/10/2024,CHO vs SAC,Nick Smith Jr.,smithni01,20,CHO,1,SAC,11,3,1,0,0,2,25.15,0,3,4,15,2,8,1,2,3,0,4,12,14,15,14.1
2023-24,202401100GSW,1/10/2024,GSW vs NOP,Stephen Curry,curryst01,35,GSW,1,NOP,15,1,6,1,0,3,25.18333333,0,1,4,13,3,8,4,4,0,1,7,21,16,22,25.2
2023-24,202401100GSW,1/10/2024,GSW vs NOP,Brandin Podziemski,podzibr01,31,GSW,1,NOP,2,9,2,0,0,2,25.45,3,6,1,6,0,2,0,0,1,0,11,4,11,13,13.8
2023-24,202401100UTA,1/10/2024,UTA vs DEN,Kris Dunn,dunnkr01,31,UTA,1,DEN,5,4,3,4,1,2,25.7,1,3,2,2,1,1,0,0,4,5,7,8,9,12,27.3
2023-24,202401100ATL,1/10/2024,ATL vs PHI,Marcus Morris,morrima03,28,PHI,0,ATL,17,4,1,0,0,1,25.9,1,3,4,9,3,8,6,6,3,0,5,18,21,22,22.3
2023-24,202401100IND,1/10/2024,IND vs WAS,Andrew Nembhard,nembhan01,25,IND,1,WAS,2,2,5,2,0,5,26.18333333,2,0,1,8,0,1,0,0,3,2,7,7,4,9,12.9
2023-24,202401100GSW,1/10/2024,GSW vs NOP,CJ McCollum,mccolcj01,25,NOP,0,GSW,14,3,8,2,1,0,26.25,0,3,5,13,2,7,2,2,0,3,11,22,17,25,38.6
2023-24,202401100MIA,1/10/2024,MIA vs OKC,Luguentz Dort,dortlu01,35,OKC,0,MIA,14,2,0,0,0,0,26.28333333,0,2,5,10,2,4,2,4,3,0,2,14,16,16,16.4
2023-24,202401100CHO,1/10/2024,CHO vs SAC,Nick Richards,richani01,29,CHO,1,SAC,8,9,3,0,1,1,26.35,4,5,3,5,0,0,2,2,3,1,12,11,17,20,25.3
2023-24,202401100DET,1/10/2024,DET vs SAS,Tre Jones,jonestr01,32,SAS,0,DET,11,2,5,0,1,2,27.08333333,0,2,5,9,0,1,1,1,2,1,7,16,13,18,21.9
2023-24,202401100IND,1/10/2024,IND vs WAS,Bruce Brown,brownbr01,32,IND,1,WAS,16,9,6,1,1,0,27.21666667,0,9,5,11,1,2,5,5,2,2,15,22,25,31,41.8
2023-24,202401100LAC,1/10/2024,LAC vs TOR,Norman Powell,powelno01,37,LAC,1,TOR,13,3,1,0,0,0,27.36666667,0,3,4,11,3,8,2,2,1,0,4,14,16,17,18.1
2023-24,202401100DET,1/10/2024,DET vs SAS,Devin Vassell,vassede01,31,SAS,0,DET,16,3,5,1,0,1,27.46666667,0,3,6,12,1,5,3,4,0,1,8,21,19,24,29.1
2023-24,202401100CHO,1/10/2024,CHO vs SAC,Brandon Miller,millebr02,31,CHO,1,SAC,15,1,2,0,0,0,27.95,0,1,5,10,4,6,1,2,1,0,3,17,16,18,19.2
2023-24,202401100CHO,1/10/2024,CHO vs SAC,Domantas Sabonis,sabondo01,37,SAC,0,CHO,24,10,7,0,1,2,27.96666667,1,9,9,13,1,2,5,6,2,1,17,31,34,41,47.5
2023-24,202401100IND,1/10/2024,IND vs WAS,Obi Toppin,toppiob01,38,IND,1,WAS,15,7,3,0,0,2,27.98333333,1,6,6,10,3,6,0,0,2,0,10,18,22,25,25.9
2023-24,202401100CHO,1/10/2024,CHO vs SAC,De'Aaron Fox,foxde01,31,SAC,0,CHO,19,1,3,1,1,1,28.23333333,0,1,8,14,3,7,0,2,0,2,4,22,20,23,29.7
2023-24,202401100ATL,1/10/2024,ATL vs PHI,Bogdan Bogdanovic,bogdabo01,34,ATL,1,PHI,15,2,4,2,0,1,28.3,0,2,7,16,1,8,0,1,1,2,6,19,17,21,28.4
2023-24,202401100GSW,1/10/2024,GSW vs NOP,Jonathan Kuminga,kuminjo01,36,GSW,1,NOP,12,3,4,0,1,3,28.31666667,0,3,4,7,0,1,4,6,3,1,7,16,15,19,21.6
2023-24,202401100UTA,1/10/2024,UTA vs DEN,Kentavious Caldwell-Pope,caldwke01,37,DEN,0,UTA,12,1,1,4,1,1,28.33333333,0,1,4,9,2,5,2,2,2,5,2,13,13,14,28.7
2023-24,202401100IND,1/10/2024,IND vs WAS,Bennedict Mathurin,mathube01,38,IND,1,WAS,16,7,0,1,0,1,28.36666667,2,5,4,13,0,1,8,8,2,1,7,16,23,23,26.4
2023-24,202401100DET,1/10/2024,DET vs SAS,Jeremy Sochan,sochaje01,36,SAS,0,DET,15,4,2,0,0,1,28.36666667,1,3,7,15,1,2,0,0,1,0,6,17,19,21,21.8
2023-24,202401100UTA,1/10/2024,UTA vs DEN,Aaron Gordon,gordoaa01,33,DEN,0,UTA,12,5,4,1,0,2,28.55,2,3,5,6,2,2,0,0,4,1,9,16,17,21,25
2023-24,202401100CHI,1/10/2024,CHI vs HOU,Patrick Williams,willipa01,38,CHI,1,HOU,5,0,1,3,0,2,28.61666667,0,0,2,6,1,3,0,0,2,3,1,6,5,6,13.5
2023-24,202401100IND,1/10/2024,IND vs WAS,Corey Kispert,kispeco01,36,WAS,0,IND,15,3,2,0,0,1,29.6,2,1,6,11,3,8,0,0,0,0,5,17,18,20,20.6
2023-24,202401100GSW,1/10/2024,GSW vs NOP,Zion Williamson,willizi01,31,NOP,0,GSW,19,5,7,1,0,4,29.7,1,4,8,12,0,0,3,5,2,1,12,26,24,31,34.5
2023-24,202401100CHO,1/10/2024,CHO vs SAC,Malik Monk,monkma01,36,SAC,0,CHO,20,4,4,0,2,1,29.8,0,4,6,13,1,5,7,7,0,2,8,24,24,28,35.8
2023-24,202401100DET,1/10/2024,DET vs SAS,Jalen Duren,durenja01,23,DET,1,SAS,21,12,2,0,0,1,30.31666667,2,10,10,16,0,0,1,1,4,0,14,23,33,35,37.4
2023-24,202401100DET,1/10/2024,DET vs SAS,Jaden Ivey,iveyja01,34,DET,1,SAS,19,3,5,2,2,1,30.41666667,0,3,7,18,2,10,3,5,0,4,8,24,22,27,41.1
2023-24,202401100UTA,1/10/2024,UTA vs DEN,Nikola Jokic,jokicni01,38,DEN,0,UTA,27,11,6,1,0,6,30.46666667,1,10,8,9,1,1,10,12,3,1,17,33,38,44,46.2
2023-24,202401100IND,1/10/2024,IND vs WAS,Myles Turner,turnemy01,37,IND,1,WAS,18,13,3,0,2,2,30.75,6,7,7,15,1,5,3,3,3,2,16,21,31,34,42.1
2023-24,202401100LAC,1/10/2024,LAC vs TOR,Ivica Zubac,zubaciv01,37,LAC,1,TOR,12,11,3,0,1,2,31.16666667,5,6,6,8,0,0,0,0,2,1,14,15,23,26,30.7
2023-24,202401100UTA,1/10/2024,UTA vs DEN,Jamal Murray,murraja01,25,DEN,0,UTA,17,1,6,1,2,4,31.28333333,0,1,6,15,1,5,4,4,3,3,7,23,18,24,32.2
2023-24,202401100DET,1/10/2024,DET vs SAS,Killian Hayes,hayeski01,33,DET,1,SAS,4,4,12,0,0,1,31.51666667,1,3,2,8,0,0,0,0,1,0,16,16,8,20,25.8
2023-24,202401100CHO,1/10/2024,CHO vs SAC,Terry Rozier,roziete01,24,CHO,1,SAC,22,4,2,1,1,0,31.55,0,4,6,14,3,6,7,8,1,2,6,24,26,28,35.8
2023-24,202401100CHO,1/10/2024,CHO vs SAC,Keegan Murray,murrake02,33,SAC,0,CHO,25,6,3,0,1,0,31.6,0,6,11,18,3,7,0,0,2,1,9,28,31,34,39.7
2023-24,202401100ATL,1/10/2024,ATL vs PHI,Kelly Oubre Jr.,oubreke01,25,PHI,0,ATL,7,3,2,1,0,1,31.75,0,3,3,11,0,3,1,2,3,1,5,9,10,12,15.6
2023-24,202401100CHI,1/10/2024,CHI vs HOU,Alex Caruso,carusal01,32,CHI,1,HOU,12,6,3,1,1,0,32.28333333,2,4,3,10,2,9,4,6,3,2,9,15,18,21,29.7
2023-24,202401100UTA,1/10/2024,UTA vs DEN,Lauri Markkanen,markkla01,29,UTA,1,DEN,26,12,2,0,1,0,32.4,2,10,6,13,2,5,12,12,2,1,14,28,38,40,46.4
2023-24,202401100MIA,1/10/2024,MIA vs OKC,Nikola Jovic,jovicni01,11,MIA,1,OKC,15,5,4,1,1,1,32.58333333,0,5,5,8,3,5,2,2,3,2,9,19,20,24,32
2023-24,202401100DET,1/10/2024,DET vs SAS,Bojan Bogdanovic,bogdabo02,19,DET,1,SAS,19,2,2,1,0,4,32.71666667,0,2,8,13,3,5,0,0,1,1,4,21,21,23,23.4
2023-24,202401100CHI,1/10/2024,CHI vs HOU,Cam Whitmore,whitmca01,13,HOU,0,CHI,16,5,1,2,0,1,32.96666667,1,4,6,12,2,5,2,2,1,2,6,17,21,22,28.5
2023-24,202401100UTA,1/10/2024,UTA vs DEN,Jordan Clarkson,clarkjo01,29,UTA,1,DEN,27,2,9,0,0,3,33,0,2,12,19,3,8,0,1,1,0,11,36,29,38,39.9
2023-24,202401100MIA,1/10/2024,MIA vs OKC,Chet Holmgren,holmgch01,36,OKC,0,MIA,23,9,2,0,3,2,33.28333333,0,9,10,15,1,5,2,3,4,3,11,25,32,34,43.8
2023-24,202401100LAC,1/10/2024,LAC vs TOR,Dennis Schroder,schrode01,38,TOR,0,LAC,22,1,4,0,0,2,33.5,0,1,8,13,1,5,5,5,1,0,5,26,23,27,27.2
2023-24,202401100IND,1/10/2024,IND vs WAS,Jordan Poole,poolejo01,36,WAS,0,IND,28,4,7,3,0,1,33.58333333,1,3,11,21,2,7,4,6,3,3,11,35,32,39,51.3
2023-24,202401100IND,1/10/2024,IND vs WAS,Tyus Jones,jonesty01,37,WAS,0,IND,11,4,4,0,1,2,33.6,1,3,5,12,1,5,0,0,2,1,8,15,15,19,22.8
2023-24,202401100LAC,1/10/2024,LAC vs TOR,James Harden,hardeja01,32,LAC,1,TOR,14,5,11,1,0,3,33.66666667,0,5,5,13,2,7,2,2,4,1,16,25,19,30,36.5
2023-24,202401100IND,1/10/2024,IND vs WAS,Kyle Kuzma,kuzmaky01,37,WAS,0,IND,11,11,5,2,0,4,33.91666667,3,8,4,15,0,4,3,3,0,2,16,16,22,27,33.7
2023-24,202401100MIA,1/10/2024,MIA vs OKC,Jaime Jaquez Jr.,jaqueja01,37,MIA,1,OKC,21,5,2,0,0,3,33.93333333,0,5,6,9,3,5,6,9,4,0,7,23,26,28,27
2023-24,202401100CHO,1/10/2024,CHO vs SAC,Miles Bridges,bridgmi02,24,CHO,1,SAC,24,7,6,1,0,3,33.95,1,6,10,21,4,8,0,0,1,1,13,30,31,37,41.4
2023-24,202401100MIA,1/10/2024,MIA vs OKC,Shai Gilgeous-Alexander,gilgesh01,35,OKC,0,MIA,28,2,8,1,1,3,34.16666667,0,2,11,17,2,5,4,5,3,2,10,36,30,38,45.4
2023-24,202401100LAC,1/10/2024,LAC vs TOR,Scottie Barnes,barnesc01,38,TOR,0,LAC,12,7,6,0,2,2,34.48333333,0,7,5,10,1,5,1,3,1,2,13,18,19,25,33.4
2023-24,202401100MIA,1/10/2024,MIA vs OKC,Jalen Williams,willija06,33,OKC,0,MIA,19,9,12,1,0,1,34.5,1,8,8,15,1,3,2,2,2,1,21,31,28,40,49.8
2023-24,202401100MIA,1/10/2024,MIA vs OKC,Haywood Highsmith,highsha01,23,MIA,1,OKC,19,5,2,1,0,0,35.03333333,2,3,7,14,5,7,0,0,2,1,7,21,24,26,31
2023-24,202401100ATL,1/10/2024,ATL vs PHI,Onyeka Okongwu,okongon01,35,ATL,1,PHI,19,11,1,0,2,2,35.51666667,6,5,7,10,0,0,5,5,5,2,12,20,30,31,37.7
2023-24,202401100LAC,1/10/2024,LAC vs TOR,Immanuel Quickley,quickim01,36,TOR,0,LAC,25,4,6,1,0,1,36.46666667,0,4,7,16,2,4,9,9,1,1,10,31,29,35,40.8
2023-24,202401100MIA,1/10/2024,MIA vs OKC,Tyler Herro,herroty01,19,MIA,1,OKC,17,5,6,3,0,1,36.5,0,5,7,21,1,5,2,4,1,3,11,23,22,28,40
2023-24,202401100LAC,1/10/2024,LAC vs TOR,RJ Barrett,barrerj01,32,TOR,0,LAC,24,5,4,0,0,4,36.6,1,4,10,16,4,6,0,0,4,0,9,28,29,33,32
2023-24,202401100MIA,1/10/2024,MIA vs OKC,Bam Adebayo,adebaba01,27,MIA,1,OKC,25,11,6,0,2,1,36.73333333,5,6,9,16,0,0,7,7,1,2,17,31,36,42,52.2
2023-24,202401100ATL,1/10/2024,ATL vs PHI,Saddiq Bey,beysa01,36,ATL,1,PHI,15,10,1,0,0,1,36.76666667,6,4,6,16,1,6,2,3,1,0,11,16,25,26,27.5
2023-24,202401100BOS,1/10/2024,BOS vs MIN,Naz Reid,reidna01,37,MIN,0,BOS,19,10,3,0,3,1,37.43333333,3,7,7,15,3,7,2,2,4,3,13,22,29,32,43.5
2023-24,202401100ATL,1/10/2024,ATL vs PHI,Nicolas Batum,batumni01,25,PHI,0,ATL,6,4,2,0,3,1,37.46666667,2,2,2,4,1,2,1,2,4,3,6,8,10,12,21.8
2023-24,202401100IND,1/10/2024,IND vs WAS,Daniel Gafford,gaffoda01,34,WAS,0,IND,12,8,2,2,6,3,37.46666667,1,7,4,6,0,0,4,6,4,8,10,14,20,22,45.6
2023-24,202401100LAC,1/10/2024,LAC vs TOR,Kawhi Leonard,leonaka01,33,LAC,1,TOR,29,3,7,1,2,0,37.75,2,1,10,18,2,4,7,7,3,3,10,36,32,39,52.1
2023-24,202401100ATL,1/10/2024,ATL vs PHI,Dejounte Murray,murrade01,36,ATL,1,PHI,25,5,5,1,0,1,37.85,0,5,8,18,5,7,4,4,2,1,10,30,30,35,40.5
2023-24,202401100LAC,1/10/2024,LAC vs TOR,Paul George,georgpa01,35,LAC,1,TOR,29,7,6,2,1,0,38.26666667,0,7,12,22,5,9,0,0,4,3,13,35,36,42,55.4
2023-24,202401100BOS,1/10/2024,BOS vs MIN,Al Horford,horfoal01,31,BOS,1,MIN,9,8,5,0,0,1,38.26666667,1,7,3,8,3,6,0,0,3,0,13,14,17,22,25.1
2023-24,202401100BOS,1/10/2024,BOS vs MIN,Kyle Anderson,anderky01,37,MIN,0,BOS,17,8,5,1,1,0,39.23333333,2,6,7,12,0,0,3,4,5,2,13,22,25,30,40.1
2023-24,202401100CHI,1/10/2024,CHI vs HOU,Jalen Green,greenja05,36,HOU,0,CHI,18,6,8,1,0,2,39.55,1,5,8,19,2,7,0,1,2,1,14,26,24,32,38.2
2023-24,202401100BOS,1/10/2024,BOS vs MIN,Jrue Holiday,holidjr01,34,BOS,1,MIN,12,5,4,2,1,2,39.9,1,4,5,15,2,10,0,0,3,3,9,16,17,21,31
2023-24,202401100BOS,1/10/2024,BOS vs MIN,Nickeil Alexander-Walker,alexani01,37,MIN,0,BOS,15,4,3,1,1,1,40.31666667,2,2,5,8,3,5,2,2,4,2,7,18,19,22,29.3
2023-24,202401100CHI,1/10/2024,CHI vs HOU,Nikola Vucevic,vucevni01,34,CHI,1,HOU,18,15,3,0,1,0,40.5,3,12,9,17,0,5,0,0,4,1,18,21,33,36,43.5
2023-24,202401100ATL,1/10/2024,ATL vs PHI,Jalen Johnson,johnsja05,22,ATL,1,PHI,25,16,7,1,2,1,40.93333333,2,14,8,13,3,4,6,6,3,3,23,32,41,48,62.7
2023-24,202401100CHI,1/10/2024,CHI vs HOU,Alperen Sengun,sengual01,36,HOU,0,CHI,25,9,5,2,0,2,41.2,2,7,11,19,0,3,3,8,5,2,14,30,34,39,47.3
2023-24,202401100CHI,1/10/2024,CHI vs HOU,Zach LaVine,lavinza01,21,CHI,1,HOU,25,13,7,3,1,4,41.23333333,1,12,8,15,4,8,5,6,5,4,20,32,38,45,59.1
2023-24,202401100ATL,1/10/2024,ATL vs PHI,Tobias Harris,harrito02,35,PHI,0,ATL,32,10,4,0,1,1,41.25,2,8,12,24,1,2,7,7,2,1,14,36,42,46,52
2023-24,202401100CHI,1/10/2024,CHI vs HOU,Fred VanVleet,vanvlfr01,35,HOU,0,CHI,20,6,10,1,3,2,42.15,0,6,7,19,3,14,3,4,3,4,16,30,26,36,52.2
2023-24,202401100BOS,1/10/2024,BOS vs MIN,Jayson Tatum,tatumja01,34,BOS,1,MIN,45,4,2,1,0,1,42.25,0,4,13,26,6,11,13,14,3,1,6,47,49,51,54.8
2023-24,202401100CHI,1/10/2024,CHI vs HOU,DeMar DeRozan,derozde01,37,CHI,1,HOU,19,4,4,0,0,1,42.51666667,0,4,5,19,3,6,6,6,2,0,8,23,23,27,28.8
2023-24,202401100ATL,1/10/2024,ATL vs PHI,Tyrese Maxey,maxeyty01,35,PHI,0,ATL,35,8,9,4,0,3,42.91666667,1,7,12,29,4,11,7,9,6,4,17,44,43,52,67.1
2023-24,202401100BOS,1/10/2024,BOS vs MIN,Jaylen Brown,brownja02,35,BOS,1,MIN,35,11,3,2,1,2,43.15,1,10,9,16,4,7,13,13,1,3,14,38,46,49,59.7
2023-24,202401100CHI,1/10/2024,CHI vs HOU,Coby White,whiteco01,39,CHI,1,HOU,30,4,8,0,1,4,43.28333333,0,4,9,17,6,11,6,7,1,1,12,38,34,42,45.8
2023-24,202401100BOS,1/10/2024,BOS vs MIN,Derrick White,whitede01,34,BOS,1,MIN,9,6,6,0,0,2,43.4,2,4,3,11,1,5,2,2,5,0,12,15,15,21,23.2
2023-24,202401100ATL,1/10/2024,ATL vs PHI,Trae Young,youngtr01,34,ATL,1,PHI,28,1,11,1,1,5,43.41666667,0,1,7,22,2,8,12,14,2,2,12,39,29,40,46.7
2023-24,202401100BOS,1/10/2024,BOS vs MIN,Karl-Anthony Towns,townska01,36,MIN,0,BOS,25,13,6,2,0,1,44.35,1,12,8,17,2,7,7,7,6,2,19,31,38,44,54.6
2023-24,202401100BOS,1/10/2024,BOS vs MIN,Anthony Edwards,edwaran01,34,MIN,0,BOS,29,6,3,0,0,5,45.71666667,0,6,11,25,3,6,4,4,1,0,9,32,35,38,35.7
2023-24,202401100CHI,1/10/2024,CHI vs HOU,Jabari Smith Jr.,smithja05,35,HOU,0,CHI,18,15,1,0,1,2,47.41666667,2,13,7,14,4,9,0,0,3,1,16,19,33,34,38.5
2023-24,202401090DET,1/9/2024,DET vs SAC,Alex Len,lenal01,12,SAC,0,DET,6,3,0,0,1,1,10.03333333,1,2,3,3,0,0,0,1,1,1,3,6,9,9,11.6
2023-24,202401090LAL,1/9/2024,LAL vs TOR,Jontay Porter,portejo01,4,TOR,0,LAL,0,0,3,1,0,0,10.06666667,0,0,0,2,0,2,0,0,0,1,3,3,0,3,7.5
2023-24,202401090DAL,1/9/2024,DAL vs MEM,Seth Curry,curryse01,29,DAL,1,MEM,2,0,0,0,0,1,10.38333333,0,0,1,2,0,1,0,0,1,0,0,2,2,2,1
2023-24,202401090NYK,1/9/2024,NYK vs POR,Matisse Thybulle,thybuma01,35,POR,0,NYK,0,1,0,1,1,0,11.68333333,0,1,0,1,0,1,0,0,0,2,1,0,1,1,7.2
2023-24,202401090NYK,1/9/2024,NYK vs POR,Justin Minaya,minayju01,7,POR,0,NYK,3,1,1,0,1,1,12,1,0,1,4,0,2,1,2,1,1,2,4,4,5,7.7
2023-24,202401090NYK,1/9/2024,NYK vs POR,Rayan Rupert,ruperra01,10,POR,0,NYK,4,5,1,0,0,1,12,1,4,2,5,0,1,0,0,0,0,6,5,9,10,10.5
2023-24,202401090ORL,1/9/2024,ORL vs MIN,Markelle Fultz,fultzma01,7,ORL,1,MIN,4,3,2,0,0,0,12.68333333,1,2,2,7,0,0,0,0,0,0,5,6,7,9,10.6
2023-24,202401090NYK,1/9/2024,NYK vs POR,Malcolm Brogdon,brogdma01,29,POR,0,NYK,2,1,0,0,0,1,13.13333333,0,1,1,5,0,0,0,0,2,0,1,2,3,3,2.2
2023-24,202401090DET,1/9/2024,DET vs SAC,Ausar Thompson,thompau01,37,DET,1,SAC,0,2,0,3,0,0,13.51666667,0,2,0,2,0,0,0,0,3,3,2,0,2,2,11.4
2023-24,202401090DET,1/9/2024,DET vs SAC,Harrison Barnes,barneha02,36,SAC,0,DET,0,1,1,0,0,0,13.7,0,1,0,1,0,0,0,2,0,0,2,1,1,2,2.7
2023-24,202401090LAL,1/9/2024,LAL vs TOR,Chris Boucher,bouchch01,34,TOR,0,LAL,2,7,1,2,0,3,14.03333333,0,7,1,3,0,2,0,0,1,2,8,3,9,10,14.9
2023-24,202401090DET,1/9/2024,DET vs SAC,Juan Toscano-Anderson,toscaju01,9,SAC,0,DET,0,6,1,0,0,1,14.28333333,2,4,0,3,0,1,0,0,4,0,7,1,6,7,7.7
2023-24,202401090DET,1/9/2024,DET vs SAC,Isaiah Livers,liveris01,21,DET,1,SAC,3,1,2,0,0,0,15.16666667,1,0,1,3,1,2,0,0,0,0,3,5,4,6,7.2
2023-24,202401090ORL,1/9/2024,ORL vs MIN,Jordan McLaughlin,mclaujo01,16,MIN,0,ORL,4,0,5,1,0,1,15.46666667,0,0,2,3,0,1,0,0,1,1,5,9,4,9,13.5
2023-24,202401090NYK,1/9/2024,NYK vs POR,Kris Murray,murrakr01,20,POR,0,NYK,9,3,1,1,0,1,16.36666667,2,1,3,10,0,3,3,3,0,1,4,10,12,13,16.1
2023-24,202401090LAL,1/9/2024,LAL vs TOR,D'Angelo Russell,russeda01,35,LAL,1,TOR,11,1,5,0,0,2,16.51666667,1,0,4,8,2,6,1,2,1,0,6,16,12,17,17.7
2023-24,202401090ORL,1/9/2024,ORL vs MIN,Goga Bitadze,bitadgo01,33,ORL,1,MIN,2,6,1,1,2,1,16.55,4,2,1,3,0,0,0,0,4,3,7,3,8,9,18.7
2023-24,202401090LAL,1/9/2024,LAL vs TOR,Jarred Vanderbilt,vandeja01,18,LAL,1,TOR,3,6,1,0,0,3,17.81666667,2,4,1,2,0,0,1,2,1,0,7,4,9,10,8.7
2023-24,202401090ORL,1/9/2024,ORL vs MIN,Nickeil Alexander-Walker,alexani01,36,MIN,0,ORL,0,2,3,0,1,2,18.13333333,0,2,0,5,0,4,0,0,1,1,5,3,2,5,7.9
2023-24,202401090DAL,1/9/2024,DAL vs MEM,Bismack Biyombo,biyombi01,30,MEM,0,DAL,2,2,4,0,0,2,18.15,1,1,1,2,0,0,0,0,2,0,6,6,4,8,8.4
2023-24,202401090LAL,1/9/2024,LAL vs TOR,Max Christie,chrisma02,29,LAL,1,TOR,6,4,2,0,0,0,18.43333333,1,3,2,2,1,1,1,2,0,0,6,8,10,12,13.8
2023-24,202401090DET,1/9/2024,DET vs SAC,Marcus Sasser,sassema01,33,DET,1,SAC,2,2,4,1,1,0,18.55,0,2,0,4,0,2,2,2,0,2,6,6,4,8,16.4
2023-24,202401090NYK,1/9/2024,NYK vs POR,Donte DiVincenzo,divindo01,37,NYK,1,POR,13,4,2,1,0,0,18.66666667,0,4,4,9,3,8,2,2,2,1,6,15,17,19,23.8
2023-24,202401090DAL,1/9/2024,DAL vs MEM,Jaden Hardy,hardyja02,33,DAL,1,MEM,10,0,1,0,0,1,19,0,0,4,7,2,4,0,0,2,0,1,11,10,11,10.5
2023-24,202401090DET,1/9/2024,DET vs SAC,Kevin Knox,knoxke01,19,DET,1,SAC,8,2,1,1,0,2,19.66666667,1,1,3,8,1,4,1,1,1,1,3,9,10,11,12.9
2023-24,202401090NYK,1/9/2024,NYK vs POR,Precious Achiuwa,achiupr01,30,NYK,1,POR,2,9,1,1,1,1,20.13333333,5,4,1,9,0,3,0,0,0,2,10,3,11,12,19.3
2023-24,202401090DET,1/9/2024,DET vs SAC,Alec Burks,burksal01,30,DET,1,SAC,16,3,1,1,0,2,20.16666667,0,3,5,11,3,7,3,5,0,1,4,17,19,20,22.1
2023-24,202401090NYK,1/9/2024,NYK vs POR,Duop Reath,reathdu01,24,POR,0,NYK,7,6,0,0,0,0,20.75,1,5,3,6,1,3,0,0,2,0,6,7,13,13,14.2
2023-24,202401090ORL,1/9/2024,ORL vs MIN,Naz Reid,reidna01,36,MIN,0,ORL,13,10,2,0,0,3,21.03333333,2,8,5,8,2,4,1,2,3,0,12,15,23,25,25
2023-24,202401090NYK,1/9/2024,NYK vs POR,Quentin Grimes,grimequ01,34,NYK,1,POR,17,4,1,3,0,2,21.05,0,4,5,11,4,9,3,3,1,3,5,18,21,22,30.3
2023-24,202401090DAL,1/9/2024,DAL vs MEM,Marcus Smart,smartma01,20,MEM,0,DAL,23,4,1,2,0,1,21.13333333,0,4,9,16,4,8,1,1,0,2,5,24,27,28,34.3
2023-24,202401090ORL,1/9/2024,ORL vs MIN,Anthony Black,blackan01,35,ORL,1,MIN,3,1,4,3,1,2,21.25,0,1,1,4,1,3,0,0,2,4,5,7,4,8,20.2
2023-24,202401090ORL,1/9/2024,ORL vs MIN,Kyle Anderson,anderky01,36,MIN,0,ORL,11,1,3,0,0,0,21.43333333,0,1,4,6,0,1,3,4,1,0,4,14,12,15,16.7
2023-24,202401090NYK,1/9/2024,NYK vs POR,Shaedon Sharpe,sharpsh01,31,POR,0,NYK,9,4,4,2,1,1,21.95,1,3,4,8,0,2,1,1,1,3,8,13,13,17,27.8
2023-24,202401090NYK,1/9/2024,NYK vs POR,Miles McBride,mcbrimi01,24,NYK,1,POR,16,2,0,1,0,2,22.05,1,1,6,13,4,7,0,0,1,1,2,16,18,18,19.4
2023-24,202401090DAL,1/9/2024,DAL vs MEM,Dwight Powell,poweldw01,35,DAL,1,MEM,4,4,3,2,1,2,22.23333333,1,3,2,3,0,0,0,0,3,3,7,7,8,11,20.3
2023-24,202401090LAL,1/9/2024,LAL vs TOR,Cam Reddish,reddica01,32,LAL,1,TOR,13,1,0,1,1,2,22.63333333,0,1,4,7,4,6,1,2,1,2,1,13,14,14,18.2
2023-24,202401090DAL,1/9/2024,DAL vs MEM,Josh Green,greenjo02,26,DAL,1,MEM,0,3,0,0,1,0,23.03333333,1,2,0,3,0,1,0,0,1,1,3,0,3,3,6.6
2023-24,202401090DAL,1/9/2024,DAL vs MEM,Luke Kennard,kennalu01,14,MEM,0,DAL,14,5,4,1,0,2,23.05,1,4,5,7,3,4,1,1,2,1,9,18,19,23,27
2023-24,202401090LAL,1/9/2024,LAL vs TOR,Gary Trent Jr.,trentga02,33,TOR,0,LAL,14,1,1,0,0,0,23.65,0,1,5,10,4,6,0,0,1,0,2,15,15,16,16.7
2023-24,202401090LAL,1/9/2024,LAL vs TOR,Christian Wood,woodch01,33,LAL,1,TOR,14,4,1,1,1,2,23.78333333,0,4,5,10,2,4,2,2,5,2,5,15,18,19,24.3
2023-24,202401090DET,1/9/2024,DET vs SAC,Jalen Duren,durenja01,22,DET,1,SAC,16,10,3,0,0,3,23.96666667,3,7,8,14,0,0,0,0,4,0,13,19,26,29,29.5
2023-24,202401090DET,1/9/2024,DET vs SAC,James Wiseman,wisemja01,26,DET,1,SAC,4,5,1,0,1,1,24.03333333,1,4,2,3,0,0,0,0,2,1,6,5,9,10,13.5
2023-24,202401090NYK,1/9/2024,NYK vs POR,Scoot Henderson,hendesc01,27,POR,0,NYK,8,3,4,1,0,3,24.86666667,0,3,3,8,1,3,1,2,2,1,7,12,11,15,17.6
2023-24,202401090DAL,1/9/2024,DAL vs MEM,John Konchar,konchjo01,29,MEM,0,DAL,4,7,3,0,1,0,25.1,3,4,1,3,0,2,2,2,0,1,10,7,11,14,19.9
2023-24,202401090DAL,1/9/2024,DAL vs MEM,David Roddy,roddyda01,34,MEM,0,DAL,11,5,3,0,0,2,25.18333333,2,3,3,7,1,2,4,4,2,0,8,14,16,19,19.5
2023-24,202401090NYK,1/9/2024,NYK vs POR,Toumani Camara,camarto01,35,POR,0,NYK,5,6,2,1,2,2,25.5,3,3,2,4,1,3,0,0,3,3,8,7,11,13,22.2
2023-24,202401090ORL,1/9/2024,ORL vs MIN,Anthony Edwards,edwaran01,33,MIN,0,ORL,6,4,3,0,0,5,25.61666667,1,3,2,7,0,2,2,3,3,0,7,9,10,13,10.3
2023-24,202401090NYK,1/9/2024,NYK vs POR,Josh Hart,hartjo01,37,NYK,1,POR,2,7,4,0,0,3,25.7,1,6,1,4,0,2,0,0,3,0,11,6,9,13,13.4
2023-24,202401090NYK,1/9/2024,NYK vs POR,Jalen Brunson,brunsja01,37,NYK,1,POR,12,3,7,0,0,0,25.95,1,2,3,11,1,7,5,6,0,0,10,19,15,22,26.1
2023-24,202401090LAL,1/9/2024,LAL vs TOR,Immanuel Quickley,quickim01,35,TOR,0,LAL,21,5,5,0,0,1,26.05,1,4,8,14,4,6,1,3,6,0,10,26,26,31,33.5
2023-24,202401090DAL,1/9/2024,DAL vs MEM,Ziaire Williams,willizi02,35,MEM,0,DAL,14,4,0,1,0,1,26.58333333,1,3,6,9,2,5,0,0,1,1,4,14,18,18,20.8
2023-24,202401090NYK,1/9/2024,NYK vs POR,Anfernee Simons,simonan01,15,POR,0,NYK,12,4,3,0,0,3,26.66666667,0,4,4,14,2,7,2,2,2,0,7,15,16,19,18.3
2023-24,202401090ORL,1/9/2024,ORL vs MIN,Jalen Suggs,suggsja01,33,ORL,1,MIN,20,5,2,3,0,2,26.7,1,4,8,14,4,8,0,1,2,3,7,22,25,27,36
2023-24,202401090ORL,1/9/2024,ORL vs MIN,Chuma Okeke,okekech01,20,ORL,1,MIN,3,10,1,0,1,0,27,2,8,1,10,1,8,0,0,2,1,11,4,13,14,19.5
2023-24,202401090NYK,1/9/2024,NYK vs POR,Ibou Badji,badjiib01,8,POR,0,NYK,4,7,3,2,2,1,27.25,3,4,2,5,0,0,0,2,2,4,10,7,11,14,27.9
2023-24,202401090DAL,1/9/2024,DAL vs MEM,Xavier Tillman Sr.,tillmxa01,25,MEM,0,DAL,14,11,2,0,2,3,27.8,6,5,6,9,0,1,2,4,3,2,13,16,25,27,33.2
2023-24,202401090NYK,1/9/2024,NYK vs POR,Jerami Grant,grantje01,32,POR,0,NYK,21,2,0,0,0,1,27.83333333,0,2,8,16,1,4,4,6,2,0,2,21,23,23,22.4
2023-24,202401090NYK,1/9/2024,NYK vs POR,Isaiah Hartenstein,harteis01,37,NYK,1,POR,5,14,3,3,1,2,27.86666667,5,9,1,1,0,0,3,4,3,4,17,8,19,22,36.3
2023-24,202401090DET,1/9/2024,DET vs SAC,Malik Monk,monkma01,35,SAC,0,DET,20,2,9,1,2,3,28.05,0,2,9,15,2,6,0,0,5,3,11,29,22,31,41.9
2023-24,202401090ORL,1/9/2024,ORL vs MIN,Trevelin Queen,queentr01,5,ORL,1,MIN,11,3,3,1,0,2,28.38333333,1,2,3,9,3,4,2,2,1,1,6,14,14,17,20.1
2023-24,202401090LAL,1/9/2024,LAL vs TOR,Thaddeus Young,youngth01,9,TOR,0,LAL,10,5,4,3,1,0,28.88333333,1,4,5,9,0,1,0,0,4,4,9,14,15,19,34
2023-24,202401090DET,1/9/2024,DET vs SAC,Kevin Huerter,huertke01,35,SAC,0,DET,4,5,5,1,1,0,29.2,0,5,2,11,0,6,0,0,1,2,10,9,9,14,23.5
2023-24,202401090NYK,1/9/2024,NYK vs POR,OG Anunoby,anunoog01,32,NYK,1,POR,23,4,0,1,1,1,29.41666667,2,2,9,12,4,6,1,2,3,2,4,23,27,27,32.8
2023-24,202401090DAL,1/9/2024,DAL vs MEM,Tim Hardaway Jr.,hardati02,35,DAL,1,MEM,9,3,2,0,0,1,29.58333333,0,3,3,6,2,3,1,1,3,0,5,11,12,14,14.6
2023-24,202401090LAL,1/9/2024,LAL vs TOR,Dennis Schroder,schrode01,37,TOR,0,LAL,10,2,6,0,0,2,29.61666667,1,1,3,6,2,3,2,2,2,0,8,16,12,18,19.4
2023-24,202401090DAL,1/9/2024,DAL vs MEM,Vince Williams Jr.,willivi01,27,MEM,0,DAL,6,6,6,3,0,3,29.61666667,2,4,2,8,2,5,0,0,5,3,12,12,12,18,28.2
2023-24,202401090DET,1/9/2024,DET vs SAC,Killian Hayes,hayeski01,32,DET,1,SAC,4,4,7,1,0,6,30.73333333,1,3,1,4,0,1,2,2,2,1,11,11,8,15,16.3
2023-24,202401090ORL,1/9/2024,ORL vs MIN,Mike Conley,conlemi01,36,MIN,0,ORL,11,3,10,2,0,1,30.96666667,0,3,3,8,3,6,2,2,3,2,13,21,14,24,34.6
2023-24,202401090ORL,1/9/2024,ORL vs MIN,Moritz Wagner,wagnemo01,37,ORL,1,MIN,21,8,2,2,0,1,31.45,3,5,6,9,1,4,8,11,3,2,10,23,29,31,38.6
2023-24,202401090NYK,1/9/2024,NYK vs POR,Julius Randle,randlju01,37,NYK,1,POR,20,7,8,0,1,2,31.65,0,7,7,17,2,4,4,4,1,1,15,28,27,35,41.4
2023-24,202401090DET,1/9/2024,DET vs SAC,Trey Lyles,lylestr01,22,SAC,0,DET,6,8,3,0,0,1,31.83333333,1,7,1,4,1,3,3,4,2,0,11,9,14,17,19.1
2023-24,202401090LAL,1/9/2024,LAL vs TOR,Austin Reaves,reaveau01,39,LAL,1,TOR,11,3,7,1,0,0,31.9,0,3,3,10,1,6,4,4,2,1,10,18,14,21,28.1
2023-24,202401090LAL,1/9/2024,LAL vs TOR,Pascal Siakam,siakapa01,37,TOR,0,LAL,25,4,3,0,1,1,32.06666667,0,4,10,17,3,5,2,3,2,1,7,28,29,32,36.3
2023-24,202401090DET,1/9/2024,DET vs SAC,Bojan Bogdanovic,bogdabo02,18,DET,1,SAC,26,5,2,3,0,3,32.58333333,1,4,10,14,4,7,2,3,1,3,7,28,31,33,41
2023-24,202401090DET,1/9/2024,DET vs SAC,Jaden Ivey,iveyja01,33,DET,1,SAC,22,5,6,2,0,4,32.66666667,5,0,7,17,2,9,6,8,4,2,11,28,27,33,39
2023-24,202401090DET,1/9/2024,DET vs SAC,De'Aaron Fox,foxde01,30,SAC,0,DET,26,3,4,2,0,5,33.3,0,3,10,19,4,7,2,2,2,2,7,30,29,33,36.6
2023-24,202401090ORL,1/9/2024,ORL vs MIN,Rudy Gobert,goberru01,36,MIN,0,ORL,21,12,1,1,3,2,33.56666667,1,11,8,10,0,0,5,6,3,4,13,22,33,34,46.9
2023-24,202401090ORL,1/9/2024,ORL vs MIN,Karl-Anthony Towns,townska01,35,MIN,0,ORL,28,6,5,3,0,2,33.75,1,5,11,19,5,5,1,1,2,3,11,33,34,39,49.7
2023-24,202401090LAL,1/9/2024,LAL vs TOR,Taurean Prince,princta02,37,LAL,1,TOR,11,4,0,2,0,0,33.88333333,0,4,4,8,2,6,1,2,2,2,4,11,15,15,21.8
2023-24,202401090ORL,1/9/2024,ORL vs MIN,Caleb Houstan,houstca01,28,ORL,1,MIN,8,7,2,0,0,0,34.13333333,3,4,3,12,2,10,0,0,2,0,9,10,15,17,19.4
2023-24,202401090DET,1/9/2024,DET vs SAC,Keegan Murray,murrake02,32,SAC,0,DET,32,5,2,1,2,1,34.66666667,0,5,13,17,5,9,1,1,2,3,7,34,37,39,49
2023-24,202401090ORL,1/9/2024,ORL vs MIN,Paolo Banchero,banchpa01,37,ORL,1,MIN,18,2,3,3,1,4,35.06666667,0,2,8,22,1,4,1,4,4,4,5,21,20,23,32.9
2023-24,202401090ORL,1/9/2024,ORL vs MIN,Jaden McDaniels,mcdanja02,26,MIN,0,ORL,15,9,1,1,0,2,35.13333333,0,9,6,10,2,5,1,1,1,1,10,16,24,25,28.3
2023-24,202401090LAL,1/9/2024,LAL vs TOR,LeBron James,jamesle01,36,LAL,1,TOR,22,5,12,1,1,3,35.21666667,0,5,8,17,2,5,4,6,0,2,17,34,27,39,49
2023-24,202401090LAL,1/9/2024,LAL vs TOR,RJ Barrett,barrerj01,31,TOR,0,LAL,23,10,5,2,0,3,35.46666667,1,9,10,13,1,3,2,3,4,2,15,28,33,38,45.5
2023-24,202401090DAL,1/9/2024,DAL vs MEM,Luka Doncic,doncilu01,34,DAL,1,MEM,31,6,6,3,0,3,35.9,0,6,9,21,2,8,11,15,1,3,12,37,37,43,53.2
2023-24,202401090DAL,1/9/2024,DAL vs MEM,Derrick Jones Jr.,jonesde02,37,DAL,1,MEM,11,4,2,0,1,0,36.16666667,0,4,5,9,0,1,1,1,1,1,6,13,15,17,21.8
2023-24,202401090DET,1/9/2024,DET vs SAC,Domantas Sabonis,sabondo01,36,SAC,0,DET,37,10,13,3,0,5,37.96666667,5,5,16,21,1,1,4,4,3,3,23,50,47,60,72.5
2023-24,202401090DAL,1/9/2024,DAL vs MEM,Desmond Bane,banede01,36,MEM,0,DAL,32,9,4,0,0,2,39.28333333,2,7,11,27,2,9,8,9,3,0,13,36,41,45,46.8
2023-24,202401090LAL,1/9/2024,LAL vs TOR,Anthony Davis,davisan02,37,LAL,1,TOR,41,11,6,0,1,3,39.81666667,1,10,13,17,2,2,13,14,4,1,17,47,52,58,63.2
2023-24,202401090DAL,1/9/2024,DAL vs MEM,Kyrie Irving,irvinky01,22,DAL,1,MEM,33,8,4,4,1,3,40.08333333,4,4,11,25,2,7,9,10,3,5,12,37,41,45,60.6
2023-24,202401090LAL,1/9/2024,LAL vs TOR,Scottie Barnes,barnesc01,37,TOR,0,LAL,26,3,6,0,2,2,40.16666667,1,2,11,20,3,7,1,2,6,2,9,32,29,35,42.6
2023-24,202401080IND,1/8/2024,IND vs BOS,Luke Kornet,kornelu01,23,BOS,0,IND,5,2,2,0,2,1,10.4,2,0,1,4,0,0,3,4,2,2,4,7,7,9,15.4
2023-24,202401080MIL,1/8/2024,MIL vs UTA,A.J. Green,greenaj01,23,MIL,1,UTA,8,1,0,0,0,0,11.05,1,0,3,4,2,3,0,0,0,0,1,8,9,9,9.2
2023-24,202401080MIA,1/8/2024,MIA vs HOU,Amen Thompson,thompam01,16,HOU,0,MIA,5,2,1,1,1,2,11.05,0,2,1,2,0,0,3,3,3,2,3,6,7,8,12.9
2023-24,202401080CHO,1/8/2024,CHO vs CHI,Dalen Terry,terryda01,22,CHI,0,CHO,2,2,1,0,0,1,11.66666667,1,1,0,1,0,1,2,2,1,0,3,3,4,5,4.9
2023-24,202401080IND,1/8/2024,IND vs BOS,Andrew Nembhard,nembhan01,24,IND,1,BOS,9,0,3,0,0,2,12.38333333,0,0,4,6,1,2,0,0,5,0,3,12,9,12,11.5
2023-24,202401080IND,1/8/2024,IND vs BOS,Tyrese Haliburton,halibty01,34,IND,1,BOS,7,2,6,0,0,2,13.48333333,0,2,3,5,1,3,0,0,1,0,8,13,9,15,16.4
2023-24,202401080LAC,1/8/2024,LAC vs PHO,Daniel Theis,theisda01,26,LAC,1,PHO,6,3,3,1,1,1,14.08333333,2,1,3,6,0,1,0,0,3,2,6,9,9,12,19.1
2023-24,202401080MIL,1/8/2024,MIL vs UTA,MarJon Beauchamp,beaucma01,32,MIL,1,UTA,3,2,3,2,0,0,14.28333333,0,2,1,6,1,4,0,0,1,2,5,6,5,8,15.9
2023-24,202401080CHO,1/8/2024,CHO vs CHI,Nathan Mensah,mensana01,10,CHO,1,CHI,3,4,0,0,0,1,14.5,3,1,1,2,0,0,1,2,3,0,4,3,7,7,6.8
2023-24,202401080MIL,1/8/2024,MIL vs UTA,Chris Livingston,livinch01,9,MIL,1,UTA,6,2,0,1,0,1,14.65,1,1,2,5,0,0,2,2,1,1,2,6,8,8,10.4
2023-24,202401080LAC,1/8/2024,LAC vs PHO,Russell Westbrook,westbru01,36,LAC,1,PHO,9,2,7,2,0,1,14.98333333,2,0,3,6,0,1,3,3,2,2,9,16,11,18,26.9
2023-24,202401080MIL,1/8/2024,MIL vs UTA,Ochai Agbaji,agbajoc01,38,UTA,0,MIL,2,1,0,0,0,0,15.05,0,1,1,2,0,1,0,0,1,0,1,2,3,3,3.2
2023-24,202401080CHO,1/8/2024,CHO vs CHI,Ish Smith,smithis01,28,CHO,1,CHI,2,0,1,0,0,0,15.35,0,0,1,4,0,0,0,0,1,0,1,3,2,3,3.5
2023-24,202401080IND,1/8/2024,IND vs BOS,Oshae Brissett,brissos01,20,BOS,0,IND,6,6,0,2,0,0,15.66666667,2,4,1,4,1,4,3,6,3,2,6,6,12,12,19.2
2023-24,202401080MIA,1/8/2024,MIA vs HOU,Haywood Highsmith,highsha01,22,MIA,1,HOU,3,3,0,0,0,0,15.78333333,0,3,1,2,1,2,0,0,0,0,3,3,6,6,6.6
2023-24,202401080MIL,1/8/2024,MIL vs UTA,Bobby Portis,portibo01,37,MIL,1,UTA,8,3,0,0,0,0,16.01666667,1,2,4,11,0,2,0,0,4,0,3,8,11,11,11.6
2023-24,202401080WAS,1/8/2024,WAS vs OKC,Landry Shamet,shamela01,22,WAS,1,OKC,15,2,1,2,2,3,16.2,1,1,3,7,1,4,8,9,4,4,3,16,17,18,27.9
2023-24,202401080LAC,1/8/2024,LAC vs PHO,Drew Eubanks,eubandr01,33,PHO,0,LAC,0,4,0,0,2,0,16.36666667,2,2,0,1,0,0,0,0,2,2,4,0,4,4,10.8
2023-24,202401080MIA,1/8/2024,MIA vs HOU,Kyle Lowry,lowryky01,32,MIA,1,HOU,6,3,1,0,2,1,16.36666667,1,2,2,3,1,1,1,2,1,2,4,7,9,10,16.1
2023-24,202401080WAS,1/8/2024,WAS vs OKC,Delon Wright,wrighde01,15,WAS,1,OKC,7,1,2,0,0,0,17.06666667,1,0,3,6,1,1,0,0,2,0,3,9,8,10,11.2
2023-24,202401080MIA,1/8/2024,MIA vs HOU,Cam Whitmore,whitmca01,12,HOU,0,MIA,11,6,0,1,0,1,17.23333333,1,5,5,8,1,2,0,0,4,1,6,11,17,17,20.2
2023-24,202401080WAS,1/8/2024,WAS vs OKC,Kenrich Williams,willike04,24,OKC,0,WAS,2,3,2,1,0,1,17.23333333,2,1,1,3,0,1,0,0,2,1,5,4,5,7,10.6
2023-24,202401080MIL,1/8/2024,MIL vs UTA,Kelly Olynyk,olynyke01,36,UTA,0,MIL,13,6,3,0,0,2,17.43333333,2,4,4,6,2,2,3,4,4,0,9,16,19,22,22.7
2023-24,202401080CHO,1/8/2024,CHO vs CHI,Ayo Dosunmu,dosunay01,36,CHI,0,CHO,6,1,2,0,1,1,17.58333333,1,0,2,3,0,0,2,2,3,1,3,8,7,9,12.2
2023-24,202401080LAC,1/8/2024,LAC vs PHO,Josh Okogie,okogijo01,31,PHO,0,LAC,4,1,2,3,0,0,17.75,1,0,2,3,0,1,0,0,2,3,3,6,5,7,17.2
2023-24,202401080MIL,1/8/2024,MIL vs UTA,Collin Sexton,sextoco01,38,UTA,0,MIL,19,0,3,1,0,0,18.21666667,0,0,8,13,3,6,0,0,0,1,3,22,19,22,26.5
2023-24,202401080WAS,1/8/2024,WAS vs OKC,Corey Kispert,kispeco01,35,WAS,1,OKC,11,1,2,0,0,1,18.43333333,0,1,4,5,3,4,0,0,1,0,3,13,12,14,14.2
2023-24,202401080MIA,1/8/2024,MIA vs HOU,Jeff Green,greenje02,34,HOU,0,MIA,5,0,2,0,1,1,19.9,0,0,2,4,0,1,1,2,3,1,2,7,5,7,10
2023-24,202401080IND,1/8/2024,IND vs BOS,Obi Toppin,toppiob01,37,IND,1,BOS,13,0,1,0,0,0,19.96666667,0,0,4,5,3,4,2,2,2,0,1,14,13,14,14.5
2023-24,202401080IND,1/8/2024,IND vs BOS,Bruce Brown,brownbr01,31,IND,1,BOS,7,2,2,1,0,0,20.5,0,2,1,6,1,1,4,4,1,1,4,9,9,11,15.4
2023-24,202401080MIL,1/8/2024,MIL vs UTA,Walker Kessler,kesslwa01,30,UTA,0,MIL,8,6,0,1,2,0,21.16666667,2,4,3,4,0,0,2,4,1,3,6,8,14,14,24.2
2023-24,202401080WAS,1/8/2024,WAS vs OKC,Isaiah Joe,joeis01,35,OKC,0,WAS,16,4,3,0,0,1,21.36666667,1,3,6,10,4,7,0,0,0,0,7,19,20,23,24.3
2023-24,202401080LAC,1/8/2024,LAC vs PHO,Jusuf Nurkic,nurkiju01,35,PHO,0,LAC,8,3,2,1,0,0,21.36666667,1,2,3,8,1,2,1,2,1,1,5,10,11,13,17.6
2023-24,202401080MIA,1/8/2024,MIA vs HOU,Nikola Jovic,jovicni01,10,MIA,1,HOU,6,8,6,2,2,2,21.38333333,3,5,2,9,1,5,1,4,3,4,14,12,14,20,34.6
2023-24,202401080CHO,1/8/2024,CHO vs CHI,JT Thor,thorjt01,28,CHO,1,CHI,9,8,0,0,2,0,21.38333333,6,2,4,12,1,2,0,0,1,2,8,9,17,17,24.6
2023-24,202401080MIL,1/8/2024,MIL vs UTA,Pat Connaughton,connapa01,31,MIL,1,UTA,6,2,1,0,0,0,21.88333333,0,2,2,3,2,3,0,0,3,0,3,7,8,9,9.9
2023-24,202401080MIL,1/8/2024,MIL vs UTA,Keyonte George,georgke01,32,UTA,0,MIL,19,6,4,0,0,2,22.45,0,6,7,13,4,9,1,1,0,0,10,23,25,29,30.2
2023-24,202401080CHO,1/8/2024,CHO vs CHI,Andre Drummond,drumman01,38,CHI,0,CHO,21,15,0,0,0,2,22.51666667,5,10,9,12,0,0,3,3,1,0,15,21,36,36,37
2023-24,202401080MIA,1/8/2024,MIA vs HOU,Aaron Holiday,holidaa01,33,HOU,0,MIA,8,4,1,1,0,0,22.56666667,0,4,2,6,1,5,3,3,2,1,5,9,12,13,17.3
2023-24,202401080WAS,1/8/2024,WAS vs OKC,Aaron Wiggins,wiggiaa01,33,OKC,0,WAS,13,5,0,1,0,1,22.58333333,2,3,6,8,1,1,0,0,1,1,5,13,18,18,21
2023-24,202401080CHO,1/8/2024,CHO vs CHI,Patrick Williams,willipa01,37,CHI,0,CHO,8,5,0,1,1,2,22.81666667,1,4,2,6,1,2,3,4,1,2,5,8,13,13,18
2023-24,202401080MIA,1/8/2024,MIA vs HOU,Kevin Love,loveke01,29,MIA,1,HOU,15,7,4,1,0,1,23.18333333,3,4,4,7,1,3,6,7,2,1,11,19,22,26,31.4
2023-24,202401080IND,1/8/2024,IND vs BOS,Payton Pritchard,pritcpa01,36,BOS,0,IND,14,7,3,0,0,1,23.45,4,3,5,6,4,5,0,0,2,0,10,17,21,24,25.9
2023-24,202401080LAC,1/8/2024,LAC vs PHO,Amir Coffey,coffeam01,24,LAC,1,PHO,9,2,0,0,0,0,23.48333333,0,2,4,5,1,1,0,0,3,0,2,9,11,11,11.4
2023-24,202401080CHO,1/8/2024,CHO vs CHI,Bryce McGowens,mcgowbr01,29,CHO,1,CHI,3,1,2,0,0,0,23.6,0,1,1,7,1,5,0,0,1,0,3,5,4,6,7.2
2023-24,202401080WAS,1/8/2024,WAS vs OKC,Cason Wallace,wallaca01,35,OKC,0,WAS,5,2,2,2,3,1,24,1,1,2,7,1,4,0,0,1,5,4,7,7,9,24.4
2023-24,202401080MIL,1/8/2024,MIL vs UTA,Kris Dunn,dunnkr01,30,UTA,0,MIL,5,4,13,1,2,1,24.21666667,1,3,2,2,1,1,0,0,1,3,17,18,9,22,37.3
2023-24,202401080MIL,1/8/2024,MIL vs UTA,Malik Beasley,beaslma01,35,MIL,1,UTA,17,4,2,1,1,0,24.33333333,1,3,6,12,5,8,0,0,1,2,6,19,21,23,30.8
2023-24,202401080LAC,1/8/2024,LAC vs PHO,Norman Powell,powelno01,36,LAC,1,PHO,14,5,1,0,0,1,24.55,1,4,4,6,2,3,4,4,1,0,6,15,19,20,20.5
2023-24,202401080LAC,1/8/2024,LAC vs PHO,Eric Gordon,gordoer01,31,PHO,0,LAC,12,1,2,0,0,1,24.6,0,1,3,8,2,7,4,4,1,0,3,14,13,15,15.2
2023-24,202401080WAS,1/8/2024,WAS vs OKC,Bilal Coulibaly,coulibi01,35,WAS,1,OKC,5,5,3,0,2,0,24.76666667,1,4,1,4,1,2,2,2,2,2,8,8,10,13,21.5
2023-24,202401080IND,1/8/2024,IND vs BOS,T.J. McConnell,mccontj01,29,IND,1,BOS,12,4,7,2,0,2,24.76666667,1,3,6,12,0,2,0,0,1,2,11,19,16,23,31.3
2023-24,202401080IND,1/8/2024,IND vs BOS,Buddy Hield,hieldbu01,37,IND,1,BOS,15,4,3,1,1,1,24.78333333,1,3,6,11,3,7,0,0,3,2,7,18,19,22,29.3
2023-24,202401080WAS,1/8/2024,WAS vs OKC,Daniel Gafford,gaffoda01,33,WAS,1,OKC,9,9,1,0,1,0,25.51666667,4,5,3,7,0,0,3,3,2,1,10,10,18,19,24.3
2023-24,202401080IND,1/8/2024,IND vs BOS,Aaron Nesmith,nesmiaa01,35,IND,1,BOS,17,4,2,0,1,0,26.16666667,2,2,6,10,3,5,2,3,2,1,6,19,21,23,27.8
2023-24,202401080WAS,1/8/2024,WAS vs OKC,Josh Giddey,giddejo01,34,OKC,0,WAS,9,6,9,2,0,1,26.18333333,1,5,4,11,1,3,0,0,2,2,15,18,15,24,34.7
2023-24,202401080MIL,1/8/2024,MIL vs UTA,Andre Jackson Jr.,jacksan01,31,MIL,1,UTA,7,5,3,0,2,1,26.4,2,3,2,6,1,2,2,2,2,2,8,10,12,15,22.5
2023-24,202401080IND,1/8/2024,IND vs BOS,Jalen Smith,smithja04,24,IND,1,BOS,11,9,1,0,3,2,26.68333333,2,7,3,8,1,4,4,4,1,3,10,12,20,21,30.3
2023-24,202401080MIL,1/8/2024,MIL vs UTA,John Collins,collijo01,34,UTA,0,MIL,19,3,1,1,0,3,26.83333333,0,3,8,15,3,7,0,0,3,1,4,20,22,23,24.1
2023-24,202401080WAS,1/8/2024,WAS vs OKC,Luguentz Dort,dortlu01,34,OKC,0,WAS,7,3,1,0,1,2,27.31666667,0,3,2,5,0,3,3,4,4,1,4,8,10,11,13.1
2023-24,202401080LAC,1/8/2024,LAC vs PHO,Ivica Zubac,zubaciv01,36,LAC,1,PHO,19,8,3,1,1,0,27.66666667,2,6,8,9,0,0,3,6,3,2,11,22,27,30,39.1
2023-24,202401080LAC,1/8/2024,LAC vs PHO,Terance Mann,mannte01,30,LAC,1,PHO,14,5,3,0,0,1,27.95,3,2,5,9,3,6,1,2,2,0,8,17,19,22,23.5
2023-24,202401080IND,1/8/2024,IND vs BOS,Bennedict Mathurin,mathube01,37,IND,1,BOS,26,4,3,2,0,2,29.08333333,0,4,8,15,5,9,5,7,4,2,7,29,30,33,39.3
2023-24,202401080MIA,1/8/2024,MIA vs HOU,Josh Richardson,richajo01,27,MIA,1,HOU,12,2,2,0,1,0,29.13333333,0,2,4,6,2,3,2,2,2,1,4,14,14,16,20.4
2023-24,202401080WAS,1/8/2024,WAS vs OKC,Jordan Poole,poolejo01,35,WAS,1,OKC,24,0,5,0,0,1,29.31666667,0,0,8,17,4,8,4,5,5,0,5,29,24,29,30.5
2023-24,202401080MIA,1/8/2024,MIA vs HOU,Duncan Robinson,robindu01,34,MIA,1,HOU,14,3,7,1,0,1,29.46666667,0,3,4,12,3,10,3,3,6,1,10,21,17,24,30.1
2023-24,202401080LAC,1/8/2024,LAC vs PHO,James Harden,hardeja01,31,LAC,1,PHO,19,7,10,0,0,3,29.6,0,7,6,8,3,4,4,4,1,0,17,29,26,36,39.4
2023-24,202401080CHO,1/8/2024,CHO vs CHI,Nikola Vucevic,vucevni01,33,CHI,0,CHO,21,10,4,1,1,1,30.48333333,3,7,10,18,1,3,0,0,4,2,14,25,31,35,44
2023-24,202401080CHO,1/8/2024,CHO vs CHI,Brandon Miller,millebr02,30,CHO,1,CHI,4,6,4,1,0,3,30.6,0,6,2,11,0,7,0,0,4,1,10,8,10,14,17.2
2023-24,202401080LAC,1/8/2024,LAC vs PHO,Grayson Allen,allengr01,32,PHO,0,LAC,8,3,2,0,0,1,30.85,0,3,1,3,1,3,5,5,1,0,5,10,11,13,13.6
2023-24,202401080WAS,1/8/2024,WAS vs OKC,Tyus Jones,jonesty01,36,WAS,1,OKC,18,0,9,3,0,2,30.93333333,0,0,7,10,3,5,1,2,1,3,9,27,18,27,38.5
2023-24,202401080MIL,1/8/2024,MIL vs UTA,Jordan Clarkson,clarkjo01,28,UTA,0,MIL,21,4,6,0,1,1,31.11666667,1,3,7,14,2,3,5,5,0,1,10,27,25,31,36.8
2023-24,202401080LAC,1/8/2024,LAC vs PHO,Paul George,georgpa01,34,LAC,1,PHO,25,7,0,1,0,1,31.33333333,1,6,10,19,4,9,1,2,2,1,7,25,32,32,35.4
2023-24,202401080MIA,1/8/2024,MIA vs HOU,Jalen Green,greenja05,35,HOU,0,MIA,11,5,6,0,0,3,31.45,0,5,2,10,2,8,5,6,3,0,11,17,16,22,23
2023-24,202401080MIL,1/8/2024,MIL vs UTA,Simone Fontecchio,fontesi01,36,UTA,0,MIL,5,3,1,1,1,1,31.56666667,0,3,2,6,1,5,0,0,4,2,4,6,8,9,15.1
2023-24,202401080MIA,1/8/2024,MIA vs HOU,Bam Adebayo,adebaba01,26,MIA,1,HOU,22,12,3,1,0,3,31.63333333,1,11,9,12,0,0,4,7,4,1,15,25,34,37,40.9
2023-24,202401080WAS,1/8/2024,WAS vs OKC,Chet Holmgren,holmgch01,35,OKC,0,WAS,31,4,5,0,2,0,31.78333333,1,3,11,14,4,5,5,8,3,2,9,36,35,40,49.3
2023-24,202401080MIL,1/8/2024,MIL vs UTA,Lauri Markkanen,markkla01,28,UTA,0,MIL,21,14,2,1,2,0,31.95,4,10,5,15,4,10,7,8,1,3,16,23,35,37,49.8
2023-24,202401080MIA,1/8/2024,MIA vs HOU,Jabari Smith Jr.,smithja05,34,HOU,0,MIA,10,6,0,0,0,1,32.18333333,3,3,3,13,1,5,3,3,3,0,6,10,16,16,16.2
2023-24,202401080IND,1/8/2024,IND vs BOS,Al Horford,horfoal01,30,BOS,0,IND,11,6,0,0,1,1,32.25,0,6,4,5,3,4,0,0,1,1,6,11,17,17,20.2
2023-24,202401080CHO,1/8/2024,CHO vs CHI,Nick Smith Jr.,smithni01,19,CHO,1,CHI,15,4,3,1,0,3,32.33333333,2,2,6,15,3,6,0,0,2,1,7,18,19,22,24.3
2023-24,202401080LAC,1/8/2024,LAC vs PHO,Kawhi Leonard,leonaka01,32,LAC,1,PHO,17,3,2,5,1,3,32.45,0,3,8,15,1,3,0,0,1,6,5,19,20,22,38.6
2023-24,202401080WAS,1/8/2024,WAS vs OKC,Deni Avdija,avdijde01,36,WAS,1,OKC,17,4,4,1,0,4,32.75,0,4,5,8,2,3,5,6,4,1,8,21,21,25,26.8
2023-24,202401080MIA,1/8/2024,MIA vs HOU,Alperen Sengun,sengual01,35,HOU,0,MIA,22,10,2,3,0,3,32.8,3,7,9,15,1,2,3,4,6,3,12,24,32,34,43
2023-24,202401080MIL,1/8/2024,MIL vs UTA,Khris Middleton,middlkh01,32,MIL,1,UTA,23,3,8,2,1,3,33.55,0,3,7,16,3,6,6,6,1,3,11,31,26,34,44.6
2023-24,202401080MIA,1/8/2024,MIA vs HOU,Jae'Sean Tate,tateja01,33,HOU,0,MIA,9,4,1,2,0,0,33.63333333,3,1,3,8,1,4,2,2,5,2,5,10,13,14,21.3
2023-24,202401080WAS,1/8/2024,WAS vs OKC,Jalen Williams,willija06,32,OKC,0,WAS,21,7,10,2,0,4,33.83333333,1,6,9,13,1,1,2,2,3,2,17,31,28,38,46.4
2023-24,202401080LAC,1/8/2024,LAC vs PHO,Devin Booker,bookede01,28,PHO,0,LAC,20,0,5,0,0,6,34,0,0,8,14,2,6,2,2,4,0,5,25,20,25,21.5
2023-24,202401080CHO,1/8/2024,CHO vs CHI,Alex Caruso,carusal01,31,CHI,0,CHO,5,2,3,2,1,0,34.2,0,2,2,7,1,3,0,0,4,3,5,8,7,10,20.9
2023-24,202401080MIA,1/8/2024,MIA vs HOU,Tyler Herro,herroty01,18,MIA,1,HOU,28,3,3,0,0,1,34.43333333,2,1,10,20,5,10,3,3,2,0,6,31,31,34,35.1
2023-24,202401080LAC,1/8/2024,LAC vs PHO,Kevin Durant,duranke01,30,PHO,0,LAC,30,7,2,0,1,3,34.66666667,0,7,10,17,3,6,7,8,2,1,9,32,37,39,41.4
2023-24,202401080LAC,1/8/2024,LAC vs PHO,Bradley Beal,bealbr01,13,PHO,0,LAC,15,3,2,2,0,2,34.8,0,3,7,15,0,2,1,2,4,2,5,17,18,20,25.6
2023-24,202401080IND,1/8/2024,IND vs BOS,Myles Turner,turnemy01,36,IND,1,BOS,16,8,1,0,0,2,34.83333333,2,6,7,13,1,3,1,2,2,0,9,17,24,25,25.1
2023-24,202401080CHO,1/8/2024,CHO vs CHI,Zach LaVine,lavinza01,20,CHI,0,CHO,9,3,5,0,2,2,35.66666667,1,2,2,8,2,6,3,4,1,2,8,14,12,17,24.1
2023-24,202401080WAS,1/8/2024,WAS vs OKC,Shai Gilgeous-Alexander,gilgesh01,34,OKC,0,WAS,32,6,5,3,1,3,35.7,1,5,11,17,2,3,8,10,5,4,11,37,38,43,55.7
2023-24,202401080IND,1/8/2024,IND vs BOS,Derrick White,whitede01,33,BOS,0,IND,13,4,6,0,2,1,35.95,0,4,4,16,2,8,3,3,3,2,10,19,17,23,31.8
2023-24,202401080WAS,1/8/2024,WAS vs OKC,Kyle Kuzma,kuzmaky01,36,WAS,1,OKC,22,15,5,0,0,2,37.18333333,4,11,10,24,0,5,2,2,1,0,20,27,37,42,45.5
2023-24,202401080IND,1/8/2024,IND vs BOS,Kristaps Porzingis,porzikr01,27,BOS,0,IND,19,5,7,0,3,1,37.56666667,2,3,6,13,1,4,6,7,2,3,12,26,24,31,43.5
2023-24,202401080MIL,1/8/2024,MIL vs UTA,Brook Lopez,lopezbr01,37,MIL,1,UTA,13,6,3,0,2,0,37.8,1,5,5,11,3,6,0,0,2,2,9,16,19,22,30.7
2023-24,202401080IND,1/8/2024,IND vs BOS,Jrue Holiday,holidjr01,33,BOS,0,IND,21,6,6,1,0,3,37.96666667,1,5,9,16,3,6,0,0,2,1,12,27,27,33,37.2
2023-24,202401080IND,1/8/2024,IND vs BOS,Jaylen Brown,brownja02,34,BOS,0,IND,40,5,2,0,0,5,37.98333333,1,4,17,26,3,4,3,5,2,0,7,42,45,47,44
2023-24,202401080MIL,1/8/2024,MIL vs UTA,Giannis Antetokounmpo,antetgi01,36,MIL,1,UTA,25,10,11,0,0,4,38.38333333,4,6,10,20,0,2,5,9,5,0,21,36,35,46,49.5
2023-24,202401080CHO,1/8/2024,CHO vs CHI,Nick Richards,richani01,28,CHO,1,CHI,10,8,1,0,3,0,38.5,1,7,5,6,0,0,0,0,4,3,9,11,18,19,30.1
2023-24,202401080MIA,1/8/2024,MIA vs HOU,Jaime Jaquez Jr.,jaqueja01,36,MIA,1,HOU,14,4,4,1,0,2,38.61666667,0,4,5,11,1,2,3,4,1,1,8,18,18,22,25.8
2023-24,202401080MIA,1/8/2024,MIA vs HOU,Fred VanVleet,vanvlfr01,34,HOU,0,MIA,32,5,7,0,2,1,39.18333333,2,3,10,22,7,14,5,5,2,2,12,39,37,44,53.5
2023-24,202401080CHO,1/8/2024,CHO vs CHI,Miles Bridges,bridgmi02,23,CHO,1,CHI,24,8,5,1,2,5,40.11666667,2,6,9,18,4,8,2,3,3,3,13,29,32,37,45.1
2023-24,202401080CHO,1/8/2024,CHO vs CHI,Coby White,whiteco01,38,CHI,0,CHO,27,6,5,0,0,1,41.91666667,0,6,10,19,3,7,4,5,3,0,11,32,33,38,40.7
2023-24,202401080CHO,1/8/2024,CHO vs CHI,DeMar DeRozan,derozde01,36,CHI,0,CHO,18,7,7,3,1,3,43.81666667,0,7,7,16,1,3,3,4,0,4,14,25,25,32,45.9
2023-24,202401080CHO,1/8/2024,CHO vs CHI,Terry Rozier,roziete01,23,CHO,1,CHI,39,3,8,0,0,0,44.35,0,3,10,18,7,13,12,12,2,0,11,47,42,50,54.6
2023-24,202401070SAC,1/7/2024,SAC vs NOP,Jeremiah Robinson-Earl,robinje02,15,NOP,0,SAC,7,0,0,0,1,1,10.03333333,0,0,3,4,1,2,0,0,1,1,0,7,7,7,9
2023-24,202401070SAC,1/7/2024,SAC vs NOP,Colby Jones,jonesco02,13,SAC,1,NOP,4,1,4,1,0,0,10.4,0,1,2,5,0,2,0,0,1,1,5,8,5,9,14.2
2023-24,202401070SAC,1/7/2024,SAC vs NOP,Davion Mitchell,mitchda01,28,SAC,1,NOP,0,0,0,1,0,0,10.45,0,0,0,2,0,2,0,0,1,1,0,0,0,0,3
2023-24,202401070DEN,1/7/2024,DEN vs DET,Marcus Sasser,sassema01,32,DET,0,DEN,7,2,1,0,0,0,10.61666667,0,2,2,6,1,2,2,2,0,0,3,8,9,10,10.9
2023-24,202401070DEN,1/7/2024,DEN vs DET,Cade Cunningham,cunnica01,36,DET,0,DEN,3,3,3,0,0,0,10.73333333,0,3,1,6,1,2,0,0,2,0,6,6,6,9,11.1
2023-24,202401070CLE,1/7/2024,CLE vs SAS,Dean Wade,wadede01,29,CLE,1,SAS,0,2,1,0,0,1,10.96666667,0,2,0,3,0,2,0,0,2,0,3,1,2,3,2.9
2023-24,202401070CLE,1/7/2024,CLE vs SAS,Blake Wesley,weslebl01,14,SAS,0,CLE,3,2,0,0,0,2,11.5,0,2,1,2,0,1,1,2,1,0,2,3,5,5,3.4
2023-24,202401070ORL,1/7/2024,ORL vs ATL,Anthony Black,blackan01,34,ORL,1,ATL,0,0,0,1,0,1,11.58333333,0,0,0,2,0,1,0,0,1,1,0,0,0,0,2
2023-24,202401070GSW,1/7/2024,GSW vs TOR,Jontay Porter,portejo01,3,TOR,0,GSW,2,2,1,1,1,0,11.63333333,1,1,1,3,0,2,0,0,1,2,3,3,4,5,11.9
2023-24,202401070DAL,1/7/2024,DAL vs MIN,Seth Curry,curryse01,28,DAL,1,MIN,0,3,0,1,0,1,11.95,0,3,0,3,0,2,0,0,1,1,3,0,3,3,5.6
2023-24,202401070SAC,1/7/2024,SAC vs NOP,Keon Ellis,elliske01,24,SAC,1,NOP,13,2,1,1,0,0,12,2,0,5,6,3,3,0,0,1,1,3,14,15,16,19.9
2023-24,202401070PHO,1/7/2024,PHO vs MEM,Chimezie Metu,metuch01,26,PHO,1,MEM,4,1,0,1,0,1,12.21666667,0,1,2,7,0,5,0,0,3,1,1,4,5,5,7.2
2023-24,202401070LAL,1/7/2024,LAL vs LAC,Max Christie,chrisma02,28,LAL,1,LAC,7,3,0,0,2,0,12.61666667,2,1,3,6,1,1,0,0,0,2,3,7,10,10,16.6
2023-24,202401070DAL,1/7/2024,DAL vs MIN,Nickeil Alexander-Walker,alexani01,35,MIN,0,DAL,3,1,1,0,0,0,12.83333333,1,0,1,5,1,4,0,0,0,0,2,4,4,5,5.7
2023-24,202401070DAL,1/7/2024,DAL vs MIN,Jordan McLaughlin,mclaujo01,15,MIN,0,DAL,6,1,1,2,1,0,13.05,0,1,2,7,2,7,0,0,0,3,2,7,7,8,17.7
2023-24,202401070LAL,1/7/2024,LAL vs LAC,Amir Coffey,coffeam01,23,LAC,0,LAL,0,1,0,0,0,0,13.15,0,1,0,1,0,0,0,0,0,0,1,0,1,1,1.2
2023-24,202401070PHO,1/7/2024,PHO vs MEM,Drew Eubanks,eubandr01,32,PHO,1,MEM,8,7,0,0,0,2,13.35,3,4,2,3,0,0,4,5,1,0,7,8,15,15,14.4
2023-24,202401070PHO,1/7/2024,PHO vs MEM,Josh Okogie,okogijo01,30,PHO,1,MEM,6,1,2,2,0,0,13.6,0,1,2,5,0,2,2,2,5,2,3,8,7,9,16.2
2023-24,202401070PHO,1/7/2024,PHO vs MEM,Keita Bates-Diop,bateske01,26,PHO,1,MEM,3,3,1,0,0,0,14.3,1,2,1,3,1,3,0,0,3,0,4,4,6,7,8.1
2023-24,202401070SAC,1/7/2024,SAC vs NOP,Larry Nance Jr.,nancela02,20,NOP,0,SAC,2,7,4,0,1,2,14.35,2,5,1,4,0,0,0,0,1,1,11,6,9,13,17.4
2023-24,202401070GSW,1/7/2024,GSW vs TOR,Cory Joseph,josepco01,17,GSW,1,TOR,0,0,2,0,0,1,14.41666667,0,0,0,2,0,1,0,0,1,0,2,2,0,2,2
2023-24,202401070ORL,1/7/2024,ORL vs ATL,Markelle Fultz,fultzma01,6,ORL,1,ATL,0,2,4,1,0,1,14.85,0,2,0,2,0,0,0,4,0,1,6,4,2,6,10.4
2023-24,202401070SAC,1/7/2024,SAC vs NOP,Chris Duarte,duartch01,32,SAC,1,NOP,1,0,1,0,0,0,14.86666667,0,0,0,3,0,2,1,2,0,0,1,2,1,2,2.5
2023-24,202401070CLE,1/7/2024,CLE vs SAS,Malaki Branham,branhma01,34,SAS,0,CLE,2,1,2,0,0,1,15,0,1,1,5,0,3,0,0,2,0,3,4,3,5,5.2
2023-24,202401070CLE,1/7/2024,CLE vs SAS,Julian Champagnie,champju02,28,SAS,0,CLE,2,2,1,1,0,1,15.51666667,0,2,0,2,0,2,2,2,0,1,3,3,4,5,7.9
2023-24,202401070PHO,1/7/2024,PHO vs MEM,Santi Aldama,aldamsa01,29,MEM,0,PHO,7,7,1,1,1,4,15.56666667,2,5,2,11,1,7,2,3,2,2,8,8,14,15,18.9
2023-24,202401070LAL,1/7/2024,LAL vs LAC,Christian Wood,woodch01,32,LAL,1,LAC,9,10,0,0,2,1,15.95,1,9,4,6,1,2,0,0,2,2,10,9,19,19,26
2023-24,202401070GSW,1/7/2024,GSW vs TOR,Chris Boucher,bouchch01,33,TOR,0,GSW,17,9,1,1,1,0,16.05,2,7,7,7,3,3,0,0,0,2,10,18,26,27,35.3
2023-24,202401070BRK,1/7/2024,BRK vs POR,Day'Ron Sharpe,sharpda01,37,BRK,1,POR,11,6,2,0,1,0,16.58333333,3,3,4,7,0,0,3,4,3,1,8,13,17,19,24.2
2023-24,202401070CLE,1/7/2024,CLE vs SAS,Tristan Thompson,thomptr01,31,CLE,1,SAS,8,4,2,0,0,1,16.85,2,2,3,4,0,0,2,4,4,0,6,10,12,14,14.8
2023-24,202401070GSW,1/7/2024,GSW vs TOR,Andrew Wiggins,wiggian01,32,GSW,1,TOR,3,2,1,0,0,1,16.96666667,0,2,1,6,0,2,1,2,0,0,3,4,5,6,5.9
2023-24,202401070GSW,1/7/2024,GSW vs TOR,Kevon Looney,looneke01,36,GSW,1,TOR,10,7,2,0,0,1,17.06666667,7,0,4,6,0,0,2,2,2,0,9,12,17,19,20.4
2023-24,202401070BRK,1/7/2024,BRK vs POR,Cam Thomas,thomaca02,28,BRK,1,POR,9,3,0,0,0,1,17.88333333,0,3,4,9,1,3,0,0,0,0,3,9,12,12,11.6
2023-24,202401070DEN,1/7/2024,DEN vs DET,James Wiseman,wisemja01,25,DET,0,DEN,9,3,0,0,0,0,18.01666667,2,1,4,7,0,0,1,3,1,0,3,9,12,12,12.6
2023-24,202401070BRK,1/7/2024,BRK vs POR,Royce O'Neale,onealro01,36,BRK,1,POR,8,3,1,1,0,2,18.11666667,0,3,3,5,2,4,0,0,3,1,4,9,11,12,14.1
2023-24,202401070GSW,1/7/2024,GSW vs TOR,Dario Saric,saricda01,36,GSW,1,TOR,11,5,4,2,0,0,18.33333333,2,3,4,10,2,5,1,1,1,2,9,15,16,20,29
2023-24,202401070LAL,1/7/2024,LAL vs LAC,Russell Westbrook,westbru01,35,LAC,0,LAL,7,1,3,1,0,0,19.03333333,0,1,3,9,1,4,0,0,1,1,4,10,8,11,15.7
2023-24,202401070DAL,1/7/2024,DAL vs MIN,Kyle Anderson,anderky01,35,MIN,0,DAL,4,2,4,0,0,1,19.73333333,1,1,1,1,0,0,2,2,3,0,6,8,6,10,11.4
2023-24,202401070DEN,1/7/2024,DEN vs DET,Alec Burks,burksal01,29,DET,0,DEN,18,4,1,0,0,1,19.83333333,1,3,6,9,3,3,3,3,1,0,5,19,22,23,23.3
2023-24,202401070DEN,1/7/2024,DEN vs DET,Ausar Thompson,thompau01,36,DET,0,DEN,5,5,4,0,0,1,20.23333333,3,2,2,5,0,1,1,2,2,0,9,9,10,14,16
2023-24,202401070DAL,1/7/2024,DAL vs MIN,Grant Williams,willigr01,33,DAL,1,MIN,9,2,0,0,2,3,20.28333333,0,2,3,5,1,3,2,2,3,2,2,9,11,11,14.4
2023-24,202401070DEN,1/7/2024,DEN vs DET,Aaron Gordon,gordoaa01,32,DEN,1,DET,8,1,1,1,0,0,20.35,1,0,3,4,0,0,2,2,0,1,2,9,9,10,13.7
2023-24,202401070LAL,1/7/2024,LAL vs LAC,Cam Reddish,reddica01,31,LAL,1,LAC,7,4,1,2,0,5,20.35,1,3,2,6,2,3,1,2,1,2,5,8,11,12,14.3
2023-24,202401070DEN,1/7/2024,DEN vs DET,Kevin Knox,knoxke01,18,DET,0,DEN,12,3,1,0,0,0,20.36666667,2,1,4,8,1,3,3,4,0,0,4,13,15,16,17.1
2023-24,202401070LAL,1/7/2024,LAL vs LAC,Jarred Vanderbilt,vandeja01,17,LAL,1,LAC,2,4,4,1,0,1,20.55,2,2,1,3,0,1,0,0,0,1,8,6,6,10,14.8
2023-24,202401070SAC,1/7/2024,SAC vs NOP,Malik Monk,monkma01,34,SAC,1,NOP,6,1,5,1,1,1,20.58333333,0,1,2,9,2,6,0,0,1,2,6,11,7,12,19.7
2023-24,202401070SAC,1/7/2024,SAC vs NOP,Sasha Vezenkov,vezenal01,28,SAC,1,NOP,11,2,0,0,0,0,20.63333333,1,1,5,9,1,5,0,0,0,0,2,11,13,13,13.4
2023-24,202401070DEN,1/7/2024,DEN vs DET,DeAndre Jordan,jordade01,15,DEN,1,DET,9,7,1,0,1,3,20.9,0,7,3,3,0,0,3,5,5,1,8,10,16,17,18.9
2023-24,202401070CLE,1/7/2024,CLE vs SAS,Cedi Osman,osmande01,35,SAS,0,CLE,9,6,1,1,0,0,20.91666667,2,4,4,7,1,4,0,0,1,1,7,10,15,16,20.7
2023-24,202401070DEN,1/7/2024,DEN vs DET,Christian Braun,braunch01,38,DEN,1,DET,7,3,1,0,1,0,21.01666667,0,3,3,5,0,1,1,2,0,1,4,8,10,11,15.1
2023-24,202401070DEN,1/7/2024,DEN vs DET,Reggie Jackson,jacksre01,38,DEN,1,DET,13,3,9,1,0,1,21.2,2,1,5,7,1,1,2,2,5,1,12,22,16,25,32.1
2023-24,202401070GSW,1/7/2024,GSW vs TOR,Moses Moody,moodymo01,33,GSW,1,TOR,21,3,1,1,0,1,21.6,0,3,7,9,4,6,3,3,1,1,4,22,24,25,28.1
2023-24,202401070BRK,1/7/2024,BRK vs POR,Malcolm Brogdon,brogdma01,28,POR,0,BRK,18,3,2,0,0,0,21.68333333,1,2,5,8,4,6,4,4,0,0,5,20,21,23,24.6
2023-24,202401070PHO,1/7/2024,PHO vs MEM,Luke Kennard,kennalu01,13,MEM,0,PHO,9,3,3,0,0,0,21.86666667,0,3,3,5,3,3,0,0,2,0,6,12,12,15,17.1
2023-24,202401070SAC,1/7/2024,SAC vs NOP,Jonas Valanciunas,valanjo01,37,NOP,0,SAC,15,12,1,0,1,1,22.01666667,1,11,6,10,1,2,2,2,2,1,13,16,27,28,32.9
2023-24,202401070SAC,1/7/2024,SAC vs NOP,Naji Marshall,marshna01,28,NOP,0,SAC,11,6,2,0,0,1,22.1,2,4,3,4,1,1,4,4,2,0,8,13,17,19,20.2
2023-24,202401070CLE,1/7/2024,CLE vs SAS,Dominick Barlow,barlodo01,13,SAS,0,CLE,6,6,2,1,1,1,22.15,2,4,3,5,0,0,0,0,3,2,8,8,12,14,21.2
2023-24,202401070SAC,1/7/2024,SAC vs NOP,Harrison Barnes,barneha02,35,SAC,1,NOP,10,1,0,1,0,0,22.15,1,0,4,9,2,5,0,0,1,1,1,10,11,11,14.2
2023-24,202401070CLE,1/7/2024,CLE vs SAS,Sam Merrill,merrisa01,21,CLE,1,SAS,18,3,3,0,0,0,22.61666667,0,3,5,11,5,9,3,3,0,0,6,21,21,24,26.1
2023-24,202401070DEN,1/7/2024,DEN vs DET,Peyton Watson,watsope01,36,DEN,1,DET,15,6,1,1,1,0,23.36666667,1,5,4,10,2,4,5,5,0,2,7,16,21,22,29.7
2023-24,202401070GSW,1/7/2024,GSW vs TOR,Scottie Barnes,barnesc01,36,TOR,0,GSW,6,2,3,1,1,2,23.66666667,1,1,3,11,0,4,0,0,1,2,5,9,8,11,16.9
2023-24,202401070SAC,1/7/2024,SAC vs NOP,Jordan Hawkins,hawkijo01,32,NOP,0,SAC,12,3,2,0,1,2,24.03333333,0,3,5,9,1,5,1,2,2,1,5,14,15,17,19.6
2023-24,202401070SAC,1/7/2024,SAC vs NOP,Kevin Huerter,huertke01,34,SAC,1,NOP,17,1,3,1,1,0,24.26666667,1,0,6,10,2,6,3,4,0,2,4,20,18,21,28.7
2023-24,202401070SAC,1/7/2024,SAC vs NOP,Trey Murphy III,murphtr02,14,NOP,0,SAC,11,2,5,1,0,1,24.45,0,2,4,7,3,6,0,0,1,1,7,16,13,18,22.9
2023-24,202401070DEN,1/7/2024,DEN vs DET,Nikola Jokic,jokicni01,37,DEN,1,DET,4,7,16,0,5,2,24.61666667,0,7,2,3,0,0,0,0,4,5,23,20,11,27,49.4
2023-24,202401070CLE,1/7/2024,CLE vs SAS,Victor Wembanyama,wembavi01,31,SAS,0,CLE,24,10,3,1,5,3,24.61666667,0,10,6,13,2,5,10,11,3,6,13,27,34,37,55.5
2023-24,202401070LAL,1/7/2024,LAL vs LAC,Norman Powell,powelno01,35,LAC,0,LAL,14,0,0,2,0,0,24.78333333,0,0,3,12,2,5,6,6,1,2,0,14,14,14,20
2023-24,202401070GSW,1/7/2024,GSW vs TOR,Jonathan Kuminga,kuminjo01,35,GSW,1,TOR,13,4,4,1,1,1,24.9,1,3,5,13,1,5,2,2,0,2,8,17,17,21,28.8
2023-24,202401070LAL,1/7/2024,LAL vs LAC,Terance Mann,mannte01,29,LAC,0,LAL,6,0,3,0,0,1,25.13333333,0,0,2,5,2,3,0,0,2,0,3,9,6,9,9.5
2023-24,202401070DEN,1/7/2024,DEN vs DET,Killian Hayes,hayeski01,31,DET,0,DEN,2,2,6,1,0,1,25.15,0,2,1,5,0,1,0,0,4,1,8,8,4,10,15.4
2023-24,202401070ORL,1/7/2024,ORL vs ATL,Moritz Wagner,wagnemo01,36,ORL,1,ATL,15,7,0,1,0,0,25.41666667,2,5,6,12,1,4,2,2,2,1,7,15,22,22,26.4
2023-24,202401070SAC,1/7/2024,SAC vs NOP,De'Aaron Fox,foxde01,29,SAC,1,NOP,3,2,4,0,0,4,25.55,0,2,1,10,1,4,0,0,3,0,6,7,5,9,7.4
2023-24,202401070PHO,1/7/2024,PHO vs MEM,Bismack Biyombo,biyombi01,29,MEM,0,PHO,1,6,2,0,3,2,25.96666667,1,5,0,2,0,0,1,2,3,3,8,3,7,9,18.2
2023-24,202401070SAC,1/7/2024,SAC vs NOP,Herbert Jones,joneshe01,34,NOP,0,SAC,9,3,2,0,1,1,26,1,2,3,7,1,3,2,2,1,1,5,11,12,14,17.6
2023-24,202401070SAC,1/7/2024,SAC vs NOP,Keegan Murray,murrake02,31,SAC,1,NOP,8,1,0,1,0,0,26,1,0,2,9,1,6,3,3,1,1,1,8,9,9,12.2
2023-24,202401070ORL,1/7/2024,ORL vs ATL,Bogdan Bogdanovic,bogdabo01,33,ATL,0,ORL,18,3,1,4,0,0,26.03333333,1,2,7,17,4,9,0,0,5,4,4,19,21,22,35.1
2023-24,202401070GSW,1/7/2024,GSW vs TOR,Immanuel Quickley,quickim01,34,TOR,0,GSW,9,5,10,1,0,0,26.03333333,1,4,4,10,1,4,0,0,0,1,15,19,14,24,33
2023-24,202401070GSW,1/7/2024,GSW vs TOR,Gary Trent Jr.,trentga02,32,TOR,0,GSW,14,1,1,2,1,0,26.38333333,0,1,6,11,2,5,0,0,1,3,2,15,15,16,25.7
2023-24,202401070CLE,1/7/2024,CLE vs SAS,Caris LeVert,leverca01,28,CLE,1,SAS,23,2,3,2,0,4,26.46666667,0,2,9,13,4,5,1,3,2,2,5,26,25,28,31.9
2023-24,202401070DAL,1/7/2024,DAL vs MIN,Naz Reid,reidna01,35,MIN,0,DAL,15,9,0,0,0,0,26.65,4,5,7,12,1,4,0,2,2,0,9,15,24,24,25.8
2023-24,202401070GSW,1/7/2024,GSW vs TOR,Trayce Jackson-Davis,jackstr02,26,GSW,1,TOR,16,11,2,0,3,0,26.81666667,3,8,8,9,0,0,0,0,0,3,13,18,27,29,41.2
2023-24,202401070CLE,1/7/2024,CLE vs SAS,Georges Niang,niangge01,36,CLE,1,SAS,11,4,1,0,1,1,26.91666667,0,4,4,7,3,6,0,0,2,1,5,12,15,16,19.3
2023-24,202401070CLE,1/7/2024,CLE vs SAS,Isaac Okoro,okorois01,27,CLE,1,SAS,3,5,1,0,0,2,27.03333333,4,1,1,2,1,2,0,0,0,0,6,4,8,9,8.5
2023-24,202401070DEN,1/7/2024,DEN vs DET,Bojan Bogdanovic,bogdabo02,17,DET,0,DEN,14,1,1,3,0,3,27.06666667,0,1,6,12,2,4,0,0,2,3,2,15,15,16,22.7
2023-24,202401070DEN,1/7/2024,DEN vs DET,Jaden Ivey,iveyja01,32,DET,0,DEN,13,4,6,1,0,4,27.31666667,1,3,4,11,0,6,5,8,2,1,10,19,17,23,25.8
2023-24,202401070SAC,1/7/2024,SAC vs NOP,CJ McCollum,mccolcj01,24,NOP,0,SAC,30,7,4,0,2,3,27.4,1,6,11,16,7,10,1,2,0,2,11,34,37,41,47.4
2023-24,202401070DAL,1/7/2024,DAL vs MIN,Karl-Anthony Towns,townska01,34,MIN,0,DAL,24,7,1,0,2,3,27.43333333,0,7,8,16,3,9,5,6,5,2,8,25,31,32,36.9
2023-24,202401070PHO,1/7/2024,PHO vs MEM,Ziaire Williams,willizi02,34,MEM,0,PHO,9,4,3,2,0,1,27.45,2,2,4,10,1,5,0,1,4,2,7,12,13,16,23.3
2023-24,202401070ORL,1/7/2024,ORL vs ATL,Goga Bitadze,bitadgo01,32,ORL,1,ATL,11,14,3,0,2,0,27.58333333,7,7,5,6,0,0,1,2,4,2,17,14,25,28,38.3
2023-24,202401070BRK,1/7/2024,BRK vs POR,Spencer Dinwiddie,dinwisp01,35,BRK,1,POR,5,3,5,0,0,1,27.6,1,2,1,6,1,4,2,2,0,0,8,10,8,13,15.1
2023-24,202401070GSW,1/7/2024,GSW vs TOR,Dennis Schroder,schrode01,36,TOR,0,GSW,13,3,4,0,0,0,27.78333333,0,3,6,10,1,3,0,1,5,0,7,17,16,20,22.6
2023-24,202401070CLE,1/7/2024,CLE vs SAS,Jeremy Sochan,sochaje01,35,SAS,0,CLE,11,5,4,0,0,1,27.83333333,1,4,4,9,2,5,1,1,2,0,9,15,16,20,22
2023-24,202401070DAL,1/7/2024,DAL vs MIN,Dwight Powell,poweldw01,34,DAL,1,MIN,9,6,4,1,0,0,28.01666667,5,1,3,5,0,0,3,5,4,1,10,13,15,19,25.2
2023-24,202401070DEN,1/7/2024,DEN vs DET,Michael Porter Jr.,portemi01,38,DEN,1,DET,18,1,2,0,0,1,28.06666667,0,1,7,12,1,5,3,3,1,0,3,20,19,21,21.2
2023-24,202401070GSW,1/7/2024,GSW vs TOR,Klay Thompson,thompkl01,35,GSW,1,TOR,25,0,3,0,0,2,28.48333333,0,0,10,15,5,7,0,0,0,0,3,28,25,28,27.5
2023-24,202401070BRK,1/7/2024,BRK vs POR,Toumani Camara,camarto01,34,POR,0,BRK,5,6,1,1,0,2,28.51666667,1,5,1,4,0,2,3,4,4,1,7,6,11,12,14.7
2023-24,202401070GSW,1/7/2024,GSW vs TOR,Brandin Podziemski,podzibr01,30,GSW,1,TOR,5,8,4,0,0,0,28.55,2,6,2,11,1,8,0,0,1,0,12,9,13,17,20.6
2023-24,202401070SAC,1/7/2024,SAC vs NOP,Domantas Sabonis,sabondo01,35,SAC,1,NOP,17,10,6,1,0,3,28.91666667,0,10,8,12,1,2,0,1,2,1,16,23,27,33,38
2023-24,202401070SAC,1/7/2024,SAC vs NOP,Dyson Daniels,daniedy01,37,NOP,0,SAC,14,5,6,0,0,0,29.1,1,4,6,6,2,2,0,0,3,0,11,20,19,25,29
2023-24,202401070ORL,1/7/2024,ORL vs ATL,Jalen Suggs,suggsja01,32,ORL,1,ATL,16,5,3,1,0,1,29.25,1,4,6,13,4,7,0,0,6,1,8,19,21,24,28.5
2023-24,202401070BRK,1/7/2024,BRK vs POR,Dennis Smith Jr.,smithde03,22,BRK,1,POR,10,2,10,2,1,1,29.33333333,0,2,3,8,0,1,4,4,6,3,12,20,12,22,35.4
2023-24,202401070BRK,1/7/2024,BRK vs POR,Scoot Henderson,hendesc01,26,POR,0,BRK,10,3,4,0,0,2,29.55,1,2,3,8,2,3,2,2,2,0,7,14,13,17,17.6
2023-24,202401070SAC,1/7/2024,SAC vs NOP,Brandon Ingram,ingrabr01,34,NOP,0,SAC,15,4,8,1,1,1,29.81666667,0,4,6,12,1,3,2,2,0,2,12,23,19,27,36.8
2023-24,202401070GSW,1/7/2024,GSW vs TOR,Stephen Curry,curryst01,34,GSW,1,TOR,9,1,6,0,0,2,29.85,0,1,2,14,0,9,5,5,3,0,7,15,10,16,17.2
2023-24,202401070DEN,1/7/2024,DEN vs DET,Jalen Duren,durenja01,21,DET,0,DEN,20,5,4,0,0,1,29.98333333,2,3,8,12,0,0,4,6,1,0,9,24,25,29,31
2023-24,202401070DEN,1/7/2024,DEN vs DET,Jamal Murray,murraja01,24,DEN,1,DET,37,5,4,1,1,1,30.01666667,2,3,14,24,3,8,6,7,4,2,9,41,42,46,54
2023-24,202401070GSW,1/7/2024,GSW vs TOR,Pascal Siakam,siakapa01,36,TOR,0,GSW,16,6,6,0,2,1,30.16666667,1,5,7,11,2,3,0,0,0,2,12,22,22,28,37.2
2023-24,202401070LAL,1/7/2024,LAL vs LAC,Taurean Prince,princta02,36,LAL,1,LAC,13,1,2,1,0,0,30.25,0,1,4,8,3,6,2,2,3,1,3,15,14,16,20.2
2023-24,202401070ORL,1/7/2024,ORL vs ATL,Cole Anthony,anthoco01,35,ORL,1,ATL,10,9,5,0,0,4,30.66666667,0,9,3,13,0,3,4,4,5,0,14,15,19,24,24.3
2023-24,202401070DEN,1/7/2024,DEN vs DET,Isaiah Livers,liveris01,20,DET,0,DEN,11,5,1,1,0,0,30.68333333,2,3,4,8,1,2,2,2,5,1,6,12,16,17,21.5
2023-24,202401070GSW,1/7/2024,GSW vs TOR,Jakob Poeltl,poeltja01,36,TOR,0,GSW,14,11,5,0,0,2,30.85,3,8,6,8,0,0,2,5,3,0,16,19,25,30,32.7
2023-24,202401070DAL,1/7/2024,DAL vs MIN,Josh Green,greenjo02,25,DAL,1,MIN,4,5,1,0,1,0,30.86666667,0,5,2,3,0,1,0,0,2,1,6,5,9,10,14.5
2023-24,202401070LAL,1/7/2024,LAL vs LAC,D'Angelo Russell,russeda01,34,LAL,1,LAC,13,0,6,1,1,3,30.95,0,0,5,14,3,9,0,0,2,2,6,19,13,19,25
2023-24,202401070CLE,1/7/2024,CLE vs SAS,Jarrett Allen,allenja01,31,CLE,1,SAS,29,16,2,1,1,1,31.15,5,11,11,19,0,0,7,7,3,2,18,31,45,47,56.2
2023-24,202401070DAL,1/7/2024,DAL vs MIN,Tim Hardaway Jr.,hardati02,34,DAL,1,MIN,12,4,1,0,0,0,31.61666667,0,4,4,13,2,8,2,2,2,0,5,13,16,17,18.3
2023-24,202401070ORL,1/7/2024,ORL vs ATL,Onyeka Okongwu,okongon01,34,ATL,0,ORL,5,6,3,0,5,0,31.76666667,1,5,2,3,1,2,0,2,3,5,9,8,11,14,31.7
2023-24,202401070PHO,1/7/2024,PHO vs MEM,Jaren Jackson Jr.,jacksja02,36,MEM,0,PHO,28,10,6,0,1,2,31.8,1,9,11,20,3,8,3,4,5,1,16,34,38,44,50
2023-24,202401070DAL,1/7/2024,DAL vs MIN,Mike Conley,conlemi01,35,MIN,0,DAL,9,1,7,0,0,2,32.16666667,0,1,3,7,3,6,0,0,1,0,8,16,10,17,18.7
2023-24,202401070LAL,1/7/2024,LAL vs LAC,Austin Reaves,reaveau01,38,LAL,1,LAC,8,0,2,0,0,2,32.18333333,0,0,2,5,0,3,4,5,0,0,2,10,8,10,9
2023-24,202401070PHO,1/7/2024,PHO vs MEM,Jusuf Nurkic,nurkiju01,34,PHO,1,MEM,18,19,5,0,1,2,32.33333333,6,13,8,17,1,2,1,3,4,1,24,23,37,42,49.3
2023-24,202401070CLE,1/7/2024,CLE vs SAS,Keldon Johnson,johnske04,33,SAS,0,CLE,18,4,2,1,0,0,32.96666667,3,1,6,16,3,6,3,4,3,1,6,20,22,24,28.8
2023-24,202401070BRK,1/7/2024,BRK vs POR,Cameron Johnson,johnsca02,29,BRK,1,POR,17,6,3,1,1,0,33.5,1,5,5,11,3,8,4,5,3,2,9,20,23,26,34.7
2023-24,202401070DAL,1/7/2024,DAL vs MIN,Rudy Gobert,goberru01,35,MIN,0,DAL,9,17,1,1,0,5,34.21666667,6,11,4,9,0,0,1,4,4,1,18,10,26,27,28.9
2023-24,202401070CLE,1/7/2024,CLE vs SAS,Tre Jones,jonestr01,31,SAS,0,CLE,18,2,4,2,0,2,34.41666667,0,2,7,8,2,2,2,2,1,2,6,22,20,24,30.4
2023-24,202401070DAL,1/7/2024,DAL vs MIN,Derrick Jones Jr.,jonesde02,36,DAL,1,MIN,12,10,1,1,3,1,34.55,5,5,5,12,1,6,1,2,2,4,11,13,22,23,36.5
2023-24,202401070LAL,1/7/2024,LAL vs LAC,Kawhi Leonard,leonaka01,31,LAC,0,LAL,15,8,2,3,2,3,34.7,0,8,6,17,2,7,1,2,4,5,10,17,23,25,39.6
2023-24,202401070CLE,1/7/2024,CLE vs SAS,Devin Vassell,vassede01,30,SAS,0,CLE,22,2,3,3,0,0,35.08333333,0,2,9,19,4,9,0,0,2,3,5,25,24,27,37.9
2023-24,202401070BRK,1/7/2024,BRK vs POR,Dorian Finney-Smith,finnedo01,34,BRK,1,POR,9,5,2,1,0,1,35.5,2,3,3,8,3,7,0,0,3,1,7,11,14,16,20
2023-24,202401070DEN,1/7/2024,DEN vs DET,Kentavious Caldwell-Pope,caldwke01,36,DEN,1,DET,18,4,0,2,1,3,36.11666667,0,4,6,10,3,6,3,3,2,3,4,18,22,22,28.8
2023-24,202401070GSW,1/7/2024,GSW vs TOR,RJ Barrett,barrerj01,30,TOR,0,GSW,37,6,6,1,0,0,36.16666667,0,6,13,20,5,8,6,8,3,1,12,43,43,49,56.2
2023-24,202401070BRK,1/7/2024,BRK vs POR,Nic Claxton,claxtni01,27,BRK,1,POR,16,11,3,2,4,5,36.25,2,9,8,8,0,0,0,2,5,6,14,19,27,30,46.7
2023-24,202401070PHO,1/7/2024,PHO vs MEM,Kevin Durant,duranke01,29,PHO,1,MEM,23,10,5,0,1,1,36.36666667,2,8,11,23,0,1,1,1,1,1,15,28,33,38,44.5
2023-24,202401070ORL,1/7/2024,ORL vs ATL,Caleb Houstan,houstca01,27,ORL,1,ATL,25,2,4,1,0,0,36.41666667,1,1,8,15,7,14,2,3,2,1,6,29,27,31,36.4
2023-24,202401070ORL,1/7/2024,ORL vs ATL,Clint Capela,capelca01,34,ATL,0,ORL,4,12,0,3,2,1,36.43333333,4,8,2,6,0,0,0,2,3,5,12,4,16,16,32.4
2023-24,202401070PHO,1/7/2024,PHO vs MEM,Desmond Bane,banede01,35,MEM,0,PHO,23,5,5,1,1,3,36.53333333,2,3,8,14,2,7,5,5,3,2,10,28,28,33,39.5
2023-24,202401070CLE,1/7/2024,CLE vs SAS,Donovan Mitchell,mitchdo01,27,CLE,1,SAS,17,2,9,1,0,4,36.86666667,0,2,7,18,1,10,2,4,1,1,11,26,19,28,31.9
2023-24,202401070DAL,1/7/2024,DAL vs MIN,Anthony Edwards,edwaran01,32,MIN,0,DAL,36,10,3,3,1,2,36.91666667,5,5,14,27,3,6,5,7,3,4,13,39,46,49,62.5
2023-24,202401070PHO,1/7/2024,PHO vs MEM,Vince Williams Jr.,willivi01,26,MEM,0,PHO,19,9,1,0,2,0,36.96666667,4,5,6,11,3,4,4,4,2,2,10,20,28,29,37.3
2023-24,202401070DAL,1/7/2024,DAL vs MIN,Jaden McDaniels,mcdanja02,25,MIN,0,DAL,2,3,4,0,0,0,37,1,2,1,10,0,5,0,0,4,0,7,6,5,9,11.6
2023-24,202401070PHO,1/7/2024,PHO vs MEM,Bradley Beal,bealbr01,12,PHO,1,MEM,12,6,5,0,0,1,37.15,3,3,5,12,0,1,2,4,3,0,11,17,18,23,25.7
2023-24,202401070PHO,1/7/2024,PHO vs MEM,Devin Booker,bookede01,27,PHO,1,MEM,24,0,8,2,1,2,37.25,0,0,9,17,2,6,4,5,4,3,8,32,24,32,43
2023-24,202401070CLE,1/7/2024,CLE vs SAS,Max Strus,strusma01,36,CLE,1,SAS,8,5,4,2,0,2,37.46666667,1,4,3,11,2,9,0,0,2,2,9,12,13,17,24
2023-24,202401070LAL,1/7/2024,LAL vs LAC,Ivica Zubac,zubaciv01,35,LAC,0,LAL,22,19,1,0,1,2,37.48333333,10,9,9,13,0,0,4,4,4,1,20,23,41,42,47.3
2023-24,202401070PHO,1/7/2024,PHO vs MEM,Marcus Smart,smartma01,19,MEM,0,PHO,25,6,8,3,0,5,37.66666667,0,6,9,20,4,13,3,5,2,3,14,33,31,39,48.2
2023-24,202401070LAL,1/7/2024,LAL vs LAC,LeBron James,jamesle01,35,LAL,1,LAC,25,8,7,1,0,4,38.11666667,1,7,11,19,1,3,2,3,2,1,15,32,33,40,44.1
2023-24,202401070ORL,1/7/2024,ORL vs ATL,Saddiq Bey,beysa01,35,ATL,0,ORL,16,7,2,1,0,0,38.2,1,6,5,10,2,4,4,5,1,1,9,18,23,25,30.4
2023-24,202401070ORL,1/7/2024,ORL vs ATL,Chuma Okeke,okekech01,19,ORL,1,ATL,3,7,2,0,0,1,38.28333333,0,7,1,5,1,5,0,0,0,0,9,5,10,12,13.4
2023-24,202401070LAL,1/7/2024,LAL vs LAC,Paul George,georgpa01,33,LAC,0,LAL,22,4,3,5,1,3,38.43333333,0,4,8,18,4,11,2,2,4,6,7,25,26,29,46.3
2023-24,202401070LAL,1/7/2024,LAL vs LAC,James Harden,hardeja01,30,LAC,0,LAL,15,4,9,1,0,5,38.51666667,2,2,4,13,3,7,4,5,3,1,13,24,19,28,31.3
2023-24,202401070PHO,1/7/2024,PHO vs MEM,Grayson Allen,allengr01,31,PHO,1,MEM,16,2,3,0,2,3,38.95,0,2,6,15,4,8,0,0,2,2,5,19,18,21,25.9
2023-24,202401070LAL,1/7/2024,LAL vs LAC,Anthony Davis,davisan02,36,LAL,1,LAC,22,10,1,3,1,3,39.03333333,1,9,10,15,0,1,2,4,1,4,11,23,32,33,44.5
2023-24,202401070DAL,1/7/2024,DAL vs MIN,Kyrie Irving,irvinky01,21,DAL,1,MIN,35,8,5,3,2,3,39.28333333,5,3,14,27,6,8,1,1,2,5,13,40,43,48,64.1
2023-24,202401070DAL,1/7/2024,DAL vs MIN,Luka Doncic,doncilu01,33,DAL,1,MIN,34,6,8,1,0,3,39.31666667,0,6,12,26,5,12,5,8,3,1,14,42,40,48,53.2
2023-24,202401070ORL,1/7/2024,ORL vs ATL,Dejounte Murray,murrade01,35,ATL,0,ORL,24,6,2,0,0,3,40.1,0,6,9,20,0,2,6,10,2,0,8,26,30,32,31.2
2023-24,202401070BRK,1/7/2024,BRK vs POR,Shaedon Sharpe,sharpsh01,30,POR,0,BRK,21,1,1,2,1,0,40.16666667,0,1,7,14,3,6,4,7,2,3,2,22,22,23,32.7
2023-24,202401070ORL,1/7/2024,ORL vs ATL,Jalen Johnson,johnsja05,21,ATL,0,ORL,12,11,4,0,1,3,40.28333333,1,10,6,12,0,4,0,0,6,1,15,16,23,27,31.2
2023-24,202401070BRK,1/7/2024,BRK vs POR,Duop Reath,reathdu01,23,POR,0,BRK,15,13,1,1,3,1,40.76666667,3,10,5,10,3,4,2,3,4,4,14,16,28,29,43.1
2023-24,202401070ORL,1/7/2024,ORL vs ATL,Trae Young,youngtr01,33,ATL,0,ORL,31,4,9,1,1,5,42.05,0,4,11,23,2,9,7,10,2,2,13,40,35,44,50.3
2023-24,202401070BRK,1/7/2024,BRK vs POR,Jerami Grant,grantje01,31,POR,0,BRK,27,2,1,1,1,0,42.45,0,2,11,24,3,7,2,2,2,2,3,28,29,30,36.9
2023-24,202401070BRK,1/7/2024,BRK vs POR,Mikal Bridges,bridgmi01,37,BRK,1,POR,42,4,3,0,0,3,44.1,0,4,15,26,4,8,8,8,0,0,7,45,46,49,48.3
2023-24,202401070ORL,1/7/2024,ORL vs ATL,Paolo Banchero,banchpa01,36,ORL,1,ATL,35,10,4,3,1,2,44.9,1,9,13,29,4,7,5,7,2,4,14,39,45,49,63
2023-24,202401070BRK,1/7/2024,BRK vs POR,Anfernee Simons,simonan01,14,POR,0,BRK,38,4,11,0,0,2,45.38333333,0,4,13,25,5,10,7,8,2,0,15,49,42,53,57.3
2023-24,202401060HOU,1/6/2024,HOU vs MIL,Andre Jackson Jr.,jacksan01,30,MIL,0,HOU,1,2,0,2,0,0,12.03333333,0,2,0,1,0,1,1,1,3,2,2,1,3,3,9.4
2023-24,202401060IND,1/6/2024,IND vs BOS,T.J. McConnell,mccontj01,28,IND,1,BOS,6,1,5,2,0,3,12.18333333,0,1,3,3,0,0,0,0,0,2,6,11,7,12,17.7
2023-24,202401060HOU,1/6/2024,HOU vs MIL,Cam Whitmore,whitmca01,11,HOU,1,MIL,12,3,0,1,0,0,12.78333333,0,3,4,6,1,1,3,3,0,1,3,12,15,15,18.6
2023-24,202401060PHI,1/6/2024,PHI vs UTA,Ochai Agbaji,agbajoc01,37,UTA,0,PHI,0,3,1,0,0,1,13.01666667,1,2,0,2,0,2,0,0,1,0,4,1,3,4,4.1
2023-24,202401060WAS,1/6/2024,WAS vs NYK,Miles McBride,mcbrimi01,23,NYK,0,WAS,5,1,5,1,0,0,13.06666667,1,0,2,6,1,2,0,0,2,1,6,10,6,11,16.7
2023-24,202401060PHI,1/6/2024,PHI vs UTA,Jaden Springer,sprinja01,22,PHI,1,UTA,0,2,2,0,0,0,13.33333333,1,1,0,3,0,3,0,0,1,0,4,2,2,4,5.4
2023-24,202401060WAS,1/6/2024,WAS vs NYK,Mike Muscala,muscami01,22,WAS,1,NYK,1,6,0,0,0,1,13.91666667,3,3,0,4,0,3,1,2,0,0,6,1,7,7,7.2
2023-24,202401060WAS,1/6/2024,WAS vs NYK,Corey Kispert,kispeco01,34,WAS,1,NYK,8,2,1,0,1,4,14.66666667,0,2,3,4,1,2,1,1,0,1,3,9,10,11,10.9
2023-24,202401060WAS,1/6/2024,WAS vs NYK,Quentin Grimes,grimequ01,33,NYK,0,WAS,6,1,1,1,0,1,14.83333333,0,1,2,5,2,4,0,0,1,1,2,7,7,8,10.7
2023-24,202401060PHI,1/6/2024,PHI vs UTA,Kelly Olynyk,olynyke01,35,UTA,0,PHI,5,1,4,0,0,3,15.15,0,1,2,3,1,1,0,0,3,0,5,9,6,10,9.2
2023-24,202401060IND,1/6/2024,IND vs BOS,Payton Pritchard,pritcpa01,35,BOS,0,IND,5,2,0,1,0,0,15.46666667,0,2,2,5,1,3,0,0,0,1,2,5,7,7,10.4
2023-24,202401060HOU,1/6/2024,HOU vs MIL,Amen Thompson,thompam01,15,HOU,1,MIL,4,3,5,0,0,1,15.65,1,2,2,3,0,1,0,0,2,0,8,9,7,12,14.1
2023-24,202401060PHI,1/6/2024,PHI vs UTA,Keyonte George,georgke01,31,UTA,0,PHI,6,2,3,0,0,2,16.01666667,0,2,2,4,0,2,2,2,2,0,5,9,8,11,10.9
2023-24,202401060IND,1/6/2024,IND vs BOS,Luke Kornet,kornelu01,22,BOS,0,IND,4,4,3,1,0,1,16.01666667,3,1,1,2,0,0,2,2,1,1,7,7,8,11,15.3
2023-24,202401060HOU,1/6/2024,HOU vs MIL,Malik Beasley,beaslma01,34,MIL,0,HOU,3,1,0,0,0,2,16.05,0,1,1,1,1,1,0,0,2,0,1,3,4,4,2.2
2023-24,202401060IND,1/6/2024,IND vs BOS,Sam Hauser,hausesa01,35,BOS,0,IND,5,4,1,0,0,1,16.43333333,0,4,2,6,1,5,0,0,4,0,5,6,9,10,10.3
2023-24,202401060WAS,1/6/2024,WAS vs NYK,Delon Wright,wrighde01,14,WAS,1,NYK,2,3,3,0,0,0,16.58333333,0,3,1,6,0,1,0,0,0,0,6,5,5,8,10.1
2023-24,202401060HOU,1/6/2024,HOU vs MIL,Bobby Portis,portibo01,36,MIL,0,HOU,6,6,0,1,1,2,16.86666667,0,6,2,5,1,2,1,2,5,2,6,6,12,12,17.2
2023-24,202401060PHI,1/6/2024,PHI vs UTA,Mo Bamba,bambamo01,22,PHI,1,UTA,6,5,1,1,1,0,16.95,3,2,3,9,0,2,0,1,4,2,6,7,11,12,19.5
2023-24,202401060PHI,1/6/2024,PHI vs UTA,KJ Martin,martike04,23,PHI,1,UTA,9,2,1,1,0,0,17.18333333,1,1,4,7,0,1,1,2,4,1,3,10,11,12,15.9
2023-24,202401060HOU,1/6/2024,HOU vs MIL,Pat Connaughton,connapa01,30,MIL,0,HOU,9,1,1,0,0,0,18.98333333,0,1,3,5,3,5,0,0,0,0,2,10,10,11,11.7
2023-24,202401060PHI,1/6/2024,PHI vs UTA,Walker Kessler,kesslwa01,29,UTA,0,PHI,10,4,0,1,0,0,19.11666667,1,3,4,4,0,0,2,2,2,1,4,10,14,14,17.8
2023-24,202401060HOU,1/6/2024,HOU vs MIL,Jae'Sean Tate,tateja01,32,HOU,1,MIL,4,8,0,1,0,0,19.48333333,3,5,2,3,0,0,0,0,4,1,8,4,12,12,16.6
2023-24,202401060IND,1/6/2024,IND vs BOS,Oshae Brissett,brissos01,19,BOS,0,IND,8,8,0,0,1,0,19.78333333,5,3,3,9,1,3,1,1,3,1,8,8,16,16,20.6
2023-24,202401060HOU,1/6/2024,HOU vs MIL,Aaron Holiday,holidaa01,32,HOU,1,MIL,11,1,0,0,0,2,20.85,0,1,4,7,3,5,0,0,1,0,1,11,12,12,10.2
2023-24,202401060HOU,1/6/2024,HOU vs MIL,MarJon Beauchamp,beaucma01,31,MIL,0,HOU,5,4,3,0,1,1,23,1,3,2,4,1,3,0,0,1,1,7,8,9,12,16.3
2023-24,202401060IND,1/6/2024,IND vs BOS,Obi Toppin,toppiob01,36,IND,1,BOS,10,3,1,0,0,0,23.18333333,1,2,4,8,2,4,0,0,1,0,4,11,13,14,15.1
2023-24,202401060PHI,1/6/2024,PHI vs UTA,Kris Dunn,dunnkr01,29,UTA,0,PHI,0,5,1,1,2,1,23.23333333,0,5,0,1,0,1,0,0,3,3,6,1,5,6,15.5
2023-24,202401060IND,1/6/2024,IND vs BOS,Derrick White,whitede01,32,BOS,0,IND,7,5,2,0,1,4,24.18333333,0,5,3,6,1,2,0,0,5,1,7,9,12,14,15
2023-24,202401060PHI,1/6/2024,PHI vs UTA,Paul Reed,reedpa01,35,PHI,1,UTA,16,6,1,0,0,1,24.78333333,3,3,7,12,0,0,2,4,1,0,7,17,22,23,23.7
2023-24,202401060IND,1/6/2024,IND vs BOS,Jalen Smith,smithja04,23,IND,1,BOS,7,7,2,0,0,0,25.81666667,1,6,2,6,1,4,2,2,2,0,9,9,14,16,18.4
2023-24,202401060PHI,1/6/2024,PHI vs UTA,Nicolas Batum,batumni01,24,PHI,1,UTA,2,4,4,4,2,2,26.06666667,1,3,1,6,0,5,0,0,3,6,8,6,6,10,28.8
2023-24,202401060WAS,1/6/2024,WAS vs NYK,Donte DiVincenzo,divindo01,36,NYK,0,WAS,10,5,3,1,0,1,26.36666667,1,4,4,10,2,7,0,0,1,1,8,13,15,18,22.5
2023-24,202401060PHI,1/6/2024,PHI vs UTA,Collin Sexton,sextoco01,37,UTA,0,PHI,22,3,10,0,0,5,27.11666667,1,2,9,14,1,3,3,4,3,0,13,32,25,35,35.6
2023-24,202401060WAS,1/6/2024,WAS vs NYK,Bilal Coulibaly,coulibi01,34,WAS,1,NYK,4,3,3,0,0,3,27.76666667,2,1,2,5,0,2,0,0,3,0,6,7,7,10,9.1
2023-24,202401060PHI,1/6/2024,PHI vs UTA,John Collins,collijo01,33,UTA,0,PHI,19,5,2,0,1,1,27.86666667,1,4,9,10,0,0,1,2,1,1,7,21,24,26,30
2023-24,202401060WAS,1/6/2024,WAS vs NYK,Tyus Jones,jonesty01,35,WAS,1,NYK,11,1,8,0,0,2,27.96666667,0,1,4,13,2,6,1,2,0,0,9,19,12,20,22.2
2023-24,202401060PHI,1/6/2024,PHI vs UTA,Marcus Morris,morrima03,27,PHI,1,UTA,15,6,1,2,2,0,28.13333333,2,4,5,12,3,7,2,2,2,4,7,16,21,22,35.7
2023-24,202401060HOU,1/6/2024,HOU vs MIL,Jalen Green,greenja05,34,HOU,1,MIL,16,4,2,1,0,1,28.26666667,0,4,5,12,1,6,5,5,1,1,6,18,20,22,25.8
2023-24,202401060IND,1/6/2024,IND vs BOS,Al Horford,horfoal01,29,BOS,0,IND,10,7,8,1,2,2,29.58333333,1,6,4,8,2,5,0,2,1,3,15,18,17,25,37.4
2023-24,202401060IND,1/6/2024,IND vs BOS,Myles Turner,turnemy01,35,IND,1,BOS,12,7,2,0,0,0,29.86666667,3,4,5,11,0,5,2,4,3,0,9,14,19,21,23.4
2023-24,202401060WAS,1/6/2024,WAS vs NYK,Jordan Poole,poolejo01,34,WAS,1,NYK,10,3,4,2,0,2,29.88333333,0,3,4,10,1,5,1,2,3,2,7,14,13,17,23.6
2023-24,202401060IND,1/6/2024,IND vs BOS,Buddy Hield,hieldbu01,36,IND,1,BOS,15,2,3,0,0,0,30.6,0,2,6,16,3,10,0,0,3,0,5,18,17,20,21.9
2023-24,202401060WAS,1/6/2024,WAS vs NYK,Daniel Gafford,gaffoda01,32,WAS,1,NYK,6,12,3,1,1,1,30.63333333,4,8,2,2,0,0,2,4,5,2,15,9,18,21,29.9
2023-24,202401060PHI,1/6/2024,PHI vs UTA,Jordan Clarkson,clarkjo01,27,UTA,0,PHI,18,5,6,1,0,5,30.65,0,5,5,14,0,6,8,9,0,1,11,24,23,29,31
2023-24,202401060HOU,1/6/2024,HOU vs MIL,Alperen Sengun,sengual01,34,HOU,1,MIL,21,11,4,0,0,3,31.18333333,1,10,7,21,0,1,7,10,5,0,15,25,32,36,37.2
2023-24,202401060WAS,1/6/2024,WAS vs NYK,OG Anunoby,anunoog01,31,NYK,0,WAS,9,5,2,1,0,1,31.21666667,2,3,4,7,1,3,0,0,3,1,7,11,14,16,20
2023-24,202401060HOU,1/6/2024,HOU vs MIL,Brook Lopez,lopezbr01,36,MIL,0,HOU,7,5,0,1,1,0,31.3,0,5,3,9,1,6,0,0,2,2,5,7,12,12,19
2023-24,202401060WAS,1/6/2024,WAS vs NYK,Kyle Kuzma,kuzmaky01,35,WAS,1,NYK,27,2,2,0,1,3,31.78333333,0,2,10,21,4,10,3,4,3,1,4,29,29,31,32.4
2023-24,202401060IND,1/6/2024,IND vs BOS,Aaron Nesmith,nesmiaa01,34,IND,1,BOS,8,4,0,3,1,0,31.88333333,1,3,3,13,0,7,2,2,2,4,4,8,12,12,24.8
2023-24,202401060WAS,1/6/2024,WAS vs NYK,Josh Hart,hartjo01,36,NYK,0,WAS,9,4,1,0,0,2,32.3,2,2,3,8,1,4,2,2,1,0,5,10,13,14,13.3
2023-24,202401060PHI,1/6/2024,PHI vs UTA,Simone Fontecchio,fontesi01,35,UTA,0,PHI,7,7,2,1,0,4,32.85,1,6,3,9,1,6,0,0,1,1,9,9,14,16,17.4
2023-24,202401060HOU,1/6/2024,HOU vs MIL,Khris Middleton,middlkh01,31,MIL,0,HOU,10,3,5,1,0,3,32.91666667,0,3,3,9,0,5,4,6,5,1,8,15,13,18,21.1
2023-24,202401060WAS,1/6/2024,WAS vs NYK,Deni Avdija,avdijde01,35,WAS,1,NYK,23,10,6,2,0,4,33,3,7,9,13,2,4,3,5,5,2,16,29,33,39,46
2023-24,202401060PHI,1/6/2024,PHI vs UTA,Patrick Beverley,beverpa01,34,PHI,1,UTA,12,4,7,0,0,0,34.01666667,2,2,5,13,2,6,0,0,0,0,11,19,16,23,27.3
2023-24,202401060HOU,1/6/2024,HOU vs MIL,Jeff Green,greenje02,33,HOU,1,MIL,16,2,2,0,1,1,34.31666667,0,2,5,11,2,5,4,5,4,1,4,18,18,20,23.4
2023-24,202401060IND,1/6/2024,IND vs BOS,Tyrese Haliburton,halibty01,33,IND,1,BOS,17,6,7,5,0,4,34.71666667,1,5,5,17,2,9,5,5,1,5,13,24,23,30,45.7
2023-24,202401060WAS,1/6/2024,WAS vs NYK,Jalen Brunson,brunsja01,36,NYK,0,WAS,33,3,8,0,0,2,34.93333333,0,3,10,18,4,8,9,9,2,0,11,41,36,44,46.6
2023-24,202401060PHI,1/6/2024,PHI vs UTA,Lauri Markkanen,markkla01,27,UTA,0,PHI,33,13,1,0,1,1,34.98333333,4,9,12,19,5,9,4,5,2,1,14,34,46,47,52.1
2023-24,202401060IND,1/6/2024,IND vs BOS,Bennedict Mathurin,mathube01,36,IND,1,BOS,20,4,2,2,1,2,35.4,2,2,7,14,0,3,6,9,2,3,6,22,24,26,34.8
2023-24,202401060IND,1/6/2024,IND vs BOS,Jaylen Brown,brownja02,33,BOS,0,IND,31,4,1,0,1,3,35.76666667,1,3,13,20,1,4,4,8,0,1,5,32,35,36,37.3
2023-24,202401060IND,1/6/2024,IND vs BOS,Jrue Holiday,holidjr01,32,BOS,0,IND,8,6,5,1,0,2,36.73333333,1,5,3,9,1,5,1,2,2,1,11,13,14,19,23.7
2023-24,202401060HOU,1/6/2024,HOU vs MIL,Fred VanVleet,vanvlfr01,33,HOU,1,MIL,14,2,7,2,0,1,37.3,1,1,4,13,3,10,3,3,3,2,9,21,16,23,31.9
2023-24,202401060PHI,1/6/2024,PHI vs UTA,Kelly Oubre Jr.,oubreke01,24,PHI,1,UTA,24,4,4,1,0,0,37.46666667,1,3,8,18,1,6,7,8,5,1,8,28,28,32,37.8
2023-24,202401060IND,1/6/2024,IND vs BOS,Jayson Tatum,tatumja01,33,BOS,0,IND,38,13,6,1,0,4,37.6,1,12,14,23,8,13,2,4,4,1,19,44,51,57,61.6
2023-24,202401060WAS,1/6/2024,WAS vs NYK,Julius Randle,randlju01,36,NYK,0,WAS,39,7,5,1,0,2,37.71666667,3,4,13,23,3,8,10,13,2,1,12,44,46,51,55.9
2023-24,202401060HOU,1/6/2024,HOU vs MIL,Damian Lillard,lillada01,34,MIL,0,HOU,18,2,8,2,0,1,38.48333333,0,2,5,16,1,8,7,10,1,2,10,26,20,28,37.4
2023-24,202401060HOU,1/6/2024,HOU vs MIL,Giannis Antetokounmpo,antetgi01,35,MIL,0,HOU,48,17,2,0,1,2,38.93333333,3,14,16,25,1,2,15,21,4,1,19,50,65,67,72.4
2023-24,202401060WAS,1/6/2024,WAS vs NYK,Isaiah Hartenstein,harteis01,36,NYK,0,WAS,8,19,2,4,2,5,39.21666667,2,17,4,8,0,0,0,0,3,6,21,10,27,29,46.8
2023-24,202401060HOU,1/6/2024,HOU vs MIL,Jabari Smith Jr.,smithja05,33,HOU,1,MIL,14,12,2,2,1,1,40.16666667,1,11,3,7,3,5,5,6,4,3,14,16,26,28,39.4
2023-24,202401060PHI,1/6/2024,PHI vs UTA,Tyrese Maxey,maxeyty01,34,PHI,1,UTA,25,1,9,3,1,3,42.06666667,1,0,9,24,1,8,6,6,0,4,10,34,26,35,48.7
2023-24,202401050DEN,1/5/2024,DEN vs ORL,Justin Holiday,holidju01,20,DEN,1,ORL,0,1,1,0,0,0,10.08333333,0,1,0,1,0,1,0,0,1,0,2,1,1,2,2.7
2023-24,202401050PHO,1/5/2024,PHO vs MIA,Bol Bol,bolbo01,11,PHO,1,MIA,4,3,1,0,1,0,10.28333333,1,2,2,2,0,0,0,1,1,1,4,5,7,8,12.1
2023-24,202401050SAC,1/5/2024,SAC vs TOR,Davion Mitchell,mitchda01,27,SAC,1,TOR,7,1,2,0,0,0,10.51666667,0,1,3,8,1,4,0,0,0,0,3,9,8,10,11.2
2023-24,202401050DEN,1/5/2024,DEN vs ORL,Zeke Nnaji,nnajize01,31,DEN,1,ORL,3,2,0,1,0,2,11.15,1,1,1,1,0,0,1,2,4,1,2,3,5,5,6.4
2023-24,202401050BOS,1/5/2024,BOS vs UTA,Luke Kornet,kornelu01,21,BOS,1,UTA,2,7,0,1,1,1,11.46666667,4,3,1,3,0,0,0,0,1,2,7,2,9,9,15.4
2023-24,202401050BRK,1/5/2024,BRK vs OKC,Kenrich Williams,willike04,23,OKC,0,BRK,0,1,1,1,0,3,11.53333333,0,1,0,1,0,0,0,0,2,1,2,1,1,2,2.7
2023-24,202401050CLE,1/5/2024,CLE vs WAS,Craig Porter Jr.,portecr01,24,CLE,1,WAS,7,4,4,1,0,5,11.78333333,1,3,3,6,0,0,1,1,2,1,8,11,11,15,15.8
2023-24,202401050PHI,1/5/2024,PHI vs NYK,Paul Reed,reedpa01,34,PHI,1,NYK,6,1,0,0,0,0,11.78333333,0,1,3,5,0,0,0,0,2,0,1,6,7,7,7.2
2023-24,202401050LAL,1/5/2024,LAL vs MEM,Xavier Tillman Sr.,tillmxa01,23,MEM,0,LAL,1,5,1,2,0,1,11.8,1,4,0,1,0,0,1,2,3,2,6,2,6,7,13.5
2023-24,202401050DAL,1/5/2024,DAL vs POR,Greg Brown III,browngr01,6,DAL,1,POR,7,2,1,0,3,1,11.86666667,1,1,3,5,1,2,0,0,2,3,3,8,9,10,18.9
2023-24,202401050BOS,1/5/2024,BOS vs UTA,Talen Horton-Tucker,hortota01,30,UTA,0,BOS,11,1,0,2,0,0,12,0,1,4,10,0,1,3,6,1,2,1,11,12,12,18.2
2023-24,202401050BOS,1/5/2024,BOS vs UTA,Luka Samanic,samanlu01,16,UTA,0,BOS,6,5,0,0,0,2,12,2,3,1,3,0,1,4,5,0,0,5,6,11,11,10
2023-24,202401050BOS,1/5/2024,BOS vs UTA,Lamar Stevens,stevela01,13,BOS,1,UTA,4,5,0,1,1,1,12,1,4,2,4,0,1,0,0,1,2,5,4,9,9,15
2023-24,202401050IND,1/5/2024,IND vs ATL,Jarace Walker,walkeja02,12,IND,1,ATL,8,1,1,0,0,1,12,1,0,3,6,2,3,0,0,1,0,2,9,9,10,9.7
2023-24,202401050BOS,1/5/2024,BOS vs UTA,Omer Yurtseven,yurtsom01,21,UTA,0,BOS,0,7,0,0,0,1,12,3,4,0,4,0,2,0,2,1,0,7,0,7,7,7.4
2023-24,202401050BRK,1/5/2024,BRK vs OKC,Vasilije Micic,micicva01,15,OKC,0,BRK,6,0,3,1,1,0,12.26666667,0,0,3,4,0,1,0,0,0,2,3,9,6,9,16.5
2023-24,202401050GSW,1/5/2024,GSW vs DET,Kevon Looney,looneke01,35,GSW,1,DET,4,4,1,0,0,0,12.46666667,1,3,1,1,0,0,2,2,2,0,5,5,8,9,10.3
2023-24,202401050PHI,1/5/2024,PHI vs NYK,Precious Achiuwa,achiupr01,28,NYK,0,PHI,5,3,0,0,1,1,12.53333333,2,1,2,3,1,2,0,0,0,1,3,5,8,8,10.6
2023-24,202401050DEN,1/5/2024,DEN vs ORL,Peyton Watson,watsope01,35,DEN,1,ORL,4,1,0,0,0,0,12.76666667,1,0,2,6,0,2,0,0,4,0,1,4,5,5,5.2
2023-24,202401050HOU,1/5/2024,HOU vs MIN,Jordan McLaughlin,mclaujo01,14,MIN,0,HOU,3,3,3,2,0,0,12.81666667,0,3,1,1,1,1,0,0,0,2,6,6,6,9,17.1
2023-24,202401050SAC,1/5/2024,SAC vs TOR,Jontay Porter,portejo01,2,TOR,0,SAC,10,3,0,0,1,1,13.43333333,1,2,3,4,2,3,2,2,2,1,3,10,13,13,15.6
2023-24,202401050PHI,1/5/2024,PHI vs NYK,Patrick Beverley,beverpa01,33,PHI,1,NYK,2,2,0,1,0,2,13.56666667,0,2,0,1,0,1,2,2,2,1,2,2,4,4,5.4
2023-24,202401050DAL,1/5/2024,DAL vs POR,Matisse Thybulle,thybuma01,34,POR,0,DAL,0,2,0,1,1,0,13.68333333,0,2,0,2,0,1,0,0,0,2,2,0,2,2,8.4
2023-24,202401050DAL,1/5/2024,DAL vs POR,Olivier-Maxence Prosper,prospol01,23,DAL,1,POR,8,6,3,0,0,0,13.78333333,1,5,3,7,2,3,0,0,3,0,9,11,14,17,19.7
2023-24,202401050BOS,1/5/2024,BOS vs UTA,Kelly Olynyk,olynyke01,34,UTA,0,BOS,6,1,1,1,0,0,13.96666667,0,1,0,2,0,1,6,8,3,1,2,7,7,8,11.7
2023-24,202401050SAC,1/5/2024,SAC vs TOR,Kevin Huerter,huertke01,33,SAC,1,TOR,3,2,3,0,0,0,14.01666667,0,2,1,2,1,2,0,0,1,0,5,6,5,8,9.9
2023-24,202401050BOS,1/5/2024,BOS vs UTA,Walker Kessler,kesslwa01,28,UTA,0,BOS,4,7,0,0,0,0,14.08333333,1,6,2,3,0,0,0,0,2,0,7,4,11,11,12.4
2023-24,202401050IND,1/5/2024,IND vs ATL,Trent Forrest,forretr01,10,ATL,0,IND,6,2,2,1,0,2,14.38333333,0,2,2,4,0,1,2,2,0,1,4,8,8,10,12.4
2023-24,202401050CHI,1/5/2024,CHI vs CHO,Jevon Carter,carteje01,37,CHI,1,CHO,7,2,2,0,0,0,14.45,0,2,3,5,1,2,0,0,1,0,4,9,9,11,12.4
2023-24,202401050BOS,1/5/2024,BOS vs UTA,Svi Mykhailiuk,mykhasv01,14,BOS,1,UTA,3,3,0,0,0,0,14.83333333,0,3,1,7,1,6,0,0,2,0,3,3,6,6,6.6
2023-24,202401050HOU,1/5/2024,HOU vs MIN,Cam Whitmore,whitmca01,10,HOU,1,MIN,11,2,0,2,0,4,14.88333333,0,2,4,10,1,4,2,2,1,2,2,11,13,13,15.4
2023-24,202401050PHI,1/5/2024,PHI vs NYK,Jaden Springer,sprinja01,21,PHI,1,NYK,3,1,1,1,1,0,14.91666667,1,0,1,7,0,3,1,2,1,2,2,4,4,5,11.7
2023-24,202401050PHI,1/5/2024,PHI vs NYK,Miles McBride,mcbrimi01,22,NYK,0,PHI,15,1,4,0,0,0,14.96666667,0,1,4,8,4,6,3,3,1,0,5,19,16,20,22.2
2023-24,202401050SAC,1/5/2024,SAC vs TOR,Trey Lyles,lylestr01,21,SAC,1,TOR,12,3,1,0,0,0,15.23333333,0,3,4,6,4,5,0,0,2,0,4,13,15,16,17.1
2023-24,202401050GSW,1/5/2024,GSW vs DET,James Wiseman,wisemja01,24,DET,0,GSW,4,3,0,0,2,0,15.23333333,1,2,1,5,0,1,2,3,2,2,3,4,7,7,13.6
2023-24,202401050GSW,1/5/2024,GSW vs DET,Killian Hayes,hayeski01,30,DET,0,GSW,0,1,5,2,0,0,15.75,0,1,0,3,0,2,0,0,0,2,6,5,1,6,14.7
2023-24,202401050CHI,1/5/2024,CHI vs CHO,JT Thor,thorjt01,27,CHO,0,CHI,2,2,1,0,0,0,15.98333333,0,2,1,2,0,0,0,0,1,0,3,3,4,5,5.9
2023-24,202401050CHI,1/5/2024,CHI vs CHO,Nick Smith Jr.,smithni01,18,CHO,0,CHI,10,2,0,1,0,1,16,0,2,4,6,2,2,0,0,0,1,2,10,12,12,14.4
2023-24,202401050CHI,1/5/2024,CHI vs CHO,Ish Smith,smithis01,27,CHO,0,CHI,6,2,4,1,0,0,16.16666667,1,1,3,9,0,2,0,0,1,1,6,10,8,12,17.4
2023-24,202401050BRK,1/5/2024,BRK vs OKC,Royce O'Neale,onealro01,35,BRK,1,OKC,5,4,2,1,0,5,16.3,2,2,2,4,1,2,0,0,3,1,6,7,9,11,10.8
2023-24,202401050LAL,1/5/2024,LAL vs MEM,Christian Wood,woodch01,31,LAL,1,MEM,11,5,0,1,0,1,16.31666667,0,5,3,5,1,2,4,4,0,1,5,11,16,16,19
2023-24,202401050DEN,1/5/2024,DEN vs ORL,Christian Braun,braunch01,37,DEN,1,ORL,6,4,0,0,0,1,16.33333333,1,3,2,4,1,3,1,2,0,0,4,6,10,10,9.8
2023-24,202401050DAL,1/5/2024,DAL vs POR,Malcolm Brogdon,brogdma01,27,POR,0,DAL,4,3,3,1,0,3,16.4,0,3,2,8,0,4,0,2,0,1,6,7,7,10,12.1
2023-24,202401050SAC,1/5/2024,SAC vs TOR,Chris Duarte,duartch01,31,SAC,1,TOR,10,0,1,0,0,1,16.4,0,0,4,6,2,3,0,0,2,0,1,11,10,11,10.5
2023-24,202401050CLE,1/5/2024,CLE vs WAS,Delon Wright,wrighde01,13,WAS,0,CLE,7,2,2,5,0,1,16.41666667,0,2,3,6,1,3,0,0,0,5,4,9,9,11,26.4
2023-24,202401050PHI,1/5/2024,PHI vs NYK,Marcus Morris,morrima03,26,PHI,1,NYK,0,0,1,0,0,0,16.45,0,0,0,1,0,1,0,0,0,0,1,1,0,1,1.5
2023-24,202401050NOP,1/5/2024,NOP vs LAC,Terance Mann,mannte01,28,LAC,0,NOP,8,3,1,1,0,0,16.55,1,2,2,3,2,3,2,2,2,1,4,9,11,12,16.1
2023-24,202401050PHI,1/5/2024,PHI vs NYK,Donte DiVincenzo,divindo01,35,NYK,0,PHI,14,2,3,1,0,2,16.7,1,1,4,6,4,6,2,2,4,1,5,17,16,19,21.9
2023-24,202401050LAL,1/5/2024,LAL vs MEM,Jarred Vanderbilt,vandeja01,16,LAL,1,MEM,0,5,1,1,0,0,16.73333333,1,4,0,0,0,0,0,0,1,1,6,1,5,6,10.5
2023-24,202401050IND,1/5/2024,IND vs ATL,Buddy Hield,hieldbu01,35,IND,1,ATL,11,3,1,0,0,1,16.78333333,0,3,4,9,3,8,0,0,4,0,4,12,14,15,15.1
2023-24,202401050NOP,1/5/2024,NOP vs LAC,Trey Murphy III,murphtr02,13,NOP,1,LAC,3,2,1,0,1,0,16.85,0,2,1,9,1,6,0,0,0,1,3,4,5,6,9.9
2023-24,202401050CLE,1/5/2024,CLE vs WAS,Tristan Thompson,thomptr01,30,CLE,1,WAS,8,4,2,0,0,2,16.85,2,2,4,5,0,0,0,2,6,0,6,10,12,14,13.8
2023-24,202401050CHI,1/5/2024,CHI vs CHO,Nathan Mensah,mensana01,9,CHO,0,CHI,4,2,0,1,1,1,17.1,0,2,1,1,0,0,2,2,4,2,2,4,6,6,11.4
2023-24,202401050BOS,1/5/2024,BOS vs UTA,Oshae Brissett,brissos01,18,BOS,1,UTA,6,3,2,2,0,0,17.25,1,2,2,5,0,2,2,2,3,2,5,8,9,11,18.6
2023-24,202401050PHO,1/5/2024,PHO vs MIA,Chimezie Metu,metuch01,25,PHO,1,MIA,7,2,0,2,0,2,17.28333333,0,2,3,3,0,0,1,1,0,2,2,7,9,9,13.4
2023-24,202401050DEN,1/5/2024,DEN vs ORL,Reggie Jackson,jacksre01,37,DEN,1,ORL,11,3,3,0,0,1,17.3,1,2,5,12,1,5,0,0,0,0,6,14,14,17,18.1
2023-24,202401050BOS,1/5/2024,BOS vs UTA,Jordan Clarkson,clarkjo01,26,UTA,0,BOS,2,2,2,1,0,4,17.36666667,1,1,1,7,0,2,0,0,0,1,4,4,4,6,6.4
2023-24,202401050NOP,1/5/2024,NOP vs LAC,Daniel Theis,theisda01,24,LAC,0,NOP,2,5,0,0,0,1,17.4,2,3,1,3,0,1,0,0,1,0,5,2,7,7,7
2023-24,202401050NOP,1/5/2024,NOP vs LAC,Naji Marshall,marshna01,27,NOP,1,LAC,9,3,1,1,0,2,17.46666667,3,0,4,9,1,1,0,0,2,1,4,10,12,13,15.1
2023-24,202401050IND,1/5/2024,IND vs ATL,Bennedict Mathurin,mathube01,35,IND,1,ATL,18,3,4,0,0,0,17.51666667,1,2,6,9,2,4,4,4,2,0,7,22,21,25,27.6
2023-24,202401050HOU,1/5/2024,HOU vs MIN,Nickeil Alexander-Walker,alexani01,34,MIN,0,HOU,11,3,3,2,2,0,17.53333333,1,2,4,6,2,4,1,2,2,4,6,14,14,17,31.1
2023-24,202401050HOU,1/5/2024,HOU vs MIN,Kyle Anderson,anderky01,34,MIN,0,HOU,2,7,5,3,0,2,17.58333333,1,6,1,4,0,0,0,0,3,3,12,7,9,14,24.9
2023-24,202401050DAL,1/5/2024,DAL vs POR,Ibou Badji,badjiib01,6,POR,0,DAL,0,2,1,0,0,1,17.71666667,0,2,0,1,0,0,0,0,3,0,3,1,2,3,2.9
2023-24,202401050CLE,1/5/2024,CLE vs WAS,Mike Muscala,muscami01,21,WAS,0,CLE,0,6,0,0,0,1,18.4,1,5,0,3,0,2,0,0,2,0,6,0,6,6,6.2
2023-24,202401050DAL,1/5/2024,DAL vs POR,Rayan Rupert,ruperra01,9,POR,0,DAL,7,3,0,0,0,2,18.56666667,1,2,3,5,1,2,0,0,3,0,3,7,10,10,8.6
2023-24,202401050PHO,1/5/2024,PHO vs MIA,Keita Bates-Diop,bateske01,25,PHO,1,MIA,0,4,0,3,0,0,18.58333333,1,3,0,6,0,3,0,0,1,3,4,0,4,4,13.8
2023-24,202401050GSW,1/5/2024,GSW vs DET,Andrew Wiggins,wiggian01,31,GSW,1,DET,3,2,2,0,0,1,18.6,1,1,1,5,1,2,0,0,2,0,4,5,5,7,7.4
2023-24,202401050NOP,1/5/2024,NOP vs LAC,Jose Alvarado,alvarjo01,22,NOP,1,LAC,2,1,2,0,1,0,18.68333333,0,1,1,7,0,2,0,0,0,1,3,4,3,5,9.2
2023-24,202401050NOP,1/5/2024,NOP vs LAC,Larry Nance Jr.,nancela02,19,NOP,1,LAC,7,6,2,1,0,0,18.9,3,3,3,6,1,2,0,0,0,1,8,9,13,15,20.2
2023-24,202401050HOU,1/5/2024,HOU vs MIN,Aaron Holiday,holidaa01,31,HOU,1,MIN,5,2,2,0,0,0,18.95,0,2,2,3,1,1,0,0,0,0,4,7,7,9,10.4
2023-24,202401050NOP,1/5/2024,NOP vs LAC,Zion Williamson,willizi01,30,NOP,1,LAC,12,6,1,1,1,1,19.41666667,2,4,3,9,0,0,6,8,3,2,7,13,18,19,25.7
2023-24,202401050IND,1/5/2024,IND vs ATL,Clint Capela,capelca01,33,ATL,0,IND,9,7,0,0,1,1,19.45,5,2,4,9,0,0,1,2,2,1,7,9,16,16,19.4
2023-24,202401050IND,1/5/2024,IND vs ATL,Garrison Mathews,mathega01,22,ATL,0,IND,6,3,2,0,0,1,19.45,1,2,2,3,2,3,0,0,1,0,5,8,9,11,11.6
2023-24,202401050HOU,1/5/2024,HOU vs MIN,Amen Thompson,thompam01,14,HOU,1,MIN,6,6,1,3,0,2,19.61666667,1,5,2,9,0,2,2,3,3,3,7,7,12,13,21.7
2023-24,202401050BRK,1/5/2024,BRK vs OKC,Isaiah Joe,joeis01,34,OKC,0,BRK,3,1,1,0,1,1,19.86666667,0,1,1,5,1,3,0,0,1,1,2,4,4,5,7.7
2023-24,202401050DAL,1/5/2024,DAL vs POR,Kris Murray,murrakr01,18,POR,0,DAL,10,4,1,2,0,1,20.01666667,2,2,4,8,2,3,0,0,0,2,5,11,14,15,21.3
2023-24,202401050DAL,1/5/2024,DAL vs POR,Seth Curry,curryse01,27,DAL,1,POR,9,2,1,0,0,0,20.03333333,1,1,4,9,1,4,0,0,2,0,3,10,11,12,12.9
2023-24,202401050PHO,1/5/2024,PHO vs MIA,Kevin Love,loveke01,28,MIA,0,PHO,20,7,2,0,0,2,20.06666667,3,4,6,9,3,6,5,6,4,0,9,22,27,29,29.4
2023-24,202401050CLE,1/5/2024,CLE vs WAS,Corey Kispert,kispeco01,33,WAS,0,CLE,13,1,1,0,1,2,20.13333333,0,1,6,12,1,6,0,0,2,1,2,14,14,15,16.7
2023-24,202401050LAL,1/5/2024,LAL vs MEM,Max Christie,chrisma02,27,LAL,1,MEM,2,3,0,1,0,2,20.26666667,0,3,1,3,0,1,0,0,2,1,3,2,5,5,6.6
2023-24,202401050LAL,1/5/2024,LAL vs MEM,Ziaire Williams,willizi02,33,MEM,0,LAL,15,1,1,1,0,2,20.31666667,0,1,6,11,2,6,1,1,2,1,2,16,16,17,18.7
2023-24,202401050BOS,1/5/2024,BOS vs UTA,Keyonte George,georgke01,30,UTA,0,BOS,12,4,1,0,0,1,20.35,1,3,4,10,2,7,2,2,0,0,5,13,16,17,17.3
2023-24,202401050LAL,1/5/2024,LAL vs MEM,Luke Kennard,kennalu01,12,MEM,0,LAL,0,3,4,1,0,0,20.46666667,1,2,0,4,0,3,0,0,0,1,7,4,3,7,12.6
2023-24,202401050BOS,1/5/2024,BOS vs UTA,Collin Sexton,sextoco01,36,UTA,0,BOS,13,1,3,3,0,3,20.46666667,0,1,5,12,0,3,3,3,1,3,4,16,14,17,24.7
2023-24,202401050DAL,1/5/2024,DAL vs POR,Derrick Jones Jr.,jonesde02,35,DAL,1,POR,12,3,0,3,0,3,20.48333333,0,3,5,6,2,3,0,0,4,3,3,12,15,15,21.6
2023-24,202401050IND,1/5/2024,IND vs ATL,Onyeka Okongwu,okongon01,33,ATL,0,IND,3,6,1,0,1,0,20.78333333,4,2,1,1,0,0,1,2,1,1,7,4,9,10,14.7
2023-24,202401050HOU,1/5/2024,HOU vs MIN,Jeff Green,greenje02,32,HOU,1,MIN,4,1,0,0,0,0,20.83333333,1,0,2,4,0,2,0,0,2,0,1,4,5,5,5.2
2023-24,202401050HOU,1/5/2024,HOU vs MIN,Jae'Sean Tate,tateja01,31,HOU,1,MIN,0,3,2,1,0,0,20.85,0,3,0,1,0,1,0,0,1,1,5,2,3,5,9.6
2023-24,202401050NOP,1/5/2024,NOP vs LAC,Amir Coffey,coffeam01,22,LAC,0,NOP,4,3,0,1,0,2,20.9,1,2,2,4,0,2,0,0,1,1,3,4,7,7,8.6
2023-24,202401050CHI,1/5/2024,CHI vs CHO,Dalen Terry,terryda01,21,CHI,1,CHO,8,1,4,2,0,0,21.01666667,0,1,3,5,2,4,0,0,2,2,5,12,9,13,21.2
2023-24,202401050PHI,1/5/2024,PHI vs NYK,Nicolas Batum,batumni01,23,PHI,1,NYK,0,4,1,0,1,2,21.26666667,1,3,0,2,0,1,0,0,2,1,5,1,4,5,7.3
2023-24,202401050GSW,1/5/2024,GSW vs DET,Alec Burks,burksal01,28,DET,0,GSW,13,4,2,0,1,2,21.36666667,1,3,5,14,3,10,0,0,2,1,6,15,17,19,21.8
2023-24,202401050BRK,1/5/2024,BRK vs OKC,Dorian Finney-Smith,finnedo01,33,BRK,1,OKC,9,3,2,1,1,0,21.53333333,1,2,3,6,3,5,0,0,4,2,5,11,12,14,21.6
2023-24,202401050CLE,1/5/2024,CLE vs WAS,Isaac Okoro,okorois01,26,CLE,1,WAS,8,4,0,1,0,3,21.6,2,2,2,5,0,0,4,6,2,1,4,8,12,12,12.8
2023-24,202401050CLE,1/5/2024,CLE vs WAS,Dean Wade,wadede01,28,CLE,1,WAS,6,5,1,1,0,0,21.61666667,0,5,2,4,2,3,0,0,0,1,6,7,11,12,16.5
2023-24,202401050PHO,1/5/2024,PHO vs MIA,Drew Eubanks,eubandr01,31,PHO,1,MIA,11,6,0,1,0,0,21.7,2,4,4,8,1,1,2,4,1,1,6,11,17,17,21.2
2023-24,202401050BOS,1/5/2024,BOS vs UTA,Ochai Agbaji,agbajoc01,36,UTA,0,BOS,5,4,1,0,0,2,21.81666667,1,3,2,5,0,3,1,1,4,0,5,6,9,10,9.3
2023-24,202401050GSW,1/5/2024,GSW vs DET,Isaiah Livers,liveris01,19,DET,0,GSW,5,1,1,1,0,0,21.81666667,0,1,2,3,1,2,0,0,2,1,2,6,6,7,10.7
2023-24,202401050NOP,1/5/2024,NOP vs LAC,Russell Westbrook,westbru01,34,LAC,0,NOP,8,5,5,2,2,4,21.86666667,2,3,3,6,1,3,1,2,2,4,10,13,13,18,29.5
2023-24,202401050BOS,1/5/2024,BOS vs UTA,John Collins,collijo01,32,UTA,0,BOS,12,11,2,0,1,2,21.91666667,0,11,5,8,0,1,2,3,5,1,13,14,23,25,29.2
2023-24,202401050IND,1/5/2024,IND vs ATL,Obi Toppin,toppiob01,35,IND,1,ATL,9,3,2,1,0,1,22.15,0,3,3,6,3,5,0,0,2,1,5,11,12,14,17.6
2023-24,202401050IND,1/5/2024,IND vs ATL,Bruce Brown,brownbr01,30,IND,1,ATL,17,3,2,0,0,2,22.25,0,3,8,9,1,1,0,0,1,0,5,19,20,22,21.6
2023-24,202401050IND,1/5/2024,IND vs ATL,Aaron Nesmith,nesmiaa01,33,IND,1,ATL,15,2,3,1,1,2,22.25,0,2,7,11,1,2,0,0,3,2,5,18,17,20,25.9
2023-24,202401050IND,1/5/2024,IND vs ATL,Myles Turner,turnemy01,34,IND,1,ATL,27,5,3,1,1,1,22.25,2,3,10,14,2,3,5,5,0,2,8,30,32,35,42.5
2023-24,202401050PHI,1/5/2024,PHI vs NYK,Danuel House Jr.,houseda01,22,PHI,1,NYK,2,4,1,1,0,0,22.3,0,4,1,3,0,1,0,0,1,1,5,3,6,7,11.3
2023-24,202401050GSW,1/5/2024,GSW vs DET,Dario Saric,saricda01,35,GSW,1,DET,17,3,1,0,0,1,22.48333333,0,3,6,10,3,5,2,2,3,0,4,18,20,21,21.1
2023-24,202401050SAC,1/5/2024,SAC vs TOR,Jakob Poeltl,poeltja01,35,TOR,0,SAC,14,6,2,0,3,3,22.51666667,1,5,7,10,0,0,0,0,6,3,8,16,20,22,30.2
2023-24,202401050DAL,1/5/2024,DAL vs POR,Jerami Grant,grantje01,30,POR,0,DAL,18,1,3,3,1,1,22.55,0,1,6,11,2,3,4,5,1,4,4,21,19,22,34.7
2023-24,202401050NOP,1/5/2024,NOP vs LAC,Jonas Valanciunas,valanjo01,36,NOP,1,LAC,13,11,1,0,1,3,22.61666667,4,7,6,12,1,1,0,0,2,1,12,14,24,25,27.7
2023-24,202401050CHI,1/5/2024,CHI vs CHO,Brandon Miller,millebr02,29,CHO,0,CHI,9,3,1,1,0,0,22.76666667,0,3,3,13,1,7,2,2,3,1,4,10,12,13,17.1
2023-24,202401050GSW,1/5/2024,GSW vs DET,Trayce Jackson-Davis,jackstr02,25,GSW,1,DET,11,9,0,0,1,2,22.8,2,7,5,5,0,0,1,1,2,1,9,11,20,20,22.8
2023-24,202401050IND,1/5/2024,IND vs ATL,T.J. McConnell,mccontj01,27,IND,1,ATL,10,3,10,3,0,1,22.8,2,1,5,6,0,0,0,0,2,3,13,20,13,23,36.6
2023-24,202401050IND,1/5/2024,IND vs ATL,Jalen Smith,smithja04,22,IND,1,ATL,11,2,2,0,0,0,22.93333333,0,2,5,7,1,3,0,0,2,0,4,13,13,15,16.4
2023-24,202401050PHO,1/5/2024,PHO vs MIA,Kyle Lowry,lowryky01,31,MIA,0,PHO,6,3,4,0,0,4,22.98333333,1,2,2,7,2,6,0,0,2,0,7,10,9,13,11.6
2023-24,202401050DAL,1/5/2024,DAL vs POR,Anfernee Simons,simonan01,13,POR,0,DAL,6,5,4,0,0,2,23.05,0,5,1,8,1,4,3,3,1,0,9,10,11,15,16
2023-24,202401050CHI,1/5/2024,CHI vs CHO,Andre Drummond,drumman01,37,CHI,1,CHO,7,10,0,1,3,2,23.08333333,3,7,3,7,0,0,1,2,1,4,10,7,17,17,29
2023-24,202401050GSW,1/5/2024,GSW vs DET,Kevin Knox,knoxke01,17,DET,0,GSW,18,1,3,1,2,0,23.13333333,0,1,7,13,4,8,0,0,3,3,4,21,19,22,32.7
2023-24,202401050BOS,1/5/2024,BOS vs UTA,Payton Pritchard,pritcpa01,34,BOS,1,UTA,7,2,4,1,0,3,23.16666667,1,1,3,10,1,7,0,0,3,1,6,11,9,13,15.4
2023-24,202401050CLE,1/5/2024,CLE vs WAS,Jordan Poole,poolejo01,33,WAS,0,CLE,2,0,1,0,1,0,23.33333333,0,0,0,4,0,2,2,2,4,1,1,3,2,3,6.5
2023-24,202401050IND,1/5/2024,IND vs ATL,Bogdan Bogdanovic,bogdabo01,32,ATL,0,IND,16,4,3,2,0,3,23.36666667,0,4,3,14,1,9,9,10,2,2,7,19,20,23,28.3
2023-24,202401050BOS,1/5/2024,BOS vs UTA,Lauri Markkanen,markkla01,26,UTA,0,BOS,17,5,5,0,0,0,23.4,4,1,7,16,2,7,1,2,1,0,10,22,22,27,30.5
2023-24,202401050NOP,1/5/2024,NOP vs LAC,Ivica Zubac,zubaciv01,34,LAC,0,NOP,15,8,2,0,2,1,23.41666667,0,8,6,7,0,0,3,4,3,2,10,17,23,25,32.6
2023-24,202401050BRK,1/5/2024,BRK vs OKC,Cason Wallace,wallaca01,34,OKC,0,BRK,8,2,0,1,0,0,23.46666667,1,1,3,7,2,4,0,0,1,1,2,8,10,10,13.4
2023-24,202401050BOS,1/5/2024,BOS vs UTA,Sam Hauser,hausesa01,34,BOS,1,UTA,13,5,1,1,0,0,23.48333333,1,4,5,10,3,7,0,0,1,1,6,14,18,19,23.5
2023-24,202401050BOS,1/5/2024,BOS vs UTA,Jrue Holiday,holidjr01,31,BOS,1,UTA,14,6,1,0,2,2,23.53333333,1,5,6,8,2,3,0,0,1,2,7,15,20,21,26.7
2023-24,202401050GSW,1/5/2024,GSW vs DET,Chris Paul,paulch01,32,GSW,1,DET,8,6,4,0,1,1,23.53333333,0,6,3,5,2,4,0,1,2,1,10,12,14,18,23.2
2023-24,202401050BRK,1/5/2024,BRK vs OKC,Josh Giddey,giddejo01,33,OKC,0,BRK,13,8,5,1,1,2,23.6,0,8,5,9,0,1,3,4,3,2,13,18,21,26,34.1
2023-24,202401050PHI,1/5/2024,PHI vs NYK,Quentin Grimes,grimequ01,32,NYK,0,PHI,19,8,2,1,1,1,23.61666667,2,6,6,13,4,9,3,3,3,2,10,21,27,29,36.6
2023-24,202401050DAL,1/5/2024,DAL vs POR,Shaedon Sharpe,sharpsh01,29,POR,0,DAL,15,5,2,0,1,2,23.68333333,1,4,5,15,1,6,4,4,2,1,7,17,20,22,25
2023-24,202401050GSW,1/5/2024,GSW vs DET,Jaden Ivey,iveyja01,31,DET,0,GSW,12,4,3,0,1,4,23.91666667,2,2,5,10,2,5,0,0,6,1,7,15,16,19,20.3
2023-24,202401050PHI,1/5/2024,PHI vs NYK,Tobias Harris,harrito02,34,PHI,1,NYK,5,3,4,0,0,0,24.05,0,3,2,6,1,2,0,1,2,0,7,9,8,12,14.6
2023-24,202401050DEN,1/5/2024,DEN vs ORL,Caleb Houstan,houstca01,26,ORL,0,DEN,8,0,1,0,0,0,24.08333333,0,0,3,6,2,5,0,2,3,0,1,9,8,9,9.5
2023-24,202401050CLE,1/5/2024,CLE vs WAS,Daniel Gafford,gaffoda01,31,WAS,0,CLE,4,4,1,0,1,0,24.2,0,4,1,2,0,0,2,2,2,1,5,5,8,9,13.3
2023-24,202401050DAL,1/5/2024,DAL vs POR,Toumani Camara,camarto01,33,POR,0,DAL,10,7,1,1,0,2,24.21666667,1,6,4,10,2,7,0,1,2,1,8,11,17,18,20.9
2023-24,202401050PHO,1/5/2024,PHO vs MIA,Nikola Jovic,jovicni01,9,MIA,0,PHO,3,4,1,0,0,0,24.26666667,1,3,1,3,1,3,0,0,0,0,5,4,7,8,9.3
2023-24,202401050BRK,1/5/2024,BRK vs OKC,Cam Thomas,thomaca02,27,BRK,1,OKC,19,2,0,1,0,1,24.35,0,2,6,14,3,5,4,5,0,1,2,19,21,21,23.4
2023-24,202401050PHO,1/5/2024,PHO vs MIA,Josh Okogie,okogijo01,29,PHO,1,MIA,7,2,4,3,2,0,24.41666667,1,1,0,2,0,1,7,8,5,5,6,11,9,13,30.4
2023-24,202401050GSW,1/5/2024,GSW vs DET,Brandin Podziemski,podzibr01,29,GSW,1,DET,11,5,5,1,0,1,24.63333333,2,3,4,7,2,2,1,3,2,1,10,16,16,21,26.5
2023-24,202401050BOS,1/5/2024,BOS vs UTA,Jayson Tatum,tatumja01,32,BOS,1,UTA,30,9,5,1,1,1,24.63333333,0,9,6,12,5,8,13,14,1,2,14,35,39,44,53.3
2023-24,202401050BRK,1/5/2024,BRK vs OKC,Dennis Smith Jr.,smithde03,21,BRK,1,OKC,13,12,7,2,0,0,24.65,6,6,6,11,1,4,0,0,4,2,19,20,25,32,43.9
2023-24,202401050CLE,1/5/2024,CLE vs WAS,Georges Niang,niangge01,35,CLE,1,WAS,14,9,1,0,0,1,24.7,0,9,5,9,4,8,0,0,2,0,10,15,23,24,25.3
2023-24,202401050HOU,1/5/2024,HOU vs MIN,Naz Reid,reidna01,34,MIN,0,HOU,16,7,2,0,1,0,24.76666667,1,6,6,11,3,6,1,2,1,1,9,18,23,25,30.4
2023-24,202401050BOS,1/5/2024,BOS vs UTA,Simone Fontecchio,fontesi01,34,UTA,0,BOS,7,4,3,1,0,2,24.81666667,1,3,2,7,2,5,1,2,2,1,7,10,11,14,17.3
2023-24,202401050DAL,1/5/2024,DAL vs POR,A.J. Lawson,lawsoaj01,15,DAL,1,POR,14,5,2,2,0,2,24.86666667,1,4,4,8,1,4,5,6,5,2,7,16,19,21,27
2023-24,202401050CHI,1/5/2024,CHI vs CHO,Nikola Vucevic,vucevni01,32,CHI,1,CHO,11,7,3,0,0,1,24.91666667,0,7,5,12,1,5,0,0,3,0,10,14,18,21,22.9
2023-24,202401050HOU,1/5/2024,HOU vs MIN,Mike Conley,conlemi01,34,MIN,0,HOU,8,2,5,0,0,0,25,0,2,3,8,2,5,0,0,3,0,7,13,10,15,17.9
2023-24,202401050NOP,1/5/2024,NOP vs LAC,Norman Powell,powelno01,34,LAC,0,NOP,13,3,2,1,0,0,25,0,3,5,13,3,6,0,0,1,1,5,15,16,18,22.6
2023-24,202401050IND,1/5/2024,IND vs ATL,Tyrese Haliburton,halibty01,32,IND,1,ATL,10,8,18,2,1,2,25.2,1,7,4,6,2,4,0,0,1,3,26,28,18,36,53.6
2023-24,202401050NOP,1/5/2024,NOP vs LAC,Herbert Jones,joneshe01,33,NOP,1,LAC,9,0,2,1,1,0,25.25,0,0,3,6,1,2,2,2,1,2,2,11,9,11,18
2023-24,202401050DAL,1/5/2024,DAL vs POR,Josh Green,greenjo02,24,DAL,1,POR,14,5,5,1,0,1,25.31666667,2,3,7,8,0,0,0,0,0,1,10,19,19,24,29.5
2023-24,202401050CLE,1/5/2024,CLE vs WAS,Kyle Kuzma,kuzmaky01,34,WAS,0,CLE,9,2,2,1,0,7,25.46666667,1,1,4,14,1,4,0,0,2,1,4,11,11,13,10.4
2023-24,202401050CLE,1/5/2024,CLE vs WAS,Donovan Mitchell,mitchdo01,26,CLE,1,WAS,26,2,4,1,0,3,25.51666667,1,1,8,15,5,8,5,8,2,1,6,30,28,32,34.4
2023-24,202401050DAL,1/5/2024,DAL vs POR,Dwight Powell,poweldw01,33,DAL,1,POR,6,9,3,1,1,2,25.73333333,2,7,2,4,0,0,2,4,0,2,12,9,15,18,25.3
2023-24,202401050BOS,1/5/2024,BOS vs UTA,Kris Dunn,dunnkr01,28,UTA,0,BOS,2,5,5,3,1,1,25.81666667,2,3,1,7,0,1,0,0,4,4,10,7,7,12,26.5
2023-24,202401050CLE,1/5/2024,CLE vs WAS,Deni Avdija,avdijde01,34,WAS,0,CLE,13,5,4,2,1,3,25.86666667,0,5,5,8,0,1,3,4,4,3,9,17,18,22,31
2023-24,202401050CLE,1/5/2024,CLE vs WAS,Tyus Jones,jonesty01,34,WAS,0,CLE,16,1,5,2,0,1,26.18333333,0,1,6,10,4,6,0,0,0,2,6,21,17,22,29.7
2023-24,202401050NOP,1/5/2024,NOP vs LAC,Dyson Daniels,daniedy01,36,NOP,1,LAC,2,3,3,4,0,0,26.2,0,3,1,4,0,1,0,2,1,4,6,5,5,8,22.1
2023-24,202401050BOS,1/5/2024,BOS vs UTA,Derrick White,whitede01,31,BOS,1,UTA,10,7,3,1,1,0,26.2,0,7,3,9,2,7,2,2,2,2,10,13,17,20,28.9
2023-24,202401050PHO,1/5/2024,PHO vs MIA,Jusuf Nurkic,nurkiju01,33,PHO,1,MIA,6,9,2,1,0,0,26.3,1,8,3,6,0,1,0,0,2,1,11,8,15,17,22.8
2023-24,202401050CLE,1/5/2024,CLE vs WAS,Sam Merrill,merrisa01,20,CLE,1,WAS,11,2,2,1,0,0,26.4,0,2,4,12,3,9,0,0,2,1,4,13,13,15,19.4
2023-24,202401050PHO,1/5/2024,PHO vs MIA,Duncan Robinson,robindu01,33,MIA,0,PHO,4,1,3,1,1,3,26.51666667,0,1,1,7,1,6,1,2,3,2,4,7,5,8,12.7
2023-24,202401050DAL,1/5/2024,DAL vs POR,Tim Hardaway Jr.,hardati02,33,DAL,1,POR,19,2,4,1,1,2,26.6,0,2,8,14,3,7,0,1,3,2,6,23,21,25,31.4
2023-24,202401050DAL,1/5/2024,DAL vs POR,Duop Reath,reathdu01,22,POR,0,DAL,16,7,2,0,0,3,26.88333333,4,3,7,12,1,3,1,2,3,0,9,18,23,25,24.4
2023-24,202401050BOS,1/5/2024,BOS vs UTA,Jaylen Brown,brownja02,32,BOS,1,UTA,13,3,5,1,1,3,26.9,0,3,5,12,2,4,1,2,2,2,8,18,16,21,27.1
2023-24,202401050BOS,1/5/2024,BOS vs UTA,Kristaps Porzingis,porzikr01,25,BOS,1,UTA,19,5,2,0,1,1,26.9,0,5,4,7,1,3,10,12,3,1,7,21,24,26,30
2023-24,202401050CHI,1/5/2024,CHI vs CHO,Nick Richards,richani01,27,CHO,0,CHI,4,12,1,0,0,2,27,5,7,2,6,0,0,0,2,4,0,13,5,16,17,17.9
2023-24,202401050SAC,1/5/2024,SAC vs TOR,RJ Barrett,barrerj01,29,TOR,0,SAC,14,4,2,0,1,0,27.21666667,1,3,4,8,2,4,4,4,2,1,6,16,18,20,24.8
2023-24,202401050CLE,1/5/2024,CLE vs WAS,Caris LeVert,leverca01,27,CLE,1,WAS,11,4,11,2,0,2,27.46666667,0,4,3,7,1,2,4,4,0,2,15,22,15,26,36.3
2023-24,202401050SAC,1/5/2024,SAC vs TOR,Chris Boucher,bouchch01,32,TOR,0,SAC,14,9,1,1,1,0,27.68333333,3,6,5,9,1,5,3,5,2,2,10,15,23,24,32.3
2023-24,202401050IND,1/5/2024,IND vs ATL,Trae Young,youngtr01,32,ATL,0,IND,13,2,6,2,0,3,28,0,2,4,18,1,11,4,5,2,2,8,19,15,21,27.4
2023-24,202401050BRK,1/5/2024,BRK vs OKC,Luguentz Dort,dortlu01,33,OKC,0,BRK,12,4,3,3,0,1,28.5,2,2,5,8,2,5,0,0,4,3,7,15,16,19,29.3
2023-24,202401050CLE,1/5/2024,CLE vs WAS,Jarrett Allen,allenja01,30,CLE,1,WAS,12,12,3,2,1,4,28.51666667,6,6,5,7,0,0,2,2,2,3,15,15,24,27,35.9
2023-24,202401050DEN,1/5/2024,DEN vs ORL,Chuma Okeke,okekech01,18,ORL,0,DEN,3,7,1,1,1,4,28.51666667,3,4,1,3,1,3,0,2,1,2,8,4,10,11,14.9
2023-24,202401050DAL,1/5/2024,DAL vs POR,Kyrie Irving,irvinky01,20,DAL,1,POR,24,9,5,2,2,1,28.9,0,9,10,18,3,7,1,1,0,4,14,29,33,38,53.3
2023-24,202401050PHO,1/5/2024,PHO vs MIA,Josh Richardson,richajo01,26,MIA,0,PHO,10,8,7,2,0,0,28.98333333,1,7,2,9,1,6,5,5,3,2,15,17,18,25,36.1
2023-24,202401050NOP,1/5/2024,NOP vs LAC,James Harden,hardeja01,29,LAC,0,NOP,8,3,13,0,0,1,29,0,3,2,7,1,6,3,3,2,0,16,21,11,24,30.1
2023-24,202401050DEN,1/5/2024,DEN vs ORL,Kentavious Caldwell-Pope,caldwke01,35,DEN,1,ORL,6,3,2,1,1,3,29.01666667,1,2,1,4,0,3,4,4,1,2,5,8,9,11,15.6
2023-24,202401050IND,1/5/2024,IND vs ATL,Jalen Johnson,johnsja05,20,ATL,0,IND,12,8,3,1,0,0,29.03333333,1,7,5,11,1,4,1,1,1,1,11,15,20,23,29.1
2023-24,202401050LAL,1/5/2024,LAL vs MEM,Jaren Jackson Jr.,jacksja02,35,MEM,0,LAL,31,9,1,0,3,3,29.5,0,9,11,14,5,6,4,4,5,3,10,32,40,41,49.3
2023-24,202401050PHI,1/5/2024,PHI vs NYK,Josh Hart,hartjo01,35,NYK,0,PHI,10,15,6,0,1,2,29.58333333,3,12,4,7,0,2,2,2,2,1,21,16,25,31,38
2023-24,202401050NOP,1/5/2024,NOP vs LAC,Kawhi Leonard,leonaka01,30,LAC,0,NOP,19,9,2,1,1,2,29.58333333,2,7,7,15,2,4,3,4,1,2,11,21,28,30,36.8
2023-24,202401050NOP,1/5/2024,NOP vs LAC,Paul George,georgpa01,32,LAC,0,NOP,24,7,1,0,1,2,29.65,0,7,9,15,6,10,0,0,2,1,8,25,31,32,34.9
2023-24,202401050HOU,1/5/2024,HOU vs MIN,Jaden McDaniels,mcdanja02,24,MIN,0,HOU,16,3,0,1,0,0,29.78333333,0,3,7,10,2,3,0,0,1,1,3,16,19,19,22.6
2023-24,202401050CHI,1/5/2024,CHI vs CHO,Zach LaVine,lavinza01,19,CHI,1,CHO,15,5,4,0,0,2,29.91666667,0,5,6,11,1,5,2,3,1,0,9,19,20,24,25
2023-24,202401050IND,1/5/2024,IND vs ATL,Saddiq Bey,beysa01,34,ATL,0,IND,9,4,2,0,0,1,30.1,3,1,2,7,1,6,4,4,1,0,6,11,13,15,15.8
2023-24,202401050PHI,1/5/2024,PHI vs NYK,Julius Randle,randlju01,35,NYK,0,PHI,8,7,5,1,1,4,30.1,0,7,1,11,0,3,6,6,3,2,12,13,15,20,25.9
2023-24,202401050CLE,1/5/2024,CLE vs WAS,Max Strus,strusma01,35,CLE,1,WAS,9,5,3,0,0,3,30.15,0,5,4,6,1,3,0,0,1,0,8,12,14,17,16.5
2023-24,202401050NOP,1/5/2024,NOP vs LAC,Brandon Ingram,ingrabr01,33,NOP,1,LAC,12,1,4,0,0,2,30.46666667,0,1,3,9,0,1,6,7,2,0,5,16,13,17,17.2
2023-24,202401050HOU,1/5/2024,HOU vs MIN,Jalen Green,greenja05,33,HOU,1,MIN,20,5,2,0,0,2,30.7,1,4,7,16,4,8,2,4,1,0,7,22,25,27,27
2023-24,202401050DEN,1/5/2024,DEN vs ORL,Trevelin Queen,queentr01,3,ORL,0,DEN,5,5,2,2,1,0,30.75,1,4,2,4,0,1,1,1,4,3,7,7,10,12,23
2023-24,202401050GSW,1/5/2024,GSW vs DET,Stephen Curry,curryst01,33,GSW,1,DET,26,6,4,1,1,4,30.93333333,0,6,7,19,4,12,8,9,0,2,10,30,32,36,41.2
2023-24,202401050DEN,1/5/2024,DEN vs ORL,Michael Porter Jr.,portemi01,37,DEN,1,ORL,22,3,1,2,0,0,30.95,0,3,9,14,4,6,0,0,2,2,4,23,25,26,33.1
2023-24,202401050HOU,1/5/2024,HOU vs MIN,Fred VanVleet,vanvlfr01,32,HOU,1,MIN,7,1,8,1,1,1,30.96666667,0,1,2,9,2,5,1,1,0,2,9,15,8,16,25.2
2023-24,202401050PHI,1/5/2024,PHI vs NYK,Kelly Oubre Jr.,oubreke01,23,PHI,1,NYK,15,7,1,0,3,3,30.98333333,2,5,6,12,3,6,0,0,2,3,8,16,22,23,30.9
2023-24,202401050DEN,1/5/2024,DEN vs ORL,Cole Anthony,anthoco01,34,ORL,0,DEN,23,2,4,1,0,3,31.03333333,0,2,8,15,3,8,4,4,2,1,6,27,25,29,31.4
2023-24,202401050NOP,1/5/2024,NOP vs LAC,CJ McCollum,mccolcj01,23,NOP,1,LAC,12,6,3,1,0,1,31.18333333,1,5,4,13,4,9,0,0,3,1,9,15,18,21,25.7
2023-24,202401050LAL,1/5/2024,LAL vs MEM,Bismack Biyombo,biyombi01,28,MEM,0,LAL,6,10,1,0,0,2,31.25,1,9,3,3,0,0,0,0,2,0,11,7,16,17,17.5
2023-24,202401050HOU,1/5/2024,HOU vs MIN,Karl-Anthony Towns,townska01,33,MIN,0,HOU,22,8,6,0,1,4,31.33333333,2,6,8,17,1,4,5,5,2,1,14,28,30,36,39.6
2023-24,202401050SAC,1/5/2024,SAC vs TOR,Malik Monk,monkma01,33,SAC,1,TOR,15,1,9,1,0,1,31.9,0,1,6,16,3,9,0,1,4,1,10,24,16,25,31.7
2023-24,202401050SAC,1/5/2024,SAC vs TOR,Dennis Schroder,schrode01,35,TOR,0,SAC,18,2,3,1,1,0,31.9,1,1,7,11,0,4,4,5,1,2,5,21,20,23,30.9
2023-24,202401050LAL,1/5/2024,LAL vs MEM,Cam Reddish,reddica01,30,LAL,1,MEM,8,2,0,1,0,0,32,1,1,3,8,2,3,0,0,0,1,2,8,10,10,13.4
2023-24,202401050BRK,1/5/2024,BRK vs OKC,Cameron Johnson,johnsca02,28,BRK,1,OKC,9,3,2,1,0,0,32.13333333,1,2,3,15,3,10,0,0,4,1,5,11,12,14,18.6
2023-24,202401050PHI,1/5/2024,PHI vs NYK,Jalen Brunson,brunsja01,35,NYK,0,PHI,29,3,2,1,1,0,32.38333333,0,3,11,20,4,9,3,3,1,2,5,31,32,34,41.6
2023-24,202401050HOU,1/5/2024,HOU vs MIN,Jabari Smith Jr.,smithja05,32,HOU,1,MIN,16,9,2,0,0,4,32.41666667,1,8,6,13,3,5,1,2,3,0,11,18,25,27,25.8
2023-24,202401050DAL,1/5/2024,DAL vs POR,Jaden Hardy,hardyja02,31,DAL,1,POR,19,9,9,1,0,4,32.48333333,2,7,8,14,3,7,0,0,2,1,18,28,28,37,42.3
2023-24,202401050HOU,1/5/2024,HOU vs MIN,Anthony Edwards,edwaran01,31,MIN,0,HOU,24,3,5,2,0,5,32.55,0,3,8,17,2,5,6,6,2,2,8,29,27,32,36.1
2023-24,202401050GSW,1/5/2024,GSW vs DET,Jalen Duren,durenja01,20,DET,0,GSW,13,12,2,0,2,1,32.76666667,4,8,6,6,0,0,1,2,2,2,14,15,25,27,35.4
2023-24,202401050HOU,1/5/2024,HOU vs MIN,Rudy Gobert,goberru01,34,MIN,0,HOU,13,12,1,2,2,1,32.96666667,3,9,6,7,0,0,1,3,2,4,13,14,25,26,39.9
2023-24,202401050BRK,1/5/2024,BRK vs OKC,Spencer Dinwiddie,dinwisp01,34,BRK,1,OKC,23,3,4,0,1,2,33.03333333,0,3,7,12,3,7,6,6,3,1,7,27,26,30,33.6
2023-24,202401050DAL,1/5/2024,DAL vs POR,Scoot Henderson,hendesc01,25,POR,0,DAL,17,3,10,1,0,1,33.21666667,1,2,7,15,3,7,0,0,0,1,13,27,20,30,37.6
2023-24,202401050HOU,1/5/2024,HOU vs MIN,Alperen Sengun,sengual01,33,HOU,1,MIN,19,5,1,0,0,2,33.33333333,1,4,8,17,0,1,3,3,3,0,6,20,24,25,24.5
2023-24,202401050DEN,1/5/2024,DEN vs ORL,Jamal Murray,murraja01,23,DEN,1,ORL,20,7,9,1,0,3,33.35,1,6,9,23,0,6,2,2,3,1,16,29,27,36,41.9
2023-24,202401050DEN,1/5/2024,DEN vs ORL,Jalen Suggs,suggsja01,31,ORL,0,DEN,27,4,1,0,1,2,33.88333333,2,2,9,15,7,9,2,4,3,1,5,28,31,32,34.3
2023-24,202401050SAC,1/5/2024,SAC vs TOR,Harrison Barnes,barneha02,34,SAC,1,TOR,16,4,2,0,0,1,33.9,3,1,5,12,5,8,1,2,3,0,6,18,20,22,22.8
2023-24,202401050BRK,1/5/2024,BRK vs OKC,Nic Claxton,claxtni01,26,BRK,1,OKC,23,13,3,1,0,3,33.91666667,8,5,8,11,0,0,7,10,1,1,16,26,36,39,43.1
2023-24,202401050IND,1/5/2024,IND vs ATL,Dejounte Murray,murrade01,34,ATL,0,IND,30,1,2,0,0,1,34.33333333,0,1,13,19,2,3,2,2,0,0,3,32,31,33,33.2
2023-24,202401050SAC,1/5/2024,SAC vs TOR,Keegan Murray,murrake02,30,SAC,1,TOR,18,12,1,1,0,3,34.51666667,3,9,6,11,4,4,2,4,1,1,13,19,30,31,33.9
2023-24,202401050LAL,1/5/2024,LAL vs MEM,Ja Morant,moranja01,9,MEM,0,LAL,21,7,7,1,1,2,34.61666667,2,5,7,17,3,7,4,5,3,2,14,28,28,35,43.9
2023-24,202401050PHO,1/5/2024,PHO vs MIA,Devin Booker,bookede01,26,PHO,1,MIA,20,5,10,2,0,3,34.68333333,0,5,9,19,2,7,0,0,2,2,15,30,25,35,44
2023-24,202401050GSW,1/5/2024,GSW vs DET,Klay Thompson,thompkl01,34,GSW,1,DET,19,3,4,1,2,2,34.71666667,1,2,6,18,3,9,4,4,2,3,7,23,22,26,35.6
2023-24,202401050LAL,1/5/2024,LAL vs MEM,Taurean Prince,princta02,35,LAL,1,MEM,10,2,2,2,1,1,34.88333333,1,1,3,9,3,7,1,2,3,3,4,12,12,14,23.4
2023-24,202401050BRK,1/5/2024,BRK vs OKC,Chet Holmgren,holmgch01,34,OKC,0,BRK,17,6,3,1,1,1,34.98333333,3,3,8,15,0,4,1,2,3,2,9,20,23,26,33.7
2023-24,202401050SAC,1/5/2024,SAC vs TOR,Scottie Barnes,barnesc01,35,TOR,0,SAC,20,4,6,1,2,5,35.05,0,4,8,15,4,8,0,0,2,3,10,26,24,30,37.8
2023-24,202401050PHO,1/5/2024,PHO vs MIA,Tyler Herro,herroty01,17,MIA,0,PHO,9,4,6,0,0,1,35.15,0,4,4,17,1,7,0,0,2,0,10,15,13,19,21.8
2023-24,202401050PHI,1/5/2024,PHI vs NYK,Isaiah Hartenstein,harteis01,35,NYK,0,PHI,17,6,5,2,2,1,35.45,1,5,8,9,0,0,1,2,4,4,11,22,23,28,42.7
2023-24,202401050PHO,1/5/2024,PHO vs MIA,Jaime Jaquez Jr.,jaqueja01,35,MIA,0,PHO,10,3,1,2,0,3,35.46666667,1,2,5,7,0,2,0,0,4,2,4,11,13,14,18.1
2023-24,202401050GSW,1/5/2024,GSW vs DET,Cade Cunningham,cunnica01,35,DET,0,GSW,30,5,3,0,1,2,35.48333333,0,5,13,22,1,7,3,3,2,1,8,33,35,38,41.5
2023-24,202401050BRK,1/5/2024,BRK vs OKC,Jalen Williams,willija06,31,OKC,0,BRK,20,5,5,0,1,3,35.61666667,0,5,8,11,2,4,2,3,3,1,10,25,25,30,33.5
2023-24,202401050GSW,1/5/2024,GSW vs DET,Bojan Bogdanovic,bogdabo02,16,DET,0,GSW,12,5,3,2,0,1,35.63333333,2,3,5,19,2,8,0,0,0,2,8,15,17,20,27.5
2023-24,202401050GSW,1/5/2024,GSW vs DET,Jonathan Kuminga,kuminjo01,34,GSW,1,DET,11,6,1,0,0,4,35.63333333,0,6,4,8,0,1,3,3,2,0,7,12,17,18,15.7
2023-24,202401050BRK,1/5/2024,BRK vs OKC,Shai Gilgeous-Alexander,gilgesh01,33,OKC,0,BRK,34,9,6,0,0,2,35.73333333,1,8,11,19,2,5,10,15,5,0,15,40,43,49,51.8
2023-24,202401050CHI,1/5/2024,CHI vs CHO,Cody Martin,martico01,7,CHO,0,CHI,13,5,2,2,0,1,35.85,2,3,5,11,3,7,0,0,4,2,7,15,18,20,27
2023-24,202401050PHO,1/5/2024,PHO vs MIA,Bam Adebayo,adebaba01,25,MIA,0,PHO,28,10,1,0,1,1,36.11666667,2,8,11,19,0,0,6,7,2,1,11,29,38,39,43.5
2023-24,202401050CLE,1/5/2024,CLE vs WAS,Bilal Coulibaly,coulibi01,33,WAS,0,CLE,15,7,1,1,3,1,36.13333333,2,5,6,13,2,4,1,3,0,4,8,16,22,23,35.9
2023-24,202401050PHI,1/5/2024,PHI vs NYK,Joel Embiid,embiijo01,27,PHI,1,NYK,30,10,3,1,3,6,36.21666667,3,7,10,23,1,1,9,12,3,4,13,33,40,43,52.5
2023-24,202401050DEN,1/5/2024,DEN vs ORL,Aaron Gordon,gordoaa01,31,DEN,1,ORL,16,8,3,0,0,1,36.23333333,3,5,5,8,2,4,4,5,4,0,11,19,24,27,29.1
2023-24,202401050CHI,1/5/2024,CHI vs CHO,Terry Rozier,roziete01,22,CHO,0,CHI,15,4,7,1,0,3,36.4,1,3,5,17,1,7,4,4,2,1,11,22,19,26,30.3
2023-24,202401050PHI,1/5/2024,PHI vs NYK,Tyrese Maxey,maxeyty01,33,PHI,1,NYK,27,4,9,2,1,1,36.45,1,3,9,20,1,7,8,10,1,3,13,36,31,40,53.3
2023-24,202401050DEN,1/5/2024,DEN vs ORL,Nikola Jokic,jokicni01,36,DEN,1,ORL,29,4,8,3,0,2,36.85,0,4,13,19,0,1,3,4,3,3,12,37,33,41,52.8
2023-24,202401050PHO,1/5/2024,PHO vs MIA,Bradley Beal,bealbr01,11,PHO,1,MIA,25,8,9,0,0,2,36.96666667,1,7,11,18,2,6,1,1,2,0,17,34,33,42,46.1
2023-24,202401050LAL,1/5/2024,LAL vs MEM,Desmond Bane,banede01,34,MEM,0,LAL,24,5,13,1,0,3,37,0,5,8,14,5,8,3,4,2,1,18,37,29,42,49.5
2023-24,202401050PHO,1/5/2024,PHO vs MIA,Grayson Allen,allengr01,30,PHO,1,MIA,31,4,4,0,2,2,37.05,1,3,11,19,9,14,0,0,4,2,8,35,35,39,45.8
2023-24,202401050PHI,1/5/2024,PHI vs NYK,OG Anunoby,anunoog01,30,NYK,0,PHI,11,2,0,1,0,0,37.35,1,1,3,11,1,3,4,4,3,1,2,11,13,13,16.4
2023-24,202401050SAC,1/5/2024,SAC vs TOR,Pascal Siakam,siakapa01,35,TOR,0,SAC,18,4,9,2,1,2,37.41666667,1,3,6,11,0,0,6,7,3,3,13,27,22,31,43.3
2023-24,202401050SAC,1/5/2024,SAC vs TOR,De'Aaron Fox,foxde01,28,SAC,1,TOR,24,2,4,2,1,2,37.48333333,1,1,10,20,1,3,3,3,4,3,6,28,26,30,39.4
2023-24,202401050SAC,1/5/2024,SAC vs TOR,Immanuel Quickley,quickim01,33,TOR,0,SAC,20,5,8,0,0,3,37.5,0,5,6,17,4,12,4,4,1,0,13,28,25,33,35
2023-24,202401050CHI,1/5/2024,CHI vs CHO,DeMar DeRozan,derozde01,35,CHI,1,CHO,17,1,6,3,0,3,37.51666667,0,1,6,10,0,2,5,5,4,3,7,23,18,24,33.2
2023-24,202401050DEN,1/5/2024,DEN vs ORL,Moritz Wagner,wagnemo01,35,ORL,0,DEN,19,11,3,2,0,0,37.81666667,3,8,8,14,2,4,1,2,4,2,14,22,30,33,42.7
2023-24,202401050SAC,1/5/2024,SAC vs TOR,Domantas Sabonis,sabondo01,34,SAC,1,TOR,24,15,11,0,0,6,38.56666667,4,11,11,16,0,0,2,3,6,0,26,35,39,50,52.5
2023-24,202401050LAL,1/5/2024,LAL vs MEM,LeBron James,jamesle01,34,LAL,1,MEM,32,5,7,5,0,4,38.83333333,2,3,11,24,4,9,6,10,0,5,12,39,37,44,59.5
2023-24,202401050LAL,1/5/2024,LAL vs MEM,Marcus Smart,smartma01,18,MEM,0,LAL,29,2,5,1,0,3,39.15,1,1,9,16,8,14,3,4,2,1,7,34,31,36,38.9
2023-24,202401050BRK,1/5/2024,BRK vs OKC,Mikal Bridges,bridgmi01,36,BRK,1,OKC,17,8,3,0,1,4,39.16666667,1,7,5,13,0,5,7,8,4,1,11,20,25,28,30.1
2023-24,202401050CHI,1/5/2024,CHI vs CHO,Coby White,whiteco01,37,CHI,1,CHO,22,10,6,0,0,5,39.83333333,1,9,7,12,3,6,5,6,1,0,16,28,32,38,38
2023-24,202401050LAL,1/5/2024,LAL vs MEM,Austin Reaves,reaveau01,37,LAL,1,MEM,19,7,12,2,0,1,40,0,7,8,14,0,3,3,4,4,2,19,31,26,38,50.4
2023-24,202401050CHI,1/5/2024,CHI vs CHO,Ayo Dosunmu,dosunay01,35,CHI,1,CHO,12,5,4,1,2,0,40.15,0,5,5,9,2,3,0,0,2,3,9,16,17,21,33
2023-24,202401050DEN,1/5/2024,DEN vs ORL,Paolo Banchero,banchpa01,35,ORL,0,DEN,32,10,11,3,0,5,40.68333333,1,9,8,21,1,4,15,19,2,3,21,43,42,53,64.5
2023-24,202401050LAL,1/5/2024,LAL vs MEM,Anthony Davis,davisan02,35,LAL,1,MEM,31,6,4,0,2,4,40.96666667,3,3,13,22,0,3,5,7,4,2,10,35,37,41,46.2
2023-24,202401050CHI,1/5/2024,CHI vs CHO,Miles Bridges,bridgmi02,22,CHO,0,CHI,28,5,2,0,0,2,41.96666667,0,5,12,18,3,7,1,2,1,0,7,30,33,35,35
2023-24,202401040SAS,1/4/2024,SAS vs MIL,Dominick Barlow,barlodo01,12,SAS,1,MIL,6,1,4,1,2,0,14.78333333,0,1,3,3,0,0,0,0,1,3,5,10,7,11,22.2
2023-24,202401040SAS,1/4/2024,SAS vs MIL,Blake Wesley,weslebl01,13,SAS,1,MIL,0,1,1,0,0,0,14.93333333,0,1,0,1,0,0,0,0,3,0,2,1,1,2,2.7
2023-24,202401040SAS,1/4/2024,SAS vs MIL,Cameron Payne,payneca01,35,MIL,0,SAS,5,1,4,0,0,0,15.31666667,0,1,0,3,0,3,5,5,1,0,5,9,6,10,12.2
2023-24,202401040SAS,1/4/2024,SAS vs MIL,Khris Middleton,middlkh01,30,MIL,0,SAS,12,3,5,1,0,1,15.48333333,0,3,5,8,2,3,0,0,0,1,8,17,15,20,25.1
2023-24,202401040GSW,1/4/2024,GSW vs DEN,Reggie Jackson,jacksre01,36,DEN,0,GSW,2,0,3,0,0,1,15.95,0,0,1,6,0,0,0,0,0,0,3,5,2,5,5.5
2023-24,202401040SAS,1/4/2024,SAS vs MIL,MarJon Beauchamp,beaucma01,30,MIL,0,SAS,8,3,0,0,0,1,17.3,2,1,3,8,2,4,0,0,1,0,3,8,11,11,10.6
2023-24,202401040GSW,1/4/2024,GSW vs DEN,Christian Braun,braunch01,36,DEN,0,GSW,2,0,1,1,1,1,18.46666667,0,0,1,4,0,2,0,0,3,2,1,3,2,3,8.5
2023-24,202401040GSW,1/4/2024,GSW vs DEN,Jonathan Kuminga,kuminjo01,33,GSW,1,DEN,16,4,4,0,0,1,18.95,1,3,5,7,0,1,6,7,1,0,8,20,20,24,25.8
2023-24,202401040GSW,1/4/2024,GSW vs DEN,Peyton Watson,watsope01,34,DEN,0,GSW,19,5,0,0,0,0,19.2,1,4,6,10,2,4,5,6,1,0,5,19,24,24,25
2023-24,202401040GSW,1/4/2024,GSW vs DEN,Trayce Jackson-Davis,jackstr02,24,GSW,1,DEN,4,2,2,0,0,2,20.53333333,2,0,2,4,0,0,0,0,4,0,4,6,6,8,7.4
2023-24,202401040SAS,1/4/2024,SAS vs MIL,Bobby Portis,portibo01,35,MIL,0,SAS,5,4,0,0,1,2,20.73333333,1,3,2,6,0,2,1,2,3,1,4,5,9,9,10.8
2023-24,202401040SAS,1/4/2024,SAS vs MIL,Julian Champagnie,champju02,27,SAS,1,MIL,0,0,2,1,0,0,20.9,0,0,0,4,0,2,0,0,0,1,2,2,0,2,6
2023-24,202401040GSW,1/4/2024,GSW vs DEN,Kevon Looney,looneke01,34,GSW,1,DEN,7,4,3,0,0,0,22.33333333,2,2,3,4,0,0,1,1,5,0,7,10,11,14,16.3
2023-24,202401040GSW,1/4/2024,GSW vs DEN,Dario Saric,saricda01,34,GSW,1,DEN,13,7,6,1,0,2,22.71666667,1,6,5,7,1,2,2,2,1,1,13,19,20,26,31.4
2023-24,202401040SAS,1/4/2024,SAS vs MIL,Victor Wembanyama,wembavi01,30,SAS,1,MIL,27,9,1,1,5,5,26.18333333,3,6,10,18,2,8,5,6,5,6,10,28,36,37,52.3
2023-24,202401040SAS,1/4/2024,SAS vs MIL,Malik Beasley,beaslma01,33,MIL,0,SAS,10,2,0,0,0,2,26.58333333,0,2,4,6,2,4,0,0,0,0,2,10,12,12,10.4
2023-24,202401040GSW,1/4/2024,GSW vs DEN,Andrew Wiggins,wiggian01,30,GSW,1,DEN,11,3,0,0,1,1,27.26666667,2,1,5,10,1,4,0,0,2,1,3,11,14,14,16.6
2023-24,202401040SAS,1/4/2024,SAS vs MIL,Cedi Osman,osmande01,34,SAS,1,MIL,13,2,5,3,0,1,28.15,0,2,4,7,3,6,2,3,3,3,7,18,15,20,30.9
2023-24,202401040GSW,1/4/2024,GSW vs DEN,Brandin Podziemski,podzibr01,28,GSW,1,DEN,13,2,5,1,0,0,28.25,0,2,5,10,3,4,0,0,2,1,7,18,15,20,25.9
2023-24,202401040SAS,1/4/2024,SAS vs MIL,Pat Connaughton,connapa01,29,MIL,0,SAS,7,6,0,1,0,3,28.33333333,1,5,2,4,2,4,1,2,0,1,6,7,13,13,14.2
2023-24,202401040SAS,1/4/2024,SAS vs MIL,Keldon Johnson,johnske04,32,SAS,1,MIL,14,10,1,0,0,1,29.96666667,2,8,5,17,2,8,2,2,1,0,11,15,24,25,26.5
2023-24,202401040GSW,1/4/2024,GSW vs DEN,Chris Paul,paulch01,31,GSW,1,DEN,9,4,6,0,0,0,30.23333333,1,3,4,7,1,3,0,1,2,0,10,15,13,19,22.8
2023-24,202401040GSW,1/4/2024,GSW vs DEN,Michael Porter Jr.,portemi01,36,DEN,0,GSW,8,4,0,0,0,0,30.48333333,0,4,3,6,2,5,0,0,3,0,4,8,12,12,12.8
2023-24,202401040GSW,1/4/2024,GSW vs DEN,Jamal Murray,murraja01,22,DEN,0,GSW,25,2,6,2,0,0,32.05,0,2,8,16,1,6,8,9,4,2,8,31,27,33,42.4
2023-24,202401040SAS,1/4/2024,SAS vs MIL,Jeremy Sochan,sochaje01,34,SAS,1,MIL,9,8,5,2,1,1,32.58333333,2,6,3,11,1,5,2,2,1,3,13,14,17,22,34.1
2023-24,202401040SAS,1/4/2024,SAS vs MIL,Brook Lopez,lopezbr01,35,MIL,0,SAS,9,4,1,0,3,4,33.23333333,0,4,4,10,1,5,0,0,4,3,5,10,13,14,20.3
2023-24,202401040GSW,1/4/2024,GSW vs DEN,Stephen Curry,curryst01,32,GSW,1,DEN,30,4,6,1,1,2,34.58333333,0,4,11,23,5,12,3,3,1,2,10,36,34,40,47.8
2023-24,202401040GSW,1/4/2024,GSW vs DEN,Kentavious Caldwell-Pope,caldwke01,34,DEN,0,GSW,8,3,4,1,1,1,34.76666667,1,2,4,8,0,2,0,0,0,2,7,12,11,15,22.6
2023-24,202401040SAS,1/4/2024,SAS vs MIL,Devin Vassell,vassede01,29,SAS,1,MIL,34,6,4,1,0,0,34.8,1,5,14,21,6,9,0,0,0,1,10,38,40,44,50.2
2023-24,202401040GSW,1/4/2024,GSW vs DEN,Klay Thompson,thompkl01,33,GSW,1,DEN,24,3,3,1,1,0,35.13333333,0,3,9,18,4,10,2,2,2,2,6,27,27,30,38.1
2023-24,202401040SAS,1/4/2024,SAS vs MIL,Tre Jones,jonestr01,30,SAS,1,MIL,18,5,6,1,0,3,35.16666667,2,3,7,13,0,2,4,4,2,1,11,24,23,29,33
2023-24,202401040GSW,1/4/2024,GSW vs DEN,Aaron Gordon,gordoaa01,30,DEN,0,GSW,30,9,2,0,1,0,35.2,5,4,11,17,2,4,6,7,2,1,11,32,39,41,46.8
2023-24,202401040GSW,1/4/2024,GSW vs DEN,Nikola Jokic,jokicni01,35,DEN,0,GSW,34,9,10,2,1,4,38.41666667,2,7,13,16,2,2,6,7,2,3,19,44,43,53,64.8
2023-24,202401040SAS,1/4/2024,SAS vs MIL,Damian Lillard,lillada01,33,MIL,0,SAS,25,4,10,1,0,0,38.53333333,1,3,10,19,1,6,4,4,3,1,14,35,29,39,47.8
2023-24,202401040SAS,1/4/2024,SAS vs MIL,Giannis Antetokounmpo,antetgi01,34,MIL,0,SAS,44,14,7,2,1,1,39.5,3,11,19,28,2,3,4,6,3,3,21,51,58,65,79.3
2023-24,202401030SAC,1/3/2024,SAC vs ORL,Chris Duarte,duartch01,30,SAC,1,ORL,0,0,1,1,0,2,10.4,0,0,0,3,0,1,0,0,3,1,1,1,0,1,2.5
2023-24,202401030DAL,1/3/2024,DAL vs POR,Jaden Hardy,hardyja02,30,DAL,1,POR,11,1,1,0,1,0,10.86666667,0,1,4,10,1,6,2,3,0,1,2,12,12,13,16.7
2023-24,202401030UTA,1/3/2024,UTA vs DET,Ausar Thompson,thompau01,34,DET,0,UTA,2,3,1,1,1,0,11.11666667,2,1,1,4,0,1,0,2,2,2,4,3,5,6,13.1
2023-24,202401030NYK,1/3/2024,NYK vs CHI,Precious Achiuwa,achiupr01,27,NYK,1,CHI,4,3,1,0,1,0,11.41666667,2,1,2,2,0,0,0,0,2,1,4,5,7,8,12.1
2023-24,202401030SAC,1/3/2024,SAC vs ORL,Gary Harris,harriga01,27,ORL,0,SAC,5,1,1,1,0,1,11.55,0,1,2,4,1,3,0,1,2,1,2,6,6,7,9.7
2023-24,202401030DAL,1/3/2024,DAL vs POR,Markieff Morris,morrima02,14,DAL,1,POR,3,3,1,1,0,1,12,0,3,1,3,1,1,0,0,2,1,4,4,6,7,10.1
2023-24,202401030UTA,1/3/2024,UTA vs DET,Ochai Agbaji,agbajoc01,35,UTA,1,DET,3,1,2,2,0,1,12.66666667,0,1,1,1,1,1,0,0,2,2,3,5,4,6,12.2
2023-24,202401030SAC,1/3/2024,SAC vs ORL,Moritz Wagner,wagnemo01,34,ORL,0,SAC,2,3,2,0,0,3,12.81666667,1,2,0,2,0,1,2,2,2,0,5,4,5,7,5.6
2023-24,202401030UTA,1/3/2024,UTA vs DET,Kevin Knox,knoxke01,16,DET,0,UTA,4,1,2,0,0,0,12.85,1,0,2,5,0,2,0,0,1,0,3,6,5,7,8.2
2023-24,202401030DAL,1/3/2024,DAL vs POR,Dwight Powell,poweldw01,32,DAL,1,POR,5,3,2,0,0,1,12.88333333,1,2,1,1,0,0,3,6,2,0,5,7,8,10,10.6
2023-24,202401030PHO,1/3/2024,PHO vs LAC,Amir Coffey,coffeam01,21,LAC,0,PHO,3,0,1,0,0,0,13.03333333,0,0,1,1,0,0,1,2,1,0,1,4,3,4,4.5
2023-24,202401030IND,1/3/2024,IND vs MIL,Buddy Hield,hieldbu01,34,IND,1,MIL,10,0,0,1,0,0,13.13333333,0,0,3,8,2,4,2,3,1,1,0,10,10,10,13
2023-24,202401030MEM,1/3/2024,MEM vs TOR,Chris Boucher,bouchch01,31,TOR,0,MEM,4,8,2,0,0,1,13.35,3,5,2,2,0,0,0,0,0,0,10,6,12,14,15.6
2023-24,202401030MIN,1/3/2024,MIN vs NOP,Kyle Anderson,anderky01,33,MIN,1,NOP,1,4,0,2,0,0,13.38333333,1,3,0,2,0,0,1,2,0,2,4,1,5,5,11.8
2023-24,202401030UTA,1/3/2024,UTA vs DET,Killian Hayes,hayeski01,29,DET,0,UTA,2,4,6,0,1,0,13.43333333,0,4,1,3,0,0,0,0,2,1,10,8,6,12,18.8
2023-24,202401030IND,1/3/2024,IND vs MIL,Andre Jackson Jr.,jacksan01,28,MIL,0,IND,7,2,2,0,0,1,13.7,0,2,3,4,1,2,0,0,1,0,4,9,9,11,11.4
2023-24,202401030SAC,1/3/2024,SAC vs ORL,Davion Mitchell,mitchda01,26,SAC,1,ORL,2,1,3,0,0,2,13.95,0,1,1,3,0,2,0,0,0,0,4,5,3,6,5.7
2023-24,202401030HOU,1/3/2024,HOU vs BRK,Aaron Holiday,holidaa01,30,HOU,1,BRK,3,1,3,0,0,1,14.01666667,0,1,1,5,1,3,0,0,2,0,4,6,4,7,7.7
2023-24,202401030MIN,1/3/2024,MIN vs NOP,Naji Marshall,marshna01,26,NOP,0,MIN,2,2,0,1,0,0,14.13333333,0,2,1,4,0,2,0,0,4,1,2,2,4,4,7.4
2023-24,202401030IND,1/3/2024,IND vs MIL,Pat Connaughton,connapa01,28,MIL,0,IND,3,2,1,0,0,0,14.18333333,1,1,1,3,1,2,0,0,3,0,3,4,5,6,6.9
2023-24,202401030ATL,1/3/2024,ATL vs OKC,Trent Forrest,forretr01,9,ATL,1,OKC,6,2,2,0,1,0,14.31666667,0,2,3,3,0,0,0,0,3,1,4,8,8,10,14.4
2023-24,202401030PHO,1/3/2024,PHO vs LAC,Chimezie Metu,metuch01,24,PHO,1,LAC,7,3,2,2,0,1,14.56666667,1,2,3,6,1,4,0,0,0,2,5,9,10,12,18.6
2023-24,202401030DAL,1/3/2024,DAL vs POR,Grant Williams,willigr01,32,DAL,1,POR,2,2,2,0,0,3,14.58333333,1,1,1,2,0,0,0,0,2,0,4,4,4,6,4.4
2023-24,202401030DAL,1/3/2024,DAL vs POR,Kris Murray,murrakr01,17,POR,0,DAL,2,1,2,0,0,1,14.6,0,1,1,3,0,1,0,0,0,0,3,4,3,5,5.2
2023-24,202401030CLE,1/3/2024,CLE vs WAS,Craig Porter Jr.,portecr01,23,CLE,1,WAS,8,3,3,0,0,1,14.61666667,1,2,4,5,0,0,0,1,0,0,6,11,11,14,15.1
2023-24,202401030DAL,1/3/2024,DAL vs POR,Ibou Badji,badjiib01,5,POR,0,DAL,0,4,0,0,2,4,14.85,3,1,0,2,0,0,0,0,6,2,4,0,4,4,6.8
2023-24,202401030ATL,1/3/2024,ATL vs OKC,Jaylin Williams,willija07,28,OKC,0,ATL,3,3,2,2,0,0,15.01666667,0,3,1,2,1,2,0,0,4,2,5,5,6,8,15.6
2023-24,202401030CLE,1/3/2024,CLE vs WAS,Landry Shamet,shamela01,21,WAS,0,CLE,9,3,2,1,0,0,15.13333333,0,3,3,6,2,3,1,2,0,1,5,11,12,14,18.6
2023-24,202401030DAL,1/3/2024,DAL vs POR,Seth Curry,curryse01,26,DAL,1,POR,0,1,2,0,0,0,15.35,0,1,0,1,0,0,0,0,0,0,3,2,1,3,4.2
2023-24,202401030LAL,1/3/2024,LAL vs MIA,Jarred Vanderbilt,vandeja01,15,LAL,1,MIA,4,2,0,0,0,2,15.51666667,0,2,2,3,0,0,0,0,0,0,2,4,6,6,4.4
2023-24,202401030NYK,1/3/2024,NYK vs CHI,Jevon Carter,carteje01,36,CHI,0,NYK,2,0,2,1,1,1,15.6,0,0,1,6,0,3,0,0,2,2,2,4,2,4,10
2023-24,202401030NYK,1/3/2024,NYK vs CHI,Terry Taylor,taylote01,13,CHI,0,NYK,4,2,0,0,0,0,15.71666667,1,1,2,3,0,0,0,0,0,0,2,4,6,6,6.4
2023-24,202401030PHO,1/3/2024,PHO vs LAC,Josh Okogie,okogijo01,28,PHO,1,LAC,5,2,1,0,1,1,15.86666667,1,1,2,3,1,2,0,0,2,1,3,6,7,8,10.9
2023-24,202401030UTA,1/3/2024,UTA vs DET,Kris Dunn,dunnkr01,27,UTA,1,DET,4,1,4,3,1,0,15.96666667,0,1,2,6,0,1,0,0,0,4,5,8,5,9,23.2
2023-24,202401030HOU,1/3/2024,HOU vs BRK,Cam Whitmore,whitmca01,9,HOU,1,BRK,11,2,1,2,0,1,16.56666667,0,2,4,7,3,5,0,0,3,2,3,12,13,14,19.9
2023-24,202401030ATL,1/3/2024,ATL vs OKC,Garrison Mathews,mathega01,21,ATL,1,OKC,5,0,2,0,0,1,16.76666667,0,0,2,3,1,2,0,1,1,0,2,7,5,7,7
2023-24,202401030UTA,1/3/2024,UTA vs DET,James Wiseman,wisemja01,23,DET,0,UTA,8,9,0,0,0,3,16.76666667,5,4,4,7,0,0,0,0,1,0,9,8,17,17,15.8
2023-24,202401030DAL,1/3/2024,DAL vs POR,Malcolm Brogdon,brogdma01,26,POR,0,DAL,5,2,2,0,0,0,16.81666667,0,2,2,6,0,3,1,1,1,0,4,7,7,9,10.4
2023-24,202401030DAL,1/3/2024,DAL vs POR,Jabari Walker,walkeja01,33,POR,0,DAL,4,5,4,0,0,1,16.83333333,1,4,1,3,0,1,2,2,2,0,9,8,9,13,15
2023-24,202401030HOU,1/3/2024,HOU vs BRK,Jeff Green,greenje02,31,HOU,1,BRK,8,0,0,0,0,1,17.03333333,0,0,2,4,2,2,2,2,1,0,0,8,8,8,7
2023-24,202401030DAL,1/3/2024,DAL vs POR,Ish Wainright,wainris01,7,POR,0,DAL,9,5,0,1,0,0,17.35,0,5,3,5,3,5,0,0,0,1,5,9,14,14,18
2023-24,202401030MIN,1/3/2024,MIN vs NOP,Jordan McLaughlin,mclaujo01,13,MIN,1,NOP,3,3,4,1,0,0,17.36666667,2,1,1,6,0,4,1,2,0,1,7,7,6,10,15.6
2023-24,202401030HOU,1/3/2024,HOU vs BRK,Cam Thomas,thomaca02,26,BRK,0,HOU,4,0,5,1,0,1,17.48333333,0,0,0,7,0,2,4,4,1,1,5,9,4,9,13.5
2023-24,202401030ATL,1/3/2024,ATL vs OKC,Isaiah Joe,joeis01,33,OKC,0,ATL,9,1,1,1,0,2,17.71666667,1,0,4,8,1,5,0,0,2,1,2,10,10,11,12.7
2023-24,202401030IND,1/3/2024,IND vs MIL,Isaiah Jackson,jacksis01,26,IND,1,MIL,9,4,3,1,0,1,17.83333333,2,2,4,6,0,0,1,1,3,1,7,12,13,16,20.3
2023-24,202401030SAC,1/3/2024,SAC vs ORL,Kevin Huerter,huertke01,32,SAC,1,ORL,2,7,2,0,0,1,17.9,1,6,0,5,0,4,2,2,1,0,9,4,9,11,12.4
2023-24,202401030MEM,1/3/2024,MEM vs TOR,Ziaire Williams,willizi02,32,MEM,1,TOR,18,6,0,1,0,0,18.13333333,2,4,7,12,4,7,0,0,1,1,6,18,24,24,28.2
2023-24,202401030NYK,1/3/2024,NYK vs CHI,Quentin Grimes,grimequ01,31,NYK,1,CHI,8,1,0,1,0,0,18.33333333,0,1,3,9,2,6,0,0,0,1,1,8,9,9,12.2
2023-24,202401030CLE,1/3/2024,CLE vs WAS,Delon Wright,wrighde01,12,WAS,0,CLE,0,2,4,1,1,1,18.43333333,0,2,0,3,0,1,0,0,1,2,6,4,2,6,13.4
2023-24,202401030PHO,1/3/2024,PHO vs LAC,Russell Westbrook,westbru01,33,LAC,0,PHO,6,5,2,2,0,2,18.45,2,3,2,7,0,2,2,2,1,2,7,8,11,13,19
2023-24,202401030CLE,1/3/2024,CLE vs WAS,Tristan Thompson,thomptr01,29,CLE,1,WAS,7,9,4,0,1,3,18.56666667,3,6,3,7,0,0,1,3,1,1,13,11,16,20,23.8
2023-24,202401030LAL,1/3/2024,LAL vs MIA,Cam Reddish,reddica01,29,LAL,1,MIA,0,0,1,0,0,4,18.66666667,0,0,0,1,0,1,0,0,2,0,1,1,0,1,-2.5
2023-24,202401030IND,1/3/2024,IND vs MIL,T.J. McConnell,mccontj01,26,IND,1,MIL,6,6,3,0,0,1,18.68333333,0,6,2,6,0,1,2,2,1,0,9,9,12,15,16.7
2023-24,202401030DAL,1/3/2024,DAL vs POR,Dereck Lively II,livelde01,29,DAL,1,POR,0,4,4,2,3,0,18.8,1,3,0,1,0,0,0,0,1,5,8,4,4,8,25.8
2023-24,202401030MEM,1/3/2024,MEM vs TOR,Luke Kennard,kennalu01,11,MEM,1,TOR,2,1,0,0,0,0,18.81666667,0,1,1,5,0,4,0,0,1,0,1,2,3,3,3.2
2023-24,202401030MIN,1/3/2024,MIN vs NOP,Nickeil Alexander-Walker,alexani01,33,MIN,1,NOP,4,0,1,0,0,1,18.88333333,0,0,1,3,0,2,2,2,0,0,1,5,4,5,4.5
2023-24,202401030PHO,1/3/2024,PHO vs LAC,Bol Bol,bolbo01,10,PHO,1,LAC,14,5,2,1,0,2,18.9,3,2,6,7,2,2,0,0,2,1,7,16,19,21,24
2023-24,202401030IND,1/3/2024,IND vs MIL,Jalen Smith,smithja04,21,IND,1,MIL,13,7,3,0,0,1,19.23333333,2,5,5,8,1,4,2,2,2,0,10,16,20,23,24.9
2023-24,202401030CLE,1/3/2024,CLE vs WAS,Isaac Okoro,okorois01,25,CLE,1,WAS,9,2,3,1,0,0,19.5,0,2,4,4,1,1,0,0,2,1,5,12,11,14,18.9
2023-24,202401030DAL,1/3/2024,DAL vs POR,Jerami Grant,grantje01,29,POR,0,DAL,10,1,2,0,0,3,19.6,0,1,4,9,1,3,1,3,3,0,3,12,11,13,11.2
2023-24,202401030CLE,1/3/2024,CLE vs WAS,Corey Kispert,kispeco01,32,WAS,0,CLE,12,1,0,0,0,0,19.65,0,1,4,9,0,5,4,6,0,0,1,12,13,13,13.2
2023-24,202401030UTA,1/3/2024,UTA vs DET,Kelly Olynyk,olynyke01,33,UTA,1,DET,9,5,4,1,0,2,19.7,2,3,3,5,0,1,3,3,3,1,9,13,14,18,22
2023-24,202401030HOU,1/3/2024,HOU vs BRK,Amen Thompson,thompam01,13,HOU,1,BRK,10,6,1,0,0,1,19.86666667,0,6,3,7,1,3,3,7,1,0,7,11,16,17,17.7
2023-24,202401030ATL,1/3/2024,ATL vs OKC,Cason Wallace,wallaca01,33,OKC,0,ATL,15,1,2,1,0,0,19.91666667,0,1,5,9,3,7,2,2,2,1,3,17,16,18,22.2
2023-24,202401030HOU,1/3/2024,HOU vs BRK,Dorian Finney-Smith,finnedo01,32,BRK,0,HOU,9,2,2,0,1,2,20.06666667,1,1,4,16,1,11,0,0,2,1,4,11,11,13,15.4
2023-24,202401030PHO,1/3/2024,PHO vs LAC,Daniel Theis,theisda01,23,LAC,0,PHO,6,3,1,1,0,0,20.06666667,1,2,3,5,0,0,0,0,3,1,4,7,9,10,14.1
2023-24,202401030DAL,1/3/2024,DAL vs POR,Toumani Camara,camarto01,32,POR,0,DAL,10,5,0,2,1,2,20.1,2,3,3,8,2,4,2,3,6,3,5,10,15,15,23
2023-24,202401030CLE,1/3/2024,CLE vs WAS,Dean Wade,wadede01,27,CLE,1,WAS,2,3,1,0,0,0,20.1,0,3,1,3,0,1,0,0,1,0,4,3,5,6,7.1
2023-24,202401030ATL,1/3/2024,ATL vs OKC,Lindy Waters III,waterli01,12,OKC,0,ATL,9,3,1,0,0,1,20.13333333,0,3,3,6,3,6,0,0,2,0,4,10,12,13,13.1
2023-24,202401030HOU,1/3/2024,HOU vs BRK,Day'Ron Sharpe,sharpda01,35,BRK,0,HOU,11,12,1,1,1,1,20.15,4,8,4,7,0,0,3,6,5,2,13,12,23,24,31.9
2023-24,202401030CLE,1/3/2024,CLE vs WAS,Daniel Gafford,gaffoda01,30,WAS,0,CLE,12,5,1,0,1,0,20.18333333,3,2,6,8,0,0,0,1,2,1,6,13,17,18,22.5
2023-24,202401030IND,1/3/2024,IND vs MIL,Bobby Portis,portibo01,34,MIL,0,IND,9,6,1,0,1,0,20.31666667,3,3,4,10,0,2,1,2,1,1,7,10,15,16,20.7
2023-24,202401030MIN,1/3/2024,MIN vs NOP,Jonas Valanciunas,valanjo01,35,NOP,0,MIN,4,7,3,0,0,1,20.36666667,1,6,2,5,0,2,0,0,5,0,10,7,11,14,15.9
2023-24,202401030HOU,1/3/2024,HOU vs BRK,Trendon Watford,watfotr01,25,BRK,0,HOU,11,7,1,2,0,0,20.38333333,4,3,3,6,2,2,3,4,1,2,8,12,18,19,26.9
2023-24,202401030LAL,1/3/2024,LAL vs MIA,Josh Richardson,richajo01,25,MIA,0,LAL,10,1,1,0,1,0,20.5,0,1,4,7,2,3,0,0,3,1,2,11,11,12,15.7
2023-24,202401030CLE,1/3/2024,CLE vs WAS,Tyus Jones,jonesty01,33,WAS,0,CLE,9,2,2,1,1,0,20.81666667,0,2,4,11,1,2,0,0,0,2,4,11,11,13,20.4
2023-24,202401030CLE,1/3/2024,CLE vs WAS,Mike Muscala,muscami01,20,WAS,0,CLE,12,4,2,0,0,0,20.9,2,2,5,9,2,5,0,0,0,0,6,14,16,18,19.8
2023-24,202401030IND,1/3/2024,IND vs MIL,MarJon Beauchamp,beaucma01,29,MIL,0,IND,12,3,1,0,0,1,20.95,1,2,6,9,0,3,0,0,1,0,4,13,15,16,16.1
2023-24,202401030PHO,1/3/2024,PHO vs LAC,Keita Bates-Diop,bateske01,24,PHO,1,LAC,5,0,3,1,0,0,21.03333333,0,0,1,3,1,2,2,2,3,1,3,8,5,8,12.5
2023-24,202401030SAC,1/3/2024,SAC vs ORL,Wendell Carter Jr.,cartewe01,13,ORL,0,SAC,9,7,3,0,0,1,21.15,1,6,3,7,3,3,0,0,4,0,10,12,16,19,20.9
2023-24,202401030ATL,1/3/2024,ATL vs OKC,Aaron Wiggins,wiggiaa01,31,OKC,0,ATL,13,3,2,1,1,0,21.23333333,1,2,6,7,1,1,0,0,1,2,5,15,16,18,25.6
2023-24,202401030MEM,1/3/2024,MEM vs TOR,Gary Trent Jr.,trentga02,31,TOR,0,MEM,5,1,0,1,0,2,21.45,0,1,2,5,1,1,0,0,2,1,1,5,6,6,7.2
2023-24,202401030CLE,1/3/2024,CLE vs WAS,Deni Avdija,avdijde01,33,WAS,0,CLE,7,6,4,1,0,3,21.46666667,2,4,3,11,1,3,0,0,1,1,10,11,13,17,20.2
2023-24,202401030MEM,1/3/2024,MEM vs TOR,Santi Aldama,aldamsa01,27,MEM,1,TOR,7,8,3,1,0,1,21.56666667,1,7,2,6,2,4,1,2,4,1,11,10,15,18,23.1
2023-24,202401030IND,1/3/2024,IND vs MIL,Aaron Nesmith,nesmiaa01,32,IND,1,MIL,9,4,2,3,0,0,21.7,0,4,4,4,1,1,0,0,2,3,6,11,13,15,25.8
2023-24,202401030UTA,1/3/2024,UTA vs DET,Jaden Ivey,iveyja01,30,DET,0,UTA,11,1,2,0,0,2,21.75,0,1,4,8,2,3,1,2,2,0,3,13,12,14,13.2
2023-24,202401030ATL,1/3/2024,ATL vs OKC,Onyeka Okongwu,okongon01,32,ATL,1,OKC,11,7,0,1,0,0,22.01666667,3,4,3,4,0,0,5,5,2,1,7,11,18,18,22.4
2023-24,202401030SAC,1/3/2024,SAC vs ORL,Trey Lyles,lylestr01,20,SAC,1,ORL,10,3,0,0,1,0,22.06666667,3,0,4,6,2,3,0,0,3,1,3,10,13,13,16.6
2023-24,202401030ATL,1/3/2024,ATL vs OKC,Josh Giddey,giddejo01,32,OKC,0,ATL,9,3,4,1,0,2,22.36666667,2,1,3,7,2,3,1,2,1,1,7,13,12,16,19.6
2023-24,202401030MIN,1/3/2024,MIN vs NOP,Larry Nance Jr.,nancela02,18,NOP,0,MIN,8,9,2,1,1,0,22.43333333,3,6,4,6,0,0,0,0,1,2,11,10,17,19,27.8
2023-24,202401030DAL,1/3/2024,DAL vs POR,Shaedon Sharpe,sharpsh01,28,POR,0,DAL,16,4,0,0,0,0,22.43333333,1,3,6,12,1,5,3,3,3,0,4,16,20,20,20.8
2023-24,202401030DAL,1/3/2024,DAL vs POR,Derrick Jones Jr.,jonesde02,34,DAL,1,POR,5,0,1,2,2,1,22.55,0,0,2,3,0,0,1,2,2,4,1,6,5,6,17.5
2023-24,202401030CLE,1/3/2024,CLE vs WAS,Kyle Kuzma,kuzmaky01,33,WAS,0,CLE,16,2,3,1,0,1,22.7,0,2,7,12,2,6,0,0,1,1,5,19,18,21,24.9
2023-24,202401030CLE,1/3/2024,CLE vs WAS,Jordan Poole,poolejo01,32,WAS,0,CLE,8,3,2,0,0,1,22.7,3,0,3,11,2,4,0,0,3,0,5,10,11,13,13.6
2023-24,202401030UTA,1/3/2024,UTA vs DET,Keyonte George,georgke01,29,UTA,1,DET,5,2,2,1,0,1,22.73333333,0,2,2,9,1,4,0,0,1,1,4,7,7,9,12.4
2023-24,202401030IND,1/3/2024,IND vs MIL,Malik Beasley,beaslma01,32,MIL,0,IND,8,1,1,0,0,0,22.8,0,1,3,8,2,5,0,0,4,0,2,9,9,10,10.7
2023-24,202401030CLE,1/3/2024,CLE vs WAS,Caris LeVert,leverca01,26,CLE,1,WAS,21,5,5,1,1,0,22.9,2,3,9,18,3,6,0,0,1,2,10,26,26,31,40.5
2023-24,202401030PHO,1/3/2024,PHO vs LAC,Terance Mann,mannte01,27,LAC,0,PHO,12,3,1,2,0,0,22.91666667,2,1,5,8,2,4,0,0,1,2,4,13,15,16,23.1
2023-24,202401030DAL,1/3/2024,DAL vs POR,Matisse Thybulle,thybuma01,33,POR,0,DAL,12,2,1,1,0,0,23.38333333,0,2,4,6,4,6,0,0,4,1,3,13,14,15,18.9
2023-24,202401030DAL,1/3/2024,DAL vs POR,Tim Hardaway Jr.,hardati02,32,DAL,1,POR,14,3,0,0,0,0,23.45,0,3,5,10,2,5,2,2,2,0,3,14,17,17,17.6
2023-24,202401030MEM,1/3/2024,MEM vs TOR,Xavier Tillman Sr.,tillmxa01,22,MEM,1,TOR,4,5,2,0,0,0,23.45,2,3,2,3,0,0,0,0,3,0,7,6,9,11,13
2023-24,202401030UTA,1/3/2024,UTA vs DET,John Collins,collijo01,31,UTA,1,DET,17,4,3,0,0,2,23.5,4,0,7,13,2,6,1,2,3,0,7,20,21,24,24.3
2023-24,202401030MIN,1/3/2024,MIN vs NOP,Dyson Daniels,daniedy01,35,NOP,0,MIN,7,5,1,1,0,0,23.51666667,2,3,2,3,1,1,2,2,0,1,6,8,12,13,17.5
2023-24,202401030MIN,1/3/2024,MIN vs NOP,Rudy Gobert,goberru01,33,MIN,1,NOP,5,5,0,0,1,1,23.9,1,4,2,3,0,0,1,2,4,1,5,5,10,10,13
2023-24,202401030LAL,1/3/2024,LAL vs MIA,Christian Wood,woodch01,30,LAL,1,MIA,13,8,3,0,1,2,24.21666667,4,4,5,10,0,2,3,3,1,1,11,16,21,24,28.1
2023-24,202401030CLE,1/3/2024,CLE vs WAS,Donovan Mitchell,mitchdo01,25,CLE,1,WAS,22,3,4,2,2,2,24.25,1,2,6,16,4,9,6,6,0,4,7,26,25,29,41.6
2023-24,202401030SAC,1/3/2024,SAC vs ORL,Anthony Black,blackan01,32,ORL,0,SAC,9,2,4,0,0,1,24.51666667,1,1,4,7,1,1,0,0,1,0,6,13,11,15,16.4
2023-24,202401030ATL,1/3/2024,ATL vs OKC,Chet Holmgren,holmgch01,33,OKC,0,ATL,12,3,1,0,0,4,24.56666667,0,3,5,9,2,5,0,0,1,0,4,13,15,16,13.1
2023-24,202401030MIN,1/3/2024,MIN vs NOP,Naz Reid,reidna01,33,MIN,1,NOP,8,6,2,0,2,1,24.58333333,0,6,3,8,2,5,0,0,2,2,8,10,14,16,23.2
2023-24,202401030PHO,1/3/2024,PHO vs LAC,Jusuf Nurkic,nurkiju01,32,PHO,1,LAC,9,6,1,1,0,1,24.91666667,1,5,3,5,0,1,3,3,3,1,7,10,15,16,19.7
2023-24,202401030NYK,1/3/2024,NYK vs CHI,Donte DiVincenzo,divindo01,34,NYK,1,CHI,11,5,5,1,0,3,25,1,4,4,10,3,8,0,0,2,1,10,16,16,21,24.5
2023-24,202401030IND,1/3/2024,IND vs MIL,Bennedict Mathurin,mathube01,34,IND,1,MIL,16,1,3,0,0,1,25,0,1,6,9,2,2,2,2,4,0,4,19,17,20,20.7
2023-24,202401030ATL,1/3/2024,ATL vs OKC,Clint Capela,capelca01,32,ATL,1,OKC,12,14,0,0,3,0,25.26666667,7,7,5,8,0,0,2,2,2,3,14,12,26,26,37.8
2023-24,202401030NYK,1/3/2024,NYK vs CHI,Josh Hart,hartjo01,34,NYK,1,CHI,3,5,3,0,0,2,25.4,1,4,1,5,1,2,0,0,2,0,8,6,8,11,11.5
2023-24,202401030LAL,1/3/2024,LAL vs MIA,Kyle Lowry,lowryky01,30,MIA,0,LAL,10,3,6,4,0,1,25.86666667,0,3,3,6,2,5,2,2,2,4,9,16,13,19,33.6
2023-24,202401030MIN,1/3/2024,MIN vs NOP,Mike Conley,conlemi01,33,MIN,1,NOP,7,0,9,1,0,0,25.95,0,0,3,5,1,3,0,0,1,1,9,16,7,16,23.5
2023-24,202401030PHO,1/3/2024,PHO vs LAC,Norman Powell,powelno01,33,LAC,0,PHO,13,2,1,0,0,3,26.41666667,0,2,5,8,3,5,0,0,1,0,3,14,15,16,13.9
2023-24,202401030PHO,1/3/2024,PHO vs LAC,Ivica Zubac,zubaciv01,33,LAC,0,PHO,6,3,2,0,2,0,26.61666667,1,2,2,4,0,0,2,2,5,2,5,8,9,11,18.6
2023-24,202401030NYK,1/3/2024,NYK vs CHI,Patrick Williams,willipa01,36,CHI,0,NYK,5,4,2,1,0,5,26.81666667,1,3,2,8,1,2,0,0,3,1,6,7,9,11,10.8
2023-24,202401030IND,1/3/2024,IND vs MIL,Obi Toppin,toppiob01,34,IND,1,MIL,15,8,4,1,0,0,26.83333333,3,5,5,12,2,6,3,4,3,1,12,19,23,27,33.6
2023-24,202401030DAL,1/3/2024,DAL vs POR,Anfernee Simons,simonan01,12,POR,0,DAL,15,5,3,0,0,2,27,1,4,5,16,1,7,4,4,1,0,8,18,20,23,23.5
2023-24,202401030MIN,1/3/2024,MIN vs NOP,Jose Alvarado,alvarjo01,21,NOP,0,MIN,8,3,3,0,1,1,27.05,1,2,3,8,2,6,0,0,3,1,6,11,11,14,18.1
2023-24,202401030DAL,1/3/2024,DAL vs POR,Josh Green,greenjo02,23,DAL,1,POR,8,4,1,2,0,0,27.21666667,0,4,3,5,0,2,2,2,4,2,5,9,12,13,20.3
2023-24,202401030SAC,1/3/2024,SAC vs ORL,Chuma Okeke,okekech01,17,ORL,0,SAC,11,7,3,0,1,0,27.35,1,6,4,5,3,4,0,0,2,1,10,14,18,21,26.9
2023-24,202401030HOU,1/3/2024,HOU vs BRK,Nic Claxton,claxtni01,25,BRK,0,HOU,12,13,0,1,2,1,27.7,5,8,6,8,0,0,0,0,5,3,13,12,25,25,35.6
2023-24,202401030ATL,1/3/2024,ATL vs OKC,Bogdan Bogdanovic,bogdabo01,31,ATL,1,OKC,23,1,4,1,0,0,27.73333333,0,1,7,16,5,11,4,4,2,1,5,27,24,28,33.2
2023-24,202401030LAL,1/3/2024,LAL vs MIA,Tyler Herro,herroty01,16,MIA,0,LAL,21,6,4,3,0,2,27.86666667,0,6,7,19,4,8,3,3,3,3,10,25,27,31,41.2
2023-24,202401030LAL,1/3/2024,LAL vs MIA,Kevin Love,loveke01,27,MIA,0,LAL,10,14,3,1,1,0,27.88333333,3,11,4,7,0,1,2,6,3,2,17,13,24,27,37.3
2023-24,202401030CLE,1/3/2024,CLE vs WAS,Georges Niang,niangge01,34,CLE,1,WAS,15,8,1,0,0,0,27.9,1,7,5,11,3,7,2,2,2,0,9,16,23,24,26.1
2023-24,202401030PHO,1/3/2024,PHO vs LAC,Eric Gordon,gordoer01,30,PHO,1,LAC,16,5,1,1,0,1,28,1,4,5,11,3,6,3,4,1,1,6,17,21,22,25.5
2023-24,202401030CLE,1/3/2024,CLE vs WAS,Max Strus,strusma01,34,CLE,1,WAS,24,4,3,1,1,1,28,2,2,9,13,6,8,0,0,4,2,7,27,28,31,38.3
2023-24,202401030SAC,1/3/2024,SAC vs ORL,Goga Bitadze,bitadgo01,31,ORL,0,SAC,6,6,2,1,3,1,28.06666667,1,5,2,5,0,1,2,2,3,4,8,8,12,14,27.2
2023-24,202401030LAL,1/3/2024,LAL vs MIA,Nikola Jovic,jovicni01,8,MIA,0,LAL,15,8,1,1,0,0,28.08333333,1,7,6,11,3,5,0,0,4,1,9,16,23,24,29.1
2023-24,202401030HOU,1/3/2024,HOU vs BRK,Spencer Dinwiddie,dinwisp01,33,BRK,0,HOU,11,1,5,2,0,1,28.1,0,1,3,5,2,3,3,5,1,2,6,16,12,17,24.7
2023-24,202401030LAL,1/3/2024,LAL vs MIA,Max Christie,chrisma02,26,LAL,1,MIA,14,5,0,0,0,2,28.36666667,1,4,5,12,2,9,2,2,2,0,5,14,19,19,18
2023-24,202401030IND,1/3/2024,IND vs MIL,Brook Lopez,lopezbr01,34,MIL,0,IND,16,5,1,0,0,2,28.36666667,3,2,6,11,2,4,2,3,3,0,6,17,21,22,21.5
2023-24,202401030IND,1/3/2024,IND vs MIL,Bruce Brown,brownbr01,29,IND,1,MIL,15,5,2,0,0,4,28.4,0,5,5,7,0,1,5,6,6,0,7,17,20,22,20
2023-24,202401030CLE,1/3/2024,CLE vs WAS,Sam Merrill,merrisa01,19,CLE,1,WAS,11,5,6,0,0,0,28.53333333,1,4,4,11,3,9,0,0,2,0,11,17,16,22,26
2023-24,202401030MIN,1/3/2024,MIN vs NOP,Zion Williamson,willizi01,29,NOP,0,MIN,27,4,6,1,1,2,28.61666667,1,3,11,15,0,0,5,6,3,2,10,33,31,37,44.8
2023-24,202401030LAL,1/3/2024,LAL vs MIA,Taurean Prince,princta02,34,LAL,1,MIA,0,5,2,0,0,1,28.8,0,5,0,6,0,5,0,0,2,0,7,2,5,7,8
2023-24,202401030ATL,1/3/2024,ATL vs OKC,Jalen Johnson,johnsja05,19,ATL,1,OKC,28,7,3,4,0,1,28.93333333,1,6,11,18,2,4,4,4,5,4,10,31,35,38,51.9
2023-24,202401030DAL,1/3/2024,DAL vs POR,Kyrie Irving,irvinky01,19,DAL,1,POR,29,9,5,2,0,1,28.96666667,1,8,10,19,4,8,5,6,0,2,14,34,38,43,52.3
2023-24,202401030ATL,1/3/2024,ATL vs OKC,Luguentz Dort,dortlu01,32,OKC,0,ATL,14,4,3,0,0,0,29.05,3,1,3,7,2,3,6,6,4,0,7,17,18,21,23.3
2023-24,202401030UTA,1/3/2024,UTA vs DET,Walker Kessler,kesslwa01,27,UTA,1,DET,8,8,1,0,6,0,29.38333333,3,5,4,6,0,0,0,0,4,6,9,9,16,17,37.1
2023-24,202401030CLE,1/3/2024,CLE vs WAS,Jarrett Allen,allenja01,29,CLE,1,WAS,17,19,7,0,2,1,29.43333333,7,12,7,10,0,0,3,4,0,2,26,24,36,43,55.3
2023-24,202401030MEM,1/3/2024,MEM vs TOR,Dennis Schroder,schrode01,34,TOR,0,MEM,16,7,5,0,0,0,29.43333333,0,7,6,11,1,3,3,4,0,0,12,21,23,28,31.9
2023-24,202401030MIN,1/3/2024,MIN vs NOP,CJ McCollum,mccolcj01,22,NOP,0,MIN,24,3,5,0,1,2,29.66666667,0,3,8,16,4,6,4,4,2,1,8,29,27,32,36.1
2023-24,202401030MEM,1/3/2024,MEM vs TOR,Pascal Siakam,siakapa01,34,TOR,0,MEM,24,7,0,1,0,3,29.81666667,1,6,9,14,1,2,5,6,5,1,7,24,31,31,32.4
2023-24,202401030HOU,1/3/2024,HOU vs BRK,Royce O'Neale,onealro01,34,BRK,0,HOU,13,4,3,2,0,1,29.95,1,3,5,13,2,8,1,2,3,2,7,16,17,20,27.3
2023-24,202401030LAL,1/3/2024,LAL vs MIA,Duncan Robinson,robindu01,32,MIA,0,LAL,13,0,2,1,0,1,29.98333333,0,0,5,14,3,12,0,0,3,1,2,15,13,15,18
2023-24,202401030IND,1/3/2024,IND vs MIL,Myles Turner,turnemy01,33,IND,1,MIL,15,7,2,0,2,2,30.16666667,0,7,6,9,1,4,2,4,4,2,9,17,22,24,30.4
2023-24,202401030UTA,1/3/2024,UTA vs DET,Collin Sexton,sextoco01,35,UTA,1,DET,25,2,5,1,0,0,30.26666667,1,1,7,14,1,2,10,10,5,1,7,30,27,32,37.9
2023-24,202401030NYK,1/3/2024,NYK vs CHI,Andre Drummond,drumman01,36,CHI,0,NYK,13,16,0,2,1,1,30.45,8,8,5,12,0,0,3,6,3,3,16,13,29,29,40.2
2023-24,202401030DAL,1/3/2024,DAL vs POR,Luka Doncic,doncilu01,32,DAL,1,POR,41,6,5,1,0,4,30.53333333,0,6,13,21,4,7,11,14,1,1,11,46,47,52,54.7
2023-24,202401030SAC,1/3/2024,SAC vs ORL,Caleb Houstan,houstca01,25,ORL,0,SAC,15,2,1,4,0,1,30.91666667,0,2,4,6,4,6,3,3,2,4,3,16,17,18,29.9
2023-24,202401030HOU,1/3/2024,HOU vs BRK,Jalen Green,greenja05,32,HOU,1,BRK,14,8,4,0,0,4,31.33333333,0,8,5,15,3,9,1,2,1,0,12,18,22,26,25.6
2023-24,202401030NYK,1/3/2024,NYK vs CHI,Ayo Dosunmu,dosunay01,34,CHI,0,NYK,7,4,4,0,2,0,31.38333333,0,4,2,12,1,6,2,2,1,2,8,11,11,15,23.8
2023-24,202401030HOU,1/3/2024,HOU vs BRK,Jae'Sean Tate,tateja01,30,HOU,1,BRK,8,4,3,0,0,1,31.43333333,0,4,2,2,2,2,2,2,4,0,7,11,12,15,16.3
2023-24,202401030IND,1/3/2024,IND vs MIL,Khris Middleton,middlkh01,29,MIL,0,IND,19,6,7,0,2,4,32.1,1,5,7,13,4,7,1,1,2,2,13,26,25,32,38.7
2023-24,202401030HOU,1/3/2024,HOU vs BRK,Cameron Johnson,johnsca02,27,BRK,0,HOU,15,6,5,0,1,0,32.13333333,0,6,6,13,3,6,0,2,0,1,11,20,21,26,32.7
2023-24,202401030MIN,1/3/2024,MIN vs NOP,Brandon Ingram,ingrabr01,32,NOP,0,MIN,19,4,7,2,0,3,32.28333333,0,4,7,11,1,3,4,5,3,2,11,26,23,30,37.3
2023-24,202401030PHO,1/3/2024,PHO vs LAC,Grayson Allen,allengr01,29,PHO,1,LAC,10,4,3,2,0,1,32.43333333,1,3,4,9,2,4,0,1,2,2,7,13,14,17,24.3
2023-24,202401030DAL,1/3/2024,DAL vs POR,Scoot Henderson,hendesc01,24,POR,0,DAL,7,5,7,0,0,6,32.53333333,1,4,2,11,1,4,2,4,4,0,12,14,12,19,17.5
2023-24,202401030CLE,1/3/2024,CLE vs WAS,Bilal Coulibaly,coulibi01,32,WAS,0,CLE,5,5,1,3,2,2,32.55,1,4,2,12,1,4,0,2,4,5,6,6,10,11,25.5
2023-24,202401030NYK,1/3/2024,NYK vs CHI,Alex Caruso,carusal01,30,CHI,0,NYK,13,4,3,4,1,1,32.61666667,0,4,5,13,2,8,1,1,4,5,7,16,17,20,36.3
2023-24,202401030MEM,1/3/2024,MEM vs TOR,RJ Barrett,barrerj01,28,TOR,0,MEM,14,7,3,1,0,3,32.73333333,0,7,5,12,2,5,2,3,3,1,10,17,21,24,26.9
2023-24,202401030MEM,1/3/2024,MEM vs TOR,Immanuel Quickley,quickim01,32,TOR,0,MEM,26,3,5,0,1,1,32.75,0,3,8,18,5,8,5,6,3,1,8,31,29,34,39.1
2023-24,202401030HOU,1/3/2024,HOU vs BRK,Jabari Smith Jr.,smithja05,31,HOU,1,BRK,7,12,0,0,1,1,32.8,1,11,2,8,1,4,2,2,4,1,12,7,19,19,23.4
2023-24,202401030MIN,1/3/2024,MIN vs NOP,Jaden McDaniels,mcdanja02,23,MIN,1,NOP,11,0,2,2,1,1,33,0,0,5,10,1,3,0,0,3,3,2,13,11,13,22
2023-24,202401030MEM,1/3/2024,MEM vs TOR,Marcus Smart,smartma01,17,MEM,1,TOR,6,5,2,1,0,3,33.1,0,5,2,10,0,5,2,3,4,1,7,8,11,13,15
2023-24,202401030MEM,1/3/2024,MEM vs TOR,Jakob Poeltl,poeltja01,34,TOR,0,MEM,7,8,2,1,5,1,33.4,3,5,2,7,0,0,3,4,3,6,10,9,15,17,36.6
2023-24,202401030HOU,1/3/2024,HOU vs BRK,Alperen Sengun,sengual01,32,HOU,1,BRK,30,8,4,3,1,2,33.61666667,4,4,11,17,0,2,8,10,1,4,12,34,38,42,55.6
2023-24,202401030IND,1/3/2024,IND vs MIL,Tyrese Haliburton,halibty01,31,IND,1,MIL,31,2,12,1,3,0,33.85,0,2,10,20,5,11,6,6,1,4,14,43,33,45,63.4
2023-24,202401030ATL,1/3/2024,ATL vs OKC,Trae Young,youngtr01,31,ATL,1,OKC,24,4,11,2,0,6,33.95,0,4,6,13,2,9,10,11,2,2,15,35,28,39,45.3
2023-24,202401030UTA,1/3/2024,UTA vs DET,Alec Burks,burksal01,27,DET,0,UTA,27,4,1,0,0,2,34.23333333,0,4,9,17,5,9,4,5,4,0,5,28,31,32,31.3
2023-24,202401030NYK,1/3/2024,NYK vs CHI,OG Anunoby,anunoog01,29,NYK,1,CHI,11,8,2,2,0,1,34.4,2,6,5,9,1,4,0,0,2,2,10,13,19,21,28.6
2023-24,202401030ATL,1/3/2024,ATL vs OKC,Jalen Williams,willija06,30,OKC,0,ATL,21,3,6,4,0,2,34.6,1,2,9,12,1,1,2,5,4,4,9,27,24,30,43.6
2023-24,202401030MEM,1/3/2024,MEM vs TOR,Ja Morant,moranja01,8,MEM,1,TOR,28,8,9,1,0,2,34.88333333,1,7,10,18,3,6,5,6,1,1,17,37,36,45,52.1
2023-24,202401030UTA,1/3/2024,UTA vs DET,Simone Fontecchio,fontesi01,33,UTA,1,DET,16,7,4,2,0,0,35.01666667,2,5,6,11,3,4,1,1,2,2,11,20,23,27,36.4
2023-24,202401030ATL,1/3/2024,ATL vs OKC,Shai Gilgeous-Alexander,gilgesh01,32,OKC,0,ATL,33,13,8,0,0,2,35.4,1,12,11,24,2,3,9,11,2,0,21,41,46,54,58.6
2023-24,202401030ATL,1/3/2024,ATL vs OKC,Dejounte Murray,murrade01,33,ATL,1,OKC,22,6,6,0,0,3,35.4,2,4,8,18,2,5,4,4,2,0,12,28,28,34,35.2
2023-24,202401030PHO,1/3/2024,PHO vs LAC,James Harden,hardeja01,28,LAC,0,PHO,22,5,11,0,1,4,35.58333333,0,5,7,13,4,7,4,4,2,1,16,33,27,38,43.5
2023-24,202401030ATL,1/3/2024,ATL vs OKC,Saddiq Bey,beysa01,33,ATL,1,OKC,10,8,2,0,1,0,35.61666667,2,6,3,12,2,8,2,2,2,1,10,12,18,20,25.6
2023-24,202401030HOU,1/3/2024,HOU vs BRK,Fred VanVleet,vanvlfr01,31,HOU,1,BRK,21,6,10,0,2,4,35.7,0,6,7,9,6,8,1,2,2,2,16,31,27,37,45.2
2023-24,202401030IND,1/3/2024,IND vs MIL,Giannis Antetokounmpo,antetgi01,33,MIL,0,IND,26,11,8,3,1,3,35.71666667,0,11,8,13,1,2,9,13,2,4,19,34,37,45,60.2
2023-24,202401030IND,1/3/2024,IND vs MIL,Damian Lillard,lillada01,32,MIL,0,IND,23,2,5,3,0,2,36.08333333,1,1,6,18,2,8,9,10,3,3,7,28,25,30,39.9
2023-24,202401030MIN,1/3/2024,MIN vs NOP,Karl-Anthony Towns,townska01,32,MIN,1,NOP,22,6,2,0,0,1,36.16666667,2,4,8,19,0,4,6,7,2,0,8,24,28,30,31.2
2023-24,202401030UTA,1/3/2024,UTA vs DET,Jalen Duren,durenja01,19,DET,0,UTA,17,10,3,0,1,2,36.18333333,4,6,6,7,0,0,5,5,0,1,13,20,27,30,34.5
2023-24,202401030HOU,1/3/2024,HOU vs BRK,Mikal Bridges,bridgmi01,35,BRK,0,HOU,15,4,3,1,1,1,36.33333333,0,4,5,18,3,12,2,3,1,2,7,18,19,22,29.3
2023-24,202401030SAC,1/3/2024,SAC vs ORL,Harrison Barnes,barneha02,33,SAC,1,ORL,17,3,1,1,0,0,36.38333333,1,2,5,9,4,6,3,5,4,1,4,18,20,21,25.1
2023-24,202401030UTA,1/3/2024,UTA vs DET,Isaiah Livers,liveris01,18,DET,0,UTA,10,4,0,2,0,1,36.48333333,3,1,4,7,1,4,1,1,4,2,4,10,14,14,19.8
2023-24,202401030NYK,1/3/2024,NYK vs CHI,Isaiah Hartenstein,harteis01,34,NYK,1,CHI,10,20,1,0,5,2,36.58333333,7,13,4,6,0,0,2,3,2,5,21,11,30,31,48.5
2023-24,202401030MEM,1/3/2024,MEM vs TOR,Jaren Jackson Jr.,jacksja02,34,MEM,1,TOR,24,4,0,1,4,3,36.73333333,1,3,7,18,4,8,6,6,1,5,4,24,28,28,40.8
2023-24,202401030LAL,1/3/2024,LAL vs MIA,Austin Reaves,reaveau01,36,LAL,1,MIA,24,5,8,0,0,3,36.78333333,0,5,7,12,2,6,8,9,2,0,13,32,29,37,39
2023-24,202401030PHO,1/3/2024,PHO vs LAC,Paul George,georgpa01,31,LAC,0,PHO,33,7,3,2,0,1,36.8,2,5,8,14,5,10,12,14,3,2,10,36,40,43,50.9
2023-24,202401030MIN,1/3/2024,MIN vs NOP,Herbert Jones,joneshe01,32,NOP,0,MIN,16,3,2,1,1,3,36.9,0,3,6,11,4,5,0,0,3,2,5,18,19,21,25.6
2023-24,202401030MIN,1/3/2024,MIN vs NOP,Anthony Edwards,edwaran01,30,MIN,1,NOP,35,4,5,1,1,6,37.06666667,2,2,11,22,4,7,9,10,1,2,9,40,39,44,47.3
2023-24,202401030PHO,1/3/2024,PHO vs LAC,Devin Booker,bookede01,25,PHO,1,LAC,35,2,6,0,0,6,37.1,0,2,11,15,5,8,8,9,4,0,8,41,37,43,40.4
2023-24,202401030NYK,1/3/2024,NYK vs CHI,Coby White,whiteco01,36,CHI,0,NYK,26,4,8,0,1,3,37.7,0,4,9,19,6,9,2,2,1,1,12,34,30,38,42.8
2023-24,202401030MEM,1/3/2024,MEM vs TOR,Desmond Bane,banede01,33,MEM,1,TOR,22,4,8,0,0,0,37.75,2,2,9,18,2,6,2,2,4,0,12,30,26,34,38.8
2023-24,202401030UTA,1/3/2024,UTA vs DET,Lauri Markkanen,markkla01,25,UTA,1,DET,31,7,0,0,1,1,37.8,2,5,10,18,4,8,7,8,1,1,7,31,38,38,41.4
2023-24,202401030UTA,1/3/2024,UTA vs DET,Jordan Clarkson,clarkjo01,25,UTA,1,DET,36,6,3,1,0,5,37.96666667,1,5,11,20,4,5,10,11,1,1,9,39,42,45,45.7
2023-24,202401030SAC,1/3/2024,SAC vs ORL,Trevelin Queen,queentr01,2,ORL,0,SAC,5,2,6,2,1,0,38.06666667,0,2,2,7,0,3,1,2,5,3,8,11,7,13,25.4
2023-24,202401030LAL,1/3/2024,LAL vs MIA,Bam Adebayo,adebaba01,24,MIA,0,LAL,15,7,5,3,0,2,38.16666667,3,4,5,14,0,1,5,6,4,3,12,20,22,27,37.9
2023-24,202401030LAL,1/3/2024,LAL vs MIA,LeBron James,jamesle01,33,LAL,1,MIA,12,6,9,0,0,2,38.18333333,0,6,6,18,0,6,0,0,2,0,15,21,18,27,30.7
2023-24,202401030NYK,1/3/2024,NYK vs CHI,Jalen Brunson,brunsja01,34,NYK,1,CHI,31,3,13,0,0,4,38.31666667,0,3,13,22,4,9,1,1,3,0,16,44,34,47,50.1
2023-24,202401030NYK,1/3/2024,NYK vs CHI,DeMar DeRozan,derozde01,34,CHI,0,NYK,28,3,4,1,1,0,38.5,0,3,10,13,3,4,5,5,1,2,7,32,31,35,43.6
2023-24,202401030NYK,1/3/2024,NYK vs CHI,Julius Randle,randlju01,34,NYK,1,CHI,35,6,4,2,1,3,38.6,0,6,13,23,3,7,6,7,3,3,10,39,41,45,54.2
2023-24,202401030LAL,1/3/2024,LAL vs MIA,Jaime Jaquez Jr.,jaqueja01,34,MIA,0,LAL,16,0,8,1,1,2,39.05,0,0,7,14,2,6,0,0,1,2,8,24,16,24,32
2023-24,202401030SAC,1/3/2024,SAC vs ORL,Jalen Suggs,suggsja01,30,ORL,0,SAC,24,3,4,2,2,4,39.25,1,2,8,18,6,12,2,2,4,4,7,28,27,31,41.6
2023-24,202401030UTA,1/3/2024,UTA vs DET,Cade Cunningham,cunnica01,34,DET,0,UTA,31,5,13,1,0,6,39.61666667,0,5,12,21,3,7,4,5,5,1,18,44,36,49,53.5
2023-24,202401030MEM,1/3/2024,MEM vs TOR,Scottie Barnes,barnesc01,34,TOR,0,MEM,20,2,8,1,0,1,39.83333333,0,2,7,14,2,5,4,4,2,1,10,28,22,30,36.4
2023-24,202401030PHO,1/3/2024,PHO vs LAC,Kawhi Leonard,leonaka01,29,LAC,0,PHO,30,8,3,2,2,2,40.11666667,2,6,9,16,4,6,8,8,1,4,11,33,38,41,54.1
2023-24,202401030PHO,1/3/2024,PHO vs LAC,Bradley Beal,bealbr01,10,PHO,1,LAC,21,5,4,1,1,3,40.98333333,2,3,7,20,0,6,7,7,5,2,9,25,26,30,36
2023-24,202401030UTA,1/3/2024,UTA vs DET,Bojan Bogdanovic,bogdabo02,15,DET,0,UTA,36,7,5,1,0,1,42.56666667,1,6,13,26,8,15,2,2,6,1,12,41,43,48,53.9
2023-24,202401030LAL,1/3/2024,LAL vs MIA,Anthony Davis,davisan02,34,LAL,1,MIA,29,17,6,3,5,5,42.8,3,14,10,17,0,1,9,10,2,8,23,35,46,52,77.4
2023-24,202401030SAC,1/3/2024,SAC vs ORL,De'Aaron Fox,foxde01,27,SAC,1,ORL,15,4,7,1,0,3,43.95,3,1,6,22,0,5,3,4,1,1,11,22,19,26,30.3
2023-24,202401030SAC,1/3/2024,SAC vs ORL,Paolo Banchero,banchpa01,34,ORL,0,SAC,43,4,5,0,0,8,45.35,1,3,13,25,6,9,11,14,4,0,9,48,47,52,47.3
2023-24,202401030SAC,1/3/2024,SAC vs ORL,Domantas Sabonis,sabondo01,33,SAC,1,ORL,22,23,12,2,1,6,45.5,6,17,8,14,0,0,6,9,2,3,35,34,45,57,70.6
2023-24,202401030SAC,1/3/2024,SAC vs ORL,Keegan Murray,murrake02,29,SAC,1,ORL,28,12,1,1,0,0,45.7,4,8,13,21,2,6,0,0,0,1,13,29,40,41,46.9
2023-24,202401030SAC,1/3/2024,SAC vs ORL,Malik Monk,monkma01,32,SAC,1,ORL,37,3,9,2,1,3,46.05,0,3,12,20,7,13,6,8,5,3,12,46,40,49,60.1
2023-24,202401020OKC,1/2/2024,OKC vs BOS,Sam Hauser,hausesa01,33,BOS,0,OKC,6,1,0,0,0,0,10.38333333,0,1,2,3,2,3,0,0,0,0,1,6,7,7,7.2
2023-24,202401020GSW,1/2/2024,GSW vs ORL,Gary Payton II,paytoga02,16,GSW,1,ORL,2,4,0,0,0,1,10.51666667,1,3,1,5,0,3,0,0,0,0,4,2,6,6,5.8
2023-24,202401020PHI,1/2/2024,PHI vs CHI,Patrick Williams,willipa01,35,CHI,0,PHI,3,1,0,0,0,1,10.68333333,1,0,1,3,1,2,0,0,1,0,1,3,4,4,3.2
2023-24,202401020OKC,1/2/2024,OKC vs BOS,Vasilije Micic,micicva01,14,OKC,1,BOS,3,1,5,0,0,0,10.75,0,1,1,5,1,4,0,0,2,0,6,8,4,9,11.7
2023-24,202401020PHI,1/2/2024,PHI vs CHI,Marcus Morris,morrima03,25,PHI,1,CHI,2,2,0,1,0,1,11.06666667,1,1,0,3,0,0,2,4,0,1,2,2,4,4,6.4
2023-24,202401020NOP,1/2/2024,NOP vs BRK,Jalen Wilson,wilsoja03,10,BRK,0,NOP,8,4,2,1,0,0,12,4,0,4,8,0,2,0,0,0,1,6,10,12,14,18.8
2023-24,202401020SAC,1/2/2024,SAC vs CHO,Kevin Huerter,huertke01,31,SAC,1,CHO,4,2,0,0,0,0,12.35,0,2,1,4,0,2,2,2,3,0,2,4,6,6,6.4
2023-24,202401020MEM,1/2/2024,MEM vs SAS,Cedi Osman,osmande01,33,SAS,0,MEM,0,6,2,0,0,2,12.48333333,0,6,0,3,0,2,0,0,2,0,8,2,6,8,8.2
2023-24,202401020OKC,1/2/2024,OKC vs BOS,Isaiah Joe,joeis01,32,OKC,1,BOS,10,3,0,0,0,1,12.53333333,0,3,4,5,2,3,0,0,1,0,3,10,13,13,12.6
2023-24,202401020OKC,1/2/2024,OKC vs BOS,Aaron Wiggins,wiggiaa01,30,OKC,1,BOS,4,1,1,1,0,0,12.81666667,0,1,1,3,0,1,2,2,1,1,2,5,5,6,9.7
2023-24,202401020PHI,1/2/2024,PHI vs CHI,Paul Reed,reedpa01,33,PHI,1,CHI,2,4,0,2,0,0,12.95,0,4,1,3,0,0,0,0,2,2,4,2,6,6,12.8
2023-24,202401020SAC,1/2/2024,SAC vs CHO,Alex Len,lenal01,10,SAC,1,CHO,3,4,3,0,0,1,12.98333333,0,4,1,1,0,0,1,2,2,0,7,6,7,10,11.3
2023-24,202401020GSW,1/2/2024,GSW vs ORL,Anthony Black,blackan01,31,ORL,0,GSW,0,0,0,1,0,1,13.3,0,0,0,2,0,1,0,0,2,1,0,0,0,0,2
2023-24,202401020OKC,1/2/2024,OKC vs BOS,Kenrich Williams,willike04,22,OKC,1,BOS,2,4,2,0,0,0,13.43333333,3,1,1,3,0,1,0,0,4,0,6,4,6,8,9.8
2023-24,202401020MEM,1/2/2024,MEM vs SAS,Dominick Barlow,barlodo01,11,SAS,0,MEM,4,7,2,0,0,2,13.76666667,4,3,2,6,0,0,0,0,4,0,9,6,11,13,13.4
2023-24,202401020PHI,1/2/2024,PHI vs CHI,Patrick Beverley,beverpa01,32,PHI,1,CHI,3,1,2,0,0,1,14.1,0,1,1,1,1,1,0,0,1,0,3,5,4,6,6.2
2023-24,202401020SAC,1/2/2024,SAC vs CHO,Nick Smith Jr.,smithni01,17,CHO,0,SAC,6,0,1,0,2,0,14.13333333,0,0,2,3,2,3,0,0,1,2,1,7,6,7,13.5
2023-24,202401020GSW,1/2/2024,GSW vs ORL,Dario Saric,saricda01,33,GSW,1,ORL,2,3,1,0,0,2,14.21666667,1,2,1,3,0,1,0,0,0,0,4,3,5,6,5.1
2023-24,202401020SAC,1/2/2024,SAC vs CHO,Davion Mitchell,mitchda01,25,SAC,1,CHO,4,1,0,0,0,1,14.46666667,0,1,1,3,1,1,1,2,1,0,1,4,5,5,4.2
2023-24,202401020OKC,1/2/2024,OKC vs BOS,Luke Kornet,kornelu01,20,BOS,0,OKC,0,2,0,1,1,0,14.9,2,0,0,2,0,0,0,0,0,2,2,0,2,2,8.4
2023-24,202401020PHI,1/2/2024,PHI vs CHI,Danuel House Jr.,houseda01,21,PHI,1,CHI,5,0,1,0,0,1,15.23333333,0,0,2,5,0,2,1,1,1,0,1,6,5,6,5.5
2023-24,202401020GSW,1/2/2024,GSW vs ORL,Moritz Wagner,wagnemo01,33,ORL,0,GSW,12,5,1,1,0,1,15.53333333,3,2,5,8,1,2,1,1,2,1,6,13,17,18,21.5
2023-24,202401020SAC,1/2/2024,SAC vs CHO,Nathan Mensah,mensana01,8,CHO,0,SAC,0,1,0,2,2,1,15.71666667,0,1,0,1,0,0,0,0,4,4,1,0,1,1,12.2
2023-24,202401020NOP,1/2/2024,NOP vs BRK,Naji Marshall,marshna01,25,NOP,1,BRK,6,2,1,1,1,0,15.73333333,1,1,2,6,0,2,2,2,0,2,3,7,8,9,15.9
2023-24,202401020MEM,1/2/2024,MEM vs SAS,Doug McDermott,mcderdo01,31,SAS,0,MEM,3,0,0,0,0,0,16.21666667,0,0,1,4,1,4,0,0,0,0,0,3,3,3,3
2023-24,202401020SAC,1/2/2024,SAC vs CHO,Trey Lyles,lylestr01,19,SAC,1,CHO,9,3,1,0,0,0,16.6,0,3,3,6,3,5,0,0,0,0,4,10,12,13,14.1
2023-24,202401020PHI,1/2/2024,PHI vs CHI,Julian Phillips,phillju01,20,CHI,0,PHI,7,0,0,0,3,0,16.86666667,0,0,3,5,1,3,0,0,2,3,0,7,7,7,16
2023-24,202401020NOP,1/2/2024,NOP vs BRK,Day'Ron Sharpe,sharpda01,34,BRK,0,NOP,12,9,2,0,1,1,17.06666667,3,6,6,9,0,0,0,0,0,1,11,14,21,23,27.8
2023-24,202401020GSW,1/2/2024,GSW vs ORL,Kevon Looney,looneke01,33,GSW,1,ORL,5,5,2,0,0,0,17.33333333,1,4,1,2,0,0,3,4,4,0,7,7,10,12,14
2023-24,202401020OKC,1/2/2024,OKC vs BOS,Cason Wallace,wallaca01,32,OKC,1,BOS,5,1,3,1,0,0,17.4,1,0,2,3,1,2,0,0,3,1,4,8,6,9,13.7
2023-24,202401020SAC,1/2/2024,SAC vs CHO,Ish Smith,smithis01,26,CHO,0,SAC,4,6,4,1,0,4,18.25,1,5,2,4,0,0,0,0,1,1,10,8,10,14,16.2
2023-24,202401020PHI,1/2/2024,PHI vs CHI,Terry Taylor,taylote01,12,CHI,0,PHI,0,5,1,1,1,4,19.6,4,1,0,5,0,2,0,0,2,2,6,1,5,6,9.5
2023-24,202401020NOP,1/2/2024,NOP vs BRK,Dyson Daniels,daniedy01,34,NOP,1,BRK,7,2,3,2,2,1,19.63333333,1,1,2,5,1,4,2,2,0,4,5,10,9,12,24.9
2023-24,202401020OKC,1/2/2024,OKC vs BOS,Al Horford,horfoal01,28,BOS,0,OKC,7,2,3,1,5,0,19.71666667,0,2,3,5,1,3,0,0,0,6,5,10,9,12,31.9
2023-24,202401020NOP,1/2/2024,NOP vs BRK,Jonas Valanciunas,valanjo01,34,NOP,1,BRK,11,12,0,1,1,1,19.8,3,9,5,5,1,1,0,0,0,2,12,11,23,23,30.4
2023-24,202401020GSW,1/2/2024,GSW vs ORL,Wendell Carter Jr.,cartewe01,12,ORL,0,GSW,6,2,1,1,1,0,19.86666667,0,2,1,5,0,1,4,4,1,2,3,7,8,9,15.9
2023-24,202401020NOP,1/2/2024,NOP vs BRK,Dennis Smith Jr.,smithde03,20,BRK,0,NOP,9,1,4,1,0,1,19.86666667,0,1,3,7,2,4,1,2,1,1,5,13,10,14,18.2
2023-24,202401020NOP,1/2/2024,NOP vs BRK,Larry Nance Jr.,nancela02,17,NOP,1,BRK,6,8,0,2,0,1,19.9,2,6,2,4,1,2,1,2,2,2,8,6,14,14,20.6
2023-24,202401020SAC,1/2/2024,SAC vs CHO,Malik Monk,monkma01,31,SAC,1,CHO,6,3,2,0,1,1,20,1,2,2,7,2,5,0,0,2,1,5,8,9,11,14.6
2023-24,202401020NOP,1/2/2024,NOP vs BRK,Dorian Finney-Smith,finnedo01,31,BRK,0,NOP,3,4,1,2,0,0,20.1,1,3,1,6,1,4,0,0,1,2,5,4,7,8,15.3
2023-24,202401020NOP,1/2/2024,NOP vs BRK,Cam Thomas,thomaca02,25,BRK,0,NOP,0,2,0,1,0,1,20.3,1,1,0,11,0,4,0,0,0,1,2,0,2,2,4.4
2023-24,202401020MEM,1/2/2024,MEM vs SAS,Luke Kennard,kennalu01,10,MEM,1,SAS,12,5,3,0,0,0,20.71666667,1,4,3,7,3,7,3,3,2,0,8,15,17,20,22.5
2023-24,202401020PHI,1/2/2024,PHI vs CHI,Dalen Terry,terryda01,19,CHI,0,PHI,6,8,7,0,1,3,20.78333333,1,7,2,7,0,3,2,2,4,1,15,13,14,21,26.1
2023-24,202401020NOP,1/2/2024,NOP vs BRK,Spencer Dinwiddie,dinwisp01,32,BRK,0,NOP,0,0,5,0,0,1,21.28333333,0,0,0,6,0,4,0,0,1,0,5,5,0,5,6.5
2023-24,202401020PHI,1/2/2024,PHI vs CHI,Jaden Springer,sprinja01,20,PHI,1,CHI,4,2,2,1,1,2,21.28333333,2,0,2,4,0,2,0,0,4,2,4,6,6,8,13.4
2023-24,202401020GSW,1/2/2024,GSW vs ORL,Andrew Wiggins,wiggian01,29,GSW,1,ORL,10,3,0,2,0,1,21.33333333,0,3,4,7,1,3,1,3,1,2,3,10,13,13,18.6
2023-24,202401020SAC,1/2/2024,SAC vs CHO,Bryce McGowens,mcgowbr01,27,CHO,0,SAC,4,2,2,0,0,0,21.36666667,1,1,1,3,0,2,2,3,1,0,4,6,6,8,9.4
2023-24,202401020MEM,1/2/2024,MEM vs SAS,Blake Wesley,weslebl01,12,SAS,0,MEM,10,1,1,2,0,1,21.38333333,0,1,5,8,0,2,0,2,4,2,2,11,11,12,17.7
2023-24,202401020PHI,1/2/2024,PHI vs CHI,Alex Caruso,carusal01,29,CHI,0,PHI,8,2,2,0,1,2,21.45,1,1,3,10,1,6,1,2,0,1,4,10,10,12,14.4
2023-24,202401020NOP,1/2/2024,NOP vs BRK,Jose Alvarado,alvarjo01,20,NOP,1,BRK,13,3,2,2,0,1,21.96666667,1,2,4,9,3,6,2,3,2,2,5,15,16,18,24.6
2023-24,202401020MEM,1/2/2024,MEM vs SAS,Vince Williams Jr.,willivi01,25,MEM,1,SAS,8,5,2,0,0,2,21.96666667,1,4,3,6,2,5,0,0,5,0,7,10,13,15,15
2023-24,202401020PHI,1/2/2024,PHI vs CHI,Nicolas Batum,batumni01,22,PHI,1,CHI,6,3,2,0,1,1,22.38333333,2,1,2,4,1,3,1,1,2,1,5,8,9,11,14.6
2023-24,202401020MEM,1/2/2024,MEM vs SAS,Julian Champagnie,champju02,26,SAS,0,MEM,12,4,2,1,0,1,22.46666667,0,4,3,6,3,6,3,3,4,1,6,14,16,18,21.8
2023-24,202401020NOP,1/2/2024,NOP vs BRK,Nic Claxton,claxtni01,24,BRK,0,NOP,8,3,1,0,2,0,22.63333333,0,3,4,7,0,0,0,0,1,2,4,9,11,12,19.1
2023-24,202401020PHI,1/2/2024,PHI vs CHI,Jevon Carter,carteje01,35,CHI,0,PHI,9,1,1,4,0,0,22.83333333,0,1,3,11,3,8,0,0,0,4,2,10,10,11,23.7
2023-24,202401020GSW,1/2/2024,GSW vs ORL,Trayce Jackson-Davis,jackstr02,23,GSW,1,ORL,10,4,2,1,2,3,23.51666667,2,2,3,4,0,0,4,6,1,3,6,12,14,16,23.8
2023-24,202401020SAC,1/2/2024,SAC vs CHO,Harrison Barnes,barneha02,32,SAC,1,CHO,3,1,1,2,0,1,23.8,0,1,1,2,1,2,0,0,2,2,2,4,4,5,10.7
2023-24,202401020NOP,1/2/2024,NOP vs BRK,Herbert Jones,joneshe01,31,NOP,1,BRK,14,4,1,2,1,3,24.38333333,2,2,5,10,2,4,2,2,1,3,5,15,18,19,26.3
2023-24,202401020NOP,1/2/2024,NOP vs BRK,CJ McCollum,mccolcj01,21,NOP,1,BRK,16,6,5,0,0,2,24.5,2,4,6,11,4,8,0,0,0,0,11,21,22,27,28.7
2023-24,202401020NOP,1/2/2024,NOP vs BRK,Brandon Ingram,ingrabr01,31,NOP,1,BRK,12,5,5,0,1,1,24.98333333,1,4,5,9,2,2,0,0,2,1,10,17,17,22,27.5
2023-24,202401020MEM,1/2/2024,MEM vs SAS,Tre Jones,jonestr01,29,SAS,0,MEM,2,4,4,1,0,0,25.03333333,0,4,1,6,0,3,0,0,2,1,8,6,6,10,15.8
2023-24,202401020GSW,1/2/2024,GSW vs ORL,Klay Thompson,thompkl01,32,GSW,1,ORL,15,3,2,0,1,1,25.4,0,3,6,11,3,8,0,0,4,1,5,17,18,20,23.6
2023-24,202401020OKC,1/2/2024,OKC vs BOS,Payton Pritchard,pritcpa01,33,BOS,0,OKC,5,3,4,2,0,0,25.45,1,2,2,5,1,4,0,0,1,2,7,9,8,12,20.6
2023-24,202401020NOP,1/2/2024,NOP vs BRK,Zion Williamson,willizi01,28,NOP,1,BRK,10,3,5,0,1,4,25.63333333,1,2,5,9,0,0,0,0,3,1,8,15,13,18,20.1
2023-24,202401020GSW,1/2/2024,GSW vs ORL,Cole Anthony,anthoco01,33,ORL,0,GSW,8,4,2,0,1,2,25.81666667,3,1,3,8,1,2,1,1,4,1,6,10,12,14,16.8
2023-24,202401020SAC,1/2/2024,SAC vs CHO,Nick Richards,richani01,26,CHO,0,SAC,7,10,1,1,2,2,26.06666667,1,9,3,4,0,0,1,2,2,3,11,8,17,18,27.5
2023-24,202401020MEM,1/2/2024,MEM vs SAS,Victor Wembanyama,wembavi01,29,SAS,0,MEM,20,7,1,0,4,1,26.06666667,0,7,8,16,2,5,2,4,0,4,8,21,27,28,40.9
2023-24,202401020NOP,1/2/2024,NOP vs BRK,Jordan Hawkins,hawkijo01,29,NOP,1,BRK,11,0,1,0,2,0,26.1,0,0,3,13,2,8,3,4,0,2,1,12,11,12,18.5
2023-24,202401020GSW,1/2/2024,GSW vs ORL,Goga Bitadze,bitadgo01,30,ORL,0,GSW,13,7,1,1,1,0,26.21666667,3,4,6,6,1,1,0,0,3,2,8,14,20,21,28.9
2023-24,202401020NOP,1/2/2024,NOP vs BRK,Cameron Johnson,johnsca02,26,BRK,0,NOP,17,4,2,1,0,1,26.4,0,4,6,12,5,9,0,0,2,1,6,19,21,23,26.8
2023-24,202401020PHI,1/2/2024,PHI vs CHI,Kelly Oubre Jr.,oubreke01,22,PHI,1,CHI,16,3,3,3,0,1,26.71666667,0,3,5,8,3,5,3,3,3,3,6,19,19,22,32.1
2023-24,202401020OKC,1/2/2024,OKC vs BOS,Josh Giddey,giddejo01,31,OKC,1,BOS,23,8,6,0,0,3,26.88333333,1,7,8,14,4,7,3,3,0,0,14,29,31,37,38.6
2023-24,202401020MEM,1/2/2024,MEM vs SAS,Jeremy Sochan,sochaje01,33,SAS,0,MEM,12,2,1,0,2,1,27.73333333,0,2,4,6,1,2,3,4,1,2,3,13,14,15,20.9
2023-24,202401020NOP,1/2/2024,NOP vs BRK,Royce O'Neale,onealro01,33,BRK,0,NOP,0,8,5,1,0,3,27.9,4,4,0,6,0,5,0,0,3,1,13,5,8,13,17.1
2023-24,202401020MEM,1/2/2024,MEM vs SAS,Bismack Biyombo,biyombi01,27,MEM,1,SAS,4,8,1,1,3,2,27.93333333,2,6,2,4,0,0,0,0,4,4,9,5,12,13,25.1
2023-24,202401020MEM,1/2/2024,MEM vs SAS,Santi Aldama,aldamsa01,26,MEM,1,SAS,13,11,0,0,1,0,28.13333333,2,9,5,6,1,2,2,2,1,1,11,13,24,24,29.2
2023-24,202401020PHI,1/2/2024,PHI vs CHI,Andre Drummond,drumman01,35,CHI,0,PHI,11,17,0,1,1,2,28.4,10,7,5,13,0,1,1,4,2,2,17,11,28,28,35.4
2023-24,202401020GSW,1/2/2024,GSW vs ORL,Brandin Podziemski,podzibr01,27,GSW,1,ORL,10,4,2,2,0,0,28.43333333,1,3,4,7,1,3,1,4,2,2,6,12,14,16,23.8
2023-24,202401020PHI,1/2/2024,PHI vs CHI,Coby White,whiteco01,35,CHI,0,PHI,14,4,3,2,0,1,28.5,0,4,5,15,0,5,4,5,4,2,7,17,18,21,28.3
2023-24,202401020OKC,1/2/2024,OKC vs BOS,Derrick White,whitede01,30,BOS,0,OKC,19,5,6,1,1,2,28.5,0,5,7,12,5,9,0,0,4,2,11,25,24,30,38
2023-24,202401020GSW,1/2/2024,GSW vs ORL,Gary Harris,harriga01,26,ORL,0,GSW,8,2,2,0,0,0,28.7,0,2,3,7,2,6,0,0,1,0,4,10,10,12,13.4
2023-24,202401020NOP,1/2/2024,NOP vs BRK,Mikal Bridges,bridgmi01,34,BRK,0,NOP,13,3,2,0,0,4,29,2,1,4,11,2,5,3,3,0,0,5,15,16,18,15.6
2023-24,202401020SAC,1/2/2024,SAC vs CHO,P.J. Washington,washipj01,29,CHO,0,SAC,17,4,4,1,0,1,29.06666667,1,3,7,13,3,6,0,0,1,1,8,21,21,25,29.8
2023-24,202401020PHI,1/2/2024,PHI vs CHI,Tyrese Maxey,maxeyty01,32,PHI,1,CHI,21,1,5,0,0,1,29.31666667,0,1,6,12,4,7,5,6,2,0,6,26,22,27,28.7
2023-24,202401020SAC,1/2/2024,SAC vs CHO,Chris Duarte,duartch01,29,SAC,1,CHO,12,7,4,1,0,1,29.51666667,4,3,5,11,2,4,0,0,1,1,11,16,19,23,28.4
2023-24,202401020MEM,1/2/2024,MEM vs SAS,Marcus Smart,smartma01,16,MEM,1,SAS,5,2,3,0,0,3,29.71666667,1,1,1,7,0,4,3,4,3,0,5,8,7,10,8.9
2023-24,202401020PHI,1/2/2024,PHI vs CHI,Tobias Harris,harrito02,33,PHI,1,CHI,20,8,2,0,2,1,29.88333333,1,7,9,13,1,4,1,3,0,2,10,22,28,30,37.6
2023-24,202401020GSW,1/2/2024,GSW vs ORL,Chris Paul,paulch01,30,GSW,1,ORL,12,2,4,0,0,1,29.98333333,0,2,3,5,3,3,3,4,1,0,6,16,14,18,19.4
2023-24,202401020PHI,1/2/2024,PHI vs CHI,DeMar DeRozan,derozde01,33,CHI,0,PHI,16,4,3,0,0,1,30.41666667,0,4,5,10,0,3,6,7,4,0,7,19,20,23,24.3
2023-24,202401020OKC,1/2/2024,OKC vs BOS,Jrue Holiday,holidjr01,30,BOS,0,OKC,7,5,7,1,0,3,30.83333333,1,4,2,8,2,5,1,2,1,1,12,14,12,19,23.5
2023-24,202401020MEM,1/2/2024,MEM vs SAS,Keldon Johnson,johnske04,31,SAS,0,MEM,19,6,4,1,0,3,31.21666667,1,5,7,16,1,4,4,5,4,1,10,23,25,29,32.2
2023-24,202401020OKC,1/2/2024,OKC vs BOS,Jalen Williams,willija06,29,OKC,1,BOS,16,1,1,3,2,5,31.36666667,0,1,6,9,2,2,2,2,3,5,2,17,17,18,28.7
2023-24,202401020GSW,1/2/2024,GSW vs ORL,Jalen Suggs,suggsja01,29,ORL,0,GSW,10,2,3,0,0,4,31.38333333,1,1,3,14,3,7,1,2,2,0,5,13,12,15,12.9
2023-24,202401020PHI,1/2/2024,PHI vs CHI,Joel Embiid,embiijo01,26,PHI,1,CHI,31,15,10,1,2,4,31.45,0,15,10,20,2,5,9,12,4,3,25,41,46,56,69
2023-24,202401020PHI,1/2/2024,PHI vs CHI,Ayo Dosunmu,dosunay01,33,CHI,0,PHI,15,3,0,1,0,3,31.51666667,0,3,7,14,1,4,0,0,2,1,3,15,18,18,18.6
2023-24,202401020MEM,1/2/2024,MEM vs SAS,Jaren Jackson Jr.,jacksja02,33,MEM,1,SAS,10,7,1,3,4,1,32.01666667,1,6,3,14,1,4,3,4,4,7,8,11,17,18,39.9
2023-24,202401020OKC,1/2/2024,OKC vs BOS,Chet Holmgren,holmgch01,32,OKC,1,BOS,14,3,7,0,4,1,32.71666667,0,3,5,9,3,5,1,2,1,4,10,21,17,24,39.1
2023-24,202401020SAC,1/2/2024,SAC vs CHO,Cody Martin,martico01,6,CHO,0,SAC,10,2,2,1,0,1,32.76666667,0,2,4,10,1,5,1,2,2,1,4,12,12,14,17.4
2023-24,202401020GSW,1/2/2024,GSW vs ORL,Jonathan Kuminga,kuminjo01,32,GSW,1,ORL,19,6,4,0,2,1,34.03333333,2,4,7,14,1,5,4,5,2,2,10,23,25,29,37.2
2023-24,202401020MEM,1/2/2024,MEM vs SAS,Devin Vassell,vassede01,28,SAS,0,MEM,11,2,3,1,1,2,34.1,1,1,3,8,1,2,4,5,2,2,5,14,13,16,21.9
2023-24,202401020MEM,1/2/2024,MEM vs SAS,Desmond Bane,banede01,32,MEM,1,SAS,24,3,2,0,0,3,34.25,0,3,11,17,2,6,0,0,1,0,5,26,27,29,27.6
2023-24,202401020GSW,1/2/2024,GSW vs ORL,Paolo Banchero,banchpa01,33,ORL,0,GSW,27,12,6,2,1,5,34.38333333,4,8,8,20,3,8,8,11,4,3,18,33,39,45,54.4
2023-24,202401020SAC,1/2/2024,SAC vs CHO,Domantas Sabonis,sabondo01,32,SAC,1,CHO,23,19,4,1,0,11,34.81666667,9,10,11,21,1,1,0,1,5,1,23,27,42,46,43.8
2023-24,202401020OKC,1/2/2024,OKC vs BOS,Kristaps Porzingis,porzikr01,24,BOS,0,OKC,34,10,2,0,3,1,34.9,6,4,12,18,2,3,8,9,1,3,12,36,44,46,57
2023-24,202401020GSW,1/2/2024,GSW vs ORL,Stephen Curry,curryst01,31,GSW,1,ORL,36,2,6,4,1,2,35.23333333,1,1,12,20,4,9,8,11,4,5,8,42,38,44,60.4
2023-24,202401020MEM,1/2/2024,MEM vs SAS,Ja Morant,moranja01,7,MEM,1,SAS,26,5,10,1,0,4,35.31666667,0,5,7,15,3,9,9,12,3,1,15,36,31,41,46
2023-24,202401020SAC,1/2/2024,SAC vs CHO,Terry Rozier,roziete01,21,CHO,0,SAC,34,3,6,1,2,2,36.3,0,3,13,24,3,11,5,6,3,3,9,40,37,43,53.6
2023-24,202401020OKC,1/2/2024,OKC vs BOS,Shai Gilgeous-Alexander,gilgesh01,31,OKC,1,BOS,36,6,7,1,0,0,36.63333333,0,6,14,22,3,5,5,8,5,1,13,43,42,49,56.7
2023-24,202401020GSW,1/2/2024,GSW vs ORL,Franz Wagner,wagnefr01,33,ORL,0,GSW,25,6,3,2,0,4,36.68333333,2,4,10,19,1,5,4,4,4,2,9,28,31,34,38.7
2023-24,202401020OKC,1/2/2024,OKC vs BOS,Luguentz Dort,dortlu01,31,OKC,1,BOS,9,8,1,1,3,0,37.43333333,5,3,4,14,1,7,0,0,2,4,9,10,17,18,32.1
2023-24,202401020SAC,1/2/2024,SAC vs CHO,Keegan Murray,murrake02,28,SAC,1,CHO,10,3,2,3,0,1,37.48333333,1,2,4,12,1,6,1,2,5,3,5,12,13,15,24.6
2023-24,202401020OKC,1/2/2024,OKC vs BOS,Jayson Tatum,tatumja01,31,BOS,0,OKC,30,13,8,1,0,4,37.6,5,8,10,21,2,5,8,10,3,1,21,38,43,51,56.6
2023-24,202401020OKC,1/2/2024,OKC vs BOS,Jaylen Brown,brownja02,31,BOS,0,OKC,15,6,3,0,0,4,37.71666667,2,4,4,18,0,8,7,8,5,0,9,18,21,24,22.7
2023-24,202401020SAC,1/2/2024,SAC vs CHO,De'Aaron Fox,foxde01,26,SAC,1,CHO,30,5,6,1,1,3,37.78333333,0,5,11,25,3,10,5,8,2,2,11,36,35,41,48
2023-24,202401020SAC,1/2/2024,SAC vs CHO,Miles Bridges,bridgmi02,21,CHO,0,SAC,27,5,3,1,2,3,40.11666667,0,5,9,18,3,6,6,6,0,3,8,30,32,35,43.5
2023-24,202401010UTA,1/1/2024,UTA vs DAL,Dwight Powell,poweldw01,31,DAL,0,UTA,4,4,1,2,0,0,10.06666667,2,2,2,3,0,0,0,0,1,2,5,5,8,9,16.3
2023-24,202401010HOU,1/1/2024,HOU vs DET,Aaron Holiday,holidaa01,29,HOU,1,DET,0,3,4,0,0,0,10.65,1,2,0,3,0,1,0,0,1,0,7,4,3,7,9.6
2023-24,202401010TOR,1/1/2024,TOR vs CLE,Chris Boucher,bouchch01,30,TOR,1,CLE,0,1,0,0,0,0,11.35,0,1,0,0,0,0,0,0,0,0,1,0,1,1,1.2
2023-24,202401010MIL,1/1/2024,MIL vs IND,Jalen Smith,smithja04,20,IND,0,MIL,7,2,0,0,0,0,11.5,1,1,3,10,1,6,0,0,1,0,2,7,9,9,9.4
2023-24,202401010LAC,1/1/2024,LAC vs MIA,R.J. Hampton,hamptrj01,6,MIA,0,LAC,0,0,0,0,0,0,11.56666667,0,0,0,1,0,1,0,0,2,0,0,0,0,0,0
2023-24,202401010NYK,1/1/2024,NYK vs MIN,Jordan McLaughlin,mclaujo01,12,MIN,0,NYK,9,1,3,2,0,0,11.61666667,0,1,4,5,1,2,0,0,1,2,4,12,10,13,20.7
2023-24,202401010UTA,1/1/2024,UTA vs DAL,Dante Exum,exumda01,30,DAL,0,UTA,4,1,3,0,0,0,11.63333333,1,0,2,3,0,0,0,0,0,0,4,7,5,8,9.7
2023-24,202401010MIL,1/1/2024,MIL vs IND,Cameron Payne,payneca01,33,MIL,1,IND,5,1,2,1,0,2,11.68333333,1,0,1,4,0,2,3,3,1,1,3,7,6,8,10.2
2023-24,202401010PHO,1/1/2024,PHO vs POR,Ish Wainright,wainris01,6,POR,0,PHO,8,1,0,0,1,1,12.18333333,0,1,2,5,2,4,2,2,2,1,1,8,9,9,11.2
2023-24,202401010DEN,1/1/2024,DEN vs CHO,Nathan Mensah,mensana01,7,CHO,0,DEN,2,4,0,0,0,0,12.31666667,1,3,0,1,0,0,2,2,1,0,4,2,6,6,6.8
2023-24,202401010DEN,1/1/2024,DEN vs CHO,Julian Strawther,strawju01,32,DEN,1,CHO,2,1,1,0,0,1,12.56666667,0,1,1,2,0,1,0,0,1,0,2,3,3,4,3.7
2023-24,202401010HOU,1/1/2024,HOU vs DET,Isaiah Livers,liveris01,17,DET,0,HOU,2,0,0,0,0,0,13.13333333,0,0,1,2,0,0,0,0,0,0,0,2,2,2,2
2023-24,202401010HOU,1/1/2024,HOU vs DET,Reggie Bullock,bullore01,13,HOU,1,DET,7,2,2,0,0,1,14.13333333,0,2,3,5,1,2,0,0,0,0,4,9,9,11,11.4
2023-24,202401010TOR,1/1/2024,TOR vs CLE,Tristan Thompson,thomptr01,28,CLE,0,TOR,0,3,1,0,0,0,14.35,2,1,0,0,0,0,0,0,3,0,4,1,3,4,5.1
2023-24,202401010PHO,1/1/2024,PHO vs POR,Moses Brown,brownmo01,9,POR,0,PHO,2,6,1,0,1,2,15.7,0,6,1,2,0,0,0,0,2,1,7,3,8,9,11.7
2023-24,202401010TOR,1/1/2024,TOR vs CLE,Georges Niang,niangge01,33,CLE,0,TOR,8,4,2,0,0,1,16.25,0,4,4,5,0,1,0,0,5,0,6,10,12,14,14.8
2023-24,202401010LAC,1/1/2024,LAC vs MIA,Daniel Theis,theisda01,22,LAC,1,MIA,6,1,0,0,0,2,16.28333333,0,1,2,3,0,1,2,2,3,0,1,6,7,7,5.2
2023-24,202401010HOU,1/1/2024,HOU vs DET,James Wiseman,wisemja01,22,DET,0,HOU,4,4,0,0,1,1,16.45,1,3,1,1,0,0,2,2,5,1,4,4,8,8,10.8
2023-24,202401010PHO,1/1/2024,PHO vs POR,Keita Bates-Diop,bateske01,23,PHO,1,POR,3,3,1,2,0,0,16.73333333,0,3,1,1,1,1,0,0,1,2,4,4,6,7,14.1
2023-24,202401010NYK,1/1/2024,NYK vs MIN,Nickeil Alexander-Walker,alexani01,32,MIN,0,NYK,3,0,2,0,0,0,16.75,0,0,1,3,1,2,0,0,2,0,2,5,3,5,6
2023-24,202401010TOR,1/1/2024,TOR vs CLE,Sam Merrill,merrisa01,18,CLE,0,TOR,16,3,1,0,0,1,16.88333333,0,3,6,11,4,8,0,0,2,0,4,17,19,20,20.1
2023-24,202401010DEN,1/1/2024,DEN vs CHO,Reggie Jackson,jacksre01,35,DEN,1,CHO,15,4,4,1,0,0,17.06666667,0,4,6,11,2,3,1,2,2,1,8,19,19,23,28.8
2023-24,202401010NYK,1/1/2024,NYK vs MIN,Kyle Anderson,anderky01,32,MIN,0,NYK,2,2,3,2,0,3,17.38333333,0,2,1,1,0,0,0,2,0,2,5,5,4,7,11.9
2023-24,202401010PHO,1/1/2024,PHO vs POR,Skylar Mays,mayssk01,20,POR,0,PHO,7,2,3,0,1,1,17.48333333,1,1,3,8,1,3,0,0,1,1,5,10,9,12,15.9
2023-24,202401010UTA,1/1/2024,UTA vs DAL,John Collins,collijo01,30,UTA,1,DAL,15,5,1,1,0,0,17.63333333,0,5,7,13,0,5,1,1,1,1,6,16,20,21,25.5
2023-24,202401010LAC,1/1/2024,LAC vs MIA,Terance Mann,mannte01,26,LAC,1,MIA,12,3,0,0,0,1,17.78333333,1,2,5,7,1,2,1,1,2,0,3,12,15,15,14.6
2023-24,202401010MIL,1/1/2024,MIL vs IND,Bobby Portis,portibo01,33,MIL,1,IND,8,5,0,0,1,0,17.88333333,1,4,4,12,0,4,0,0,4,1,5,8,13,13,17
2023-24,202401010LAC,1/1/2024,LAC vs MIA,Russell Westbrook,westbru01,32,LAC,1,MIA,8,4,3,2,0,2,17.88333333,2,2,4,10,0,1,0,0,0,2,7,11,12,15,21.3
2023-24,202401010PHO,1/1/2024,PHO vs POR,Shaedon Sharpe,sharpsh01,27,POR,0,PHO,6,1,1,0,0,1,18.01666667,1,0,2,8,0,5,2,2,0,0,2,7,7,8,7.7
2023-24,202401010UTA,1/1/2024,UTA vs DAL,Grant Williams,willigr01,31,DAL,0,UTA,4,0,1,1,2,3,18.06666667,0,0,2,7,0,4,0,1,2,3,1,5,4,5,11.5
2023-24,202401010NYK,1/1/2024,NYK vs MIN,Quentin Grimes,grimequ01,30,NYK,1,MIN,10,3,1,0,0,0,18.23333333,2,1,3,4,2,3,2,2,1,0,4,11,13,14,15.1
2023-24,202401010PHO,1/1/2024,PHO vs POR,Josh Okogie,okogijo01,27,PHO,1,POR,3,2,3,0,1,1,18.46666667,0,2,1,2,0,0,1,2,1,1,5,6,5,8,11.9
2023-24,202401010LAC,1/1/2024,LAC vs MIA,Amir Coffey,coffeam01,20,LAC,1,MIA,5,1,2,0,0,0,18.53333333,1,0,2,3,1,2,0,0,2,0,3,7,6,8,9.2
2023-24,202401010HOU,1/1/2024,HOU vs DET,Killian Hayes,hayeski01,28,DET,0,HOU,8,1,3,1,0,1,18.83333333,0,1,3,8,1,2,1,4,2,1,4,11,9,12,15.7
2023-24,202401010UTA,1/1/2024,UTA vs DAL,Collin Sexton,sextoco01,34,UTA,1,DAL,8,3,6,0,0,1,18.88333333,1,2,2,8,0,3,4,4,1,0,9,14,11,17,19.6
2023-24,202401010DEN,1/1/2024,DEN vs CHO,Nick Smith Jr.,smithni01,16,CHO,0,DEN,5,3,2,0,1,2,18.93333333,2,1,2,8,1,3,0,0,2,1,5,7,8,10,12.6
2023-24,202401010UTA,1/1/2024,UTA vs DAL,Ochai Agbaji,agbajoc01,34,UTA,1,DAL,2,2,0,0,0,1,19,1,1,1,6,0,5,0,0,1,0,2,2,4,4,3.4
2023-24,202401010PHO,1/1/2024,PHO vs POR,Kris Murray,murrakr01,16,POR,0,PHO,6,2,1,1,1,0,19.01666667,1,1,3,5,0,2,0,0,2,2,3,7,8,9,15.9
2023-24,202401010DEN,1/1/2024,DEN vs CHO,Peyton Watson,watsope01,33,DEN,1,CHO,8,4,1,1,1,0,19.23333333,0,4,3,6,2,4,0,0,2,2,5,9,12,13,20.3
2023-24,202401010NYK,1/1/2024,NYK vs MIN,Naz Reid,reidna01,32,MIN,0,NYK,5,2,0,0,0,0,19.28333333,0,2,2,6,1,4,0,0,5,0,2,5,7,7,7.4
2023-24,202401010UTA,1/1/2024,UTA vs DAL,Kelly Olynyk,olynyke01,32,UTA,1,DAL,7,5,6,3,0,1,19.45,0,5,3,3,1,1,0,0,3,3,11,13,12,18,30
2023-24,202401010PHO,1/1/2024,PHO vs POR,Bol Bol,bolbo01,9,PHO,1,POR,11,9,1,0,0,2,19.9,2,7,4,6,1,2,2,2,5,0,10,12,20,21,21.3
2023-24,202401010PHO,1/1/2024,PHO vs POR,Eric Gordon,gordoer01,29,PHO,1,POR,12,3,1,1,0,1,20.21666667,0,3,4,10,2,6,2,5,0,1,4,13,15,16,19.1
2023-24,202401010MIL,1/1/2024,MIL vs IND,Isaiah Jackson,jacksis01,25,IND,0,MIL,18,9,1,1,0,2,20.36666667,2,7,6,9,0,0,6,7,5,1,10,19,27,28,31.3
2023-24,202401010UTA,1/1/2024,UTA vs DAL,Kris Dunn,dunnkr01,26,UTA,1,DAL,7,3,7,0,0,2,20.5,0,3,3,4,1,1,0,0,2,0,10,14,10,17,19.1
2023-24,202401010DEN,1/1/2024,DEN vs CHO,Zeke Nnaji,nnajize01,29,DEN,1,CHO,2,3,1,0,3,2,20.5,1,2,1,5,0,2,0,0,2,3,4,3,5,6,14.1
2023-24,202401010MIL,1/1/2024,MIL vs IND,Buddy Hield,hieldbu01,33,IND,0,MIL,0,3,0,0,0,0,20.6,2,1,0,6,0,4,0,0,2,0,3,0,3,3,3.6
2023-24,202401010TOR,1/1/2024,TOR vs CLE,Dean Wade,wadede01,26,CLE,0,TOR,2,3,0,1,0,0,20.73333333,0,3,1,2,0,1,0,0,2,1,3,2,5,5,8.6
2023-24,202401010PHO,1/1/2024,PHO vs POR,Malcolm Brogdon,brogdma01,25,POR,0,PHO,10,2,5,0,0,2,21.1,0,2,3,8,2,4,2,2,0,0,7,15,12,17,17.9
2023-24,202401010UTA,1/1/2024,UTA vs DAL,Josh Green,greenjo02,22,DAL,0,UTA,0,2,1,0,0,2,21.28333333,0,2,0,4,0,1,0,0,4,0,3,1,2,3,1.9
2023-24,202401010UTA,1/1/2024,UTA vs DAL,Jaden Hardy,hardyja02,29,DAL,0,UTA,17,3,1,0,0,2,21.36666667,0,3,6,15,5,9,0,0,0,0,4,18,20,21,20.1
2023-24,202401010MIL,1/1/2024,MIL vs IND,T.J. McConnell,mccontj01,25,IND,0,MIL,16,4,9,1,0,0,21.55,1,3,5,9,0,1,6,8,0,1,13,25,20,29,37.3
2023-24,202401010HOU,1/1/2024,HOU vs DET,Jalen Duren,durenja01,18,DET,0,HOU,12,14,1,0,0,1,22.33333333,3,11,6,8,0,0,0,0,5,0,15,13,26,27,29.3
2023-24,202401010LAC,1/1/2024,LAC vs MIA,Kevin Love,loveke01,26,MIA,0,LAC,17,4,3,0,2,1,22.5,2,2,7,11,1,5,2,2,2,2,7,20,21,24,31.3
2023-24,202401010HOU,1/1/2024,HOU vs DET,Alec Burks,burksal01,26,DET,0,HOU,21,2,2,1,1,2,22.7,0,2,6,11,3,6,6,6,2,2,4,23,23,25,30.4
2023-24,202401010UTA,1/1/2024,UTA vs DAL,Tim Hardaway Jr.,hardati02,31,DAL,0,UTA,6,2,0,0,0,1,22.7,0,2,3,9,0,6,0,0,1,0,2,6,8,8,7.4
2023-24,202401010DEN,1/1/2024,DEN vs CHO,Bryce McGowens,mcgowbr01,26,CHO,0,DEN,10,2,3,0,0,0,23.26666667,0,2,4,8,2,3,0,0,4,0,5,13,12,15,16.9
2023-24,202401010PHO,1/1/2024,PHO vs POR,Ibou Badji,badjiib01,4,POR,0,PHO,4,5,1,0,1,2,23.41666667,0,5,2,2,0,0,0,0,6,1,6,5,9,10,12.5
2023-24,202401010HOU,1/1/2024,HOU vs DET,Kevin Knox,knoxke01,15,DET,0,HOU,11,3,0,0,0,0,23.41666667,0,3,4,7,1,4,2,2,2,0,3,11,14,14,14.6
2023-24,202401010HOU,1/1/2024,HOU vs DET,Tari Eason,easonta01,22,HOU,1,DET,17,4,1,3,0,0,23.6,2,2,8,15,1,4,0,0,3,3,5,18,21,22,32.3
2023-24,202401010MIL,1/1/2024,MIL vs IND,Pat Connaughton,connapa01,27,MIL,1,IND,3,2,2,1,1,0,23.65,0,2,1,3,1,3,0,0,1,2,4,5,5,7,14.4
2023-24,202401010DEN,1/1/2024,DEN vs CHO,Christian Braun,braunch01,35,DEN,1,CHO,9,4,2,1,2,1,23.85,1,3,3,6,1,3,2,3,1,3,6,11,13,15,24.8
2023-24,202401010UTA,1/1/2024,UTA vs DAL,Derrick Jones Jr.,jonesde02,33,DAL,0,UTA,6,3,0,1,1,2,24.26666667,1,2,2,4,1,3,1,2,1,2,3,6,9,9,13.6
2023-24,202401010LAC,1/1/2024,LAC vs MIA,Kyle Lowry,lowryky01,29,MIA,0,LAC,8,1,3,0,0,3,24.4,1,0,3,5,0,1,2,2,3,0,4,11,9,12,10.7
2023-24,202401010HOU,1/1/2024,HOU vs DET,Ausar Thompson,thompau01,33,DET,0,HOU,5,4,2,0,2,2,24.43333333,1,3,2,4,0,0,1,2,2,2,6,7,9,11,16.8
2023-24,202401010UTA,1/1/2024,UTA vs DAL,Dereck Lively II,livelde01,28,DAL,0,UTA,10,6,2,1,1,0,24.6,2,4,5,8,0,0,0,0,1,2,8,12,16,18,26.2
2023-24,202401010DEN,1/1/2024,DEN vs CHO,Aaron Gordon,gordoaa01,29,DEN,1,CHO,10,2,0,1,1,0,24.63333333,1,1,4,5,1,1,1,2,0,2,2,10,12,12,18.4
2023-24,202401010DEN,1/1/2024,DEN vs CHO,Cody Martin,martico01,5,CHO,0,DEN,2,3,6,2,2,0,24.73333333,1,2,0,6,0,3,2,4,0,4,9,8,5,11,26.6
2023-24,202401010UTA,1/1/2024,UTA vs DAL,Lauri Markkanen,markkla01,24,UTA,1,DAL,17,4,1,1,1,1,24.75,2,2,6,12,4,8,1,1,0,2,5,18,21,22,28.3
2023-24,202401010PHO,1/1/2024,PHO vs POR,Jabari Walker,walkeja01,32,POR,0,PHO,10,9,0,1,0,1,25.1,2,7,3,7,0,2,4,6,2,1,9,10,19,19,22.8
2023-24,202401010PHO,1/1/2024,PHO vs POR,Jusuf Nurkic,nurkiju01,31,PHO,1,POR,18,7,5,1,2,2,25.13333333,1,6,6,8,1,2,5,6,3,3,12,23,25,30,40.9
2023-24,202401010PHO,1/1/2024,PHO vs POR,Jerami Grant,grantje01,28,POR,0,PHO,15,1,3,1,1,3,25.18333333,0,1,6,12,1,3,2,3,1,2,4,18,16,19,23.7
2023-24,202401010NYK,1/1/2024,NYK vs MIN,Donte DiVincenzo,divindo01,33,NYK,1,MIN,15,4,2,1,1,1,25.61666667,1,3,5,11,2,6,3,4,0,2,6,17,19,21,27.8
2023-24,202401010DEN,1/1/2024,DEN vs CHO,P.J. Washington,washipj01,28,CHO,0,DEN,6,6,0,0,0,2,25.61666667,1,5,2,5,1,3,1,1,2,0,6,6,12,12,11.2
2023-24,202401010HOU,1/1/2024,HOU vs DET,Jaden Ivey,iveyja01,29,DET,0,HOU,19,6,3,0,0,2,25.93333333,4,2,6,10,3,4,4,4,1,0,9,22,25,28,28.7
2023-24,202401010HOU,1/1/2024,HOU vs DET,Fred VanVleet,vanvlfr01,30,HOU,1,DET,15,1,7,1,0,1,25.95,0,1,6,11,3,6,0,0,1,1,8,22,16,23,28.7
2023-24,202401010TOR,1/1/2024,TOR vs CLE,Gary Trent Jr.,trentga02,30,TOR,1,CLE,9,6,2,1,0,0,26.06666667,2,4,3,10,1,5,2,2,1,1,8,11,15,17,22.2
2023-24,202401010PHO,1/1/2024,PHO vs POR,Chimezie Metu,metuch01,23,PHO,1,POR,14,5,1,1,0,2,26.08333333,2,3,4,8,2,4,4,4,3,1,6,15,19,20,22.5
2023-24,202401010LAC,1/1/2024,LAC vs MIA,Duncan Robinson,robindu01,31,MIA,0,LAC,15,1,2,0,0,1,26.08333333,0,1,3,8,3,7,6,6,1,0,3,17,16,18,18.2
2023-24,202401010HOU,1/1/2024,HOU vs DET,Jae'Sean Tate,tateja01,29,HOU,1,DET,16,3,0,1,0,1,26.21666667,0,3,6,10,0,2,4,6,6,1,3,16,19,19,21.6
2023-24,202401010UTA,1/1/2024,UTA vs DAL,Walker Kessler,kesslwa01,26,UTA,1,DAL,11,10,0,1,4,1,26.56666667,0,10,5,6,0,1,1,2,2,5,10,11,21,21,37
2023-24,202401010HOU,1/1/2024,HOU vs DET,Bojan Bogdanovic,bogdabo02,14,DET,0,HOU,14,2,2,0,0,4,26.66666667,1,1,4,11,3,6,3,4,0,0,4,16,16,18,15.4
2023-24,202401010DEN,1/1/2024,DEN vs CHO,Jamal Murray,murraja01,21,DEN,1,CHO,25,3,7,2,1,2,26.8,0,3,7,16,5,9,6,7,1,3,10,32,28,35,46.1
2023-24,202401010HOU,1/1/2024,HOU vs DET,Jabari Smith Jr.,smithja05,30,HOU,1,DET,9,6,1,0,1,1,26.95,0,6,3,7,3,5,0,0,1,1,7,10,15,16,19.7
2023-24,202401010MIL,1/1/2024,MIL vs IND,Aaron Nesmith,nesmiaa01,31,IND,0,MIL,4,5,0,3,2,0,27.35,1,4,1,10,1,7,1,2,4,5,5,4,9,9,25
2023-24,202401010TOR,1/1/2024,TOR vs CLE,Isaac Okoro,okorois01,24,CLE,0,TOR,16,1,3,2,1,1,27.43333333,0,1,5,10,0,4,6,7,4,3,4,19,17,20,29.7
2023-24,202401010HOU,1/1/2024,HOU vs DET,Jalen Green,greenja05,31,HOU,1,DET,22,5,1,1,0,0,27.46666667,0,5,6,12,5,9,5,6,0,1,6,23,27,28,32.5
2023-24,202401010HOU,1/1/2024,HOU vs DET,Alperen Sengun,sengual01,31,HOU,1,DET,26,4,9,3,0,2,27.46666667,1,3,9,13,0,2,8,9,3,3,13,35,30,39,51.3
2023-24,202401010DEN,1/1/2024,DEN vs CHO,Nikola Jokic,jokicni01,34,DEN,1,CHO,13,11,6,1,1,3,27.5,0,11,6,7,0,0,1,1,2,2,17,19,24,30,38.2
2023-24,202401010MIL,1/1/2024,MIL vs IND,Myles Turner,turnemy01,32,IND,0,MIL,13,4,0,0,2,0,27.63333333,1,3,3,5,0,2,7,7,5,2,4,13,17,17,23.8
2023-24,202401010UTA,1/1/2024,UTA vs DAL,Jordan Clarkson,clarkjo01,24,UTA,1,DAL,20,10,11,1,0,4,27.7,2,8,8,16,1,6,3,3,4,1,21,31,30,41,47.5
2023-24,202401010PHO,1/1/2024,PHO vs POR,Grayson Allen,allengr01,28,PHO,1,POR,12,2,4,2,1,1,27.85,0,2,4,7,2,5,2,2,1,3,6,16,14,18,28.4
2023-24,202401010TOR,1/1/2024,TOR vs CLE,Immanuel Quickley,quickim01,31,TOR,1,CLE,14,6,3,2,0,0,28.01666667,0,6,5,13,2,5,2,3,4,2,9,17,20,23,31.7
2023-24,202401010HOU,1/1/2024,HOU vs DET,Amen Thompson,thompam01,12,HOU,1,DET,12,4,6,2,0,2,28.43333333,1,3,5,6,1,1,1,1,3,2,10,18,16,22,29.8
2023-24,202401010NYK,1/1/2024,NYK vs MIN,Josh Hart,hartjo01,33,NYK,1,MIN,8,11,2,0,0,1,28.8,2,9,3,7,2,3,0,0,2,0,13,10,19,21,23.2
2023-24,202401010LAC,1/1/2024,LAC vs MIA,Ivica Zubac,zubaciv01,32,LAC,1,MIA,6,12,1,0,0,1,28.8,1,11,3,4,0,0,0,0,4,0,13,7,18,19,20.9
2023-24,202401010NYK,1/1/2024,NYK vs MIN,Mike Conley,conlemi01,32,MIN,0,NYK,5,2,5,1,1,0,28.83333333,0,2,2,6,0,1,1,1,1,2,7,10,7,12,20.9
2023-24,202401010UTA,1/1/2024,UTA vs DAL,Keyonte George,georgke01,28,UTA,1,DAL,14,3,3,0,0,0,28.91666667,0,3,3,8,2,6,6,6,1,0,6,17,17,20,22.1
2023-24,202401010PHO,1/1/2024,PHO vs POR,Matisse Thybulle,thybuma01,32,POR,0,PHO,3,4,0,2,2,0,28.98333333,1,3,1,5,1,4,0,0,2,4,4,3,7,7,19.8
2023-24,202401010UTA,1/1/2024,UTA vs DAL,Simone Fontecchio,fontesi01,32,UTA,1,DAL,24,6,2,2,1,1,29,0,6,10,16,3,8,1,1,0,3,8,26,30,32,42.2
2023-24,202401010DEN,1/1/2024,DEN vs CHO,Ish Smith,smithis01,25,CHO,0,DEN,10,3,4,0,0,4,29.06666667,1,2,5,12,0,0,0,0,2,0,7,14,13,17,15.6
2023-24,202401010DEN,1/1/2024,DEN vs CHO,Kentavious Caldwell-Pope,caldwke01,33,DEN,1,CHO,5,3,4,1,0,0,29.08333333,0,3,2,6,0,3,1,1,3,1,7,9,8,12,17.6
2023-24,202401010TOR,1/1/2024,TOR vs CLE,Caris LeVert,leverca01,25,CLE,0,TOR,31,4,4,0,0,0,29.31666667,0,4,12,20,2,7,5,5,0,0,8,35,35,39,41.8
2023-24,202401010TOR,1/1/2024,TOR vs CLE,RJ Barrett,barrerj01,27,TOR,1,CLE,19,9,1,0,0,5,29.41666667,3,6,6,12,1,2,6,8,5,0,10,20,28,29,26.3
2023-24,202401010MIL,1/1/2024,MIL vs IND,Obi Toppin,toppiob01,33,IND,0,MIL,11,3,2,1,0,0,29.48333333,2,1,4,9,1,3,2,2,4,1,5,13,14,16,20.6
2023-24,202401010TOR,1/1/2024,TOR vs CLE,Dennis Schroder,schrode01,33,TOR,1,CLE,12,3,8,0,0,1,29.7,0,3,3,7,1,5,5,7,2,0,11,20,15,23,26.6
2023-24,202401010DEN,1/1/2024,DEN vs CHO,Nick Richards,richani01,25,CHO,0,DEN,15,8,1,1,1,0,29.95,2,6,7,12,0,0,1,2,2,2,9,16,23,24,32.1
2023-24,202401010HOU,1/1/2024,HOU vs DET,Cade Cunningham,cunnica01,33,DET,0,HOU,6,1,10,0,0,4,30.03333333,0,1,3,16,0,5,0,1,2,0,11,16,7,17,18.2
2023-24,202401010DEN,1/1/2024,DEN vs CHO,Michael Porter Jr.,portemi01,35,DEN,1,CHO,22,8,1,0,0,1,30.5,1,7,8,17,4,11,2,2,1,0,9,23,30,31,32.1
2023-24,202401010PHO,1/1/2024,PHO vs POR,Devin Booker,bookede01,24,PHO,1,POR,10,8,6,1,0,2,30.95,3,5,4,16,1,4,1,2,2,1,14,16,18,24,29.6
2023-24,202401010LAC,1/1/2024,LAC vs MIA,James Harden,hardeja01,27,LAC,1,MIA,15,4,10,1,2,2,31.48333333,0,4,5,8,3,5,2,2,1,3,14,25,19,29,41.8
2023-24,202401010MIL,1/1/2024,MIL vs IND,Khris Middleton,middlkh01,28,MIL,1,IND,21,3,6,1,0,4,31.66666667,1,2,9,13,2,5,1,2,5,1,9,27,24,30,32.6
2023-24,202401010DEN,1/1/2024,DEN vs CHO,Brandon Miller,millebr02,28,CHO,0,DEN,15,5,1,0,0,2,31.83333333,0,5,5,17,3,9,2,2,1,0,6,16,20,21,20.5
2023-24,202401010NYK,1/1/2024,NYK vs MIN,Karl-Anthony Towns,townska01,31,MIN,0,NYK,29,6,3,0,0,3,31.86666667,1,5,10,18,3,5,6,6,5,0,9,32,35,38,37.7
2023-24,202401010UTA,1/1/2024,UTA vs DAL,Kyrie Irving,irvinky01,18,DAL,0,UTA,14,9,4,0,1,1,32.18333333,1,8,6,14,2,3,0,1,3,1,13,18,23,27,32.8
2023-24,202401010LAC,1/1/2024,LAC vs MIA,Norman Powell,powelno01,32,LAC,1,MIA,22,2,2,2,0,1,33.01666667,0,2,9,11,4,5,0,0,4,2,4,24,24,26,32.4
2023-24,202401010NYK,1/1/2024,NYK vs MIN,Jaden McDaniels,mcdanja02,22,MIN,0,NYK,8,1,0,1,1,1,33.3,1,0,2,8,1,5,3,4,4,2,1,8,9,9,14.2
2023-24,202401010TOR,1/1/2024,TOR vs CLE,Jarrett Allen,allenja01,28,CLE,0,TOR,16,11,4,1,0,0,33.61666667,3,8,5,11,0,0,6,8,4,1,15,20,27,31,38.2
2023-24,202401010LAC,1/1/2024,LAC vs MIA,Kawhi Leonard,leonaka01,28,LAC,1,MIA,24,6,5,4,1,2,33.7,1,5,10,19,2,5,2,3,0,5,11,29,30,35,51.7
2023-24,202401010UTA,1/1/2024,UTA vs DAL,Luka Doncic,doncilu01,31,DAL,0,UTA,19,6,14,1,0,4,33.73333333,0,6,6,20,3,13,4,6,1,1,20,33,25,39,46.2
2023-24,202401010LAC,1/1/2024,LAC vs MIA,Paul George,georgpa01,30,LAC,1,MIA,23,3,2,1,0,3,33.76666667,0,3,7,14,3,8,6,6,4,1,5,25,26,28,29.6
2023-24,202401010PHO,1/1/2024,PHO vs POR,Scoot Henderson,hendesc01,23,POR,0,PHO,17,3,6,1,2,5,33.8,0,3,7,18,1,3,2,4,1,3,9,23,20,26,33.6
2023-24,202401010PHO,1/1/2024,PHO vs POR,Bradley Beal,bealbr01,9,PHO,1,POR,21,4,1,1,1,4,34.23333333,0,4,8,16,1,3,4,4,2,2,5,22,25,26,29.3
2023-24,202401010LAC,1/1/2024,LAC vs MIA,Jamal Cain,cainja01,12,MIA,0,LAC,9,3,1,1,1,0,34.51666667,3,0,4,12,1,4,0,0,3,2,4,10,12,13,20.1
2023-24,202401010LAC,1/1/2024,LAC vs MIA,Tyler Herro,herroty01,15,MIA,0,LAC,12,6,6,2,0,3,34.58333333,0,6,4,13,4,8,0,0,1,2,12,18,18,24,31.2
2023-24,202401010NYK,1/1/2024,NYK vs MIN,OG Anunoby,anunoog01,28,NYK,1,MIN,17,6,1,2,0,1,35.03333333,3,3,7,12,3,6,0,0,6,2,7,18,23,24,30.7
2023-24,202401010LAC,1/1/2024,LAC vs MIA,Bam Adebayo,adebaba01,23,MIA,0,LAC,21,15,4,0,0,3,35.75,3,12,6,17,0,2,9,13,3,0,19,25,36,40,42
2023-24,202401010TOR,1/1/2024,TOR vs CLE,Scottie Barnes,barnesc01,33,TOR,1,CLE,20,6,5,1,1,0,35.96666667,1,5,7,17,1,5,5,7,3,2,11,25,26,31,40.7
2023-24,202401010DEN,1/1/2024,DEN vs CHO,Miles Bridges,bridgmi02,20,CHO,0,DEN,26,9,5,1,0,2,36.01666667,0,9,10,14,3,5,3,5,1,1,14,31,35,40,45.3
2023-24,202401010NYK,1/1/2024,NYK vs MIN,Julius Randle,randlju01,33,NYK,1,MIN,39,9,0,0,0,6,36.31666667,3,6,14,24,2,6,9,13,5,0,9,39,48,48,43.8
2023-24,202401010MIL,1/1/2024,MIL vs IND,Bennedict Mathurin,mathube01,33,IND,0,MIL,25,13,0,0,0,1,36.43333333,3,10,9,15,1,5,6,9,3,0,13,25,38,38,39.6
2023-24,202401010MIL,1/1/2024,MIL vs IND,Tyrese Haliburton,halibty01,30,IND,0,MIL,26,9,11,1,1,2,36.73333333,1,8,11,22,1,7,3,3,0,2,20,37,35,46,57.3
2023-24,202401010MIL,1/1/2024,MIL vs IND,Malik Beasley,beaslma01,31,MIL,1,IND,12,4,0,0,0,0,36.85,0,4,4,8,4,8,0,0,5,0,4,12,16,16,16.8
2023-24,202401010MIL,1/1/2024,MIL vs IND,Giannis Antetokounmpo,antetgi01,32,MIL,1,IND,30,18,11,1,2,4,36.91666667,3,15,11,20,0,3,8,11,3,3,29,41,48,59,73.1
2023-24,202401010TOR,1/1/2024,TOR vs CLE,Jakob Poeltl,poeltja01,33,TOR,1,CLE,14,11,4,0,3,4,37.11666667,4,7,5,8,0,0,4,7,4,3,15,18,25,29,38.2
2023-24,202401010TOR,1/1/2024,TOR vs CLE,Max Strus,strusma01,33,CLE,0,TOR,6,6,3,1,1,3,37.35,0,6,2,7,2,5,0,0,4,2,9,9,12,15,20.7
2023-24,202401010NYK,1/1/2024,NYK vs MIN,Anthony Edwards,edwaran01,29,MIN,0,NYK,35,4,2,0,2,4,37.51666667,0,4,11,21,4,9,9,10,1,2,6,37,39,41,44.8
2023-24,202401010NYK,1/1/2024,NYK vs MIN,Rudy Gobert,goberru01,32,MIN,0,NYK,10,15,1,0,0,1,37.8,2,13,3,8,0,0,4,6,2,0,16,11,25,26,28.5
2023-24,202401010TOR,1/1/2024,TOR vs CLE,Donovan Mitchell,mitchdo01,24,CLE,0,TOR,26,7,7,4,0,3,37.98333333,1,6,8,21,4,9,6,6,4,4,14,33,33,40,53.9
2023-24,202401010MIL,1/1/2024,MIL vs IND,Damian Lillard,lillada01,31,MIL,1,IND,13,7,5,0,0,1,38.16666667,1,6,3,16,1,9,6,6,3,0,12,18,20,25,27.9
2023-24,202401010MIL,1/1/2024,MIL vs IND,Brook Lopez,lopezbr01,33,MIL,1,IND,21,5,1,0,4,0,38.33333333,1,4,8,17,2,6,3,4,3,4,6,22,26,27,40.5
2023-24,202401010LAC,1/1/2024,LAC vs MIA,Jaime Jaquez Jr.,jaqueja01,33,MIA,0,LAC,15,4,2,4,0,2,38.48333333,3,1,6,13,0,3,3,4,2,4,6,17,19,21,32.8
2023-24,202401010NYK,1/1/2024,NYK vs MIN,Isaiah Hartenstein,harteis01,33,NYK,1,MIN,7,9,3,3,3,1,39.15,4,5,2,3,0,0,3,4,3,6,12,10,16,19,39.3
2023-24,202401010TOR,1/1/2024,TOR vs CLE,Pascal Siakam,siakapa01,33,TOR,1,CLE,36,5,2,1,0,1,40.35,0,5,13,20,5,8,5,6,3,1,7,38,41,43,47
2023-24,202401010NYK,1/1/2024,NYK vs MIN,Jalen Brunson,brunsja01,33,NYK,1,MIN,16,4,14,1,0,2,40.66666667,0,4,5,23,1,9,5,5,4,1,18,30,20,34,42.8
